,Player,Nation,Pos,Squad,Comp,Age,Born,90s,Tackles,Tackles_Won,Tackles_Def_3rd,Tackles_Mid_3rd,Tackles_Att_3rd,Dribblers_Tackled,Dribblers_Challenged,Dribblers_Tackle_W%,Dribblers_Tackle_Lost,Blocks,Shots_Blocked,Passes_Blocked,Interceptions,Tackles+Interceptions,Clearances,Errors_Shots,Matches
0,Patrick van Aanholt,nl NED,DF,Crystal Palace,eng Premier League,28,1990,27.9,43,23,31,10,2,23,50,46.0,27,31,9,22,45,88,52,1,Matches
1,Max Aarons,eng ENG,DF,Norwich City,eng Premier League,19,2000,36.0,48,30,33,9,6,18,36,50.0,18,46,29,17,37,85,97,1,Matches
2,Yunis Abdelhamid,ma MAR,DF,Reims,fr Ligue 1,31,1987,28.0,46,33,29,15,2,17,30,56.7,13,26,14,12,47,93,99,1,Matches
3,Suleiman Abdullahi,ng NGA,"FW,MF",Union Berlin,de Bundesliga,22,1996,1.7,0,0,0,0,0,0,3,0.0,3,2,1,1,1,1,1,0,Matches
4,Mehdi Abeid,dz ALG,MF,Nantes,fr Ligue 1,26,1992,20.2,55,29,18,32,5,20,53,37.7,33,16,3,13,23,78,8,1,Matches
5,Charles Abi,fr FRA,FW,Saint-Étienne,fr Ligue 1,19,2000,6.9,9,9,2,5,2,2,7,28.6,5,2,0,2,4,13,4,0,Matches
6,David Abraham,ar ARG,DF,Eint Frankfurt,de Bundesliga,33,1986,18.8,21,14,16,4,1,15,32,46.9,17,27,11,16,25,46,61,1,Matches
7,Tammy Abraham,eng ENG,FW,Chelsea,eng Premier League,21,1997,24.6,8,4,2,5,1,3,14,21.4,11,20,2,18,6,14,27,0,Matches
8,Amir Abrashi,al ALB,MF,Freiburg,de Bundesliga,29,1990,7.4,16,8,7,8,1,10,19,52.6,9,18,3,15,7,23,16,2,Matches
9,Francesco Acerbi,it ITA,DF,Lazio,it Serie A,31,1988,35.1,59,29,42,12,5,14,20,70.0,6,40,27,13,42,101,109,1,Matches
10,Che Adams,sct SCO,FW,Southampton,eng Premier League,23,1996,12.3,6,4,1,5,0,1,4,25.0,3,9,1,8,2,8,10,0,Matches
11,Tyler Adams,us USA,"MF,DF",RB Leipzig,de Bundesliga,20,1999,10.6,22,15,13,8,1,12,25,48.0,13,16,1,15,14,36,14,0,Matches
12,Sargis Adamyan,am ARM,"FW,MF",Hoffenheim,de Bundesliga,26,1993,8.3,11,7,3,6,2,3,21,14.3,18,8,1,7,2,13,4,0,Matches
13,Antonio Adán,es ESP,GK,Atlético Madrid,es La Liga,32,1987,0.3,0,0,0,0,0,0,0,,0,0,0,0,0,0,0,0,Matches
14,Bobby Adekanye,nl NED,FW,Lazio,it Serie A,20,1999,2.1,3,2,0,3,0,0,5,0.0,5,0,0,0,2,5,1,0,Matches
15,Claud Adjapong,it ITA,DF,Hellas Verona,it Serie A,21,1998,2.6,5,3,4,1,0,2,3,66.7,1,4,3,1,3,8,7,0,Matches
16,Amine Adli,ma MAR,"MF,FW",Toulouse,fr Ligue 1,19,2000,0.5,0,0,0,0,0,0,1,0.0,1,0,0,0,1,1,0,0,Matches
17,Yacine Adli,fr FRA,MF,Bordeaux,fr Ligue 1,19,2000,11.3,22,14,4,15,3,11,34,32.4,23,10,0,10,8,30,3,0,Matches
18,Adrián,es ESP,GK,Liverpool,eng Premier League,32,1987,9.7,1,1,1,0,0,1,1,100.0,0,0,0,0,0,1,8,3,Matches
19,Aritz Aduriz,es ESP,"FW,MF",Athletic Club,es La Liga,38,1981,2.3,3,2,0,3,0,0,0,,0,0,0,0,0,3,2,0,Matches
20,Lumor Agbenyenu,gh GHA,DF,Mallorca,es La Liga,22,1996,20.1,31,21,19,9,3,16,35,45.7,19,13,2,11,21,52,66,1,Matches
21,Martin Agirregabiria,es ESP,DF,Alavés,es La Liga,23,1996,23.3,55,30,32,18,5,30,54,55.6,24,19,7,12,18,73,48,0,Matches
22,Lucien Agoume,fr FRA,MF,Inter,it Serie A,17,2002,0.8,3,2,0,2,1,0,0,,0,3,1,2,0,3,0,0,Matches
23,Kevin Agudelo,co COL,"MF,FW",Fiorentina,it Serie A,20,1998,0.7,2,1,0,1,1,0,1,0.0,1,1,0,1,1,3,0,0,Matches
24,Kevin Agudelo,co COL,"MF,FW",Genoa,it Serie A,20,1998,7.4,23,14,9,12,2,10,20,50.0,10,12,1,11,6,29,2,0,Matches
25,Nayef Aguerd,ma MAR,DF,Dijon,fr Ligue 1,23,1996,10.6,13,9,7,5,1,8,12,66.7,4,11,11,0,18,31,54,0,Matches
26,Sergio Agüero,ar ARG,FW,Manchester City,eng Premier League,31,1988,16.1,7,4,0,4,3,1,8,12.5,7,9,1,8,3,10,2,0,Matches
27,Ruben Aguilar,fr FRA,DF,Monaco,fr Ligue 1,26,1993,11.9,36,22,19,15,2,19,28,67.9,9,6,2,4,11,47,21,0,Matches
28,Emmanuel Agyemang-Badu,gh GHA,MF,Hellas Verona,it Serie A,28,1990,2.6,1,1,0,1,0,1,2,50.0,1,2,2,0,1,2,6,0,Matches
29,Jean-Eudes Aholou,ci CIV,MF,Saint-Étienne,fr Ligue 1,25,1994,7.0,16,12,2,11,3,3,9,33.3,6,6,1,5,15,31,10,0,Matches
30,Joseph Aidoo,gh GHA,DF,Celta Vigo,es La Liga,23,1995,27.8,43,27,30,11,2,13,27,48.1,14,31,14,17,45,88,124,3,Matches
31,Ola Aina,ng NGA,DF,Torino,it Serie A,22,1996,23.1,45,24,23,18,4,17,37,45.9,20,24,6,18,41,86,61,0,Matches
32,Youssef Aït Bennasser,ma MAR,MF,Bordeaux,fr Ligue 1,23,1996,6.0,11,8,6,4,1,4,24,16.7,20,6,1,5,4,15,10,1,Matches
33,Rayan Aït-Nouri,dz ALG,DF,Angers,fr Ligue 1,18,2001,14.2,29,22,14,8,7,10,21,47.6,11,14,1,13,18,47,33,0,Matches
34,Albian Ajeti,ch SUI,FW,West Ham,eng Premier League,22,1997,1.5,1,0,0,0,1,0,0,,0,0,0,0,0,1,0,0,Matches
35,Ludovic Ajorque,fr FRA,FW,Strasbourg,fr Ligue 1,25,1994,22.9,15,10,2,10,3,2,13,15.4,11,11,0,11,2,17,20,0,Matches
36,Manuel Akanji,ch SUI,DF,Dortmund,de Bundesliga,24,1995,25.7,38,21,23,14,1,12,20,60.0,8,20,11,9,30,68,61,2,Matches
37,Marley Aké,fr FRA,"FW,MF",Marseille,fr Ligue 1,18,2001,1.1,2,2,1,1,0,1,3,33.3,2,0,0,0,1,3,1,0,Matches
38,Nathan Aké,nl NED,DF,Bournemouth,eng Premier League,24,1995,27.8,31,21,23,8,0,14,23,60.9,9,40,29,11,36,67,152,0,Matches
39,Chadrac Akolo,cd COD,"FW,MF",Amiens,fr Ligue 1,24,1995,6.0,16,8,8,6,2,5,12,41.7,7,6,1,5,5,21,5,0,Matches
40,Kevin Akpoguma,ng NGA,DF,Hoffenheim,de Bundesliga,24,1995,12.7,24,16,20,4,0,13,24,54.2,11,21,11,10,13,37,48,0,Matches
41,David Alaba,at AUT,DF,Bayern Munich,de Bundesliga,27,1992,27.8,30,17,14,15,1,16,25,64.0,9,19,10,9,29,59,40,0,Matches
42,Sofiane Alakouch,ma MAR,DF,Nîmes,fr Ligue 1,21,1998,15.6,45,26,25,13,7,25,48,52.1,23,13,2,11,23,68,39,3,Matches
43,Lucas Alario,ar ARG,FW,Leverkusen,de Bundesliga,26,1992,13.0,6,3,0,4,2,1,8,12.5,7,12,2,10,1,7,9,0,Matches
44,Jordi Alba,es ESP,DF,Barcelona,es La Liga,30,1989,24.3,20,13,9,7,4,6,27,22.2,21,12,3,9,37,57,40,0,Matches
45,Luis Alberto,es ESP,MF,Lazio,it Serie A,26,1992,34.6,50,30,21,19,10,27,82,32.9,55,32,1,31,21,71,9,1,Matches
46,Raúl Albiol,es ESP,DF,Villarreal,es La Liga,33,1985,36.0,43,23,27,16,0,18,27,66.7,9,29,21,8,42,85,175,2,Matches
47,Marc Albrighton,eng ENG,"MF,DF",Leicester City,eng Premier League,29,1989,9.6,24,17,10,13,1,9,30,30.0,21,19,2,17,10,34,8,0,Matches
48,Paco Alcácer,es ESP,FW,Villarreal,es La Liga,25,1993,10.3,3,3,2,1,0,1,7,14.3,6,4,1,3,2,5,10,0,Matches
49,Paco Alcácer,es ESP,FW,Dortmund,de Bundesliga,25,1993,5.9,2,2,0,2,0,1,5,20.0,4,4,1,3,2,4,3,0,Matches
50,Thiago Alcántara,es ESP,MF,Bayern Munich,de Bundesliga,28,1991,19.7,45,26,17,23,5,12,33,36.4,21,12,3,9,45,90,13,1,Matches
51,Rubén Alcaraz,es ESP,MF,Valladolid,es La Liga,28,1991,21.4,61,30,37,20,4,30,63,47.6,33,46,15,31,15,76,41,0,Matches
52,Toby Alderweireld,be BEL,DF,Tottenham,eng Premier League,30,1989,32.9,40,29,24,13,3,11,24,45.8,13,48,32,16,31,71,172,2,Matches
53,Haitam Aleesami,no NOR,DF,Amiens,fr Ligue 1,28,1991,21.3,36,16,25,9,2,18,43,41.9,25,33,10,23,34,70,59,1,Matches
54,Álex Alegría,es ESP,FW,Mallorca,es La Liga,26,1992,1.2,1,0,1,0,0,0,0,,0,2,0,2,0,1,0,0,Matches
55,Carles Aleñá,es ESP,MF,Barcelona,es La Liga,21,1998,1.9,2,1,1,1,0,1,4,25.0,3,1,0,1,0,2,0,0,Matches
56,Carles Aleñá,es ESP,"MF,FW",Betis,es La Liga,21,1998,8.2,14,9,5,7,2,3,17,17.6,14,4,1,3,1,15,3,0,Matches
57,Rúnar Alex Rúnarsson,is ISL,GK,Dijon,fr Ligue 1,24,1995,10.0,0,0,0,0,0,0,2,0.0,2,0,0,0,0,0,3,3,Matches
58,Trent Alexander-Arnold,eng ENG,DF,Liverpool,eng Premier League,20,1998,35.3,55,34,35,17,3,36,78,46.2,42,27,9,18,45,100,84,3,Matches
59,Enrico Alfonso,it ITA,GK,Brescia,it Serie A,31,1988,3.1,0,0,0,0,0,0,0,,0,0,0,0,0,0,2,0,Matches
60,Rachid Alioui,ma MAR,FW,Angers,fr Ligue 1,27,1992,17.4,8,5,0,7,1,2,13,15.4,11,3,0,3,2,10,9,0,Matches
61,Alisson,br BRA,GK,Liverpool,eng Premier League,26,1992,28.3,0,0,0,0,0,0,2,0.0,2,0,0,0,1,1,13,3,Matches
62,Allan,br BRA,MF,Napoli,it Serie A,28,1991,14.2,50,27,20,21,9,18,54,33.3,36,19,3,16,16,66,11,1,Matches
63,Dele Alli,eng ENG,"MF,FW",Tottenham,eng Premier League,23,1996,20.5,34,16,11,20,3,13,37,35.1,24,35,3,32,17,51,17,2,Matches
64,Miguel Almirón,py PAR,"MF,FW",Newcastle Utd,eng Premier League,25,1994,33.6,60,39,32,20,8,19,52,36.5,33,25,1,24,31,91,25,0,Matches
65,Marcos Alonso,es ESP,DF,Chelsea,eng Premier League,28,1990,15.9,28,16,20,6,2,14,33,42.4,19,18,2,16,20,48,32,0,Matches
66,Mickaël Alphonse,gp GLP,DF,Dijon,fr Ligue 1,30,1989,15.3,39,25,26,12,1,23,37,62.2,14,19,3,16,17,56,64,0,Matches
67,Sergio Álvarez,es ESP,"MF,DF",Eibar,es La Liga,27,1992,12.7,37,22,11,24,2,8,24,33.3,16,16,2,14,17,54,26,1,Matches
68,Sergio Álvarez,es ESP,GK,Celta Vigo,es La Liga,32,1986,2.0,0,0,0,0,0,0,0,,0,0,0,0,0,0,1,0,Matches
69,Yeray Álvarez,es ESP,DF,Athletic Club,es La Liga,24,1995,31.2,36,19,28,7,1,17,30,56.7,13,33,22,11,62,98,138,2,Matches
70,Bruno Alves,pt POR,DF,Parma,it Serie A,37,1981,29.7,17,11,12,5,0,8,13,61.5,5,30,21,9,25,42,150,2,Matches
71,Steven Alzate,co COL,"MF,DF",Brighton,eng Premier League,20,1998,13.2,33,19,20,11,2,17,27,63.0,10,18,3,15,14,47,13,0,Matches
72,Ibrahim Amadou,fr FRA,"DF,MF",Norwich City,eng Premier League,26,1993,8.4,18,11,9,8,1,3,11,27.3,8,8,5,3,16,34,55,1,Matches
73,Ibrahim Amadou,fr FRA,MF,Leganés,es La Liga,26,1993,8.6,16,9,5,9,2,4,11,36.4,7,5,0,5,12,28,6,0,Matches
74,Romain Amalfitano,fr FRA,MF,Dijon,fr Ligue 1,29,1989,18.8,43,27,18,21,4,21,61,34.4,40,23,9,14,36,79,14,2,Matches
75,Amath,sn SEN,MF,Getafe,es La Liga,23,1996,0.7,2,1,1,1,0,0,5,0.0,5,2,0,2,0,2,0,0,Matches
76,Jordan Amavi,fr FRA,DF,Marseille,fr Ligue 1,25,1994,24.0,55,29,31,19,5,31,64,48.4,33,27,6,21,56,111,97,0,Matches
77,Thierry Ambrose,gp GLP,FW,Metz,fr Ligue 1,22,1997,6.1,7,5,2,2,3,2,7,28.6,5,3,0,3,3,10,3,0,Matches
78,Kelvin Amian,fr FRA,DF,Toulouse,fr Ligue 1,21,1998,18.1,27,21,21,5,1,14,25,56.0,11,14,7,7,18,45,56,0,Matches
79,Nadiem Amiri,de GER,"MF,FW",Leverkusen,de Bundesliga,22,1996,20.6,26,16,7,15,4,16,34,47.1,18,12,2,10,14,40,8,1,Matches
80,Ethan Ampadu,wls WAL,DF,RB Leipzig,de Bundesliga,18,2000,0.9,5,4,3,2,0,1,1,100.0,0,3,1,2,1,6,3,0,Matches
81,Opoku Ampomah,gh GHA,"FW,MF",Düsseldorf,de Bundesliga,23,1996,5.6,9,4,3,4,2,3,12,25.0,9,3,0,3,4,13,5,0,Matches
82,Sofyan Amrabat,ma MAR,MF,Hellas Verona,it Serie A,22,1996,32.4,58,36,26,21,11,26,55,47.3,29,29,10,19,31,89,15,1,Matches
83,Joachim Andersen,dk DEN,DF,Lyon,fr Ligue 1,23,1996,17.0,17,9,15,2,0,7,19,36.8,12,16,12,4,10,27,74,2,Matches
84,Djavan Anderson,nl NED,"FW,DF",Lazio,it Serie A,24,1995,1.9,0,0,0,0,0,0,0,,0,1,0,1,3,3,3,0,Matches
85,Felipe Anderson,br BRA,"MF,FW",West Ham,eng Premier League,26,1993,16.6,46,32,20,21,5,11,47,23.4,36,19,1,18,22,68,11,0,Matches
86,Sebastian Andersson,se SWE,FW,Union Berlin,de Bundesliga,28,1991,29.8,20,10,0,12,8,4,19,21.1,15,19,3,16,5,25,36,0,Matches
87,Florin Andone,ro ROU,FW,Brighton,eng Premier League,26,1993,0.8,1,1,0,1,0,1,1,100.0,0,1,1,0,0,1,1,0,Matches
88,Benjamin André,fr FRA,MF,Lille,fr Ligue 1,28,1990,22.8,72,44,31,35,6,29,74,39.2,45,32,9,23,59,131,40,1,Matches
89,Lorenzo Andrenacci,it ITA,GK,Brescia,it Serie A,24,1995,5.9,1,0,1,0,0,1,3,33.3,2,0,0,0,0,1,0,0,Matches
90,Robert Andrich,de GER,MF,Union Berlin,de Bundesliga,24,1994,28.6,52,27,28,18,6,19,60,31.7,41,27,7,20,47,99,36,0,Matches
91,Victorien Angban,ci CIV,MF,Metz,fr Ligue 1,22,1996,11.4,23,18,11,11,1,11,24,45.8,13,9,2,7,8,31,5,0,Matches
92,Miguel Ángel Guerrero,es ESP,FW,Leganés,es La Liga,29,1990,8.8,1,0,0,1,0,1,10,10.0,9,4,0,4,2,3,4,0,Matches
93,José Ángel,es ESP,DF,Eibar,es La Liga,29,1989,26.2,54,31,26,25,3,26,43,60.5,17,23,7,16,33,87,61,1,Matches
94,Miguel Ángel Moyá,es ESP,GK,Real Sociedad,es La Liga,35,1984,13.0,0,0,0,0,0,0,1,0.0,1,0,0,0,1,1,6,2,Matches
95,Angeliño,es ESP,DF,Manchester City,eng Premier League,22,1997,4.7,5,2,3,1,1,5,7,71.4,2,1,0,1,9,14,15,0,Matches
96,Angeliño,es ESP,"DF,FW",RB Leipzig,de Bundesliga,22,1997,12.2,15,9,7,5,3,5,15,33.3,10,14,1,13,19,34,24,0,Matches
97,Faustino Anjorin,eng ENG,FW,Chelsea,eng Premier League,17,2001,0.2,0,0,0,0,0,0,0,,0,1,0,1,0,0,0,0,Matches
98,Peter Ankersen,dk DEN,DF,Genoa,it Serie A,28,1990,11.8,16,4,7,7,2,4,13,30.8,9,19,5,14,9,25,25,1,Matches
99,Cristian Ansaldi,ar ARG,"DF,MF",Torino,it Serie A,32,1986,19.6,37,25,24,7,6,19,34,55.9,15,23,3,20,14,51,20,4,Matches
100,Janis Antiste,fr FRA,MF,Toulouse,fr Ligue 1,16,2002,0.1,0,0,0,0,0,0,0,,0,0,0,0,0,0,0,0,Matches
101,Michail Antonio,jm JAM,FW,West Ham,eng Premier League,29,1990,19.6,13,9,5,4,4,4,14,28.6,10,17,2,15,9,22,5,0,Matches
102,Antoñito,es ESP,"DF,MF",Valladolid,es La Liga,31,1987,11.4,26,18,19,7,0,12,20,60.0,8,9,0,9,15,41,20,1,Matches
103,Mirko Antonucci,it ITA,"FW,MF",Roma,it Serie A,20,1999,0.9,4,3,1,0,3,3,3,100.0,0,2,0,2,2,6,1,0,Matches
104,Vitorino Antunes,pt POR,MF,Getafe,es La Liga,32,1987,0.1,0,0,0,0,0,0,0,,0,0,0,0,0,0,1,0,Matches
105,Christopher Antwi-Adjei,gh GHA,"MF,FW",Paderborn 07,de Bundesliga,25,1994,27.4,25,16,13,9,3,9,33,27.3,24,29,2,27,15,40,14,0,Matches
106,Anuar,ma MAR,"MF,FW",Valladolid,es La Liga,24,1995,2.1,4,2,1,2,1,2,6,33.3,4,7,3,4,5,9,0,0,Matches
107,Houssem Aouar,dz ALG,"MF,FW",Lyon,fr Ligue 1,21,1998,21.7,28,12,6,18,4,10,35,28.6,25,15,1,14,13,41,11,0,Matches
108,Adil Aouchiche,fr FRA,MF,Paris S-G,fr Ligue 1,17,2002,0.7,3,2,1,2,0,2,4,50.0,2,3,0,3,0,3,0,0,Matches
109,Dennis Appiah,fr FRA,DF,Nantes,fr Ligue 1,27,1992,17.8,58,35,32,20,6,28,52,53.8,24,9,3,6,23,81,34,0,Matches
110,Mauro Arambarri,uy URU,MF,Getafe,es La Liga,23,1995,34.1,72,33,24,40,8,31,69,44.9,38,52,5,47,43,115,40,2,Matches
111,Guilherme Arana,br BRA,DF,Atalanta,it Serie A,22,1997,0.9,4,4,1,3,0,3,5,60.0,2,0,0,0,2,6,0,0,Matches
112,Charles Aránguiz,cl CHI,MF,Leverkusen,de Bundesliga,30,1989,23.5,56,37,19,29,8,27,74,36.5,47,27,6,21,22,78,21,1,Matches
113,Luiz Araújo,br BRA,"FW,MF",Lille,fr Ligue 1,23,1996,9.2,20,11,3,8,9,5,31,16.1,26,14,0,14,4,24,6,0,Matches
114,Néstor Araujo,mx MEX,DF,Celta Vigo,es La Liga,27,1991,32.1,44,27,35,8,1,22,36,61.1,14,26,18,8,52,96,142,0,Matches
115,Ronald Araújo,uy URU,DF,Barcelona,es La Liga,20,1999,2.6,3,2,2,1,0,1,1,100.0,0,6,2,4,0,3,9,0,Matches
116,Anaitz Arbilla,es ESP,DF,Eibar,es La Liga,32,1987,22.3,33,20,23,8,2,16,34,47.1,18,20,4,16,29,62,82,0,Matches
117,Alphonse Areola,fr FRA,GK,Real Madrid,es La Liga,26,1993,4.0,0,0,0,0,0,0,0,,0,0,0,0,0,0,0,0,Matches
118,Alphonse Areola,fr FRA,GK,Paris S-G,fr Ligue 1,26,1993,3.0,0,0,0,0,0,0,0,,0,0,0,0,0,0,1,1,Matches
119,Santiago Arias,co COL,DF,Atlético Madrid,es La Liga,27,1992,12.0,36,24,20,12,4,10,18,55.6,8,12,7,5,19,55,20,1,Matches
120,Nicolò Armini,it ITA,DF,Lazio,it Serie A,18,2001,0.0,1,1,1,0,0,1,1,100.0,0,0,0,0,0,1,1,0,Matches
121,Stuart Armstrong,sct SCO,MF,Southampton,eng Premier League,27,1992,19.1,32,19,19,11,2,9,38,23.7,29,22,4,18,11,43,23,1,Matches
122,José Arnaiz,es ESP,"FW,MF",Osasuna,es La Liga,24,1995,8.8,3,2,0,2,1,0,12,0.0,12,7,0,7,5,8,5,0,Matches
123,José Arnaiz,es ESP,MF,Leganés,es La Liga,24,1995,3.7,3,0,1,2,0,2,5,40.0,3,4,0,4,2,5,1,0,Matches
124,Maximilian Arnold,de GER,MF,Wolfsburg,de Bundesliga,25,1994,31.3,42,24,15,23,4,16,62,25.8,46,25,6,19,25,67,35,0,Matches
125,Kepa Arrizabalaga,es ESP,GK,Chelsea,eng Premier League,24,1994,33.0,1,1,1,0,0,1,2,50.0,1,0,0,0,1,2,7,2,Matches
126,Kwadwo Asamoah,gh GHA,"DF,FW",Inter,it Serie A,30,1988,7.1,10,8,4,5,1,6,14,42.9,8,8,1,7,9,19,13,0,Matches
127,Santiago Ascacíbar,ar ARG,MF,Hertha BSC,de Bundesliga,22,1997,7.0,26,13,15,11,0,11,28,39.3,17,13,2,11,16,42,13,0,Matches
128,Sergio Asenjo,es ESP,GK,Villarreal,es La Liga,30,1989,34.0,0,0,0,0,0,0,2,0.0,2,0,0,0,1,1,15,1,Matches
129,Marco Asensio,es ESP,FW,Real Madrid,es La Liga,23,1996,3.7,4,3,3,1,0,1,4,25.0,3,2,0,2,1,5,4,0,Matches
130,Kristoffer Askildsen,no NOR,MF,Sampdoria,it Serie A,18,2001,0.8,1,1,1,0,0,0,0,,0,1,0,1,1,2,0,0,Matches
131,Iago Aspas,es ESP,FW,Celta Vigo,es La Liga,31,1987,36.2,29,19,7,9,13,12,45,26.7,33,16,1,15,22,51,7,0,Matches
132,Roger Assalé,ci CIV,"FW,MF",Leganés,es La Liga,25,1993,5.9,3,2,1,0,2,1,9,11.1,8,8,0,8,0,3,1,0,Matches
133,Youcef Atal,dz ALG,"FW,DF",Nice,fr Ligue 1,23,1996,11.1,24,11,15,6,3,13,31,41.9,18,12,1,11,24,48,11,1,Matches
134,Miguel Atienza,es ESP,MF,Eibar,es La Liga,20,1999,0.3,1,1,0,1,0,1,2,50.0,1,1,1,0,2,3,1,0,Matches
135,Christian Atsu,gh GHA,"MF,FW",Newcastle Utd,eng Premier League,27,1992,8.3,10,8,5,5,0,5,14,35.7,9,19,0,19,5,15,9,0,Matches
136,Pierre-Emerick Aubameyang,ga GAB,FW,Arsenal,eng Premier League,30,1989,34.8,31,19,10,12,9,12,51,23.5,39,39,1,38,14,45,16,0,Matches
137,Emil Audero,it ITA,GK,Sampdoria,it Serie A,22,1997,36.0,1,1,1,0,0,1,3,33.3,2,0,0,0,0,1,21,1,Matches
138,Tommaso Augello,it ITA,DF,Sampdoria,it Serie A,24,1994,12.6,14,9,6,3,5,5,7,71.4,2,8,0,8,15,29,21,1,Matches
139,Jean-Kévin Augustin,fr FRA,FW,Monaco,fr Ligue 1,22,1997,3.0,3,0,1,2,0,1,6,16.7,5,2,0,2,3,6,0,0,Matches
140,Ludwig Augustinsson,se SWE,"DF,MF",Werder Bremen,de Bundesliga,25,1994,10.3,29,12,15,9,5,12,23,52.2,11,19,5,14,10,39,29,0,Matches
141,Serge Aurier,ci CIV,DF,Tottenham,eng Premier League,26,1992,30.0,93,69,58,27,8,39,69,56.5,30,38,6,32,47,140,98,2,Matches
142,Mathias Autret,fr FRA,"MF,FW",Brest,fr Ligue 1,28,1991,13.6,23,17,5,11,7,8,25,32.0,17,14,1,13,10,33,3,0,Matches
143,Ezequiel Ávila,ar ARG,FW,Osasuna,es La Liga,25,1994,17.7,17,12,6,7,4,6,18,33.3,12,12,0,12,3,20,5,0,Matches
144,Javier Avilés,es ESP,"MF,FW",Leganés,es La Liga,21,1997,2.0,9,7,2,7,0,2,4,50.0,2,3,0,3,3,12,1,0,Matches
145,Chidozie Awaziem,ng NGA,DF,Leganés,es La Liga,22,1997,22.2,34,22,29,5,0,16,27,59.3,11,26,15,11,28,62,73,1,Matches
146,Taiwo Awoniyi,ng NGA,"FW,MF",Mainz 05,de Bundesliga,21,1997,5.4,2,0,0,2,0,0,4,0.0,4,4,2,2,2,4,3,0,Matches
147,Florian Ayé,fr FRA,"FW,MF",Brescia,it Serie A,22,1997,15.3,17,9,9,5,3,6,13,46.2,7,17,2,15,4,21,18,1,Matches
148,Jordan Ayew,gh GHA,FW,Crystal Palace,eng Premier League,27,1991,35.0,48,30,10,22,16,17,49,34.7,32,29,4,25,15,63,21,0,Matches
149,Kaan Ayhan,tr TUR,DF,Düsseldorf,de Bundesliga,24,1994,30.3,38,25,26,11,1,20,37,54.1,17,28,15,13,45,83,72,1,Matches
150,Ramon Azeez,ng NGA,MF,Granada,es La Liga,26,1992,15.1,11,8,2,8,1,7,19,36.8,12,8,2,6,19,30,11,1,Matches
151,César Azpilicueta,es ESP,DF,Chelsea,eng Premier League,29,1989,35.9,86,56,40,32,14,35,69,50.7,34,56,21,35,67,153,94,0,Matches
152,Ludovic Baal,gf GUF,DF,Brest,fr Ligue 1,33,1986,9.2,27,15,13,12,2,10,22,45.5,12,9,3,6,17,44,20,0,Matches
153,Iddrisu Baba,gh GHA,MF,Mallorca,es La Liga,23,1996,32.3,59,37,26,29,4,20,70,28.6,50,31,8,23,39,98,42,0,Matches
154,Khouma Babacar,sn SEN,FW,Lecce,it Serie A,26,1993,15.8,12,8,2,6,4,1,7,14.3,6,12,3,9,3,15,34,0,Matches
155,Carlos Bacca,co COL,FW,Villarreal,es La Liga,32,1986,7.6,5,1,1,2,2,2,6,33.3,4,4,0,4,0,5,7,0,Matches
156,Milan Badelj,hr CRO,MF,Fiorentina,it Serie A,30,1989,17.6,29,17,10,16,3,15,50,30.0,35,21,3,18,45,74,34,1,Matches
157,Matthias Bader,de GER,DF,Köln,de Bundesliga,22,1997,0.1,1,1,1,0,0,1,2,50.0,1,0,0,0,0,1,1,0,Matches
158,Benoît Badiashile,fr FRA,DF,Monaco,fr Ligue 1,18,2001,15.7,18,12,12,5,1,6,12,50.0,6,20,11,9,27,45,57,1,Matches
159,Bastian Badu,fr FRA,FW,Montpellier,fr Ligue 1,19,2000,0.1,0,0,0,0,0,0,0,,0,0,0,0,0,0,0,0,Matches
160,Alex Baena,es ESP,MF,Villarreal,es La Liga,18,2001,0.2,0,0,0,0,0,0,0,,0,1,0,1,0,0,0,0,Matches
161,Stéphane Bahoken,cm CMR,FW,Angers,fr Ligue 1,27,1992,10.1,7,4,1,2,4,1,7,14.3,6,4,1,3,2,9,2,0,Matches
162,Daniel Baier,de GER,MF,Augsburg,de Bundesliga,35,1984,21.6,33,17,14,14,5,15,43,34.9,28,19,7,12,58,91,27,0,Matches
163,Leon Bailey,jm JAM,"FW,MF",Leverkusen,de Bundesliga,21,1997,12.1,6,3,1,5,0,6,16,37.5,10,9,0,9,8,14,3,0,Matches
164,Eric Bailly,ci CIV,DF,Manchester Utd,eng Premier League,25,1994,1.7,0,0,0,0,0,0,1,0.0,1,3,3,0,4,4,7,1,Matches
165,Dénys Bain,fr FRA,DF,Brest,fr Ligue 1,26,1993,14.1,21,14,15,6,0,9,9,100.0,0,13,10,3,28,49,66,0,Matches
166,Leighton Baines,eng ENG,DF,Everton,eng Premier League,34,1984,4.5,10,6,6,2,2,8,10,80.0,2,5,2,3,5,15,14,0,Matches
167,Stefan Bajic,fr FRA,GK,Saint-Étienne,fr Ligue 1,17,2001,1.0,0,0,0,0,0,0,0,,0,1,0,1,0,0,2,0,Matches
168,Tiemoué Bakayoko,fr FRA,MF,Monaco,fr Ligue 1,24,1994,19.1,48,24,16,27,5,29,54,53.7,25,12,4,8,29,77,17,0,Matches
169,Lewis Baker,eng ENG,MF,Düsseldorf,de Bundesliga,24,1995,6.1,8,5,6,2,0,2,10,20.0,8,5,2,3,2,10,5,0,Matches
170,Mitchel Bakker,nl NED,DF,Paris S-G,fr Ligue 1,19,2000,1.0,2,2,1,1,0,1,1,100.0,0,0,0,0,0,2,2,0,Matches
171,Ridle Baku,de GER,"DF,MF",Mainz 05,de Bundesliga,21,1998,26.1,54,31,25,22,7,26,53,49.1,27,45,7,38,42,96,57,0,Matches
172,Fabián Balbuena,py PAR,DF,West Ham,eng Premier League,27,1991,13.1,17,12,13,3,1,9,25,36.0,16,15,5,10,26,43,75,3,Matches
173,Keita Baldé,sn SEN,"FW,MF",Monaco,fr Ligue 1,24,1995,9.5,6,5,1,1,4,3,9,33.3,6,4,1,3,2,8,7,1,Matches
174,George Baldock,gr GRE,DF,Sheffield Utd,eng Premier League,26,1993,38.0,62,43,35,17,10,27,47,57.4,20,26,3,23,34,96,83,3,Matches
175,Gareth Bale,wls WAL,"FW,MF",Real Madrid,es La Liga,30,1989,12.1,9,5,5,2,2,3,14,21.4,11,8,2,6,6,15,9,0,Matches
176,Mikel Balenziaga,es ESP,DF,Athletic Club,es La Liga,31,1988,6.3,15,10,4,10,1,9,11,81.8,2,4,1,3,2,17,20,0,Matches
177,Leonardo Balerdi,ar ARG,"DF,MF",Dortmund,de Bundesliga,20,1999,1.5,2,1,1,1,0,2,2,100.0,0,0,0,0,4,6,3,0,Matches
178,Marco Ballarini,it ITA,MF,Udinese,it Serie A,18,2001,0.0,0,0,0,0,0,0,0,,0,0,0,0,0,0,0,0,Matches
179,Fodé Ballo-Touré,sn SEN,DF,Monaco,fr Ligue 1,22,1997,18.7,36,25,21,11,4,17,32,53.1,15,10,1,9,24,60,45,0,Matches
180,Florent Balmont,fr FRA,MF,Dijon,fr Ligue 1,39,1980,4.5,12,6,5,7,0,7,12,58.3,5,6,0,6,1,13,3,0,Matches
181,Mario Balotelli,it ITA,FW,Brescia,it Serie A,28,1990,15.6,2,2,0,2,0,0,2,0.0,2,1,1,0,8,10,22,0,Matches
182,Abdoulaye Bamba,ci CIV,DF,Angers,fr Ligue 1,29,1990,6.2,10,7,7,1,2,8,15,53.3,7,4,1,3,4,14,18,0,Matches
183,Jonathan Bamba,ci CIV,"FW,MF",Lille,fr Ligue 1,23,1996,21.5,12,6,5,5,2,7,29,24.1,22,19,3,16,16,28,8,2,Matches
184,Éver Banega,ar ARG,MF,Sevilla,es La Liga,31,1988,27.5,43,28,16,18,9,21,70,30.0,49,19,1,18,15,58,5,0,Matches
185,Mattia Bani,it ITA,DF,Bologna,it Serie A,25,1993,24.5,47,28,27,19,1,25,36,69.4,11,29,15,14,52,99,92,2,Matches
186,Antonín Barák,cz CZE,"MF,FW",Udinese,it Serie A,24,1994,2.2,5,4,3,0,2,1,5,20.0,4,6,1,5,0,5,4,0,Matches
187,Antonín Barák,cz CZE,MF,Lecce,it Serie A,24,1994,15.2,19,10,9,10,0,6,24,25.0,18,18,1,17,9,28,20,2,Matches
188,Federico Barba,it ITA,DF,Valladolid,es La Liga,25,1993,5.0,12,6,10,2,0,7,9,77.8,2,5,2,3,8,20,12,0,Matches
189,Danilo Barbosa,br BRA,"DF,MF",Nice,fr Ligue 1,23,1996,12.5,28,21,17,9,2,13,29,44.8,16,21,6,15,20,48,38,0,Matches
190,Melvin Bard,fr FRA,DF,Lyon,fr Ligue 1,18,2000,0.5,0,0,0,0,0,0,0,,0,0,0,0,1,1,0,0,Matches
191,Enis Bardhi,mk MKD,MF,Levante,es La Liga,24,1995,23.5,24,11,7,15,2,8,35,22.9,27,15,4,11,15,39,19,0,Matches
192,Phil Bardsley,sct SCO,DF,Burnley,eng Premier League,34,1985,21.0,49,36,16,24,9,24,37,64.9,13,24,11,13,30,79,73,0,Matches
193,Nicolò Barella,it ITA,MF,Inter,it Serie A,22,1997,22.4,36,21,14,15,7,8,37,21.6,29,20,5,15,14,50,14,0,Matches
194,Philipp Bargfrede,de GER,MF,Werder Bremen,de Bundesliga,30,1989,6.5,15,12,8,5,2,6,23,26.1,17,8,2,6,16,31,15,0,Matches
195,Antonino Barillà,it ITA,MF,Parma,it Serie A,31,1988,18.8,43,31,22,19,2,16,45,35.6,29,26,8,18,17,60,32,0,Matches
196,Kike Barja,es ESP,"MF,FW",Osasuna,es La Liga,22,1997,3.5,1,1,1,0,0,1,1,100.0,0,3,1,2,0,1,2,0,Matches
197,Ross Barkley,eng ENG,MF,Chelsea,eng Premier League,25,1993,12.3,16,9,6,6,4,5,18,27.8,13,7,2,5,7,23,7,0,Matches
198,Aymen Barkok,ma MAR,"FW,MF",Düsseldorf,de Bundesliga,21,1998,0.9,1,1,0,0,1,0,2,0.0,2,2,0,2,3,4,1,0,Matches
199,Ashley Barnes,eng ENG,FW,Burnley,eng Premier League,29,1989,15.0,10,5,3,5,2,3,9,33.3,6,7,2,5,6,16,9,0,Matches
200,Harvey Barnes,eng ENG,"MF,FW",Leicester City,eng Premier League,21,1997,23.1,16,11,7,7,2,5,23,21.7,18,13,3,10,8,24,6,1,Matches
201,Antonio Barragán,es ESP,DF,Betis,es La Liga,32,1987,7.1,7,5,4,2,1,3,6,50.0,3,2,2,0,8,15,22,0,Matches
202,Antonio Barreca,it ITA,"DF,FW",Genoa,it Serie A,24,1995,12.2,10,7,5,3,2,4,5,80.0,1,12,7,5,1,11,22,0,Matches
203,Leandro Barreiro Martins,lu LUX,MF,Mainz 05,de Bundesliga,19,2000,10.4,38,21,16,19,3,14,29,48.3,15,18,3,15,9,47,18,1,Matches
204,Ander Barrenetxea,es ESP,"FW,MF",Real Sociedad,es La Liga,17,2001,4.9,12,9,5,5,2,4,10,40.0,6,3,0,3,3,15,4,0,Matches
205,Édgar Barreto,py PAR,MF,Sampdoria,it Serie A,35,1984,1.0,4,3,0,1,3,2,3,66.7,1,1,0,1,0,4,0,0,Matches
206,Musa Barrow,gm GAM,"FW,MF",Bologna,it Serie A,20,1998,15.0,20,13,11,7,2,6,20,30.0,14,15,0,15,5,25,11,0,Matches
207,Musa Barrow,gm GAM,"FW,MF",Atalanta,it Serie A,20,1998,2.1,1,1,0,0,1,1,4,25.0,3,4,0,4,0,1,1,0,Matches
208,Fin Bartels,de GER,"MF,FW",Werder Bremen,de Bundesliga,32,1987,3.8,9,5,4,4,1,3,12,25.0,9,3,1,2,1,10,1,0,Matches
209,Marc Bartra,es ESP,"DF,MF",Betis,es La Liga,28,1991,28.0,62,34,39,23,0,27,54,50.0,27,45,24,21,35,97,127,0,Matches
210,Daniele Baselli,it ITA,MF,Torino,it Serie A,27,1992,14.2,43,23,17,19,7,13,40,32.5,27,20,4,16,25,68,25,0,Matches
211,Chris Basham,eng ENG,DF,Sheffield Utd,eng Premier League,31,1988,36.0,85,48,58,20,7,48,81,59.3,33,38,15,23,77,162,173,1,Matches
212,Toma Bašić,hr CRO,MF,Bordeaux,fr Ligue 1,22,1996,11.0,26,22,9,16,1,12,27,44.4,15,14,2,12,9,35,12,1,Matches
213,Thomas Basila,fr FRA,DF,Nantes,fr Ligue 1,20,1999,4.6,6,3,2,4,0,4,4,100.0,0,0,0,0,4,10,14,0,Matches
214,Gil Bastião Dias,pt POR,"MF,DF",Granada,es La Liga,22,1996,4.0,19,14,10,6,3,7,17,41.2,10,4,1,3,3,22,7,0,Matches
215,Gil Bastião Dias,pt POR,"DF,MF",Monaco,fr Ligue 1,22,1996,11.7,53,33,30,21,2,29,58,50.0,29,15,1,14,13,66,22,1,Matches
216,Borja Bastón,es ESP,"MF,FW",Aston Villa,eng Premier League,26,1992,0.2,1,0,0,1,0,0,2,0.0,2,1,0,1,0,1,0,1,Matches
217,Alessandro Bastoni,it ITA,DF,Inter,it Serie A,20,1999,21.3,32,17,14,11,7,15,24,62.5,9,18,9,9,26,58,54,0,Matches
218,Bastos,ao ANG,DF,Lazio,it Serie A,28,1991,8.5,9,5,6,3,0,4,11,36.4,7,13,8,5,13,22,26,0,Matches
219,Oliver Batista-Meier,de GER,MF,Bayern Munich,de Bundesliga,18,2001,0.1,0,0,0,0,0,0,2,0.0,2,0,0,0,0,0,0,0,Matches
220,Michy Batshuayi,be BEL,FW,Chelsea,eng Premier League,25,1993,2.7,4,1,2,2,0,0,5,0.0,5,1,1,0,0,4,1,0,Matches
221,Cristian Battocchio,it ITA,MF,Brest,fr Ligue 1,27,1992,15.5,31,24,13,13,5,14,36,38.9,22,13,4,9,19,50,21,0,Matches
222,Oliver Baumann,de GER,GK,Hoffenheim,de Bundesliga,29,1990,30.0,0,0,0,0,0,0,0,,0,1,0,1,3,3,15,0,Matches
223,Julian Baumgartlinger,at AUT,MF,Leverkusen,de Bundesliga,31,1988,19.9,42,21,15,21,6,18,42,42.9,24,37,4,33,20,62,16,1,Matches
224,Christoph Baumgartner,at AUT,"MF,FW",Hoffenheim,de Bundesliga,19,1999,16.6,32,17,15,16,1,10,37,27.0,27,25,1,24,8,40,13,0,Matches
225,Noah Joel Sarenren Bazee,ng NGA,FW,Augsburg,de Bundesliga,22,1996,4.2,4,3,0,4,0,1,4,25.0,3,2,1,1,5,9,4,0,Matches
226,Ihlas Bebou,tg TOG,"FW,MF",Hoffenheim,de Bundesliga,25,1994,23.4,27,15,9,13,5,8,23,34.8,15,25,4,21,11,38,25,0,Matches
227,Rodrigo Becão,br BRA,DF,Udinese,it Serie A,23,1996,24.6,56,25,34,19,3,26,46,56.5,20,40,20,20,45,101,77,0,Matches
228,Sheraldo Becker,sr SUR,"MF,FW",Union Berlin,de Bundesliga,24,1995,6.0,2,1,2,0,0,1,3,33.3,2,1,0,1,0,2,1,0,Matches
229,Timo Becker,de GER,"DF,MF",Schalke 04,de Bundesliga,22,1997,3.7,10,9,3,6,1,5,9,55.6,4,6,1,5,3,13,8,0,Matches
230,Jan Bednarek,pl POL,DF,Southampton,eng Premier League,23,1996,34.0,65,38,41,18,6,31,61,50.8,30,44,23,21,77,142,198,4,Matches
231,Asmir Begović,ba BIH,GK,Milan,it Serie A,32,1987,1.4,0,0,0,0,0,0,0,,0,0,0,0,0,0,0,0,Matches
232,Valon Behrami,ch SUI,MF,Genoa,it Serie A,34,1985,12.3,34,26,13,17,4,8,32,25.0,24,25,10,15,9,43,16,0,Matches
233,Maximilian Beier,de GER,FW,Hoffenheim,de Bundesliga,16,2002,1.2,5,2,0,1,4,1,2,50.0,1,2,0,2,0,5,0,0,Matches
234,Gaëtan Belaud,fr FRA,DF,Brest,fr Ligue 1,32,1986,6.4,13,7,10,2,1,4,8,50.0,4,8,3,5,15,28,15,0,Matches
235,Ishak Belfodil,dz ALG,"FW,MF",Hoffenheim,de Bundesliga,27,1992,3.0,0,0,0,0,0,0,1,0.0,1,0,0,0,0,0,2,0,Matches
236,Haris Belkebla,dz ALG,MF,Brest,fr Ligue 1,25,1994,20.2,44,24,17,17,10,10,28,35.7,18,25,5,20,53,97,21,2,Matches
237,Raoul Bellanova,it ITA,DF,Atalanta,it Serie A,19,2000,0.2,0,0,0,0,0,0,0,,0,0,0,0,0,0,0,0,Matches
238,Raoul Bellanova,it ITA,DF,Bordeaux,fr Ligue 1,19,2000,0.7,1,1,1,0,0,0,1,0.0,1,0,0,0,0,1,0,0,Matches
239,Karim Bellarabi,de GER,"FW,DF",Leverkusen,de Bundesliga,29,1990,15.8,19,11,9,7,3,9,28,32.1,19,16,0,16,10,29,4,0,Matches
240,Jean-Ricner Bellegarde,fr FRA,MF,Strasbourg,fr Ligue 1,21,1998,16.6,40,27,18,19,3,13,21,61.9,8,16,3,13,22,62,6,0,Matches
241,Héctor Bellerín,es ESP,"DF,MF",Arsenal,eng Premier League,24,1995,12.9,20,13,7,11,2,11,29,37.9,18,20,4,16,19,39,27,1,Matches
242,Andrea Belotti,it ITA,FW,Torino,it Serie A,25,1993,33.4,29,16,7,17,5,5,31,16.1,26,23,5,18,5,34,20,1,Matches
243,Fran Beltrán,es ESP,MF,Celta Vigo,es La Liga,20,1999,20.3,31,19,15,12,4,11,35,31.4,24,14,1,13,14,45,17,0,Matches
244,Sami Ben Amar,ma MAR,FW,Nîmes,fr Ligue 1,21,1998,0.2,1,1,0,0,1,1,1,100.0,0,1,0,1,1,2,0,0,Matches
245,Hatem Ben Arfa,fr FRA,"MF,FW",Valladolid,es La Liga,32,1987,1.8,0,0,0,0,0,0,4,0.0,4,1,0,1,0,0,0,0,Matches
246,Wissam Ben Yedder,fr FRA,FW,Monaco,fr Ligue 1,28,1990,24.0,22,16,2,12,8,8,19,42.1,11,12,0,12,4,26,1,0,Matches
247,Marco Benassi,it ITA,MF,Fiorentina,it Serie A,24,1994,10.9,18,12,9,5,4,10,24,41.7,14,11,1,10,4,22,9,0,Matches
248,Cristian Benavente,pe PER,"MF,FW",Nantes,fr Ligue 1,25,1994,3.9,8,5,2,5,1,2,8,25.0,6,1,0,1,3,11,0,0,Matches
249,Lars Bender,de GER,"DF,MF",Leverkusen,de Bundesliga,30,1989,15.3,42,26,17,20,5,19,38,50.0,19,32,6,26,24,66,30,0,Matches
250,Sven Bender,de GER,DF,Leverkusen,de Bundesliga,30,1989,30.3,53,34,29,17,7,23,48,47.9,25,42,13,29,67,120,88,2,Matches
251,Darío Benedetto,ar ARG,FW,Marseille,fr Ligue 1,29,1990,23.3,12,9,0,9,3,3,18,16.7,15,15,2,13,3,15,23,1,Matches
252,László Bénes,sk SVK,MF,Gladbach,de Bundesliga,21,1997,10.0,15,8,3,5,7,6,19,31.6,13,6,2,4,8,23,3,1,Matches
253,Walter Benítez,ar ARG,GK,Nice,fr Ligue 1,26,1993,26.0,1,1,1,0,0,1,3,33.3,2,0,0,0,0,1,8,0,Matches
254,Loris Benito,ch SUI,DF,Bordeaux,fr Ligue 1,27,1992,21.1,40,25,23,11,6,16,43,37.2,27,14,5,9,29,69,58,1,Matches
255,Bilal Benkhedim,fr FRA,"MF,FW",Saint-Étienne,fr Ligue 1,18,2001,1.5,3,3,1,1,1,1,4,25.0,3,1,0,1,1,4,0,0,Matches
256,Ismaël Bennacer,dz ALG,MF,Milan,it Serie A,21,1997,27.6,67,47,21,34,12,29,73,39.7,44,25,7,18,54,121,15,2,Matches
257,Ryan Bennett,eng ENG,DF,Wolves,eng Premier League,29,1990,6.7,4,2,4,0,0,2,6,33.3,4,14,8,6,9,13,29,0,Matches
258,Ryan Bennett,eng ENG,DF,Leicester City,eng Premier League,29,1990,3.7,5,4,3,2,0,4,6,66.7,2,3,1,2,7,12,8,0,Matches
259,Keanan Bennetts,eng ENG,MF,Gladbach,de Bundesliga,20,1999,0.0,0,0,0,0,0,0,1,0.0,1,0,0,0,0,0,0,0,Matches
260,Yassine Benrahou,fr FRA,"FW,MF",Bordeaux,fr Ligue 1,20,1999,1.9,3,0,1,1,1,2,5,40.0,3,1,0,1,2,5,1,0,Matches
261,Yassine Benrahou,fr FRA,"MF,FW",Nîmes,fr Ligue 1,20,1999,8.5,13,8,3,3,7,5,16,31.3,11,1,0,1,2,15,0,0,Matches
262,Ramy Bensebaini,dz ALG,DF,Gladbach,de Bundesliga,24,1995,16.1,33,17,17,12,4,18,31,58.1,13,24,4,20,38,71,49,0,Matches
263,Nabil Bentaleb,dz ALG,MF,Newcastle Utd,eng Premier League,24,1994,8.3,23,13,14,9,0,7,25,28.0,18,9,2,7,19,42,9,1,Matches
264,Rodrigo Bentancur,uy URU,MF,Juventus,it Serie A,22,1997,24.4,58,32,27,18,13,31,66,47.0,35,44,9,35,32,90,34,1,Matches
265,Christian Benteke,be BEL,FW,Crystal Palace,eng Premier League,28,1990,14.0,9,5,1,6,2,0,10,0.0,10,11,4,7,4,13,28,1,Matches
266,Romario Benzar,ro ROU,DF,Lecce,it Serie A,27,1992,1.1,2,2,1,1,0,2,3,66.7,1,1,0,1,0,2,2,0,Matches
267,Karim Benzema,fr FRA,FW,Real Madrid,es La Liga,31,1987,34.9,18,8,3,11,4,2,16,12.5,14,16,4,12,7,25,30,1,Matches
268,Yassine Benzia,dz ALG,MF,Dijon,fr Ligue 1,24,1994,1.9,3,2,2,1,0,1,6,16.7,5,4,2,2,3,6,1,0,Matches
269,Domenico Berardi,it ITA,FW,Sassuolo,it Serie A,24,1994,27.7,32,16,19,8,5,13,59,22.0,46,31,3,28,33,65,27,0,Matches
270,Yuri Berchiche,es ESP,DF,Athletic Club,es La Liga,29,1990,31.7,48,35,32,15,1,21,40,52.5,19,26,4,22,30,78,73,1,Matches
271,Álex Berenguer,es ESP,"MF,DF",Torino,it Serie A,24,1995,20.3,20,6,6,13,1,8,33,24.2,25,17,1,16,18,38,17,0,Matches
272,Bartosz Bereszyński,pl POL,DF,Sampdoria,it Serie A,27,1992,26.7,53,35,25,23,5,26,52,50.0,26,38,16,22,35,88,88,1,Matches
273,Jóhann Berg Guðmundsson,is ISL,MF,Burnley,eng Premier League,28,1990,6.9,4,2,2,2,0,1,8,12.5,7,8,1,7,7,11,9,0,Matches
274,Markel Bergara,es ESP,MF,Getafe,es La Liga,33,1986,0.8,0,0,0,0,0,0,0,,0,0,0,0,0,0,2,0,Matches
275,Sander Berge,no NOR,MF,Sheffield Utd,eng Premier League,21,1998,10.5,22,15,3,14,5,5,10,50.0,5,15,1,14,10,32,16,0,Matches
276,Steven Bergwijn,nl NED,"FW,MF",Tottenham,eng Premier League,21,1997,7.8,10,6,3,6,1,4,12,33.3,8,12,0,12,1,11,5,0,Matches
277,Robert Berić,si SVN,FW,Saint-Étienne,fr Ligue 1,28,1991,4.6,3,2,0,2,1,0,5,0.0,5,2,0,2,4,7,2,0,Matches
278,Etrit Berisha,al ALB,GK,SPAL,it Serie A,30,1989,26.0,3,2,3,0,0,2,3,66.7,1,0,0,0,1,4,9,0,Matches
279,Valon Berisha,xk KVX,MF,Lazio,it Serie A,26,1993,0.4,1,1,0,1,0,1,2,50.0,1,0,0,0,0,1,1,0,Matches
280,Valon Berisha,xk KVX,MF,Düsseldorf,de Bundesliga,26,1993,10.5,14,9,3,8,3,6,21,28.6,15,4,1,3,9,23,8,0,Matches
281,Sergio Bermejo,es ESP,"MF,FW",Celta Vigo,es La Liga,21,1997,0.1,0,0,0,0,0,0,0,,0,0,0,0,0,0,0,0,Matches
282,Bernard,br BRA,"MF,FW",Everton,eng Premier League,26,1992,14.2,32,22,12,14,6,13,44,29.5,31,22,2,20,16,48,7,0,Matches
283,Federico Bernardeschi,it ITA,"MF,FW",Juventus,it Serie A,25,1994,17.5,13,5,4,5,4,5,25,20.0,20,11,0,11,13,26,12,1,Matches
284,Bernardo,br BRA,"DF,MF",Brighton,eng Premier League,24,1995,7.5,27,16,12,9,6,13,17,76.5,4,7,3,4,6,33,24,0,Matches
285,Paul Bernardoni,fr FRA,GK,Nîmes,fr Ligue 1,22,1997,24.5,0,0,0,0,0,0,1,0.0,1,0,0,0,0,0,11,1,Matches
286,Juan Bernat,es ESP,"DF,MF",Paris S-G,fr Ligue 1,26,1993,15.4,42,27,19,16,7,20,51,39.2,31,13,1,12,10,52,26,0,Matches
287,Dimitry Bertaud,cd COD,GK,Montpellier,fr Ligue 1,21,1998,2.2,0,0,0,0,0,0,0,,0,0,0,0,0,0,0,0,Matches
288,Andrea Bertolacci,it ITA,MF,Sampdoria,it Serie A,28,1991,5.9,7,4,2,3,2,1,8,12.5,7,4,1,3,2,9,13,0,Matches
289,Ryan Bertrand,eng ENG,DF,Southampton,eng Premier League,29,1989,30.5,47,29,22,15,10,26,58,44.8,32,27,12,15,37,84,31,1,Matches
290,Muhamed Bešić,ba BIH,MF,Sheffield Utd,eng Premier League,26,1992,2.8,8,6,4,4,0,2,5,40.0,3,4,0,4,1,9,6,0,Matches
291,Jordan Beyer,de GER,DF,Gladbach,de Bundesliga,19,2000,1.2,3,1,3,0,0,0,1,0.0,1,4,2,2,1,4,4,0,Matches
292,Ermin Bičakčić,ba BIH,DF,Hoffenheim,de Bundesliga,29,1990,13.1,7,3,5,2,0,4,11,36.4,7,14,8,6,25,32,64,2,Matches
293,Pedro Bigas,es ESP,DF,Eibar,es La Liga,28,1990,19.7,18,9,11,7,0,9,19,47.4,10,16,10,6,36,54,82,0,Matches
294,Lucas Biglia,ar ARG,MF,Milan,it Serie A,33,1986,7.6,13,7,7,6,0,4,15,26.7,11,12,4,8,7,20,10,1,Matches
295,El Bilal Touré,ml MLI,FW,Reims,fr Ligue 1,17,2001,5.0,3,3,1,0,2,0,0,,0,6,0,6,1,4,1,0,Matches
296,Philip Billing,dk DEN,MF,Bournemouth,eng Premier League,23,1996,28.1,72,46,30,37,5,17,65,26.2,48,59,16,43,66,138,97,1,Matches
297,Cristiano Biraghi,it ITA,DF,Inter,it Serie A,26,1992,17.5,22,6,10,8,4,10,24,41.7,14,21,7,14,13,35,41,0,Matches
298,Davide Biraschi,it ITA,DF,Genoa,it Serie A,25,1994,21.9,32,17,17,13,2,15,26,57.7,11,22,12,10,34,66,69,0,Matches
299,Valter Birsa,si SVN,"MF,FW",Cagliari,it Serie A,32,1986,4.8,10,6,3,6,1,7,21,33.3,14,6,1,5,4,14,3,0,Matches
300,Dimitri Bisoli,it ITA,MF,Brescia,it Serie A,25,1994,23.9,64,35,34,20,10,30,49,61.2,19,41,7,34,25,89,49,0,Matches
301,Yves Bissouma,ml MLI,MF,Brighton,eng Premier League,22,1996,14.0,49,38,24,22,3,17,40,42.5,23,18,2,16,21,70,23,0,Matches
302,Leonardo Bittencourt,de GER,MF,Hoffenheim,de Bundesliga,25,1993,0.0,1,1,0,0,1,0,0,,0,0,0,0,0,1,0,0,Matches
303,Leonardo Bittencourt,de GER,"FW,MF",Werder Bremen,de Bundesliga,25,1993,21.0,52,28,23,18,11,9,51,17.6,42,20,3,17,12,64,14,0,Matches
304,Birkir Bjarnason,is ISL,"MF,FW",Brescia,it Serie A,31,1988,8.9,5,3,1,3,1,2,13,15.4,11,9,4,5,5,10,4,0,Matches
305,Rubén Blanco,es ESP,GK,Celta Vigo,es La Liga,24,1995,32.9,1,1,1,0,0,1,1,100.0,0,0,0,0,0,1,14,1,Matches
306,Ludovic Blas,fr FRA,"FW,MF",Nantes,fr Ligue 1,21,1997,20.5,26,18,7,15,4,5,26,19.2,21,17,1,16,14,40,11,0,Matches
307,Pablo de Blasis,ar ARG,"DF,MF",Eibar,es La Liga,31,1988,17.8,41,32,22,13,6,30,63,47.6,33,13,0,13,24,65,21,0,Matches
308,Alejandro Blesa,es ESP,MF,Levante,es La Liga,17,2002,0.0,0,0,0,0,0,0,1,0.0,1,0,0,0,0,0,0,0,Matches
309,Alexis Blin,fr FRA,MF,Amiens,fr Ligue 1,22,1996,20.5,39,25,18,15,6,20,61,32.8,41,25,6,19,16,55,49,0,Matches
310,Jérôme Boateng,de GER,DF,Bayern Munich,de Bundesliga,30,1988,20.0,21,14,9,12,0,11,22,50.0,11,15,11,4,33,54,58,1,Matches
311,Kevin-Prince Boateng,gh GHA,FW,Fiorentina,it Serie A,32,1987,6.7,3,1,0,2,1,2,8,25.0,6,3,0,3,1,4,7,0,Matches
312,Antonin Bobichon,fr FRA,MF,Nîmes,fr Ligue 1,23,1995,2.0,4,3,1,3,0,3,3,100.0,0,1,0,1,1,5,0,0,Matches
313,Antonin Bobichon,fr FRA,MF,Angers,fr Ligue 1,23,1995,7.2,9,4,4,5,0,2,19,10.5,17,7,0,7,7,16,4,0,Matches
314,Salvatore Bocchetti,it ITA,DF,Hellas Verona,it Serie A,32,1986,3.4,5,3,3,2,0,2,3,66.7,1,2,2,0,17,22,23,0,Matches
315,Mathieu Bodmer,fr FRA,"MF,FW",Amiens,fr Ligue 1,36,1982,1.0,0,0,0,0,0,0,1,0.0,1,1,1,0,1,1,1,0,Matches
316,Adam Bodzek,de GER,MF,Düsseldorf,de Bundesliga,33,1985,22.4,42,26,21,20,1,14,46,30.4,32,34,11,23,25,67,39,0,Matches
317,Jean-Paul Boëtius,nl NED,MF,Mainz 05,de Bundesliga,25,1994,25.2,63,33,21,31,11,20,57,35.1,37,38,1,37,26,89,6,0,Matches
318,Sacha Boey,fr FRA,DF,Rennes,fr Ligue 1,18,2000,1.9,6,4,3,1,2,4,8,50.0,4,0,0,0,2,8,5,0,Matches
319,Jeremie Boga,ci CIV,FW,Sassuolo,it Serie A,22,1997,27.9,12,7,3,8,1,6,20,30.0,14,24,0,24,3,15,4,0,Matches
320,Melayro Bogarde,nl NED,DF,Hoffenheim,de Bundesliga,17,2002,0.6,2,1,2,0,0,2,2,100.0,0,0,0,0,0,2,3,0,Matches
321,Quentin Boisgard,fr FRA,"MF,FW",Toulouse,fr Ligue 1,22,1997,12.7,31,19,10,14,7,14,35,40.0,21,11,0,11,12,43,4,1,Matches
322,Willy Boly,ci CIV,DF,Wolves,eng Premier League,28,1991,22.0,57,33,36,21,0,25,43,58.1,18,28,11,17,39,96,108,3,Matches
323,Giacomo Bonaventura,it ITA,"MF,FW",Milan,it Serie A,29,1989,14.9,16,9,5,6,5,5,17,29.4,12,8,3,5,7,23,10,0,Matches
324,Federico Bonazzoli,it ITA,FW,Sampdoria,it Serie A,22,1997,8.3,7,5,1,4,2,0,7,0.0,7,3,0,3,5,12,2,0,Matches
325,Gaëtan Bong,cm CMR,"DF,MF",Brighton,eng Premier League,31,1988,0.7,1,0,0,0,1,0,0,,0,1,1,0,0,1,0,0,Matches
326,Kevin Bonifazi,it ITA,DF,Torino,it Serie A,23,1996,2.7,9,8,6,3,0,5,6,83.3,1,3,2,1,5,14,10,0,Matches
327,Kevin Bonifazi,it ITA,DF,SPAL,it Serie A,23,1996,13.2,16,9,15,1,0,9,18,50.0,9,20,12,8,35,51,50,2,Matches
328,Federico Bonini,it ITA,DF,Bologna,it Serie A,17,2001,0.1,0,0,0,0,0,0,0,,0,0,0,0,0,0,0,0,Matches
329,Leonardo Bonucci,it ITA,DF,Juventus,it Serie A,32,1987,34.2,28,17,18,8,2,12,17,70.6,5,32,29,3,31,59,94,2,Matches
330,Fabio Borini,it ITA,"MF,FW",Hellas Verona,it Serie A,28,1991,9.0,2,1,2,0,0,0,4,0.0,4,3,0,3,13,15,6,0,Matches
331,Fabio Borini,it ITA,MF,Milan,it Serie A,28,1991,0.8,2,2,0,0,2,0,2,0.0,2,1,0,1,0,2,3,0,Matches
332,Dennis Borkowski,de GER,FW,RB Leipzig,de Bundesliga,17,2002,0.1,0,0,0,0,0,0,0,,0,0,0,0,0,0,0,0,Matches
333,Robin Bormuth,de GER,DF,Düsseldorf,de Bundesliga,23,1995,2.0,2,1,2,0,0,2,3,66.7,1,6,5,1,0,2,12,0,Matches
334,Sebastiaan Bornauw,be BEL,DF,Köln,de Bundesliga,20,1999,27.2,37,24,24,12,1,20,39,51.3,19,32,12,20,42,79,99,0,Matches
335,Brandon Borrello,au AUS,"MF,FW",Freiburg,de Bundesliga,24,1995,3.3,10,4,6,4,0,4,10,40.0,6,7,1,6,1,11,1,0,Matches
336,Gabriel Boschilia,br BRA,"MF,FW",Monaco,fr Ligue 1,23,1996,1.4,3,1,0,3,0,1,5,20.0,4,1,1,0,2,5,2,0,Matches
337,Denis Bouanga,ga GAB,"FW,MF",Saint-Étienne,fr Ligue 1,24,1994,22.7,45,34,10,25,10,20,55,36.4,35,30,0,30,10,55,15,0,Matches
338,Hicham Boudaoui,dz ALG,"MF,FW",Nice,fr Ligue 1,19,1999,5.4,20,10,6,11,3,9,23,39.1,14,10,3,7,13,33,7,0,Matches
339,Ryad Boudebouz,dz ALG,"MF,FW",Saint-Étienne,fr Ligue 1,29,1990,17.7,25,16,9,14,2,8,25,32.0,17,14,1,13,7,32,5,0,Matches
340,Sofiane Boufal,ma MAR,"MF,FW",Southampton,eng Premier League,25,1993,8.5,16,8,6,5,5,6,15,40.0,9,17,0,17,4,20,1,0,Matches
341,Nassim Boujellab,ma MAR,"MF,FW",Schalke 04,de Bundesliga,20,1999,4.7,12,10,5,4,3,5,14,35.7,9,8,1,7,7,19,5,0,Matches
342,Farid Boulaya,dz ALG,FW,Metz,fr Ligue 1,26,1993,9.1,14,10,7,4,3,7,19,36.8,12,5,0,5,6,20,3,0,Matches
343,Yassine Bounou,ma MAR,GK,Sevilla,es La Liga,28,1991,5.5,0,0,0,0,0,0,0,,0,0,0,0,0,0,0,0,Matches
344,Mehdi Bourabia,ma MAR,MF,Sassuolo,it Serie A,27,1991,10.3,19,9,8,10,1,9,22,40.9,13,12,2,10,22,41,23,0,Matches
345,Benjamin Bourigeaud,fr FRA,MF,Rennes,fr Ligue 1,25,1994,21.1,40,12,18,20,2,17,68,25.0,51,38,7,31,20,60,25,0,Matches
346,Bilal Boutobba,fr FRA,MF,Montpellier,fr Ligue 1,20,1998,0.1,0,0,0,0,0,0,1,0.0,1,0,0,0,0,0,0,0,Matches
347,Jarrod Bowen,eng ENG,"FW,MF",West Ham,eng Premier League,22,1996,10.2,19,15,7,9,3,4,17,23.5,13,6,0,6,16,35,8,0,Matches
348,Dedryck Boyata,be BEL,DF,Hertha BSC,de Bundesliga,28,1990,27.1,24,18,17,5,2,4,12,33.3,8,39,32,7,62,86,158,1,Matches
349,John Boye,gh GHA,DF,Metz,fr Ligue 1,32,1987,23.5,30,19,25,5,0,19,32,59.4,13,31,18,13,31,61,116,0,Matches
350,Can Bozdogan,de GER,MF,Schalke 04,de Bundesliga,18,2001,2.6,8,6,5,3,0,3,12,25.0,9,2,0,2,2,10,2,0,Matches
351,Domagoj Bradarić,hr CRO,DF,Lille,fr Ligue 1,19,1999,15.8,28,11,9,17,2,12,27,44.4,15,16,3,13,22,50,28,0,Matches
352,Filip Bradarić,hr CRO,MF,Celta Vigo,es La Liga,27,1992,7.8,12,9,5,5,2,3,8,37.5,5,12,3,9,17,29,19,0,Matches
353,Robbie Brady,ie IRL,MF,Burnley,eng Premier League,27,1992,5.0,11,9,5,4,2,3,10,30.0,7,10,2,8,5,16,8,0,Matches
354,Martin Braithwaite,dk DEN,"FW,MF",Barcelona,es La Liga,28,1991,4.5,2,2,2,0,0,0,8,0.0,8,3,0,3,1,3,1,0,Matches
355,Martin Braithwaite,dk DEN,"FW,MF",Leganés,es La Liga,28,1991,21.5,13,7,4,5,4,4,12,33.3,8,10,2,8,4,17,9,0,Matches
356,Federico Brancolini,it ITA,GK,Fiorentina,it Serie A,18,2001,0.1,0,0,0,0,0,0,0,,0,0,0,0,0,0,0,0,Matches
357,Brandon,es ESP,FW,Osasuna,es La Liga,24,1995,4.5,5,3,1,3,1,0,5,0.0,5,4,0,4,0,5,1,0,Matches
358,Julian Brandt,de GER,"MF,FW",Dortmund,de Bundesliga,23,1996,24.5,48,33,15,21,12,25,55,45.5,30,35,2,33,16,64,10,1,Matches
359,Jarrad Branthwaite,eng ENG,DF,Everton,eng Premier League,17,2002,3.3,8,7,5,3,0,3,5,60.0,2,6,3,3,2,10,12,0,Matches
360,Darko Brašanac,rs SRB,MF,Osasuna,es La Liga,27,1992,24.9,45,25,14,26,5,15,41,36.6,26,19,4,15,20,65,21,0,Matches
361,Claudio Bravo,cl CHI,GK,Manchester City,eng Premier League,36,1983,3.9,0,0,0,0,0,0,0,,0,0,0,0,0,0,1,1,Matches
362,Josip Brekalo,hr CRO,"MF,FW",Wolfsburg,de Bundesliga,21,1998,18.6,18,8,5,6,7,5,23,21.7,18,26,0,26,16,34,4,0,Matches
363,Gleison Bremer,br BRA,DF,Torino,it Serie A,22,1997,25.2,63,36,37,20,6,20,34,58.8,14,48,22,26,74,137,118,1,Matches
364,Marco Brescianini,it ITA,MF,Milan,it Serie A,19,2000,0.3,1,1,1,0,0,0,0,,0,0,0,0,2,3,0,0,Matches
365,Anthony Briançon,fr FRA,DF,Nîmes,fr Ligue 1,24,1994,19.3,29,19,20,9,0,17,34,50.0,17,22,16,6,39,68,80,0,Matches
366,Jimmy Briand,fr FRA,FW,Bordeaux,fr Ligue 1,33,1985,16.9,12,8,5,4,3,3,13,23.1,10,8,4,4,6,18,12,0,Matches
367,Yan Brice Eteki,cm CMR,MF,Granada,es La Liga,21,1997,16.7,37,21,14,18,5,15,31,48.4,16,17,4,13,24,61,20,1,Matches
368,Armando Broja,al ALB,FW,Chelsea,eng Premier League,17,2001,0.1,0,0,0,0,0,0,0,,0,0,0,0,0,0,0,0,Matches
369,Dylan Bronn,tn TUN,DF,Metz,fr Ligue 1,24,1995,9.0,7,5,6,1,0,4,7,57.1,3,11,9,2,6,13,42,0,Matches
370,David Brooks,wls WAL,"MF,FW",Bournemouth,eng Premier League,22,1997,5.6,5,5,1,2,2,2,14,14.3,12,5,1,4,2,7,1,0,Matches
371,John Brooks,us USA,DF,Wolfsburg,de Bundesliga,26,1993,24.7,38,27,27,9,2,24,49,49.0,25,31,12,19,41,79,93,0,Matches
372,Daniel Brosinski,de GER,DF,Mainz 05,de Bundesliga,31,1988,19.0,40,27,13,23,4,15,34,44.1,19,16,2,14,14,54,58,0,Matches
373,Josh Brownhill,eng ENG,MF,Burnley,eng Premier League,23,1995,8.9,14,8,5,7,2,5,13,38.5,8,9,4,5,14,28,18,0,Matches
374,Marcelo Brozović,hr CRO,MF,Inter,it Serie A,26,1992,30.0,67,35,26,31,10,19,71,26.8,52,26,9,17,46,113,46,2,Matches
375,Gastón Brugman,uy URU,MF,Parma,it Serie A,26,1992,16.2,47,24,25,15,7,19,46,41.3,27,33,15,18,27,74,19,2,Matches
376,Jeffrey Bruma,nl NED,DF,Wolfsburg,de Bundesliga,27,1991,9.0,9,5,4,5,0,7,13,53.8,6,6,3,3,13,22,51,1,Matches
377,Jeffrey Bruma,nl NED,DF,Mainz 05,de Bundesliga,27,1991,7.5,12,8,8,4,0,4,6,66.7,2,11,5,6,6,18,34,1,Matches
378,Jacob Bruun Larsen,dk DEN,"FW,MF",Hoffenheim,de Bundesliga,20,1998,4.3,3,2,3,0,0,3,8,37.5,5,3,0,3,3,6,1,0,Matches
379,Jacob Bruun Larsen,dk DEN,FW,Dortmund,de Bundesliga,20,1998,0.8,0,0,0,0,0,0,0,,0,0,0,0,0,0,0,0,Matches
380,Lucas Buadés,fr FRA,"MF,FW",Nîmes,fr Ligue 1,21,1997,1.3,4,4,3,1,0,1,5,20.0,4,0,0,0,1,5,3,0,Matches
381,Ante Budimir,hr CRO,FW,Mallorca,es La Liga,28,1991,30.7,31,15,4,22,5,7,29,24.1,22,21,4,17,8,39,29,0,Matches
382,Emi Buendía,ar ARG,"FW,MF",Norwich City,eng Premier League,22,1996,27.4,82,39,57,21,4,38,118,32.2,80,58,5,53,23,105,32,2,Matches
383,Gianluigi Buffon,it ITA,GK,Juventus,it Serie A,41,1978,9.0,0,0,0,0,0,0,0,,0,0,0,0,0,0,3,1,Matches
384,Marius Bülter,de GER,"MF,FW",Union Berlin,de Bundesliga,26,1993,25.8,38,22,19,13,6,17,54,31.5,37,37,3,34,11,49,20,1,Matches
385,Esteban Burgos,ar ARG,DF,Eibar,es La Liga,27,1992,12.4,11,9,9,2,0,5,9,55.6,4,11,6,5,17,28,66,2,Matches
386,Guido Burgstaller,at AUT,FW,Schalke 04,de Bundesliga,30,1989,13.7,7,3,0,5,2,4,15,26.7,11,12,3,9,4,11,10,0,Matches
387,Burgui,es ESP,MF,Alavés,es La Liga,25,1993,0.2,0,0,0,0,0,0,0,,0,0,0,0,0,0,0,0,Matches
388,Jonathan Burkardt,de GER,"FW,MF",Mainz 05,de Bundesliga,19,2000,2.8,9,4,2,5,2,3,8,37.5,5,6,1,5,0,9,1,0,Matches
389,Oliver Burke,sct SCO,"MF,FW",Alavés,es La Liga,22,1997,15.9,19,14,8,9,2,10,23,43.5,13,24,0,24,8,27,16,0,Matches
390,Roman Bürki,ch SUI,GK,Dortmund,de Bundesliga,28,1990,30.8,2,2,2,0,0,2,3,66.7,1,1,0,1,2,4,13,1,Matches
391,Dan Burn,eng ENG,DF,Brighton,eng Premier League,27,1992,32.0,67,42,35,27,5,25,53,47.2,28,44,20,24,42,109,130,0,Matches
392,Patrick Burner,mq MTQ,DF,Nice,fr Ligue 1,23,1996,15.9,35,25,15,17,3,14,25,56.0,11,11,2,9,30,65,37,0,Matches
393,Sergio Busquets,es ESP,MF,Barcelona,es La Liga,31,1988,27.6,80,44,23,43,14,41,71,57.7,30,36,5,31,44,124,24,2,Matches
394,Unai Bustinza,es ESP,DF,Leganés,es La Liga,27,1992,29.8,66,40,40,19,7,32,53,60.4,21,30,9,21,65,131,77,0,Matches
395,Ludovic Butelle,fr FRA,GK,Angers,fr Ligue 1,36,1983,26.0,1,1,1,0,0,1,2,50.0,1,1,0,1,0,1,10,4,Matches
396,Marcin Bułka,pl POL,GK,Paris S-G,fr Ligue 1,19,1999,1.0,0,0,0,0,0,0,0,,0,0,0,0,0,0,0,0,Matches
397,Sam Byram,eng ENG,DF,Norwich City,eng Premier League,25,1993,14.4,40,22,24,11,5,18,37,48.6,19,16,8,8,26,66,73,0,Matches
398,Erick Cabaco,uy URU,DF,Getafe,es La Liga,24,1995,3.0,3,2,1,2,0,0,3,0.0,3,1,1,0,3,6,11,0,Matches
399,Erick Cabaco,uy URU,DF,Levante,es La Liga,24,1995,9.0,12,9,9,3,0,4,6,66.7,2,12,7,5,12,24,50,1,Matches
400,Willy Caballero,ar ARG,GK,Chelsea,eng Premier League,37,1981,5.0,0,0,0,0,0,0,0,,0,0,0,0,0,0,3,0,Matches
401,Yohan Cabaye,fr FRA,MF,Saint-Étienne,fr Ligue 1,33,1986,9.5,29,18,11,14,4,14,25,56.0,11,10,0,10,22,51,7,1,Matches
402,Manuel Cabit,mq MTQ,DF,Metz,fr Ligue 1,26,1993,3.0,3,1,1,2,0,2,10,20.0,8,5,0,5,4,7,5,0,Matches
403,Ariday Cabrera,es ESP,MF,Mallorca,es La Liga,30,1988,0.4,1,1,1,0,0,0,1,0.0,1,2,0,2,0,1,0,0,Matches
404,Leandro Cabrera,uy URU,DF,Getafe,es La Liga,28,1991,17.0,10,6,5,5,0,5,12,41.7,7,10,4,6,21,31,66,0,Matches
405,Leandro Cabrera,uy URU,DF,Espanyol,es La Liga,28,1991,17.0,27,11,17,9,1,17,28,60.7,11,19,12,7,21,48,78,1,Matches
406,Fabrizio Cacciatore,it ITA,DF,Cagliari,it Serie A,32,1986,12.8,14,4,9,4,1,6,9,66.7,3,10,6,4,16,30,44,0,Matches
407,Martín Cáceres,uy URU,DF,Fiorentina,it Serie A,32,1987,26.2,47,31,34,11,2,16,34,47.1,18,29,13,16,31,78,74,2,Matches
408,Anthony Caci,fr FRA,DF,Strasbourg,fr Ligue 1,22,1997,7.7,29,17,19,9,1,8,17,47.1,9,15,5,10,19,48,15,1,Matches
409,Jhonder Cádiz,ve VEN,"FW,MF",Dijon,fr Ligue 1,24,1995,8.9,16,8,6,7,3,3,7,42.9,4,4,2,2,1,17,9,0,Matches
410,Mathieu Cafaro,fr FRA,"FW,MF",Reims,fr Ligue 1,22,1997,10.3,12,6,5,5,2,6,17,35.3,11,13,0,13,2,14,0,0,Matches
411,Jonathan Cafu,br BRA,DF,Bordeaux,fr Ligue 1,28,1991,2.2,7,3,4,3,0,4,7,57.1,3,1,0,1,1,8,3,0,Matches
412,Gary Cahill,eng ENG,DF,Crystal Palace,eng Premier League,33,1985,24.1,15,8,11,4,0,7,15,46.7,8,34,25,9,18,33,114,1,Matches
413,Felipe Caicedo,ec ECU,FW,Lazio,it Serie A,30,1988,15.6,17,10,4,7,6,2,11,18.2,9,9,1,8,4,21,2,0,Matches
414,Arturo Calabresi,it ITA,DF,Amiens,fr Ligue 1,23,1996,20.9,53,33,29,20,4,33,75,44.0,42,24,11,13,29,82,60,0,Matches
415,Davide Calabria,it ITA,DF,Milan,it Serie A,22,1996,18.0,52,33,28,22,2,17,41,41.5,24,23,5,18,21,73,47,1,Matches
416,Riccardo Calafiori,it ITA,DF,Roma,it Serie A,17,2002,0.7,0,0,0,0,0,0,1,0.0,1,0,0,0,2,2,0,0,Matches
417,Mattia Caldara,it ITA,DF,Atalanta,it Serie A,25,1994,10.7,21,11,12,8,1,5,11,45.5,6,9,5,4,30,51,22,1,Matches
418,Marco Calderoni,it ITA,DF,Lecce,it Serie A,30,1989,22.9,38,25,22,13,3,20,39,51.3,19,27,10,17,37,75,54,1,Matches
419,Fernando Calero,es ESP,DF,Espanyol,es La Liga,23,1995,11.6,14,9,10,4,0,7,15,46.7,8,13,5,8,8,22,42,1,Matches
420,Duje Ćaleta-Car,hr CRO,DF,Marseille,fr Ligue 1,22,1996,21.0,29,15,17,11,1,18,26,69.2,8,17,6,11,26,55,98,0,Matches
421,Hakan Çalhanoğlu,tr TUR,"MF,FW",Milan,it Serie A,25,1994,30.0,42,21,15,21,6,12,35,34.3,23,26,2,24,26,68,26,1,Matches
422,Daniel Caligiuri,it ITA,"MF,FW",Schalke 04,de Bundesliga,31,1988,25.5,58,37,18,25,15,27,74,36.5,47,67,6,61,25,83,39,0,Matches
423,José Callejón,es ESP,"FW,MF",Napoli,it Serie A,32,1987,24.1,13,9,3,7,3,9,25,36.0,16,15,3,12,10,23,14,1,Matches
424,Jonathan Calleri,ar ARG,FW,Espanyol,es La Liga,25,1993,20.1,12,8,6,4,2,3,24,12.5,21,11,3,8,7,19,22,0,Matches
425,Dominic Calvert-Lewin,eng ENG,FW,Everton,eng Premier League,22,1997,29.2,7,5,1,4,2,1,10,10.0,9,15,2,13,6,13,36,0,Matches
426,Mahdi Camara,fr FRA,MF,Saint-Étienne,fr Ligue 1,21,1998,10.0,33,20,12,16,5,18,32,56.3,14,20,2,18,18,51,5,0,Matches
427,Souleymane Camara,sn SEN,FW,Montpellier,fr Ligue 1,36,1982,1.8,0,0,0,0,0,0,2,0.0,2,0,0,0,0,0,1,0,Matches
428,Víctor Camarasa,es ESP,FW,Crystal Palace,eng Premier League,25,1994,0.1,0,0,0,0,0,0,0,,0,0,0,0,0,0,0,0,Matches
429,Víctor Camarasa,es ESP,MF,Alavés,es La Liga,25,1994,14.4,18,10,5,10,3,7,18,38.9,11,8,3,5,15,33,12,0,Matches
430,Eduardo Camavinga,fr FRA,MF,Rennes,fr Ligue 1,16,2002,23.4,105,64,45,56,4,48,96,50.0,48,26,8,18,34,139,35,0,Matches
431,Sergio Camello,es ESP,FW,Atlético Madrid,es La Liga,18,2001,0.3,0,0,0,0,0,0,0,,0,0,0,0,0,0,0,0,Matches
432,José Campaña,es ESP,MF,Levante,es La Liga,26,1993,35.1,38,25,15,13,10,13,53,24.5,40,30,5,25,44,82,42,2,Matches
433,Xisco Campos,es ESP,DF,Mallorca,es La Liga,37,1982,5.3,7,4,5,2,0,5,9,55.6,4,8,5,3,11,18,23,0,Matches
434,Víctor Campuzano,es ESP,FW,Espanyol,es La Liga,22,1997,9.7,12,9,1,6,5,3,19,15.8,16,8,0,8,2,14,4,0,Matches
435,Emre Can,de GER,MF,Juventus,it Serie A,25,1994,3.2,10,7,5,3,2,3,10,30.0,7,4,0,4,2,12,3,0,Matches
436,Emre Can,de GER,"MF,DF",Dortmund,de Bundesliga,25,1994,10.6,19,12,11,7,1,5,12,41.7,7,14,6,8,19,38,15,0,Matches
437,Sergio Canales,es ESP,"MF,FW",Betis,es La Liga,28,1991,35.1,25,16,14,6,5,7,28,25.0,21,30,1,29,13,38,16,0,Matches
438,João Cancelo,pt POR,DF,Manchester City,eng Premier League,25,1994,13.4,40,24,21,12,7,24,40,60.0,16,9,2,7,21,61,18,0,Matches
439,Antonio Candreva,it ITA,DF,Inter,it Serie A,32,1987,22.1,11,6,9,1,1,7,29,24.1,22,26,10,16,14,25,33,1,Matches
440,Gianmarco Cangiano,it ITA,"FW,MF",Bologna,it Serie A,17,2001,0.2,1,1,0,1,0,0,0,,0,0,0,0,1,2,0,0,Matches
441,Todd Cantwell,eng ENG,"FW,MF",Norwich City,eng Premier League,21,1998,27.7,51,31,19,27,5,26,73,35.6,47,38,2,36,18,69,35,1,Matches
442,Ander Capa,es ESP,DF,Athletic Club,es La Liga,27,1992,31.9,64,36,37,21,6,24,59,40.7,35,26,7,19,28,92,63,0,Matches
443,Pierrick Capelle,fr FRA,"MF,DF",Angers,fr Ligue 1,32,1987,19.4,42,32,18,16,8,16,48,33.3,32,17,3,14,21,63,28,0,Matches
444,Étienne Capoue,fr FRA,MF,Watford,eng Premier League,31,1988,29.2,75,40,38,30,7,37,85,43.5,48,30,11,19,68,143,61,0,Matches
445,Gianluca Caprari,it ITA,"FW,MF",Sampdoria,it Serie A,26,1993,7.4,9,7,1,6,2,4,13,30.8,9,5,0,5,7,16,1,0,Matches
446,Gianluca Caprari,it ITA,"FW,MF",Parma,it Serie A,26,1993,6.5,1,1,0,1,0,0,5,0.0,5,7,2,5,4,5,2,0,Matches
447,Francesco Caputo,it ITA,FW,Sassuolo,it Serie A,31,1987,32.6,7,4,3,2,2,3,11,27.3,8,15,0,15,1,8,8,0,Matches
448,Maxence Caqueret,fr FRA,MF,Lyon,fr Ligue 1,19,2000,6.3,24,15,10,13,1,11,25,44.0,14,14,2,12,9,33,6,1,Matches
449,Andrea Carboni,it ITA,DF,Cagliari,it Serie A,18,2001,4.1,8,4,3,5,0,3,4,75.0,1,6,6,0,7,15,20,0,Matches
450,Irvin Cardona,fr FRA,"FW,MF",Brest,fr Ligue 1,21,1997,16.1,13,8,5,6,2,9,32,28.1,23,8,0,8,1,14,7,0,Matches
451,Marc Cardona,es ESP,FW,Osasuna,es La Liga,24,1995,7.8,1,0,0,1,0,0,8,0.0,8,3,1,2,2,3,2,0,Matches
452,Diego Carlos,br BRA,DF,Sevilla,es La Liga,26,1993,34.8,35,23,25,9,1,15,25,60.0,10,33,24,9,37,72,176,1,Matches
453,Lionel Carole,fr FRA,DF,Strasbourg,fr Ligue 1,28,1991,14.1,23,8,15,6,2,13,17,76.5,4,2,1,1,19,42,22,0,Matches
454,Yannick Carrasco,be BEL,"MF,FW",Atlético Madrid,es La Liga,25,1993,7.0,11,7,4,4,3,7,21,33.3,14,9,0,9,5,16,2,0,Matches
455,Daniel Carriço,pt POR,DF,Sevilla,es La Liga,30,1988,9.4,8,2,4,3,1,1,6,16.7,5,4,3,1,8,16,23,0,Matches
456,Guido Carrillo,ar ARG,FW,Leganés,es La Liga,28,1991,13.5,13,10,3,6,4,2,14,14.3,12,9,1,8,3,16,22,0,Matches
457,Andy Carroll,eng ENG,FW,Newcastle Utd,eng Premier League,30,1989,7.0,5,3,3,2,0,2,8,25.0,6,2,1,1,2,7,24,1,Matches
458,Dani Carvajal,es ESP,DF,Real Madrid,es La Liga,27,1992,30.4,65,46,33,25,7,23,42,54.8,19,43,14,29,36,101,53,0,Matches
459,Matis Carvalho,pt POR,GK,Montpellier,fr Ligue 1,20,1999,0.8,0,0,0,0,0,0,1,0.0,1,0,0,0,0,0,1,0,Matches
460,William Carvalho,pt POR,MF,Betis,es La Liga,27,1992,9.9,7,4,4,2,1,4,14,28.6,10,7,5,2,4,11,8,1,Matches
461,Casemiro,br BRA,MF,Real Madrid,es La Liga,27,1992,34.3,96,60,43,45,8,39,99,39.4,60,53,10,43,68,164,72,0,Matches
462,Moreto Cassamã,gw GNB,MF,Reims,fr Ligue 1,21,1998,6.6,17,11,2,13,2,5,7,71.4,2,7,2,5,5,22,6,0,Matches
463,Francesco Cassata,it ITA,MF,Genoa,it Serie A,22,1997,16.2,20,10,12,5,3,9,30,30.0,21,12,2,10,11,31,11,0,Matches
464,Timothy Castagne,be BEL,DF,Atalanta,it Serie A,23,1995,19.7,31,20,9,16,6,13,25,52.0,12,34,5,29,17,48,23,0,Matches
465,Koen Casteels,be BEL,GK,Wolfsburg,de Bundesliga,27,1992,26.0,0,0,0,0,0,0,0,,0,0,0,0,0,0,9,1,Matches
466,Jean-Charles Castelletto,cm CMR,DF,Brest,fr Ligue 1,24,1995,20.4,18,9,13,5,0,9,18,50.0,9,20,16,4,33,51,87,1,Matches
467,Samu Castillejo,es ESP,"FW,MF",Milan,it Serie A,24,1995,13.4,24,15,10,11,3,9,42,21.4,33,17,2,15,24,48,5,0,Matches
468,Jonny Castro,es ESP,"MF,DF",Wolves,eng Premier League,25,1994,32.1,91,55,54,26,11,29,82,35.4,53,45,10,35,53,144,45,2,Matches
469,Lucas Castro,ar ARG,MF,SPAL,it Serie A,30,1989,4.7,13,5,5,5,3,2,4,50.0,2,4,0,4,2,15,3,0,Matches
470,Lucas Castro,ar ARG,MF,Cagliari,it Serie A,30,1989,6.7,7,3,3,4,0,1,12,8.3,11,6,1,5,8,15,14,0,Matches
471,Gaetano Castrovilli,it ITA,MF,Fiorentina,it Serie A,22,1997,29.7,59,31,25,23,11,18,53,34.0,35,29,2,27,15,74,31,1,Matches
472,Danilo Cataldi,it ITA,MF,Lazio,it Serie A,24,1994,6.6,17,11,10,5,2,10,20,50.0,10,7,1,6,13,30,10,0,Matches
473,Craig Cathcart,nir NIR,DF,Watford,eng Premier League,30,1989,27.6,41,26,25,15,1,10,24,41.7,14,19,16,3,25,66,136,1,Matches
474,Edinson Cavani,uy URU,FW,Paris S-G,fr Ligue 1,32,1987,6.7,5,1,0,2,3,0,3,0.0,3,7,0,7,1,6,2,0,Matches
475,Santi Cazorla,es ESP,MF,Villarreal,es La Liga,34,1984,27.2,48,25,14,21,13,20,57,35.1,37,23,1,22,19,67,16,2,Matches
476,Dani Ceballos,es ESP,MF,Arsenal,eng Premier League,22,1996,18.8,45,23,26,14,5,18,61,29.5,43,14,3,11,32,77,16,1,Matches
477,Federico Ceccherini,it ITA,DF,Fiorentina,it Serie A,27,1992,9.3,14,8,11,3,0,10,10,100.0,0,9,5,4,13,27,37,1,Matches
478,Christian Celesia,it ITA,DF,Torino,it Serie A,17,2002,0.0,0,0,0,0,0,0,0,,0,0,0,0,0,0,0,0,Matches
479,Zeki Çelik,tr TUR,DF,Lille,fr Ligue 1,22,1997,23.0,53,28,18,28,7,27,60,45.0,33,24,4,20,26,79,39,0,Matches
480,Fabien Centonze,fr FRA,DF,Metz,fr Ligue 1,23,1996,28.0,76,49,53,22,1,34,57,59.6,23,30,11,19,59,135,98,0,Matches
481,Luca Ceppitelli,it ITA,DF,Cagliari,it Serie A,29,1989,13.8,22,15,16,6,0,6,11,54.5,5,23,17,6,23,45,66,2,Matches
482,Alberto Cerri,it ITA,FW,SPAL,it Serie A,23,1996,4.7,2,1,0,2,0,1,3,33.3,2,1,0,1,0,2,3,0,Matches
483,Alberto Cerri,it ITA,FW,Cagliari,it Serie A,23,1996,2.7,3,1,1,0,2,2,6,33.3,4,1,0,1,2,5,4,0,Matches
484,Julian Chabot,de GER,DF,Sampdoria,it Serie A,21,1998,6.3,11,7,6,5,0,6,11,54.5,5,3,2,1,15,26,26,0,Matches
485,Florian Chabrolle,fr FRA,MF,Marseille,fr Ligue 1,21,1998,0.2,0,0,0,0,0,0,0,,0,0,0,0,0,0,0,0,Matches
486,Fouad Chafik,ma MAR,DF,Dijon,fr Ligue 1,32,1986,17.0,32,21,22,7,3,17,36,47.2,19,12,5,7,26,58,36,0,Matches
487,Sofian Chakla,ma MAR,DF,Villarreal,es La Liga,25,1993,2.0,0,0,0,0,0,0,1,0.0,1,2,1,1,3,3,7,1,Matches
488,Nathaniel Chalobah,eng ENG,MF,Watford,eng Premier League,24,1994,10.3,30,11,13,13,4,12,27,44.4,15,10,4,6,18,48,20,0,Matches
489,Calum Chambers,eng ENG,DF,Arsenal,eng Premier League,24,1995,12.2,26,10,12,8,6,11,16,68.8,5,13,7,6,16,42,43,1,Matches
490,Jhon Chancellor,ve VEN,DF,Brescia,it Serie A,27,1992,24.9,30,14,22,8,0,11,22,50.0,11,34,29,5,34,64,145,3,Matches
491,Timothy Chandler,us USA,"DF,MF",Eint Frankfurt,de Bundesliga,29,1990,13.6,22,10,9,8,5,9,16,56.3,7,9,4,5,13,35,21,0,Matches
492,Kwon Chang-hoon,kr KOR,"MF,FW",Freiburg,de Bundesliga,25,1994,7.5,7,4,2,3,2,1,10,10.0,9,5,1,4,7,14,14,0,Matches
493,Gaëtan Charbonnier,fr FRA,"FW,MF",Brest,fr Ligue 1,30,1988,22.9,36,16,11,11,14,10,35,28.6,25,19,6,13,7,43,33,1,Matches
494,Brendan Chardonnet,fr FRA,DF,Brest,fr Ligue 1,24,1994,9.1,12,6,10,2,0,7,12,58.3,5,8,5,3,15,27,50,0,Matches
495,Charles,br BRA,FW,Eibar,es La Liga,35,1984,14.5,10,5,0,6,4,4,22,18.2,18,7,2,5,7,17,6,0,Matches
496,Xavier Chavalerin,fr FRA,MF,Reims,fr Ligue 1,28,1991,23.9,71,52,29,33,9,19,49,38.8,30,23,8,15,36,107,36,0,Matches
497,Pablo Chavarría,ar ARG,"FW,MF",Mallorca,es La Liga,31,1988,2.3,1,1,0,1,0,0,4,0.0,4,1,1,0,1,2,2,0,Matches
498,Aurélien Chedjou,cm CMR,DF,Amiens,fr Ligue 1,34,1985,21.9,27,19,18,9,0,10,22,45.5,12,15,11,4,40,67,120,3,Matches
499,Pape Cheikh Diop,sn SEN,MF,Celta Vigo,es La Liga,21,1997,6.7,10,4,6,3,1,2,12,16.7,10,4,2,2,5,15,3,0,Matches
500,Chema,es ESP,DF,Getafe,es La Liga,27,1992,3.4,4,3,1,3,0,1,2,50.0,1,1,0,1,5,9,12,0,Matches
501,Rayan Cherki,fr FRA,"MF,FW",Lyon,fr Ligue 1,15,2003,1.6,3,2,0,1,2,3,4,75.0,1,3,0,3,0,3,0,0,Matches
502,Denis Cheryshev,ru RUS,"MF,FW",Valencia,es La Liga,28,1990,10.3,16,9,5,4,7,3,17,17.6,14,15,1,14,7,23,10,0,Matches
503,Giorgio Chiellini,it ITA,DF,Juventus,it Serie A,34,1984,2.2,3,0,3,0,0,1,1,100.0,0,2,2,0,1,4,9,0,Matches
504,Federico Chiesa,it ITA,"FW,DF",Fiorentina,it Serie A,21,1997,29.3,38,22,13,15,10,10,52,19.2,42,19,0,19,6,44,6,0,Matches
505,Ben Chilwell,eng ENG,DF,Leicester City,eng Premier League,22,1996,26.4,43,26,28,13,2,23,52,44.2,29,30,6,24,28,71,68,2,Matches
506,Vlad Chiricheș,ro ROU,DF,Sassuolo,it Serie A,29,1989,7.9,14,9,12,2,0,7,10,70.0,3,13,8,5,11,25,28,2,Matches
507,Tahith Chong,nl NED,"FW,DF",Manchester Utd,eng Premier League,19,1999,0.4,0,0,0,0,0,0,0,,0,0,0,0,0,0,0,0,Matches
508,Joris Chotard,fr FRA,MF,Montpellier,fr Ligue 1,17,2001,13.9,30,18,13,17,0,15,35,42.9,20,12,5,7,20,50,12,1,Matches
509,Hamza Choudhury,eng ENG,MF,Leicester City,eng Premier League,21,1997,9.9,17,8,7,8,2,3,25,12.0,22,15,6,9,24,41,13,0,Matches
510,Mounir Chouiar,fr FRA,"MF,FW",Dijon,fr Ligue 1,20,1999,16.7,36,23,13,18,5,12,42,28.6,30,8,0,8,13,49,13,0,Matches
511,Andreas Christensen,dk DEN,DF,Chelsea,eng Premier League,23,1996,19.5,38,21,25,12,1,15,21,71.4,6,12,8,4,29,67,56,0,Matches
512,Samuel Chukwueze,ng NGA,"FW,MF",Villarreal,es La Liga,20,1999,22.8,23,14,12,6,5,13,30,43.3,17,15,1,14,10,33,14,1,Matches
513,Darko Churlinov,mk MKD,MF,Köln,de Bundesliga,19,2000,0.2,1,1,1,0,0,1,2,50.0,1,0,0,0,1,2,0,0,Matches
514,Churripi,es ESP,GK,Valladolid,es La Liga,25,1994,2.7,1,1,1,0,0,1,1,100.0,0,0,0,0,0,1,2,0,Matches
515,Luca Cigarini,it ITA,MF,Cagliari,it Serie A,33,1986,17.8,37,20,23,13,1,16,40,40.0,24,28,10,18,20,57,29,0,Matches
516,Per Ciljan Skjelbred,no NOR,MF,Hertha BSC,de Bundesliga,32,1987,18.1,50,30,18,29,3,17,41,41.5,24,14,3,11,23,73,17,0,Matches
517,Jasper Cillessen,nl NED,GK,Valencia,es La Liga,30,1989,23.3,0,0,0,0,0,0,1,0.0,1,0,0,0,3,3,3,1,Matches
518,Thiago Cionek,pl POL,DF,SPAL,it Serie A,33,1986,24.1,53,32,36,12,5,22,53,41.5,31,30,11,19,46,99,91,2,Matches
519,Ibrahim Cissé,ci CIV,DF,Nice,fr Ligue 1,20,1999,0.6,1,1,1,0,0,0,0,,0,0,0,0,0,1,6,0,Matches
520,Ibrahim Cissé,sn SEN,DF,Angers,fr Ligue 1,23,1996,0.7,2,1,0,2,0,0,0,,0,0,0,0,0,2,2,0,Matches
521,Andrea Cistana,it ITA,DF,Brescia,it Serie A,22,1997,20.4,20,8,13,7,0,6,17,35.3,11,38,34,4,33,53,96,1,Matches
522,Ciaran Clark,ie IRL,DF,Newcastle Utd,eng Premier League,29,1989,13.2,20,12,18,2,0,9,15,60.0,6,18,14,4,11,31,82,0,Matches
523,Leon Clarke,eng ENG,"FW,MF",Sheffield Utd,eng Premier League,34,1985,0.4,0,0,0,0,0,0,0,,0,0,0,0,0,0,2,0,Matches
524,Alexis Claude-Maurice,fr FRA,"FW,MF",Nice,fr Ligue 1,21,1998,18.1,26,16,8,11,7,13,35,37.1,22,20,4,16,11,37,4,0,Matches
525,Christian Clemens,de GER,FW,Köln,de Bundesliga,27,1991,0.2,0,0,0,0,0,0,0,,0,1,1,0,0,0,0,0,Matches
526,Óscar Clemente,es ESP,MF,Atlético Madrid,es La Liga,20,1999,0.0,0,0,0,0,0,0,0,,0,1,0,1,0,0,0,0,Matches
527,Yannis Clementia,mq MTQ,GK,Nice,fr Ligue 1,22,1997,2.0,0,0,0,0,0,0,0,,0,0,0,0,0,0,0,0,Matches
528,Denilho Cleonise,nl NED,FW,Genoa,it Serie A,17,2001,0.5,1,0,1,0,0,0,0,,0,0,0,0,1,2,0,0,Matches
529,Carlos Clerc,es ESP,DF,Levante,es La Liga,27,1992,20.5,28,16,14,13,1,12,20,60.0,8,22,9,13,22,50,61,0,Matches
530,Tom Cleverley,eng ENG,MF,Watford,eng Premier League,29,1989,10.8,28,15,8,14,6,9,36,25.0,27,13,1,12,10,38,15,0,Matches
531,Conor Coady,eng ENG,DF,Wolves,eng Premier League,26,1993,38.0,36,23,30,6,0,15,30,50.0,15,22,15,7,28,64,119,2,Matches
532,Marcus Coco,fr FRA,FW,Nantes,fr Ligue 1,23,1996,0.2,1,0,1,0,0,1,1,100.0,0,0,0,0,0,1,0,0,Matches
533,Renaud Cohade,fr FRA,MF,Metz,fr Ligue 1,34,1984,8.5,28,20,11,12,5,12,28,42.9,16,14,3,11,8,36,6,0,Matches
534,Coke,es ESP,DF,Levante,es La Liga,32,1987,11.0,25,18,14,8,3,14,30,46.7,16,9,2,7,13,38,19,0,Matches
535,Séamus Coleman,ie IRL,DF,Everton,eng Premier League,30,1988,20.4,42,31,24,14,4,19,25,76.0,6,21,9,12,24,66,43,1,Matches
536,Álex Collado,es ESP,FW,Barcelona,es La Liga,20,1999,0.1,0,0,0,0,0,0,0,,0,0,0,0,0,0,0,0,Matches
537,Ebrima Colley,gm GAM,FW,Atalanta,it Serie A,19,2000,0.9,2,1,1,0,1,1,2,50.0,1,1,0,1,1,3,0,0,Matches
538,Omar Colley,gm GAM,DF,Sampdoria,it Serie A,26,1992,30.8,42,26,27,14,1,12,24,50.0,12,33,22,11,59,101,155,1,Matches
539,Jamilu Collins,ng NGA,DF,Paderborn 07,de Bundesliga,24,1994,29.6,69,43,44,21,4,37,62,59.7,25,53,19,34,70,139,91,1,Matches
540,Simone Colombi,it ITA,GK,Parma,it Serie A,28,1991,4.0,0,0,0,0,0,0,0,,0,0,0,0,0,0,1,0,Matches
541,Lorenzo Colombo,it ITA,FW,Milan,it Serie A,17,2002,0.1,0,0,0,0,0,0,0,,0,0,0,0,0,0,0,0,Matches
542,Racine Coly,sn SEN,"DF,FW",Nice,fr Ligue 1,23,1995,7.2,21,13,15,5,1,9,17,52.9,8,5,0,5,12,33,23,0,Matches
543,Kingsley Coman,fr FRA,"FW,MF",Bayern Munich,de Bundesliga,23,1996,16.7,19,11,6,7,6,12,27,44.4,15,9,0,9,4,23,3,0,Matches
544,Daniel Congré,fr FRA,DF,Montpellier,fr Ligue 1,34,1985,21.6,37,27,20,16,1,18,38,47.4,20,8,7,1,47,84,66,1,Matches
545,Aaron Connolly,ie IRL,FW,Brighton,eng Premier League,19,2000,14.0,7,6,1,4,2,3,10,30.0,7,11,0,11,0,7,3,0,Matches
546,Andrea Consigli,it ITA,GK,Sassuolo,it Serie A,32,1987,31.0,0,0,0,0,0,0,1,0.0,1,0,0,0,4,4,19,2,Matches
547,Andrea Conti,it ITA,DF,Milan,it Serie A,25,1994,19.2,41,25,23,15,3,21,49,42.9,28,21,8,13,43,84,42,1,Matches
548,Lewis Cook,eng ENG,"MF,FW",Bournemouth,eng Premier League,22,1997,15.0,27,14,15,9,3,10,47,21.3,37,17,5,12,17,44,17,1,Matches
549,Steve Cook,eng ENG,DF,Bournemouth,eng Premier League,28,1991,27.0,22,11,18,4,0,8,20,40.0,12,32,23,9,44,66,153,1,Matches
550,Francis Coquelin,fr FRA,MF,Valencia,es La Liga,28,1991,21.2,37,21,25,11,1,16,38,42.1,22,19,9,10,38,75,25,0,Matches
551,Gabriele Corbo,it ITA,DF,Bologna,it Serie A,19,2000,1.4,1,1,1,0,0,0,3,0.0,3,2,2,0,4,5,5,0,Matches
552,Sébastien Corchia,fr FRA,DF,Espanyol,es La Liga,28,1990,3.0,2,1,2,0,0,2,4,50.0,2,5,2,3,5,7,8,0,Matches
553,Iñigo Córdoba,es ESP,FW,Athletic Club,es La Liga,22,1997,16.0,33,20,16,12,5,14,52,26.9,38,30,2,28,16,49,13,0,Matches
554,Jhon Córdoba,co COL,FW,Köln,de Bundesliga,26,1993,22.2,9,6,1,5,3,3,13,23.1,10,19,1,18,5,14,17,0,Matches
555,Sergio Córdova,ve VEN,FW,Augsburg,de Bundesliga,21,1997,4.1,3,0,0,2,1,1,10,10.0,9,0,0,0,0,3,3,0,Matches
556,Benjamin Corgnet,fr FRA,"MF,FW",Strasbourg,fr Ligue 1,32,1987,2.9,1,1,1,0,0,1,3,33.3,2,2,0,2,2,3,3,0,Matches
557,Jack Cork,eng ENG,MF,Burnley,eng Premier League,30,1989,29.0,35,24,10,20,5,12,62,19.4,50,34,12,22,28,63,49,0,Matches
558,Andreas Cornelius,dk DEN,FW,Parma,it Serie A,26,1993,16.6,9,4,2,5,2,4,11,36.4,7,7,0,7,2,11,26,0,Matches
559,Maxwel Cornet,ci CIV,"FW,DF",Lyon,fr Ligue 1,22,1996,14.8,30,19,18,8,4,13,23,56.5,10,16,1,15,21,51,19,1,Matches
560,Quentin Cornette,fr FRA,"FW,MF",Amiens,fr Ligue 1,25,1994,3.9,8,3,3,2,3,3,9,33.3,6,7,1,6,6,14,5,0,Matches
561,Ángel Correa,ar ARG,"MF,FW",Atlético Madrid,es La Liga,24,1995,22.9,25,9,7,9,9,9,36,25.0,27,23,5,18,14,39,21,0,Matches
562,Joaquín Correa,ar ARG,FW,Lazio,it Serie A,24,1994,22.2,13,7,3,7,3,5,24,20.8,19,5,1,4,7,20,10,0,Matches
563,Rober Correa,es ESP,DF,Eibar,es La Liga,26,1992,10.3,13,6,8,3,2,6,10,60.0,4,6,4,2,16,29,31,0,Matches
564,Edmilson Correia,gw GNB,"FW,DF",Saint-Étienne,fr Ligue 1,19,2000,0.5,0,0,0,0,0,0,1,0.0,1,1,0,1,1,1,0,0,Matches
565,Thierry Correia,pt POR,DF,Valencia,es La Liga,20,1999,2.9,8,3,5,3,0,1,2,50.0,1,5,0,5,2,10,10,0,Matches
566,Antonio Cortés,es ESP,"FW,MF",Granada,es La Liga,19,2000,2.0,1,1,0,1,0,0,1,0.0,1,0,0,0,0,1,2,0,Matches
567,Danny da Costa,de GER,"DF,FW",Eint Frankfurt,de Bundesliga,26,1993,15.4,26,17,14,8,4,6,16,37.5,10,16,1,15,15,41,26,0,Matches
568,Diego Costa,es ESP,FW,Atlético Madrid,es La Liga,30,1988,15.0,9,5,1,4,4,1,10,10.0,9,4,2,2,3,12,10,0,Matches
569,Douglas Costa,br BRA,"FW,MF",Juventus,it Serie A,28,1990,8.9,2,1,1,1,0,1,12,8.3,11,7,0,7,5,7,5,0,Matches
570,Jaume Costa,es ESP,DF,Valencia,es La Liga,31,1988,15.4,27,23,17,8,2,14,28,50.0,14,11,6,5,24,51,52,1,Matches
571,Angelo da Costa Júnior,br BRA,GK,Bologna,it Serie A,35,1983,1.0,0,0,0,0,0,0,0,,0,0,0,0,0,0,0,0,Matches
572,Nuno da Costa,cv CPV,FW,Strasbourg,fr Ligue 1,28,1991,5.9,15,10,3,8,4,4,10,40.0,6,7,0,7,4,19,3,0,Matches
573,David Costas,es ESP,DF,Celta Vigo,es La Liga,24,1995,3.8,4,3,3,1,0,2,4,50.0,2,3,3,0,8,12,12,0,Matches
574,Benoît Costil,fr FRA,GK,Bordeaux,fr Ligue 1,32,1987,28.0,0,0,0,0,0,0,3,0.0,3,0,0,0,2,2,9,0,Matches
575,Kalifa Coulibaly,ml MLI,FW,Nantes,fr Ligue 1,27,1991,18.0,11,7,0,5,6,3,5,60.0,2,3,1,2,6,17,32,0,Matches
576,Senou Coulibaly,ml MLI,DF,Dijon,fr Ligue 1,24,1994,7.4,14,7,11,3,0,2,4,50.0,2,11,10,1,10,24,44,1,Matches
577,Yoann Court,fr FRA,"FW,MF",Brest,fr Ligue 1,29,1990,16.3,48,26,28,17,3,20,64,31.3,44,21,0,21,15,63,14,0,Matches
578,Thibaut Courtois,be BEL,GK,Real Madrid,es La Liga,27,1992,34.0,0,0,0,0,0,0,2,0.0,2,0,0,0,2,2,18,2,Matches
579,Philippe Coutinho,br BRA,"MF,FW",Bayern Munich,de Bundesliga,27,1992,15.7,21,15,1,13,7,2,13,15.4,11,9,2,7,6,27,0,0,Matches
580,Nicolas Cozza,fr FRA,DF,Montpellier,fr Ligue 1,20,1999,6.2,5,5,3,2,0,2,3,66.7,1,8,6,2,9,14,18,0,Matches
581,Alessio Cragno,it ITA,GK,Cagliari,it Serie A,25,1994,16.0,0,0,0,0,0,0,0,,0,0,0,0,0,0,10,0,Matches
582,Aaron Cresswell,eng ENG,DF,West Ham,eng Premier League,29,1989,30.3,43,26,21,18,4,23,46,50.0,23,33,10,23,35,78,75,2,Matches
583,Domenico Criscito,it ITA,DF,Genoa,it Serie A,32,1986,22.8,53,33,34,12,7,24,56,42.9,32,25,13,12,53,106,81,1,Matches
584,Bryan Cristante,it ITA,MF,Roma,it Serie A,24,1995,18.0,25,15,6,14,5,8,27,29.6,19,13,4,9,22,47,23,0,Matches
585,Sebastián Cristóforo,uy URU,MF,Fiorentina,it Serie A,25,1993,1.0,5,5,2,2,1,1,5,20.0,4,2,1,1,1,6,0,0,Matches
586,Sebastián Cristóforo,uy URU,MF,Eibar,es La Liga,25,1993,9.7,35,19,11,14,10,13,32,40.6,19,25,3,22,8,43,2,0,Matches
587,Juan Cuadrado,co COL,"DF,FW",Juventus,it Serie A,31,1988,29.5,67,43,32,28,7,35,62,56.5,27,22,8,14,35,102,47,0,Matches
588,Cucho,co COL,"FW,MF",Mallorca,es La Liga,20,1999,16.5,15,8,6,8,1,6,21,28.6,15,14,1,13,10,25,15,0,Matches
589,Marc Cucurella,es ESP,"MF,DF",Getafe,es La Liga,21,1998,36.0,74,51,23,38,13,24,76,31.6,52,58,8,50,36,110,28,1,Matches
590,Iván Cuéllar,es ESP,GK,Leganés,es La Liga,35,1984,27.0,0,0,0,0,0,0,2,0.0,2,0,0,0,0,0,28,2,Matches
591,Jaume Cuéllar,bo BOL,"MF,FW",SPAL,it Serie A,17,2001,0.8,1,0,0,0,1,0,1,0.0,1,0,0,0,0,1,0,0,Matches
592,Mickaël Cuisance,fr FRA,"MF,FW",Bayern Munich,de Bundesliga,19,1999,3.4,2,1,0,2,0,1,9,11.1,8,1,1,0,3,5,0,0,Matches
593,Matheus Cunha,br BRA,"FW,MF",Hertha BSC,de Bundesliga,20,1999,8.3,10,5,6,4,0,4,11,36.4,7,11,1,10,10,20,1,0,Matches
594,Matheus Cunha,br BRA,"FW,MF",RB Leipzig,de Bundesliga,20,1999,3.1,6,2,0,1,5,0,2,0.0,2,5,1,4,1,7,0,0,Matches
595,Felipe Curcio,br BRA,DF,Brescia,it Serie A,25,1993,0.1,0,0,0,0,0,0,0,,0,0,0,0,0,0,0,0,Matches
596,Patrick Cutrone,it ITA,FW,Wolves,eng Premier League,21,1998,3.3,4,2,2,1,1,1,5,20.0,4,1,1,0,2,6,1,0,Matches
597,Patrick Cutrone,it ITA,FW,Fiorentina,it Serie A,21,1998,9.3,4,2,2,1,1,1,15,6.7,14,6,1,5,2,6,6,0,Matches
598,Wylan Cyprien,fr FRA,MF,Nice,fr Ligue 1,24,1995,19.7,17,11,5,12,0,7,27,25.9,20,8,2,6,19,36,16,3,Matches
599,Rafael Czichos,de GER,DF,Köln,de Bundesliga,29,1990,24.5,43,34,26,16,1,22,45,48.9,23,24,13,11,35,78,110,1,Matches
600,Lennart-Marten Czyborra,de GER,DF,Atalanta,it Serie A,20,1999,0.2,0,0,0,0,0,0,0,,0,2,0,2,0,0,0,0,Matches
601,Marco D'Alessandro,it ITA,"MF,DF",SPAL,it Serie A,28,1991,8.7,11,8,5,3,3,5,8,62.5,3,11,0,11,5,16,6,0,Matches
602,Danilo D'Ambrosio,it ITA,DF,Inter,it Serie A,30,1988,15.6,30,16,16,12,2,16,33,48.5,17,15,4,11,14,44,25,0,Matches
603,Felice D'Amico,it ITA,MF,Sampdoria,it Serie A,18,2000,0.0,1,1,0,0,1,0,0,,0,0,0,0,0,1,0,0,Matches
604,Lucas Da Cunha,fr FRA,MF,Rennes,fr Ligue 1,18,2001,0.8,1,0,1,0,0,1,1,100.0,0,0,0,0,0,1,0,0,Matches
605,Jacopo Da Riva,it ITA,MF,Atalanta,it Serie A,18,2000,0.0,0,0,0,0,0,0,0,,0,0,0,0,0,0,0,0,Matches
606,Damien Da Silva,fr FRA,DF,Rennes,fr Ligue 1,31,1988,24.9,27,14,20,5,2,10,19,52.6,9,21,13,8,26,53,143,1,Matches
607,Moanes Dabbur,il ISR,FW,Sevilla,es La Liga,27,1992,0.3,1,1,0,0,1,0,0,,0,1,0,1,0,1,0,0,Matches
608,Moanes Dabbur,il ISR,FW,Hoffenheim,de Bundesliga,27,1992,8.5,8,5,1,3,4,3,10,30.0,7,6,2,4,4,12,1,0,Matches
609,Bryan Dabo,bf BFA,MF,SPAL,it Serie A,27,1992,12.5,18,10,13,4,1,5,15,33.3,10,13,2,11,9,27,14,0,Matches
610,Colin Dagba,fr FRA,DF,Paris S-G,fr Ligue 1,20,1998,7.4,10,4,2,4,4,5,9,55.6,4,6,1,5,6,16,9,0,Matches
611,Mahmoud Dahoud,de GER,MF,Dortmund,de Bundesliga,23,1996,6.2,10,6,4,4,2,6,18,33.3,12,8,2,6,8,18,4,0,Matches
612,Leon Dajaku,de GER,"DF,MF",Bayern Munich,de Bundesliga,18,2001,0.1,0,0,0,0,0,0,1,0.0,1,0,0,0,0,0,0,0,Matches
613,Felipe dal Belo,br BRA,DF,SPAL,it Serie A,35,1984,11.1,13,6,9,4,0,9,15,60.0,6,14,12,2,9,22,30,0,Matches
614,Christian Dalle Mura,it ITA,FW,Fiorentina,it Serie A,17,2002,0.0,0,0,0,0,0,0,0,,0,0,0,0,0,0,0,0,Matches
615,Diogo Dalot,pt POR,"DF,MF",Manchester Utd,eng Premier League,20,1999,0.7,3,2,3,0,0,3,4,75.0,1,1,0,1,2,5,1,0,Matches
616,Charlie Daniels,eng ENG,DF,Bournemouth,eng Premier League,32,1986,1.4,1,1,0,1,0,0,1,0.0,1,2,0,2,1,2,5,1,Matches
617,Danilo,br BRA,DF,Juventus,it Serie A,28,1991,16.0,30,20,16,12,2,18,30,60.0,12,12,3,9,26,56,44,0,Matches
618,Arnaut Danjuma,nl NED,MF,Bournemouth,eng Premier League,22,1997,7.0,4,2,3,1,0,1,4,25.0,3,2,0,2,8,12,4,1,Matches
619,Scott Dann,eng ENG,DF,Crystal Palace,eng Premier League,32,1987,14.1,8,4,7,1,0,8,14,57.1,6,9,7,2,14,22,67,0,Matches
620,Kevin Danso,at AUT,DF,Southampton,eng Premier League,20,1998,3.1,6,4,3,3,0,4,7,57.1,3,7,3,4,2,8,7,0,Matches
621,Dante,br BRA,DF,Nice,fr Ligue 1,35,1983,21.0,34,21,24,10,0,17,25,68.0,8,27,16,11,26,60,79,0,Matches
622,Andrea Danzi,it ITA,MF,Hellas Verona,it Serie A,20,1999,0.0,0,0,0,0,0,0,0,,0,0,0,0,0,0,0,0,Matches
623,Sergi Darder,es ESP,MF,Espanyol,es La Liga,25,1993,29.5,47,23,11,26,10,17,58,29.3,41,30,1,29,24,71,23,1,Matches
624,Vladimír Darida,cz CZE,MF,Hertha BSC,de Bundesliga,28,1990,25.1,50,27,14,31,5,11,48,22.9,37,44,7,37,27,77,19,2,Matches
625,Matteo Darmian,it ITA,DF,Parma,it Serie A,29,1989,29.8,81,42,48,30,3,40,83,48.2,43,38,16,22,25,106,78,1,Matches
626,Alphonso Davies,ca CAN,DF,Bayern Munich,de Bundesliga,18,2000,24.8,70,43,35,24,11,38,58,65.5,20,35,6,29,31,101,51,0,Matches
627,Ben Davies,wls WAL,DF,Tottenham,eng Premier League,26,1993,15.9,28,15,13,11,4,7,21,33.3,14,28,12,16,22,50,47,0,Matches
628,Tom Davies,eng ENG,MF,Everton,eng Premier League,21,1998,22.5,38,17,12,22,4,17,55,30.9,38,12,4,8,35,73,28,0,Matches
629,Keinan Davis,eng ENG,FW,Aston Villa,eng Premier League,21,1998,6.1,1,1,0,1,0,0,3,0.0,3,4,0,4,0,1,3,0,Matches
630,Paweł Dawidowicz,pl POL,DF,Hellas Verona,it Serie A,24,1995,7.7,15,12,11,4,0,5,11,45.5,6,6,5,1,12,27,26,0,Matches
631,Craig Dawson,eng ENG,DF,Watford,eng Premier League,29,1990,26.2,29,18,16,13,0,17,31,54.8,14,41,32,9,34,63,116,0,Matches
632,Kevin De Bruyne,be BEL,MF,Manchester City,eng Premier League,28,1991,31.0,45,24,8,20,17,18,66,27.3,48,26,4,22,18,63,24,2,Matches
633,Sebastien De Maio,fr FRA,DF,Udinese,it Serie A,32,1987,16.7,18,11,11,7,0,7,11,63.6,4,28,20,8,32,50,86,2,Matches
634,Rodrigo De Paul,ar ARG,MF,Udinese,it Serie A,25,1994,31.4,61,31,31,26,4,27,65,41.5,38,38,3,35,29,90,8,1,Matches
635,Mattia De Sciglio,it ITA,DF,Juventus,it Serie A,26,1992,5.2,10,8,6,4,0,6,14,42.9,8,5,2,3,8,18,18,1,Matches
636,Lorenzo De Silvestri,it ITA,DF,Torino,it Serie A,31,1988,24.9,15,8,4,7,4,11,27,40.7,16,20,7,13,19,34,72,0,Matches
637,Lucas Deaux,fr FRA,MF,Nîmes,fr Ligue 1,30,1988,14.8,49,26,16,29,4,16,45,35.6,29,20,4,16,15,64,19,0,Matches
638,Mathieu Debuchy,fr FRA,DF,Saint-Étienne,fr Ligue 1,34,1985,19.7,44,26,22,15,7,24,47,51.1,23,21,11,10,43,87,59,0,Matches
639,Troy Deeney,eng ENG,FW,Watford,eng Premier League,31,1988,24.7,19,12,6,10,3,6,29,20.7,23,13,1,12,11,30,27,0,Matches
640,Grégoire Defrel,mq MTQ,"FW,MF",Sassuolo,it Serie A,28,1991,10.9,12,8,4,6,2,4,15,26.7,11,9,0,9,3,15,5,0,Matches
641,Alessandro Deiola,it ITA,MF,Cagliari,it Serie A,23,1995,0.0,0,0,0,0,0,0,0,,0,0,0,0,1,1,0,0,Matches
642,Alessandro Deiola,it ITA,MF,Lecce,it Serie A,23,1995,8.0,16,9,9,7,0,9,24,37.5,15,12,4,8,8,24,14,1,Matches
643,Romain Del Castillo,fr FRA,"FW,MF",Rennes,fr Ligue 1,23,1996,13.8,20,14,5,11,4,6,27,22.2,21,12,2,10,7,27,7,0,Matches
644,Thomas Delaine,fr FRA,DF,Metz,fr Ligue 1,27,1992,13.9,25,16,18,6,1,12,21,57.1,9,17,1,16,15,40,28,0,Matches
645,Thomas Delaney,dk DEN,MF,Dortmund,de Bundesliga,27,1991,9.2,22,10,10,11,1,9,15,60.0,6,16,7,9,26,48,26,0,Matches
646,Paul Delecroix,gw GNB,GK,Metz,fr Ligue 1,30,1988,1.5,0,0,0,0,0,0,0,,0,0,0,0,0,0,0,0,Matches
647,Cristian Dell'Orco,it ITA,DF,Lecce,it Serie A,25,1994,11.2,22,12,14,7,1,8,14,57.1,6,11,7,4,16,38,33,0,Matches
648,Andy Delort,dz ALG,FW,Montpellier,fr Ligue 1,27,1991,25.3,28,18,11,9,8,7,27,25.9,20,21,6,15,3,31,10,0,Matches
649,Fabian Delph,eng ENG,MF,Everton,eng Premier League,29,1989,13.2,26,12,10,13,3,9,22,40.9,13,12,3,9,15,41,19,1,Matches
650,Moussa Dembélé,fr FRA,FW,Lyon,fr Ligue 1,23,1996,24.3,12,7,2,5,5,4,14,28.6,10,14,3,11,5,17,31,0,Matches
651,Ousmane Dembélé,fr FRA,FW,Barcelona,es La Liga,22,1997,4.0,2,2,1,1,0,2,5,40.0,3,4,0,4,0,2,0,1,Matches
652,Merih Demiral,tr TUR,DF,Juventus,it Serie A,21,1998,4.6,8,7,5,3,0,1,3,33.3,2,4,3,1,4,12,16,1,Matches
653,Kerem Demirbay,de GER,MF,Leverkusen,de Bundesliga,26,1993,17.5,35,19,10,21,4,12,31,38.7,19,19,5,14,22,57,7,1,Matches
654,Diego Demme,de GER,MF,Napoli,it Serie A,27,1991,10.0,18,8,14,3,1,8,23,34.8,15,9,1,8,8,26,9,0,Matches
655,Diego Demme,de GER,MF,RB Leipzig,de Bundesliga,27,1991,13.5,41,18,17,19,5,17,42,40.5,25,14,2,12,15,56,14,0,Matches
656,Jason Denayer,be BEL,DF,Lyon,fr Ligue 1,24,1995,23.7,17,13,12,5,0,10,14,71.4,4,32,29,3,20,37,83,0,Matches
657,Leander Dendoncker,be BEL,"MF,DF",Wolves,eng Premier League,24,1995,31.1,68,31,41,19,8,28,67,41.8,39,39,12,27,38,106,64,2,Matches
658,Kévin Denkey,tg TOG,FW,Nîmes,fr Ligue 1,18,2000,6.7,10,5,1,8,1,6,10,60.0,4,7,0,7,2,12,1,1,Matches
659,Stefano Denswil,sr SUR,DF,Bologna,it Serie A,26,1993,24.9,49,28,29,19,1,26,44,59.1,18,23,8,15,31,80,68,0,Matches
660,Fabio Depaoli,it ITA,"MF,DF",Sampdoria,it Serie A,22,1997,20.6,41,28,26,10,5,17,31,54.8,14,29,3,26,16,57,39,0,Matches
661,Kastriot Dermaku,al ALB,DF,Parma,it Serie A,27,1992,11.4,13,5,10,3,0,3,5,60.0,2,20,16,4,12,25,61,1,Matches
662,Daniele Dessena,it ITA,MF,Brescia,it Serie A,32,1987,20.8,21,11,5,14,2,6,25,24.0,19,11,1,10,11,32,21,0,Matches
663,Mattia Destro,it ITA,FW,Bologna,it Serie A,28,1991,2.1,3,2,1,2,0,1,3,33.3,2,1,0,1,0,3,0,0,Matches
664,Mattia Destro,it ITA,"FW,MF",Genoa,it Serie A,28,1991,1.7,0,0,0,0,0,0,0,,0,0,0,0,0,0,1,0,Matches
665,Gerard Deulofeu,es ESP,FW,Watford,eng Premier League,25,1994,23.3,33,16,18,9,6,12,59,20.3,47,10,0,10,25,58,6,0,Matches
666,Deyverson,br BRA,FW,Getafe,es La Liga,28,1991,2.3,0,0,0,0,0,0,1,0.0,1,2,1,1,0,0,5,0,Matches
667,Samuel Di Carmine,it ITA,"FW,MF",Hellas Verona,it Serie A,30,1988,14.4,2,1,0,0,2,0,8,0.0,8,3,0,3,1,3,10,0,Matches
668,Federico Di Francesco,it ITA,FW,SPAL,it Serie A,25,1994,12.0,11,5,2,6,3,3,15,20.0,12,9,1,8,3,14,2,1,Matches
669,Giovanni Di Lorenzo,it ITA,DF,Napoli,it Serie A,25,1993,33.0,59,35,27,19,13,32,61,52.5,29,27,11,16,28,87,54,0,Matches
670,Ángel Di María,ar ARG,"FW,MF",Paris S-G,fr Ligue 1,31,1988,22.2,17,12,2,8,7,4,34,11.8,30,14,3,11,11,28,1,3,Matches
671,Boulaye Dia,sn SEN,FW,Reims,fr Ligue 1,22,1996,20.1,15,9,7,6,2,3,10,30.0,7,9,2,7,7,22,16,0,Matches
672,Fousseni Diabaté,ml MLI,"FW,MF",Amiens,fr Ligue 1,23,1995,13.2,16,10,6,6,4,5,16,31.3,11,11,0,11,8,24,3,1,Matches
673,Moussa Diaby,fr FRA,"FW,MF",Leverkusen,de Bundesliga,20,1999,19.7,10,8,3,7,0,5,15,33.3,10,6,0,6,9,19,4,0,Matches
674,Mouctar Diakhaby,gn GUI,DF,Valencia,es La Liga,22,1996,16.0,11,8,7,3,1,5,8,62.5,3,17,15,2,11,22,73,0,Matches
675,Bafodé Diakité,fr FRA,DF,Toulouse,fr Ligue 1,18,2001,15.2,23,19,15,8,0,7,13,53.8,6,18,9,9,20,43,75,0,Matches
676,Abdou Diallo,sn SEN,DF,Paris S-G,fr Ligue 1,23,1996,13.3,20,11,9,10,1,8,14,57.1,6,9,5,4,10,30,32,0,Matches
677,Amad Diallo,ci CIV,FW,Atalanta,it Serie A,17,2002,0.3,1,1,0,1,0,0,0,,0,0,0,0,0,1,0,0,Matches
678,Habib Diallo,sn SEN,FW,Metz,fr Ligue 1,24,1995,24.4,2,1,0,2,0,0,6,0.0,6,6,5,1,4,6,43,0,Matches
679,Ibrahima Diallo,fr FRA,MF,Brest,fr Ligue 1,20,1999,17.3,38,24,15,22,1,12,29,41.4,17,9,2,7,23,61,16,3,Matches
680,Moussa Diarra,ml MLI,DF,Toulouse,fr Ligue 1,18,2000,1.0,3,3,2,1,0,1,1,100.0,0,0,0,0,3,6,2,0,Matches
681,Lucas Dias,fr FRA,GK,Nîmes,fr Ligue 1,20,1999,3.5,1,1,1,0,0,1,1,100.0,0,0,0,0,0,1,2,0,Matches
682,Amadou Diawara,gn GUI,MF,Roma,it Serie A,22,1997,16.9,40,25,14,20,6,8,30,26.7,22,10,1,9,33,73,16,2,Matches
683,Brahim Díaz,ma MAR,FW,Real Madrid,es La Liga,19,1999,0.7,1,0,0,1,0,0,2,0.0,2,2,0,2,0,1,0,0,Matches
684,Víctor Díaz,es ESP,DF,Granada,es La Liga,31,1988,32.0,74,43,38,31,5,31,60,51.7,29,53,23,30,48,122,94,1,Matches
685,Bakaye Dibassy,ml MLI,DF,Amiens,fr Ligue 1,29,1989,20.8,26,14,17,8,1,15,20,75.0,5,29,18,11,37,63,78,2,Matches
686,Eric Dier,eng ENG,"DF,MF",Tottenham,eng Premier League,25,1994,14.9,21,12,10,10,1,10,20,50.0,10,14,9,5,21,42,65,0,Matches
687,Lucas Digne,fr FRA,DF,Everton,eng Premier League,26,1993,33.7,73,49,49,19,5,33,68,48.5,35,39,10,29,42,115,108,0,Matches
688,Mitchell Dijks,nl NED,DF,Bologna,it Serie A,26,1993,11.2,13,10,6,5,2,8,12,66.7,4,5,1,4,10,23,23,0,Matches
689,Javairô Dilrosun,nl NED,"MF,FW",Hertha BSC,de Bundesliga,21,1998,14.5,15,8,11,1,3,5,13,38.5,8,20,0,20,18,33,10,0,Matches
690,Federico Dimarco,it ITA,DF,Hellas Verona,it Serie A,21,1997,5.8,11,5,4,4,3,6,10,60.0,4,3,2,1,4,15,11,0,Matches
691,Federico Dimarco,it ITA,DF,Inter,it Serie A,21,1997,0.3,1,0,0,1,0,0,0,,0,0,0,0,1,2,1,0,Matches
692,Tristan Dingomé,cm CMR,MF,Reims,fr Ligue 1,28,1991,9.9,10,4,3,6,1,2,12,16.7,10,6,0,6,6,16,1,0,Matches
693,Lois Diony,fr FRA,FW,Saint-Étienne,fr Ligue 1,26,1992,7.4,15,5,0,11,4,5,9,55.6,4,3,0,3,1,16,0,0,Matches
694,Issa Diop,fr FRA,DF,West Ham,eng Premier League,22,1997,30.7,27,15,18,9,0,16,25,64.0,9,37,21,16,47,74,166,2,Matches
695,Papakouli Diop,sn SEN,MF,Eibar,es La Liga,33,1986,25.0,39,26,13,22,4,18,42,42.9,24,24,7,17,34,73,38,0,Matches
696,Assane Dioussé,sn SEN,MF,Saint-Étienne,fr Ligue 1,21,1997,1.3,1,1,0,1,0,0,3,0.0,3,0,0,0,0,1,2,0,Matches
697,Axel Disasi,fr FRA,DF,Reims,fr Ligue 1,21,1998,27.0,32,21,18,13,1,17,27,63.0,10,29,24,5,26,58,97,0,Matches
698,Tiago Djaló,pt POR,DF,Lille,fr Ligue 1,19,2000,7.3,9,4,5,3,1,2,7,28.6,5,3,2,1,11,20,28,0,Matches
699,Djené,tg TOG,DF,Getafe,es La Liga,27,1991,34.0,42,32,27,15,0,17,30,56.7,13,20,7,13,34,76,105,1,Matches
700,Moussa Djenepo,ml MLI,"MF,DF",Southampton,eng Premier League,21,1998,10.3,27,21,13,9,5,11,21,52.4,10,15,1,14,9,36,9,0,Matches
701,Koffi Djidji,ci CIV,DF,Torino,it Serie A,26,1992,9.5,27,12,19,8,0,8,18,44.4,10,28,23,5,15,42,53,1,Matches
702,Alexander Djiku,gh GHA,"DF,MF",Strasbourg,fr Ligue 1,24,1994,22.9,46,32,27,19,0,21,29,72.4,8,14,8,6,55,101,82,4,Matches
703,Berat Djimsiti,al ALB,DF,Atalanta,it Serie A,26,1993,30.9,42,23,17,23,2,22,39,56.4,17,21,14,7,49,91,92,0,Matches
704,Naïs Djouahra,fr FRA,FW,Real Sociedad,es La Liga,19,1999,0.3,0,0,0,0,0,0,0,,0,0,0,0,0,0,0,0,Matches
705,Marko Dmitrović,rs SRB,GK,Eibar,es La Liga,27,1992,35.0,3,2,3,0,0,3,5,60.0,2,1,0,1,3,6,24,0,Matches
706,Matt Doherty,ie IRL,"MF,DF",Wolves,eng Premier League,27,1992,31.5,55,29,34,17,4,27,41,65.9,14,34,4,30,40,95,52,1,Matches
707,Kasper Dolberg,dk DEN,FW,Nice,fr Ligue 1,21,1997,21.0,10,6,0,3,7,4,17,23.5,13,18,2,16,10,20,24,0,Matches
708,Keagan Dolly,za RSA,MF,Montpellier,fr Ligue 1,26,1993,1.6,6,3,1,3,2,2,5,40.0,3,1,0,1,1,7,0,0,Matches
709,Jaume Doménech,es ESP,GK,Valencia,es La Liga,28,1990,14.7,0,0,0,0,0,0,1,0.0,1,0,0,0,1,1,3,1,Matches
710,Nicolás Domínguez,ar ARG,MF,Bologna,it Serie A,21,1998,7.8,21,14,15,5,1,7,18,38.9,11,12,2,10,12,33,7,0,Matches
711,Giulio Donati,it ITA,DF,Lecce,it Serie A,29,1990,19.6,32,21,22,8,2,15,28,53.6,13,19,10,9,25,57,42,0,Matches
712,Ji Dong-won,kr KOR,"FW,MF",Mainz 05,de Bundesliga,28,1991,1.1,0,0,0,0,0,0,1,0.0,1,1,0,1,0,0,0,0,Matches
713,Anastasios Donis,gr GRE,FW,Reims,fr Ligue 1,22,1996,6.8,3,2,2,1,0,1,9,11.1,8,2,0,2,1,4,3,0,Matches
714,Alfredo Donnarumma,it ITA,FW,Brescia,it Serie A,28,1990,18.7,17,9,3,9,5,6,18,33.3,12,7,0,7,5,22,1,0,Matches
715,Gianluigi Donnarumma,it ITA,GK,Milan,it Serie A,20,1999,35.6,1,0,1,0,0,1,2,50.0,1,0,0,0,3,4,25,7,Matches
716,Mathieu Dossevi,tg TOG,"MF,FW",Toulouse,fr Ligue 1,31,1988,19.5,32,20,7,17,8,15,30,50.0,15,17,0,17,14,46,7,0,Matches
717,Bas Dost,nl NED,FW,Eint Frankfurt,de Bundesliga,30,1989,16.4,11,7,1,7,3,3,7,42.9,4,6,2,4,5,16,22,0,Matches
718,Abdoulaye Doucouré,ml MLI,MF,Watford,eng Premier League,26,1993,35.1,64,30,29,29,6,16,57,28.1,41,46,8,38,31,95,32,0,Matches
719,Mamadou Doucouré,fr FRA,MF,Gladbach,de Bundesliga,21,1998,0.0,0,0,0,0,0,0,0,,0,0,0,0,0,0,0,0,Matches
720,Moussa Doumbia,ml MLI,"FW,MF",Reims,fr Ligue 1,24,1994,19.1,16,8,5,6,5,7,24,29.2,17,14,1,13,9,25,5,0,Matches
721,Souleyman Doumbia,ci CIV,DF,Angers,fr Ligue 1,22,1996,5.0,10,4,7,2,1,5,6,83.3,1,5,0,5,6,16,18,0,Matches
722,Souleyman Doumbia,ci CIV,DF,Rennes,fr Ligue 1,22,1996,1.0,1,1,1,0,0,1,1,100.0,0,2,2,0,0,1,3,0,Matches
723,Tommy Doyle,eng ENG,MF,Manchester City,eng Premier League,17,2001,0.2,0,0,0,0,0,0,1,0.0,1,0,0,0,0,0,0,0,Matches
724,Mohamed Dräger,tn TUN,DF,Paderborn 07,de Bundesliga,23,1996,16.2,32,21,22,8,2,14,33,42.4,19,17,5,12,18,50,39,0,Matches
725,Aleksandar Dragović,at AUT,DF,Leverkusen,de Bundesliga,28,1991,11.4,18,11,11,6,1,10,21,47.6,11,9,3,6,15,33,39,0,Matches
726,Bartłomiej Drągowski,pl POL,GK,Fiorentina,it Serie A,21,1997,31.0,0,0,0,0,0,0,1,0.0,1,0,0,0,3,3,8,1,Matches
727,Julian Draxler,de GER,MF,Paris S-G,fr Ligue 1,25,1993,7.6,13,10,2,9,2,7,15,46.7,8,7,1,6,10,23,1,0,Matches
728,Dominick Drexler,de GER,"MF,FW",Köln,de Bundesliga,29,1990,17.6,34,25,12,19,3,8,32,25.0,24,11,5,6,26,60,11,0,Matches
729,Danny Drinkwater,eng ENG,MF,Aston Villa,eng Premier League,29,1990,2.9,5,3,3,2,0,2,18,11.1,16,5,0,5,5,10,5,1,Matches
730,Danny Drinkwater,eng ENG,MF,Burnley,eng Premier League,29,1990,0.6,2,1,1,1,0,0,1,0.0,1,0,0,0,1,3,0,0,Matches
731,Josip Drmić,ch SUI,FW,Norwich City,eng Premier League,26,1992,7.2,3,2,1,2,0,0,8,0.0,8,6,0,6,1,4,5,1,Matches
732,Domingos Duarte,pt POR,DF,Granada,es La Liga,24,1995,34.3,30,19,24,5,1,11,20,55.0,9,34,24,10,34,64,153,1,Matches
733,Léo Duarte,br BRA,DF,Milan,it Serie A,23,1996,4.5,4,3,0,3,1,1,4,25.0,3,9,6,3,3,7,9,0,Matches
734,Óscar Duarte,cr CRC,DF,Levante,es La Liga,30,1989,5.4,12,3,11,1,0,3,4,75.0,1,7,6,1,6,18,29,0,Matches
735,Rubén Duarte,es ESP,DF,Alavés,es La Liga,23,1995,29.6,61,32,30,28,3,34,60,56.7,26,30,8,22,47,108,71,0,Matches
736,Edgaras Dubickas,lt LTU,DF,Lecce,it Serie A,21,1998,0.0,0,0,0,0,0,0,0,,0,0,0,0,0,0,0,0,Matches
737,Leo Dubois,fr FRA,DF,Lyon,fr Ligue 1,24,1994,15.0,32,23,20,9,3,13,22,59.1,9,12,4,8,18,50,34,1,Matches
738,Martin Dúbravka,sk SVK,GK,Newcastle Utd,eng Premier League,30,1989,38.0,1,1,1,0,0,1,2,50.0,1,2,0,2,1,2,17,5,Matches
739,Ondrej Duda,sk SVK,MF,Norwich City,eng Premier League,24,1994,8.0,18,11,9,6,3,7,16,43.8,9,10,2,8,6,24,8,0,Matches
740,Ondrej Duda,sk SVK,MF,Hertha BSC,de Bundesliga,24,1994,5.0,6,4,1,2,3,1,10,10.0,9,3,1,2,5,11,5,0,Matches
741,Shane Duffy,ie IRL,DF,Brighton,eng Premier League,27,1992,13.8,18,9,14,4,0,6,17,35.3,11,13,7,6,21,39,72,0,Matches
742,Haris Duljević,ba BIH,"FW,MF",Nîmes,fr Ligue 1,25,1993,5.8,11,6,3,7,1,4,12,33.3,8,5,0,5,2,13,1,0,Matches
743,Paul Dummett,wls WAL,DF,Newcastle Utd,eng Premier League,27,1991,13.6,27,17,19,7,1,21,27,77.8,6,23,9,14,23,50,69,0,Matches
744,Alfred Duncan,gh GHA,MF,Fiorentina,it Serie A,26,1993,9.9,12,9,11,1,0,2,19,10.5,17,4,0,4,5,17,12,0,Matches
745,Alfred Duncan,gh GHA,MF,Sassuolo,it Serie A,26,1993,9.4,19,12,8,7,4,6,16,37.5,10,7,0,7,9,28,13,0,Matches
746,Lewis Dunk,eng ENG,DF,Brighton,eng Premier League,27,1991,35.9,40,24,23,17,0,15,34,44.1,19,55,33,22,55,95,125,2,Matches
747,Erik Durm,de GER,"DF,FW",Eint Frankfurt,de Bundesliga,27,1992,5.7,13,6,9,2,2,9,17,52.9,8,11,2,9,3,16,11,0,Matches
748,Riza Durmisi,dk DEN,"DF,MF",Nice,fr Ligue 1,25,1994,1.8,1,1,1,0,0,0,0,,0,2,1,1,1,2,3,0,Matches
749,Hugo Duro,es ESP,"FW,MF",Getafe,es La Liga,19,1999,4.2,6,5,2,2,2,4,8,50.0,4,3,0,3,1,7,3,0,Matches
750,Jean-Kevin Duverne,ht HAI,DF,Brest,fr Ligue 1,22,1997,13.1,12,8,5,6,1,2,6,33.3,4,23,8,15,20,32,50,0,Matches
751,Paulo Dybala,ar ARG,"FW,MF",Juventus,it Serie A,25,1993,23.9,19,10,6,9,4,9,39,23.1,30,15,0,15,13,32,3,0,Matches
752,Edin Džeko,ba BIH,FW,Roma,it Serie A,33,1986,31.7,16,11,2,7,7,2,13,15.4,11,11,4,7,6,22,33,0,Matches
753,Blerim Džemaili,ch SUI,MF,Bologna,it Serie A,33,1986,7.8,19,12,3,13,3,4,22,18.2,18,9,3,6,7,26,6,0,Matches
754,Bruno Ecuele Manga,ga GAB,DF,Dijon,fr Ligue 1,31,1988,28.0,22,15,17,5,0,9,20,45.0,11,34,23,11,37,59,112,2,Matches
755,Simone Edera,it ITA,"MF,FW",Torino,it Serie A,22,1997,4.4,13,5,3,7,3,2,12,16.7,10,1,0,1,1,14,3,0,Matches
756,Ederson,br BRA,GK,Manchester City,eng Premier League,25,1993,34.1,2,2,2,0,0,2,5,40.0,3,0,0,0,3,5,16,6,Matches
757,John Egan,ie IRL,DF,Sheffield Utd,eng Premier League,26,1992,35.4,44,27,34,10,0,25,45,55.6,20,39,27,12,58,102,171,4,Matches
758,Johannes Eggestein,de GER,"MF,FW",Werder Bremen,de Bundesliga,21,1998,5.7,8,6,2,2,4,3,12,25.0,9,6,0,6,2,10,4,0,Matches
759,Maximilian Eggestein,de GER,MF,Werder Bremen,de Bundesliga,22,1996,31.7,40,28,20,18,2,15,43,34.9,28,37,8,29,36,76,57,0,Matches
760,Kingsley Ehizibue,nl NED,DF,Köln,de Bundesliga,24,1995,25.9,79,53,44,30,5,33,53,62.3,20,28,8,20,39,118,79,1,Matches
761,Albin Ekdal,se SWE,MF,Sampdoria,it Serie A,30,1989,26.5,51,25,18,31,2,24,68,35.3,44,35,14,21,33,84,46,1,Matches
762,Harvey Elliott,eng ENG,DF,Liverpool,eng Premier League,16,2003,0.1,0,0,0,0,0,0,0,,0,0,0,0,0,0,0,0,Matches
763,Elif Elmas,mk MKD,MF,Napoli,it Serie A,19,1999,12.6,16,7,5,6,5,5,20,25.0,15,11,1,10,11,27,4,0,Matches
764,Ilay Elmkies,il ISR,MF,Hoffenheim,de Bundesliga,19,2000,0.0,1,1,1,0,0,0,0,,0,0,0,0,0,1,0,0,Matches
765,Ahmed Elmohamady,eg EGY,DF,Aston Villa,eng Premier League,31,1987,11.5,19,9,10,7,2,10,21,47.6,11,11,5,6,13,32,25,1,Matches
766,Aritz Elustondo,es ESP,DF,Real Sociedad,es La Liga,25,1994,16.8,28,17,19,8,1,13,23,56.5,10,21,8,13,15,43,67,0,Matches
767,Nico Elvedi,ch SUI,DF,Gladbach,de Bundesliga,22,1996,29.1,45,27,37,8,0,19,38,50.0,19,32,15,17,62,107,112,0,Matches
768,Rodrigo Ely,br BRA,DF,Alavés,es La Liga,25,1993,23.6,22,13,15,7,0,13,29,44.8,16,23,19,4,32,54,116,0,Matches
769,Adri Embarba,es ESP,"MF,FW",Espanyol,es La Liga,27,1992,15.2,37,22,16,16,5,16,33,48.5,17,28,4,24,16,53,11,0,Matches
770,Breel Embolo,ch SUI,"FW,MF",Gladbach,de Bundesliga,22,1997,17.2,22,11,2,15,5,4,15,26.7,11,12,1,11,8,30,5,0,Matches
771,Emerson,br BRA,DF,Betis,es La Liga,20,1999,31.5,74,46,49,19,6,36,79,45.6,43,30,9,21,31,105,57,1,Matches
772,Renaud Emond,be BEL,FW,Nantes,fr Ligue 1,27,1991,3.2,3,1,0,2,1,1,5,20.0,4,0,0,0,0,3,7,0,Matches
773,Alan Empereur,br BRA,DF,Hellas Verona,it Serie A,25,1994,9.5,16,8,11,4,1,6,10,60.0,4,19,12,7,22,38,36,0,Matches
774,Youssef En-Nesyri,ma MAR,FW,Leganés,es La Liga,22,1997,15.4,9,7,1,2,6,3,17,17.6,14,15,2,13,5,14,22,0,Matches
775,Youssef En-Nesyri,ma MAR,FW,Sevilla,es La Liga,22,1997,8.8,7,5,1,6,0,3,10,30.0,7,9,3,6,5,12,7,0,Matches
776,Björn Engels,be BEL,DF,Aston Villa,eng Premier League,24,1994,16.1,11,6,8,2,1,8,13,61.5,5,18,17,1,28,39,86,3,Matches
777,Sergi Enrich,es ESP,FW,Eibar,es La Liga,29,1990,20.7,17,6,4,8,5,4,21,19.0,17,16,2,14,9,26,12,0,Matches
778,Javier Eraso,es ESP,MF,Leganés,es La Liga,29,1990,9.1,11,5,4,5,2,5,15,33.3,10,5,0,5,7,18,5,0,Matches
779,Christian Eriksen,dk DEN,"MF,FW",Tottenham,eng Premier League,27,1992,12.2,19,9,10,8,1,7,24,29.2,17,10,1,9,12,31,16,0,Matches
780,Christian Eriksen,dk DEN,MF,Inter,it Serie A,27,1992,7.8,11,6,2,8,1,5,20,25.0,15,3,0,3,0,11,0,0,Matches
781,Gonzalo Escalante,ar ARG,MF,Eibar,es La Liga,26,1993,18.6,41,22,15,17,9,24,41,58.5,17,22,4,18,29,70,14,0,Matches
782,Aarón Escandell,es ESP,GK,Granada,es La Liga,23,1995,3.0,1,1,1,0,0,1,1,100.0,0,0,0,0,0,1,0,0,Matches
783,Sergio Escudero,es ESP,DF,Sevilla,es La Liga,29,1989,8.6,29,16,17,10,2,19,28,67.9,9,11,1,10,13,42,35,0,Matches
784,Bernardo Espinosa,co COL,DF,Espanyol,es La Liga,30,1989,25.1,24,16,18,4,2,16,28,57.1,12,19,11,8,24,48,108,2,Matches
785,Sebastiano Esposito,it ITA,FW,Inter,it Serie A,17,2002,2.2,3,2,0,2,1,0,5,0.0,5,3,0,3,3,6,1,0,Matches
786,Vicente Esquerdo,es ESP,"MF,FW",Valencia,es La Liga,20,1999,0.2,1,0,1,0,0,0,0,,0,1,0,1,0,1,1,0,Matches
787,Alexander Esswein,de GER,"FW,MF",Hertha BSC,de Bundesliga,29,1990,2.4,6,4,4,2,0,3,8,37.5,5,8,1,7,7,13,7,1,Matches
788,Pervis Estupiñán,ec ECU,DF,Osasuna,es La Liga,21,1998,33.1,84,45,53,27,4,42,77,54.5,35,30,7,23,58,142,61,6,Matches
789,Oghenekaro Etebo,ng NGA,MF,Getafe,es La Liga,23,1995,6.4,12,4,5,7,0,7,12,58.3,5,10,1,9,11,23,4,1,Matches
790,Beñat Etxebarria,es ESP,MF,Athletic Club,es La Liga,32,1987,4.4,6,1,2,3,1,2,13,15.4,11,6,1,5,4,10,6,0,Matches
791,Xabier Etxeita,es ESP,DF,Getafe,es La Liga,31,1987,16.1,20,11,11,9,0,12,23,52.2,11,9,5,4,17,37,68,0,Matches
792,Antony Evans,eng ENG,"MF,DF",Paderborn 07,de Bundesliga,20,1998,1.7,5,4,1,3,1,1,5,20.0,4,1,1,0,2,7,4,0,Matches
793,Jonny Evans,nir NIR,DF,Leicester City,eng Premier League,31,1988,37.6,48,34,33,14,1,28,39,71.8,11,33,18,15,57,105,174,4,Matches
794,Edu Expósito,es ESP,MF,Eibar,es La Liga,22,1996,25.7,52,28,12,31,9,18,49,36.7,31,20,6,14,31,83,18,1,Matches
795,Valentin Eysseric,fr FRA,"MF,FW",Hellas Verona,it Serie A,27,1992,3.9,4,4,1,2,1,0,4,0.0,4,3,0,3,1,5,2,0,Matches
796,Valentin Eysseric,fr FRA,"FW,MF",Fiorentina,it Serie A,27,1992,0.5,0,0,0,0,0,0,0,,0,1,0,1,0,0,0,0,Matches
797,Łukasz Fabiański,pl POL,GK,West Ham,eng Premier League,34,1985,23.5,2,2,2,0,0,2,4,50.0,2,0,0,0,1,3,5,3,Matches
798,Fabinho,br BRA,MF,Liverpool,eng Premier League,25,1993,23.1,62,35,20,35,7,26,67,38.8,41,25,2,23,34,96,19,1,Matches
799,Fábio,br BRA,DF,Nantes,fr Ligue 1,29,1990,9.3,38,22,18,20,0,25,35,71.4,10,10,5,5,18,56,19,0,Matches
800,Cesc Fàbregas,es ESP,MF,Monaco,fr Ligue 1,32,1987,10.3,11,4,6,3,2,6,29,20.7,23,8,1,7,7,18,3,0,Matches
801,Fabricio,es ESP,GK,Mallorca,es La Liga,31,1987,1.0,0,0,0,0,0,0,0,,0,0,0,0,0,0,0,1,Matches
802,Ralf Fährmann,de GER,GK,Norwich City,eng Premier League,30,1988,0.2,0,0,0,0,0,0,0,,0,0,0,0,0,0,0,0,Matches
803,Fayçal Fajr,ma MAR,MF,Getafe,es La Liga,30,1988,4.5,1,1,0,1,0,0,3,0.0,3,4,0,4,4,5,1,0,Matches
804,Luca Falbo,it ITA,DF,Lazio,it Serie A,19,2000,0.0,0,0,0,0,0,0,0,,0,0,0,0,0,0,0,0,Matches
805,Filippo Falco,it ITA,"FW,MF",Lecce,it Serie A,27,1992,22.4,13,7,4,5,4,5,18,27.8,13,11,1,10,2,15,1,0,Matches
806,Eliseo Falcon,es ESP,DF,Levante,es La Liga,22,1997,0.8,0,0,0,0,0,0,0,,0,0,0,0,0,0,2,0,Matches
807,Wladimiro Falcone,it ITA,GK,Sampdoria,it Serie A,24,1995,2.0,0,0,0,0,0,0,0,,0,0,0,0,0,0,0,0,Matches
808,Simon Falette,gn GUI,DF,Eint Frankfurt,de Bundesliga,27,1992,1.0,0,0,0,0,0,0,1,0.0,1,3,3,0,3,3,5,0,Matches
809,Iago Falque,es ESP,"FW,MF",Torino,it Serie A,29,1990,1.1,0,0,0,0,0,0,1,0.0,1,1,0,1,0,0,0,0,Matches
810,Iago Falque,es ESP,MF,Genoa,it Serie A,29,1990,5.8,7,3,1,4,2,4,8,50.0,4,7,0,7,1,8,4,0,Matches
811,Akin Famewo,eng ENG,MF,Norwich City,eng Premier League,20,1998,0.0,0,0,0,0,0,0,0,,0,0,0,0,0,0,0,0,Matches
812,Andri Fannar Baldursson,is ISL,MF,Bologna,it Serie A,17,2002,1.6,1,0,0,1,0,0,1,0.0,1,2,0,2,1,2,3,0,Matches
813,Paolo Faragò,it ITA,"DF,MF",Cagliari,it Serie A,26,1993,14.9,41,28,21,15,5,23,46,50.0,23,18,9,9,10,51,58,0,Matches
814,Davide Faraoni,it ITA,DF,Hellas Verona,it Serie A,27,1991,35.9,67,37,43,19,5,30,67,44.8,37,50,15,35,36,103,115,0,Matches
815,Mohamed Fares,dz ALG,"DF,MF",SPAL,it Serie A,23,1996,4.7,6,4,3,2,1,2,10,20.0,8,5,3,2,5,11,8,0,Matches
816,Diego Farias,br BRA,"MF,FW",Lecce,it Serie A,29,1990,9.2,9,6,3,5,1,5,18,27.8,13,7,0,7,4,13,4,0,Matches
817,Ansu Fati,es ESP,FW,Barcelona,es La Liga,16,2002,11.4,16,8,4,7,5,5,15,33.3,10,14,1,13,8,24,3,0,Matches
818,Julien Faussurier,fr FRA,DF,Brest,fr Ligue 1,32,1987,22.0,36,22,23,13,0,21,53,39.6,32,22,7,15,33,69,46,1,Matches
819,Andrea Favilli,it ITA,FW,Genoa,it Serie A,22,1997,7.3,8,7,2,3,3,4,11,36.4,7,5,1,4,0,8,7,0,Matches
820,Federico Fazio,ar ARG,DF,Roma,it Serie A,32,1987,13.5,19,11,12,6,1,6,11,54.5,5,8,6,2,19,38,52,0,Matches
821,Aleix Febas,es ESP,"MF,FW",Mallorca,es La Liga,23,1996,18.8,36,24,13,19,4,12,36,33.3,24,15,0,15,17,53,6,0,Matches
822,Zouhair Feddal,ma MAR,DF,Betis,es La Liga,30,1989,15.9,20,13,14,5,1,10,14,71.4,4,15,9,6,23,43,74,0,Matches
823,Ljubomir Fejsa,rs SRB,MF,Alavés,es La Liga,30,1988,8.7,19,13,8,10,1,6,23,26.1,17,8,1,7,6,25,13,0,Matches
824,Nabil Fekir,fr FRA,"MF,FW",Betis,es La Liga,26,1993,29.3,41,26,14,19,8,12,37,32.4,25,27,3,24,10,51,3,0,Matches
825,Felipe,br BRA,DF,Atlético Madrid,es La Liga,30,1989,23.4,27,19,21,6,0,14,24,58.3,10,18,13,5,40,67,130,0,Matches
826,Luiz Felipe,it ITA,DF,Lazio,it Serie A,22,1997,22.5,42,24,24,15,3,19,32,59.4,13,39,30,9,41,83,69,2,Matches
827,Lucas Felippe,br BRA,"MF,DF",Hellas Verona,it Serie A,19,2000,0.3,1,1,1,0,0,1,1,100.0,0,0,0,0,0,1,0,0,Matches
828,João Félix,pt POR,"FW,MF",Atlético Madrid,es La Liga,19,1999,19.4,9,3,3,3,3,4,14,28.6,10,4,0,4,10,19,4,1,Matches
829,Ohis Felix Uduokhai,de GER,DF,Augsburg,de Bundesliga,21,1997,21.8,43,26,30,12,1,19,29,65.5,10,40,30,10,36,79,125,2,Matches
830,Kiko Femenía,es ESP,DF,Watford,eng Premier League,28,1991,24.9,68,38,49,17,2,43,80,53.8,37,16,2,14,36,104,49,0,Matches
831,Zinedine Ferhat,dz ALG,"FW,MF",Nîmes,fr Ligue 1,26,1993,25.0,26,16,5,16,5,15,46,32.6,31,15,3,12,16,42,18,0,Matches
832,Bruno Fernandes,pt POR,MF,Manchester Utd,eng Premier League,24,1994,13.2,22,12,9,9,4,5,38,13.2,33,6,0,6,11,33,16,0,Matches
833,Edimilson Fernandes,ch SUI,"MF,DF",Mainz 05,de Bundesliga,23,1996,16.5,33,20,12,15,6,15,33,45.5,18,17,9,8,32,65,47,1,Matches
834,Gedson Fernandes,pt POR,"MF,DF",Tottenham,eng Premier League,20,1999,0.8,2,0,2,0,0,0,2,0.0,2,2,0,2,1,3,0,0,Matches
835,Gelson Fernandes,ch SUI,MF,Eint Frankfurt,de Bundesliga,32,1986,8.6,30,18,13,17,0,7,21,33.3,14,11,3,8,16,46,9,2,Matches
836,Matheus Fernandes,br BRA,"MF,FW",Valladolid,es La Liga,21,1998,1.8,6,2,2,2,2,3,5,60.0,2,4,0,4,2,8,2,0,Matches
837,Aitor Fernández,es ESP,GK,Levante,es La Liga,28,1991,36.0,1,1,1,0,0,1,1,100.0,0,0,0,0,2,3,18,3,Matches
838,Andrés Fernández,es ESP,GK,Villarreal,es La Liga,32,1986,4.0,0,0,0,0,0,0,0,,0,0,0,0,0,0,2,0,Matches
839,Carlos Fernández,es ESP,"FW,MF",Granada,es La Liga,23,1996,24.5,24,15,7,11,6,3,32,9.4,29,25,2,23,11,35,30,0,Matches
840,Federico Fernández,ar ARG,DF,Newcastle Utd,eng Premier League,30,1989,29.1,42,25,30,10,2,23,46,50.0,23,41,28,13,24,66,190,2,Matches
841,Gabriel Fernández,uy URU,"FW,MF",Celta Vigo,es La Liga,25,1994,6.2,1,0,0,1,0,1,3,33.3,2,5,1,4,2,3,2,0,Matches
842,Joaquín Fernández,es ESP,"MF,DF",Valladolid,es La Liga,23,1996,18.4,30,24,17,10,3,9,30,30.0,21,14,10,4,32,62,57,0,Matches
843,Fernandinho,br BRA,DF,Manchester City,eng Premier League,34,1985,26.6,50,35,32,16,2,29,48,60.4,19,28,16,12,25,75,82,0,Matches
844,Fernando,br BRA,MF,Sevilla,es La Liga,32,1987,29.5,62,33,37,24,1,34,58,58.6,24,38,15,23,67,129,73,1,Matches
845,Juan Ferney Otero,co COL,"FW,MF",Amiens,fr Ligue 1,24,1995,13.4,17,10,6,9,2,8,24,33.3,16,12,1,11,19,36,10,0,Matches
846,Alex Ferrari,it ITA,DF,Sampdoria,it Serie A,25,1994,11.2,18,13,13,5,0,7,12,58.3,5,13,8,5,12,30,31,0,Matches
847,Facundo Ferreyra,ar ARG,"FW,MF",Espanyol,es La Liga,28,1991,6.4,9,4,4,5,0,3,10,30.0,7,4,0,4,2,11,5,0,Matches
848,Jordan Ferri,fr FRA,MF,Montpellier,fr Ligue 1,27,1992,12.8,22,13,7,12,3,13,44,29.5,31,9,0,9,10,32,10,0,Matches
849,Oliver Fink,de GER,"MF,FW",Düsseldorf,de Bundesliga,37,1982,7.5,21,12,7,11,3,5,16,31.3,11,12,1,11,15,36,7,0,Matches
850,Alfreð Finnbogason,is ISL,FW,Augsburg,de Bundesliga,30,1989,10.7,11,6,1,9,1,2,7,28.6,5,8,2,6,3,14,8,0,Matches
851,Roberto Firmino,br BRA,FW,Liverpool,eng Premier League,27,1991,33.2,37,19,8,14,15,10,43,23.3,33,34,3,31,7,44,11,1,Matches
852,Junior Firpo,do DOM,DF,Barcelona,es La Liga,22,1996,11.3,23,15,12,8,3,11,17,64.7,6,15,3,12,17,40,12,1,Matches
853,John Fleck,sct SCO,MF,Sheffield Utd,eng Premier League,27,1991,28.0,36,25,13,14,9,22,64,34.4,42,25,3,22,24,60,26,0,Matches
854,Mark Flekken,nl NED,GK,Freiburg,de Bundesliga,26,1993,10.0,0,0,0,0,0,0,1,0.0,1,0,0,0,0,0,2,2,Matches
855,Sergio Floccari,it ITA,FW,SPAL,it Serie A,37,1981,10.5,8,3,3,1,4,0,13,0.0,13,9,1,8,5,13,1,0,Matches
856,Alessandro Florenzi,it ITA,"DF,FW",Roma,it Serie A,28,1991,11.1,14,11,8,4,2,7,20,35.0,13,9,3,6,16,30,19,0,Matches
857,Alessandro Florenzi,it ITA,DF,Valencia,es La Liga,28,1991,8.4,13,9,9,4,0,8,18,44.4,10,11,1,10,14,27,21,0,Matches
858,Phil Foden,eng ENG,"FW,MF",Manchester City,eng Premier League,19,2000,10.0,14,10,4,6,4,6,19,31.6,13,5,0,5,6,20,2,0,Matches
859,Mamadou Fofana,ml MLI,"DF,MF",Metz,fr Ligue 1,21,1998,17.6,57,35,38,15,4,21,41,51.2,20,22,10,12,22,79,61,1,Matches
860,Seko Fofana,ci CIV,MF,Udinese,it Serie A,24,1995,25.0,17,12,8,8,1,9,35,25.7,26,20,1,19,17,34,19,0,Matches
861,Wesley Fofana,fr FRA,DF,Saint-Étienne,fr Ligue 1,18,2000,13.5,25,15,16,9,0,12,18,66.7,6,10,5,5,36,61,55,4,Matches
862,Youssouf Fofana,fr FRA,MF,Strasbourg,fr Ligue 1,20,1999,11.2,25,17,10,12,3,13,30,43.3,17,11,0,11,14,39,7,0,Matches
863,Youssouf Fofana,fr FRA,MF,Monaco,fr Ligue 1,20,1999,6.8,16,9,6,10,0,8,15,53.3,7,12,2,10,8,24,9,0,Matches
864,Thomas Foket,be BEL,DF,Reims,fr Ligue 1,24,1994,27.0,61,36,31,23,7,30,48,62.5,18,15,4,11,39,100,59,1,Matches
865,Lamine Fomba,fr FRA,MF,Nîmes,fr Ligue 1,21,1998,15.3,65,31,20,37,8,21,43,48.8,22,29,4,25,25,90,11,1,Matches
866,José Fonte,pt POR,DF,Lille,fr Ligue 1,35,1983,24.5,19,11,11,7,1,11,22,50.0,11,19,11,8,28,47,90,1,Matches
867,Pablo Fornals,es ESP,"MF,FW",West Ham,eng Premier League,23,1996,24.1,46,28,21,18,7,19,64,29.7,45,35,1,34,25,71,15,0,Matches
868,Emil Forsberg,se SWE,MF,RB Leipzig,de Bundesliga,27,1991,12.7,16,10,5,8,3,6,26,23.1,20,15,0,15,5,21,3,0,Matches
869,Hernâni Fortes,pt POR,"MF,FW",Levante,es La Liga,27,1991,7.3,5,2,4,0,1,1,3,33.3,2,3,0,3,4,9,9,0,Matches
870,Ben Foster,eng ENG,GK,Watford,eng Premier League,36,1983,38.0,1,0,1,0,0,1,3,33.3,2,1,0,1,0,1,16,2,Matches
871,Lyle Foster,za RSA,FW,Monaco,fr Ligue 1,18,2000,0.7,0,0,0,0,0,0,1,0.0,1,0,0,0,0,0,1,0,Matches
872,Timothy Fosu-Mensah,nl NED,DF,Manchester Utd,eng Premier League,21,1998,1.5,1,1,0,1,0,1,4,25.0,3,0,0,0,4,5,1,0,Matches
873,Dimitri Foulquier,fr FRA,"DF,MF",Watford,eng Premier League,26,1993,0.7,1,0,1,0,0,0,0,,0,1,0,1,2,3,2,0,Matches
874,Dimitri Foulquier,fr FRA,"DF,MF",Granada,es La Liga,26,1993,12.4,25,11,13,9,3,11,20,55.0,9,8,3,5,16,41,32,0,Matches
875,Juan Foyth,ar ARG,DF,Tottenham,eng Premier League,21,1998,0.8,7,3,5,2,0,3,4,75.0,1,1,0,1,1,8,3,1,Matches
876,Gianluca Frabotta,it ITA,DF,Juventus,it Serie A,20,1999,1.0,3,1,0,2,1,2,2,100.0,0,2,0,2,1,4,2,0,Matches
877,Raphael Framberger,de GER,DF,Augsburg,de Bundesliga,23,1995,13.1,43,25,23,16,4,21,29,72.4,8,23,9,14,20,63,26,0,Matches
878,Simon Francis,eng ENG,DF,Bournemouth,eng Premier League,34,1985,10.8,13,9,11,2,0,11,21,52.4,10,17,12,5,20,33,71,0,Matches
879,Mike Frantz,de GER,MF,Freiburg,de Bundesliga,32,1986,3.9,4,2,1,3,0,2,9,22.2,7,5,3,2,1,5,4,0,Matches
880,Ryan Fraser,sct SCO,"MF,FW",Bournemouth,eng Premier League,25,1994,23.0,12,6,5,5,2,7,22,31.8,15,15,3,12,15,27,24,0,Matches
881,Fred,br BRA,MF,Manchester Utd,eng Premier League,26,1993,24.0,60,32,33,22,5,25,100,25.0,75,44,8,36,38,98,32,0,Matches
882,Ryan Fredericks,eng ENG,DF,West Ham,eng Premier League,26,1992,24.9,82,56,59,18,5,41,64,64.1,23,20,10,10,24,106,73,1,Matches
883,Kieron Freeman,wls WAL,FW,Sheffield Utd,eng Premier League,27,1992,0.1,0,0,0,0,0,0,0,,0,0,0,0,0,0,0,0,Matches
884,Luke Freeman,eng ENG,MF,Sheffield Utd,eng Premier League,27,1992,4.1,6,4,2,2,2,2,8,25.0,6,1,0,1,10,16,6,0,Matches
885,Remo Freuler,ch SUI,MF,Atalanta,it Serie A,27,1992,26.0,51,30,18,25,8,22,63,34.9,41,41,6,35,28,79,26,0,Matches
886,Marco Friedl,at AUT,"DF,MF",Werder Bremen,de Bundesliga,21,1998,24.3,61,39,42,15,4,29,54,53.7,25,29,9,20,34,95,78,0,Matches
887,Marvin Friedrich,de GER,DF,Union Berlin,de Bundesliga,23,1995,31.0,45,31,30,14,1,12,37,32.4,25,46,24,22,42,87,110,0,Matches
888,Samúel Friðjónsson,is ISL,MF,Paderborn 07,de Bundesliga,23,1996,2.1,4,1,3,1,0,1,3,33.3,2,4,1,3,4,8,4,0,Matches
889,Jorge de Frutos,es ESP,"MF,DF",Valladolid,es La Liga,22,1997,0.7,2,2,2,0,0,1,2,50.0,1,0,0,0,0,2,1,0,Matches
890,Christian Fuchs,at AUT,DF,Leicester City,eng Premier League,33,1986,8.6,14,9,8,6,0,8,19,42.1,11,8,3,5,17,31,33,1,Matches
891,Angelo Fulgini,fr FRA,MF,Angers,fr Ligue 1,22,1996,17.5,28,18,8,15,5,12,23,52.2,11,6,1,5,19,47,10,0,Matches
892,Niclas Füllkrug,de GER,FW,Werder Bremen,de Bundesliga,26,1993,4.5,2,2,1,1,0,1,3,33.3,2,3,0,3,3,5,6,0,Matches
893,Ramiro Funes Mori,ar ARG,DF,Villarreal,es La Liga,28,1991,5.0,5,2,2,3,0,0,2,0.0,2,8,2,6,3,8,9,1,Matches
894,Daniel Fuzato,br BRA,GK,Roma,it Serie A,22,1997,1.0,0,0,0,0,0,0,0,,0,0,0,0,0,0,0,0,Matches
895,Matteo Gabbia,it ITA,DF,Milan,it Serie A,19,1999,7.6,7,5,5,2,0,5,8,62.5,3,6,6,0,9,16,21,0,Matches
896,Manolo Gabbiadini,it ITA,FW,Sampdoria,it Serie A,27,1991,22.6,9,7,2,3,4,1,7,14.3,6,12,0,12,10,19,11,0,Matches
897,Gabriel,br BRA,GK,Lecce,it Serie A,26,1992,33.3,2,1,2,0,0,2,3,66.7,1,0,0,0,0,2,11,10,Matches
898,Ruben Gabrielsen,no NOR,DF,Toulouse,fr Ligue 1,27,1992,7.3,3,2,3,0,0,2,4,50.0,2,5,3,2,8,11,41,0,Matches
899,Mijat Gaćinović,rs SRB,"MF,FW",Eint Frankfurt,de Bundesliga,24,1995,11.6,19,11,7,8,4,6,25,24.0,19,26,2,24,15,34,6,0,Matches
900,Luca Gagliano,it ITA,FW,Cagliari,it Serie A,19,2000,0.6,0,0,0,0,0,0,0,,0,0,0,0,1,1,0,0,Matches
901,Roberto Gagliardini,it ITA,MF,Inter,it Serie A,25,1994,20.0,38,19,12,18,8,14,41,34.1,27,28,8,20,30,68,20,1,Matches
902,Riccardo Gagliolo,se SWE,DF,Parma,it Serie A,29,1990,28.9,57,32,37,12,8,30,60,50.0,30,35,18,17,53,110,100,0,Matches
903,Nicolás Gaitán,ar ARG,"MF,FW",Lille,fr Ligue 1,31,1988,0.6,1,0,0,1,0,1,1,100.0,0,1,0,1,0,1,1,0,Matches
904,Marvin Gakpa,fr FRA,"MF,FW",Metz,fr Ligue 1,25,1993,5.2,10,6,3,4,3,4,8,50.0,4,3,0,3,5,15,1,0,Matches
905,Enric Gallego,es ESP,FW,Osasuna,es La Liga,32,1986,9.8,9,5,1,5,3,0,4,0.0,4,10,2,8,4,13,8,0,Matches
906,Enric Gallego,es ESP,FW,Getafe,es La Liga,32,1986,1.8,3,1,1,1,1,2,4,50.0,2,2,0,2,2,5,1,0,Matches
907,Kévin Gameiro,fr FRA,FW,Valencia,es La Liga,32,1987,17.6,17,9,7,6,4,5,21,23.8,16,10,1,9,5,22,5,0,Matches
908,Fran Gámez,es ESP,DF,Mallorca,es La Liga,28,1991,19.6,64,42,32,27,5,33,74,44.6,41,31,11,20,29,93,41,0,Matches
909,Idrissa Gana Gueye,sn SEN,MF,Paris S-G,fr Ligue 1,29,1989,18.4,65,34,30,25,10,18,43,41.9,25,29,4,25,33,98,15,0,Matches
910,Ignatius Ganago,cm CMR,"FW,MF",Nice,fr Ligue 1,20,1999,13.8,10,6,4,3,3,3,18,16.7,15,8,1,7,4,14,13,0,Matches
911,Ezequiel Garay,ar ARG,DF,Valencia,es La Liga,32,1986,16.0,12,8,9,2,1,7,11,63.6,4,19,17,2,14,26,71,0,Matches
912,Dani García,es ESP,MF,Athletic Club,es La Liga,29,1990,33.7,59,30,30,27,2,30,86,34.9,56,25,7,18,52,111,56,1,Matches
913,David García,es ESP,DF,Osasuna,es La Liga,25,1994,31.0,28,16,15,12,1,14,31,45.2,17,20,16,4,48,76,123,2,Matches
914,Eric García,es ESP,DF,Manchester City,eng Premier League,18,2001,8.8,6,1,4,2,0,5,9,55.6,4,2,0,2,18,24,33,0,Matches
915,Javi García,es ESP,MF,Betis,es La Liga,32,1987,4.2,2,2,2,0,0,2,3,66.7,1,1,0,1,4,6,15,0,Matches
916,Manu García,es ESP,MF,Alavés,es La Liga,33,1986,21.9,46,23,11,31,4,17,72,23.6,55,28,12,16,28,74,32,1,Matches
917,Raúl García,es ESP,"DF,MF",Valladolid,es La Liga,30,1989,11.2,20,12,11,7,2,9,22,40.9,13,12,2,10,8,28,30,0,Matches
918,Raúl García,es ESP,"MF,FW",Athletic Club,es La Liga,33,1986,31.9,57,37,19,26,12,16,76,21.1,60,46,6,40,24,81,44,0,Matches
919,Raúl García,es ESP,DF,Getafe,es La Liga,30,1989,2.7,5,3,2,3,0,3,6,50.0,3,3,1,2,4,9,10,0,Matches
920,Rubén García,es ESP,"MF,FW",Osasuna,es La Liga,26,1993,24.3,55,30,22,26,7,18,46,39.1,28,34,5,29,11,66,23,1,Matches
921,Unai García,es ESP,DF,Osasuna,es La Liga,27,1992,6.0,9,6,4,4,1,5,9,55.6,4,13,9,4,8,17,31,0,Matches
922,Víctor García,es ESP,"FW,MF",Valladolid,es La Liga,22,1997,1.0,0,0,0,0,0,0,1,0.0,1,1,0,1,0,0,1,0,Matches
923,James Garner,eng ENG,MF,Manchester Utd,eng Premier League,18,2001,0.1,0,0,0,0,0,0,1,0.0,1,0,0,0,0,0,1,0,Matches
924,Manuel Garrido,es ESP,FW,Leganés,es La Liga,18,2000,1.3,0,0,0,0,0,0,6,0.0,6,3,1,2,1,1,0,0,Matches
925,Mario Gaspar,es ESP,DF,Villarreal,es La Liga,28,1990,21.8,35,20,16,16,3,15,31,48.4,16,25,10,15,26,61,69,0,Matches
926,Daniele Gastaldello,it ITA,DF,Brescia,it Serie A,36,1983,4.3,8,5,5,3,0,2,3,66.7,1,6,3,3,5,13,29,1,Matches
927,Dwight Gayle,eng ENG,FW,Newcastle Utd,eng Premier League,28,1990,9.4,12,10,4,6,2,4,8,50.0,4,5,0,5,2,14,9,0,Matches
928,Paulo Gazzaniga,ar ARG,GK,Tottenham,eng Premier League,27,1992,17.9,0,0,0,0,0,0,0,,0,0,0,0,1,1,4,1,Matches
929,Jean-Philippe Gbamin,ci CIV,MF,Everton,eng Premier League,23,1995,1.5,4,3,1,1,2,1,2,50.0,1,1,0,1,1,5,4,0,Matches
930,Yann Gboho,fr FRA,FW,Rennes,fr Ligue 1,18,2001,2.5,2,2,1,0,1,0,2,0.0,2,1,0,1,1,3,0,0,Matches
931,David de Gea,es ESP,GK,Manchester Utd,eng Premier League,28,1990,38.0,0,0,0,0,0,0,0,,0,0,0,0,0,0,7,4,Matches
932,Theodor Gebre Selassie,cz CZE,"DF,MF",Werder Bremen,de Bundesliga,32,1986,27.0,36,27,23,10,3,17,35,48.6,18,26,9,17,63,99,81,0,Matches
933,Dennis Geiger,de GER,MF,Hoffenheim,de Bundesliga,21,1998,12.6,12,5,4,6,2,2,16,12.5,14,9,2,7,6,18,4,0,Matches
934,Jérémy Gélin,fr FRA,"DF,MF",Rennes,fr Ligue 1,22,1997,10.3,14,5,10,2,2,8,13,61.5,5,14,7,7,15,29,33,1,Matches
935,Christian Gentner,de GER,MF,Union Berlin,de Bundesliga,33,1985,27.1,53,28,16,32,5,22,73,30.1,51,46,8,38,54,107,50,0,Matches
936,Yannick Gerhardt,de GER,MF,Wolfsburg,de Bundesliga,25,1994,9.2,28,18,7,15,6,8,21,38.1,13,11,3,8,12,40,9,0,Matches
937,Valère Germain,fr FRA,FW,Marseille,fr Ligue 1,29,1990,15.0,22,12,6,11,5,6,31,19.4,25,16,3,13,8,30,26,0,Matches
938,Gervinho,ci CIV,FW,Parma,it Serie A,32,1987,25.2,12,6,5,6,1,6,17,35.3,11,4,0,4,5,17,3,0,Matches
939,Anwar El Ghazi,nl NED,"FW,MF",Aston Villa,eng Premier League,24,1995,22.8,20,11,12,5,3,8,26,30.8,18,10,1,9,13,33,16,1,Matches
940,Rachid Ghezzal,dz ALG,"MF,FW",Fiorentina,it Serie A,27,1992,9.2,27,15,14,10,3,10,33,30.3,23,6,0,6,11,38,9,0,Matches
941,Andrea Ghezzi,it ITA,"FW,MF",Brescia,it Serie A,18,2001,0.4,2,0,0,1,1,1,1,100.0,0,0,0,0,0,2,0,0,Matches
942,Paolo Ghiglione,it ITA,"DF,FW",Genoa,it Serie A,22,1997,19.1,31,16,15,13,3,18,35,51.4,17,17,2,15,9,40,42,1,Matches
943,Andrea Ghion,it ITA,"FW,MF",Sassuolo,it Serie A,19,2000,0.5,3,1,1,2,0,1,1,100.0,0,0,0,0,0,3,0,0,Matches
944,Saman Ghoddos,ir IRN,FW,Amiens,fr Ligue 1,25,1993,2.6,2,2,0,1,1,1,2,50.0,1,5,0,5,2,4,3,0,Matches
945,Faouzi Ghoulam,dz ALG,DF,Napoli,it Serie A,28,1991,4.2,6,4,1,4,1,2,5,40.0,3,3,2,1,4,10,8,0,Matches
946,Morgan Gibbs-White,eng ENG,"MF,FW",Wolves,eng Premier League,19,2000,1.4,0,0,0,0,0,0,0,,0,0,0,0,2,2,0,0,Matches
947,Niko Gießelmann,de GER,DF,Düsseldorf,de Bundesliga,27,1991,22.9,46,31,31,11,4,22,45,48.9,23,23,6,17,27,73,55,1,Matches
948,Rafał Gikiewicz,pl POL,GK,Union Berlin,de Bundesliga,31,1987,33.0,1,0,1,0,0,1,4,25.0,3,0,0,0,2,3,26,4,Matches
949,Bryan Gil,es ESP,"MF,FW",Leganés,es La Liga,18,2001,6.2,8,4,3,4,1,1,8,12.5,7,6,0,6,3,11,1,0,Matches
950,Bryan Gil,es ESP,FW,Sevilla,es La Liga,18,2001,0.7,1,1,0,1,0,0,1,0.0,1,0,0,0,0,1,0,0,Matches
951,Billy Gilmour,sct SCO,MF,Chelsea,eng Premier League,18,2001,2.2,5,2,3,2,0,2,4,50.0,2,2,0,2,3,8,3,1,Matches
952,Daniel Ginczek,de GER,FW,Wolfsburg,de Bundesliga,28,1991,8.5,4,3,3,1,0,1,11,9.1,10,3,1,2,1,5,3,0,Matches
953,Matthias Ginter,de GER,DF,Gladbach,de Bundesliga,25,1994,30.9,34,20,19,14,1,17,31,54.8,14,27,22,5,34,68,125,3,Matches
954,Andrei Girotto,br BRA,DF,Nantes,fr Ligue 1,27,1992,24.2,76,53,45,29,2,39,71,54.9,32,32,17,15,34,110,111,1,Matches
955,Olivier Giroud,fr FRA,FW,Chelsea,eng Premier League,32,1986,11.0,8,3,2,5,1,1,11,9.1,10,14,1,13,2,10,13,0,Matches
956,Klaus Gjasula,al ALB,MF,Paderborn 07,de Bundesliga,29,1989,25.3,69,39,30,35,4,30,61,49.2,31,33,6,27,32,101,50,2,Matches
957,Kamil Glik,pl POL,DF,Monaco,fr Ligue 1,31,1988,23.0,26,14,15,11,0,13,21,61.9,8,23,17,6,27,53,118,0,Matches
958,Serge Gnabry,de GER,"FW,MF",Bayern Munich,de Bundesliga,24,1995,24.4,36,16,4,19,13,9,29,31.0,20,17,0,17,16,52,2,1,Matches
959,Joris Gnagnon,fr FRA,DF,Rennes,fr Ligue 1,22,1997,14.2,16,13,14,2,0,10,11,90.9,1,21,17,4,18,34,61,0,Matches
960,Eddy Gnahoré,fr FRA,MF,Amiens,fr Ligue 1,25,1993,12.6,24,12,7,15,2,8,28,28.6,20,25,4,21,9,33,25,0,Matches
961,Ben Godfrey,eng ENG,DF,Norwich City,eng Premier League,21,1998,29.4,22,14,18,3,1,10,18,55.6,8,41,37,4,25,47,152,3,Matches
962,Diego Godín,uy URU,DF,Inter,it Serie A,33,1986,18.1,38,29,19,16,3,18,32,56.3,14,17,7,10,45,83,60,1,Matches
963,Akaki Gogia,de GER,"MF,FW",Union Berlin,de Bundesliga,27,1992,1.3,2,1,0,0,2,0,2,0.0,2,2,2,0,0,2,0,0,Matches
964,Mauro Goicoechea,uy URU,GK,Toulouse,fr Ligue 1,31,1988,2.0,0,0,0,0,0,0,0,,0,0,0,0,0,0,1,2,Matches
965,Edoardo Goldaniga,it ITA,DF,Genoa,it Serie A,25,1993,8.7,4,3,3,1,0,2,5,40.0,3,11,6,5,18,22,25,1,Matches
966,Benjamin Goller,de GER,"FW,MF",Werder Bremen,de Bundesliga,20,1999,3.2,8,3,3,4,1,3,10,30.0,7,3,0,3,1,9,1,0,Matches
967,Pierluigi Gollini,it ITA,GK,Atalanta,it Serie A,24,1995,32.0,0,0,0,0,0,0,2,0.0,2,0,0,0,0,0,13,2,Matches
968,Aleksandr Golovin,ru RUS,MF,Monaco,fr Ligue 1,23,1996,22.9,49,27,17,26,6,14,69,20.3,55,28,0,28,31,80,22,0,Matches
969,André Gomes,pt POR,MF,Everton,eng Premier League,26,1993,16.2,22,15,7,11,4,8,62,12.9,54,20,3,17,7,29,7,0,Matches
970,Angel Gomes,eng ENG,MF,Manchester Utd,eng Premier League,18,2000,0.2,0,0,0,0,0,0,0,,0,1,0,1,0,0,0,0,Matches
971,Ibai Gómez,es ESP,FW,Athletic Club,es La Liga,29,1989,7.7,5,3,2,2,1,3,8,37.5,5,4,0,4,3,8,6,0,Matches
972,Joe Gomez,eng ENG,DF,Liverpool,eng Premier League,22,1997,22.3,23,16,17,6,0,9,20,45.0,11,15,8,7,38,61,64,2,Matches
973,Maxi Gómez,uy URU,FW,Valencia,es La Liga,22,1996,23.8,9,7,1,6,2,4,8,50.0,4,8,1,7,5,14,14,0,Matches
974,Moi Gómez,es ESP,"FW,MF",Villarreal,es La Liga,25,1994,25.8,30,22,9,14,7,11,33,33.3,22,22,2,20,25,55,23,0,Matches
975,Papu Gómez,ar ARG,"MF,FW",Atalanta,it Serie A,31,1988,31.6,27,13,5,13,9,13,45,28.9,32,24,0,24,17,44,6,1,Matches
976,Sergi Gómez,es ESP,DF,Sevilla,es La Liga,27,1992,8.0,9,7,7,2,0,4,4,100.0,0,6,6,0,7,16,30,0,Matches
977,Victor Gomez,es ESP,"DF,FW",Espanyol,es La Liga,19,2000,14.1,13,5,8,4,1,7,20,35.0,13,10,0,10,21,34,31,0,Matches
978,Alfred Gomis,sn SEN,GK,Dijon,fr Ligue 1,25,1993,18.0,1,0,1,0,0,1,2,50.0,1,2,0,2,0,1,14,2,Matches
979,Maxime Gonalons,fr FRA,MF,Granada,es La Liga,30,1989,16.7,62,38,25,35,2,22,54,40.7,32,27,3,24,20,82,20,1,Matches
980,Mathieu Goncalves,fr FRA,DF,Toulouse,fr Ligue 1,18,2001,3.5,5,3,5,0,0,2,8,25.0,6,4,3,1,4,9,10,0,Matches
981,Jérôme Gondorf,de GER,MF,Freiburg,de Bundesliga,31,1988,1.3,9,6,7,1,1,3,6,50.0,3,3,2,1,0,9,2,0,Matches
982,Álvaro González,es ESP,DF,Marseille,fr Ligue 1,29,1990,18.1,19,13,14,4,1,9,13,69.2,4,7,4,3,18,37,65,0,Matches
983,Bruno González,es ESP,DF,Getafe,es La Liga,29,1990,2.0,3,2,3,0,0,1,1,100.0,0,2,0,2,0,3,3,0,Matches
984,Bruno González,es ESP,DF,Levante,es La Liga,29,1990,5.1,10,8,7,2,1,2,4,50.0,2,7,4,3,2,12,32,0,Matches
985,Édgar González,es ESP,MF,Betis,es La Liga,22,1997,7.6,8,3,3,5,0,2,14,14.3,12,4,2,2,10,18,16,0,Matches
986,Gonzalo,es ESP,DF,Levante,es La Liga,22,1997,0.1,1,0,0,1,0,0,0,,0,0,0,0,0,1,0,0,Matches
987,Anthony Gordon,eng ENG,"MF,FW",Everton,eng Premier League,18,2001,4.9,11,7,5,6,0,5,15,33.3,10,6,2,4,8,19,4,0,Matches
988,Leon Goretzka,de GER,MF,Bayern Munich,de Bundesliga,24,1995,16.8,28,15,7,18,3,10,32,31.3,22,18,2,16,24,52,8,0,Matches
989,Andoni Gorosabel,es ESP,DF,Real Sociedad,es La Liga,22,1996,7.9,14,8,9,3,2,10,20,50.0,10,13,1,12,13,27,21,0,Matches
990,Robin Gosens,de GER,DF,Atalanta,it Serie A,25,1994,29.1,53,27,19,26,8,23,51,45.1,28,38,10,28,39,92,40,0,Matches
991,Dan Gosling,eng ENG,MF,Bournemouth,eng Premier League,29,1990,14.0,26,10,14,9,3,6,27,22.2,21,31,11,20,20,46,26,0,Matches
992,Mario Götze,de GER,FW,Dortmund,de Bundesliga,27,1992,5.8,10,7,0,6,4,3,12,25.0,9,3,0,3,2,12,1,0,Matches
993,Prince-Désir Gouano,fr FRA,DF,Amiens,fr Ligue 1,25,1993,3.0,3,1,0,3,0,0,0,,0,6,3,3,2,5,15,0,Matches
994,Amine Gouiri,dz ALG,FW,Lyon,fr Ligue 1,19,2000,0.0,0,0,0,0,0,0,0,,0,0,0,0,0,0,0,0,Matches
995,Jeffrey Gouweleeuw,nl NED,DF,Augsburg,de Bundesliga,28,1991,18.3,28,16,22,5,1,12,21,57.1,9,15,8,7,37,65,97,0,Matches
996,Max Gradel,ci CIV,"MF,FW",Toulouse,fr Ligue 1,31,1987,18.2,36,20,17,14,5,12,47,25.5,35,11,1,10,11,47,23,0,Matches
997,Samuel Grandsir,fr FRA,"FW,MF",Brest,fr Ligue 1,22,1996,16.6,34,22,13,16,5,11,30,36.7,19,9,0,9,14,48,5,0,Matches
998,Esteban Granero,es ESP,MF,Espanyol,es La Liga,32,1987,5.3,10,4,5,3,2,5,11,45.5,6,3,2,1,2,12,5,0,Matches
999,Alberto Grassi,it ITA,MF,Parma,it Serie A,24,1995,7.1,10,4,7,3,0,5,13,38.5,8,5,2,3,19,29,9,1,Matches
1000,Andre Gray,jm JAM,FW,Watford,eng Premier League,28,1991,8.4,4,3,0,2,2,1,3,33.3,2,4,1,3,1,5,2,0,Matches
1001,Demarai Gray,jm JAM,"MF,FW",Leicester City,eng Premier League,23,1996,6.9,12,6,6,6,0,6,12,50.0,6,7,0,7,5,17,4,0,Matches
1002,Jack Grealish,eng ENG,"FW,MF",Aston Villa,eng Premier League,23,1995,35.9,29,19,12,12,5,13,34,38.2,21,33,12,21,22,51,22,1,Matches
1003,Mason Greenwood,eng ENG,FW,Manchester Utd,eng Premier League,17,2001,14.7,17,11,5,6,6,5,20,25.0,15,9,0,9,6,23,6,1,Matches
1004,Michael Gregoritsch,at AUT,"MF,FW",Augsburg,de Bundesliga,25,1994,3.4,2,2,0,2,0,0,4,0.0,4,4,1,3,3,5,7,0,Matches
1005,Michael Gregoritsch,at AUT,FW,Schalke 04,de Bundesliga,25,1994,9.2,8,5,0,6,2,0,9,0.0,9,9,1,8,2,10,10,0,Matches
1006,Clément Grenier,fr FRA,MF,Rennes,fr Ligue 1,28,1991,9.3,21,12,6,15,0,11,40,27.5,29,7,2,5,7,28,16,0,Matches
1007,Antoine Griezmann,fr FRA,FW,Barcelona,es La Liga,28,1991,28.3,33,18,12,11,10,9,34,26.5,25,22,3,19,12,45,20,1,Matches
1008,Vincenzo Grifo,it ITA,MF,Hoffenheim,de Bundesliga,26,1993,0.2,0,0,0,0,0,0,0,,0,0,0,0,0,0,0,0,Matches
1009,Vincenzo Grifo,it ITA,"MF,FW",Freiburg,de Bundesliga,26,1993,18.0,15,10,9,3,3,6,25,24.0,19,13,1,12,14,29,18,1,Matches
1010,Florian Grillitsch,at AUT,"MF,DF",Hoffenheim,de Bundesliga,23,1995,26.8,59,29,34,24,1,29,61,47.5,32,33,6,27,49,108,41,1,Matches
1011,Jérémy Grimm,fr FRA,MF,Strasbourg,fr Ligue 1,32,1987,0.0,0,0,0,0,0,0,0,,0,0,0,0,0,0,0,0,Matches
1012,Christian Groß,de GER,"DF,MF",Werder Bremen,de Bundesliga,30,1989,9.7,23,17,16,5,2,9,16,56.3,7,13,7,6,14,37,50,1,Matches
1013,Pascal Groß,de GER,"MF,FW",Brighton,eng Premier League,28,1991,20.0,36,13,8,21,7,14,39,35.9,25,25,3,22,9,45,7,0,Matches
1014,Carlos Gruezo,ec ECU,MF,Augsburg,de Bundesliga,24,1995,9.8,28,12,12,15,1,5,24,20.8,19,5,0,5,6,34,5,0,Matches
1015,Marko Grujić,rs SRB,MF,Hertha BSC,de Bundesliga,23,1996,26.8,56,34,21,30,5,19,63,30.2,44,43,9,34,22,78,69,0,Matches
1016,Vicente Guaita,es ESP,GK,Crystal Palace,eng Premier League,32,1987,35.0,1,1,1,0,0,1,2,50.0,1,0,0,0,0,1,18,3,Matches
1017,Andrés Guardado,mx MEX,MF,Betis,es La Liga,32,1986,22.7,30,14,15,11,4,15,41,36.6,26,15,4,11,18,48,22,1,Matches
1018,Sergi Guardiola,es ESP,FW,Valladolid,es La Liga,28,1991,29.5,14,6,3,7,4,4,24,16.7,20,23,0,23,6,20,18,1,Matches
1019,Nemanja Gudelj,rs SRB,"MF,DF",Sevilla,es La Liga,27,1991,13.5,20,14,11,8,1,6,19,31.6,13,17,8,9,12,32,35,1,Matches
1020,Gonçalo Guedes,pt POR,"MF,FW",Valencia,es La Liga,22,1996,14.1,19,11,11,7,1,9,32,28.1,23,10,1,9,7,26,1,0,Matches
1021,Mattéo Guendouzi,fr FRA,MF,Arsenal,eng Premier League,20,1999,19.4,31,16,14,13,4,14,43,32.6,29,21,7,14,29,60,38,2,Matches
1022,Raphaël Guerreiro,pt POR,"DF,MF",Dortmund,de Bundesliga,25,1993,25.9,44,24,18,21,5,20,32,62.5,12,27,3,24,42,86,26,0,Matches
1023,Adrián Guerrero,es ESP,DF,Valencia,es La Liga,21,1998,1.4,2,2,1,1,0,2,3,66.7,1,0,0,0,2,4,1,0,Matches
1024,Ander Guevara,es ESP,MF,Real Sociedad,es La Liga,22,1997,10.4,27,11,9,17,1,12,30,40.0,18,13,3,10,8,35,15,1,Matches
1025,Babacar Guèye,sn SEN,FW,Paderborn 07,de Bundesliga,24,1994,1.2,2,0,0,0,2,0,1,0.0,1,1,1,0,0,2,3,0,Matches
1026,John Guidetti,se SWE,"FW,MF",Alavés,es La Liga,27,1992,1.1,2,1,0,1,1,0,0,,0,1,0,1,0,2,0,0,Matches
1027,Josuha Guilavogui,fr FRA,"MF,DF",Wolfsburg,de Bundesliga,28,1990,22.9,41,26,17,23,1,10,30,33.3,20,35,9,26,45,86,64,2,Matches
1028,Frederic Guilbert,fr FRA,"DF,MF",Aston Villa,eng Premier League,24,1994,22.7,74,43,48,20,6,36,67,53.7,31,33,10,23,49,123,74,2,Matches
1029,Hugo Guillamón,es ESP,DF,Valencia,es La Liga,19,2000,5.5,8,3,5,2,1,5,10,50.0,5,3,2,1,5,13,29,0,Matches
1030,Bruno Guimarães,br BRA,MF,Lyon,fr Ligue 1,21,1997,3.0,12,7,5,6,1,5,10,50.0,5,1,0,1,4,16,1,0,Matches
1031,Serhou Guirassy,gn GUI,FW,Amiens,fr Ligue 1,23,1996,21.3,7,3,1,4,2,2,7,28.6,5,13,6,7,4,11,21,0,Matches
1032,Rafik Guitane,fr FRA,MF,Rennes,fr Ligue 1,20,1999,0.2,0,0,0,0,0,0,0,,0,0,0,0,0,0,0,0,Matches
1033,Péter Gulácsi,hu HUN,GK,RB Leipzig,de Bundesliga,29,1990,32.0,0,0,0,0,0,0,0,,0,0,0,0,1,1,18,6,Matches
1034,Manuel Gulde,de GER,DF,Freiburg,de Bundesliga,28,1991,15.2,28,16,17,9,2,15,24,62.5,9,23,13,10,22,50,80,1,Matches
1035,Sinan Gümüş,,"FW,MF",Genoa,it Serie A,25,1994,1.1,0,0,0,0,0,0,4,0.0,4,0,0,0,0,0,1,0,Matches
1036,İlkay Gündoğan,de GER,MF,Manchester City,eng Premier League,28,1990,22.4,27,16,9,11,7,9,41,22.0,32,17,5,12,31,58,13,0,Matches
1037,Angus Gunn,sct SCO,GK,Southampton,eng Premier League,23,1996,10.0,1,1,1,0,0,1,3,33.3,2,0,0,0,0,1,1,0,Matches
1038,Christian Günter,de GER,DF,Freiburg,de Bundesliga,26,1993,33.7,25,11,17,7,1,12,35,34.3,23,29,13,16,14,39,40,0,Matches
1039,Koray Günter,de GER,DF,Hellas Verona,it Serie A,24,1994,30.4,39,25,22,15,2,19,29,65.5,10,45,39,6,55,94,131,1,Matches
1040,Régis Gurtner,fr FRA,GK,Amiens,fr Ligue 1,32,1986,28.0,1,1,1,0,0,1,2,50.0,1,0,0,0,0,1,10,4,Matches
1041,Luiz Gustavo,br BRA,MF,Marseille,fr Ligue 1,32,1987,2.1,6,3,3,3,0,3,5,60.0,2,5,2,3,5,11,6,0,Matches
1042,Jonathan de Guzmán,nl NED,MF,Eint Frankfurt,de Bundesliga,31,1987,1.0,1,1,0,1,0,1,7,14.3,6,2,0,2,1,2,0,0,Matches
1043,Erling Haaland,no NOR,FW,Dortmund,de Bundesliga,19,2000,11.8,4,2,1,0,3,0,4,0.0,4,7,4,3,4,8,4,0,Matches
1044,Janik Haberer,de GER,"MF,FW",Freiburg,de Bundesliga,25,1994,19.1,26,18,8,14,4,12,45,26.7,33,25,4,21,25,51,23,0,Matches
1045,Alexander Hack,de GER,DF,Mainz 05,de Bundesliga,25,1993,8.9,26,10,19,6,1,16,27,59.3,11,20,9,11,23,49,60,1,Matches
1046,Munir El Haddadi,ma MAR,FW,Sevilla,es La Liga,23,1995,13.9,19,17,6,11,2,4,21,19.0,17,8,0,8,7,26,8,0,Matches
1047,André Hahn,de GER,"FW,MF",Augsburg,de Bundesliga,28,1990,7.8,15,9,7,5,3,5,21,23.8,16,23,5,18,13,28,14,0,Matches
1048,Amadou Haidara,ml MLI,MF,RB Leipzig,de Bundesliga,21,1998,8.4,26,16,7,17,2,10,24,41.7,14,14,2,12,8,34,10,1,Matches
1049,Achraf Hakimi,ma MAR,"DF,MF",Dortmund,de Bundesliga,20,1998,30.2,60,41,38,14,8,27,64,42.2,37,26,2,24,30,90,27,2,Matches
1050,Sébastien Haller,ci CIV,FW,West Ham,eng Premier League,25,1994,25.2,22,15,8,10,4,3,30,10.0,27,19,5,14,8,30,27,0,Matches
1051,Marcel Halstenberg,de GER,DF,RB Leipzig,de Bundesliga,27,1991,28.0,46,31,27,17,2,28,58,48.3,30,37,11,26,46,92,72,2,Matches
1052,Romain Hamouma,fr FRA,"FW,MF",Saint-Étienne,fr Ligue 1,32,1987,9.6,12,9,1,5,6,2,12,16.7,10,12,0,12,0,12,4,0,Matches
1053,Samir Handanović,si SVN,GK,Inter,it Serie A,35,1984,35.0,1,1,1,0,0,0,1,0.0,1,0,0,0,0,1,8,3,Matches
1054,Grant Hanley,sct SCO,DF,Norwich City,eng Premier League,27,1991,14.0,24,15,17,7,0,8,14,57.1,6,25,18,7,31,55,77,1,Matches
1055,Lukáš Haraslín,sk SVK,FW,Sassuolo,it Serie A,23,1996,4.3,5,2,1,3,1,2,9,22.2,7,5,0,5,4,9,1,0,Matches
1056,Amine Harit,ma MAR,"MF,FW",Schalke 04,de Bundesliga,22,1997,23.4,16,7,8,5,3,6,25,24.0,19,13,0,13,7,23,2,1,Matches
1057,Martin Harnik,at AUT,"MF,FW",Werder Bremen,de Bundesliga,32,1987,0.1,0,0,0,0,0,0,0,,0,0,0,0,0,0,0,0,Matches
1058,Makoto Hasebe,jp JPN,"DF,MF",Eint Frankfurt,de Bundesliga,35,1984,21.9,28,20,16,9,3,18,39,46.2,21,38,10,28,26,54,38,0,Matches
1059,Hans Hateboer,nl NED,DF,Atalanta,it Serie A,25,1994,26.2,36,23,20,9,7,18,38,47.4,20,22,7,15,10,46,32,1,Matches
1060,Kortney Hause,eng ENG,DF,Aston Villa,eng Premier League,24,1995,17.2,21,9,15,5,1,8,15,53.3,7,27,19,8,20,41,98,4,Matches
1061,Kai Havertz,de GER,"MF,FW",Leverkusen,de Bundesliga,20,1999,27.3,21,15,5,10,6,6,39,15.4,33,22,0,22,2,23,22,0,Matches
1062,Isaac Hayden,eng ENG,MF,Newcastle Utd,eng Premier League,24,1995,24.7,55,27,33,17,5,20,50,40.0,30,24,7,17,38,93,38,0,Matches
1063,Eden Hazard,be BEL,"FW,MF",Real Madrid,es La Liga,28,1991,12.0,7,3,2,3,2,3,15,20.0,12,5,0,5,6,13,0,0,Matches
1064,Thorgan Hazard,be BEL,"FW,MF",Dortmund,de Bundesliga,26,1993,26.4,40,27,17,14,9,12,50,24.0,38,29,0,29,13,53,2,1,Matches
1065,Tom Heaton,eng ENG,GK,Aston Villa,eng Premier League,33,1986,19.9,3,2,3,0,0,3,4,75.0,1,0,0,0,0,3,6,0,Matches
1066,Jonas Hector,de GER,"MF,DF",Köln,de Bundesliga,29,1990,27.0,76,49,37,34,5,24,75,32.0,51,44,10,34,46,122,38,1,Matches
1067,Dominique Heintz,de GER,DF,Freiburg,de Bundesliga,25,1993,27.0,47,30,40,6,1,17,43,39.5,26,38,25,13,41,88,131,1,Matches
1068,Dean Henderson,eng ENG,GK,Sheffield Utd,eng Premier League,22,1997,36.0,0,0,0,0,0,0,0,,0,0,0,0,1,1,13,1,Matches
1069,Jordan Henderson,eng ENG,MF,Liverpool,eng Premier League,29,1990,24.9,63,41,18,33,12,22,55,40.0,33,22,4,18,30,93,21,2,Matches
1070,Liam Henderson,sct SCO,MF,Hellas Verona,it Serie A,23,1996,2.2,3,2,0,3,0,2,3,66.7,1,1,0,1,0,3,4,0,Matches
1071,Jeff Hendrick,ie IRL,MF,Burnley,eng Premier League,27,1992,21.5,18,10,7,8,3,7,27,25.9,20,21,8,13,20,38,20,0,Matches
1072,Wayne Hennessey,wls WAL,GK,Crystal Palace,eng Premier League,32,1987,3.0,0,0,0,0,0,0,0,,0,0,0,0,1,1,3,1,Matches
1073,Rouwen Hennings,de GER,FW,Düsseldorf,de Bundesliga,31,1987,27.3,11,5,2,7,2,3,18,16.7,15,12,0,12,2,13,33,0,Matches
1074,Benjamin Henrichs,de GER,"DF,MF",Monaco,fr Ligue 1,22,1997,9.9,26,20,16,9,1,14,33,42.4,19,19,4,15,14,40,18,0,Matches
1075,Dalbert Henrique,br BRA,"DF,MF",Fiorentina,it Serie A,25,1993,27.6,52,25,35,12,5,18,51,35.3,33,34,4,30,19,71,65,0,Matches
1076,Christophe Hérelle,mq MTQ,DF,Nice,fr Ligue 1,26,1992,12.3,14,11,10,4,0,3,7,42.9,4,14,8,6,17,31,26,1,Matches
1077,Mario Hermoso,es ESP,DF,Atlético Madrid,es La Liga,24,1995,13.5,15,8,12,2,1,11,20,55.0,9,11,5,6,12,27,61,0,Matches
1078,Aridane Hernández,es ESP,DF,Osasuna,es La Liga,30,1989,29.0,35,23,22,13,0,15,19,78.9,4,24,15,9,34,69,137,2,Matches
1079,Javier Hernández,mx MEX,FW,West Ham,eng Premier League,31,1988,1.2,0,0,0,0,0,0,1,0.0,1,0,0,0,1,1,0,0,Matches
1080,Javier Hernández,mx MEX,FW,Sevilla,es La Liga,31,1988,5.0,6,4,0,4,2,1,6,16.7,5,5,0,5,5,11,1,0,Matches
1081,Juan Hernández,es ESP,"FW,MF",Celta Vigo,es La Liga,24,1994,1.0,0,0,0,0,0,0,0,,0,0,0,0,1,1,0,0,Matches
1082,Lucas Hernández,fr FRA,DF,Bayern Munich,de Bundesliga,23,1996,10.2,18,9,13,3,2,9,15,60.0,6,6,1,5,15,33,17,0,Matches
1083,Onel Hernández,cu CUB,"FW,MF",Norwich City,eng Premier League,26,1993,15.4,27,19,13,11,3,9,31,29.0,22,12,1,11,19,46,10,0,Matches
1084,Theo Hernández,fr FRA,DF,Milan,it Serie A,21,1997,31.3,56,39,32,18,6,33,53,62.3,20,34,6,28,43,99,62,2,Matches
1085,Hernani,br BRA,MF,Parma,it Serie A,25,1994,26.9,61,31,25,31,5,30,112,26.8,82,53,11,42,50,111,51,1,Matches
1086,Ander Herrera,es ESP,"MF,DF",Paris S-G,fr Ligue 1,29,1989,6.1,19,11,9,9,1,5,14,35.7,9,10,2,8,6,25,4,0,Matches
1087,Héctor Herrera,mx MEX,MF,Atlético Madrid,es La Liga,29,1990,12.5,31,21,9,18,4,13,32,40.6,19,16,7,9,17,48,13,2,Matches
1088,Sergio Herrera,es ESP,GK,Osasuna,es La Liga,26,1993,18.4,1,1,1,0,0,1,4,25.0,3,0,0,0,1,2,13,3,Matches
1089,Yangel Herrera,ve VEN,MF,Granada,es La Liga,21,1998,26.3,88,49,25,53,10,36,80,45.0,44,38,9,29,34,122,28,0,Matches
1090,Iago Herrerín,es ESP,GK,Athletic Club,es La Liga,31,1988,4.7,0,0,0,0,0,0,0,,0,0,0,0,0,0,0,0,Matches
1091,Patrick Herrmann,de GER,"FW,MF",Gladbach,de Bundesliga,28,1991,16.1,24,11,8,10,6,5,16,31.3,11,21,4,17,11,35,8,0,Matches
1092,Pablo Hervías,es ESP,"MF,FW",Valladolid,es La Liga,26,1993,11.3,24,20,8,14,2,12,22,54.5,10,8,0,8,5,29,0,0,Matches
1093,Son Heung-min,kr KOR,FW,Tottenham,eng Premier League,27,1992,27.5,23,15,10,11,2,9,57,15.8,48,23,0,23,19,42,18,1,Matches
1094,Gonzalo Higuaín,ar ARG,FW,Juventus,it Serie A,31,1987,20.7,13,7,2,6,5,4,31,12.9,27,12,0,12,6,19,14,0,Matches
1095,Vitorino Hilton,br BRA,DF,Montpellier,fr Ligue 1,41,1977,27.9,27,17,20,7,0,13,28,46.4,15,22,18,4,49,76,121,1,Matches
1096,Martin Hinteregger,at AUT,DF,Eint Frankfurt,de Bundesliga,26,1992,30.2,66,51,33,30,3,28,57,49.1,29,41,21,20,36,102,96,0,Matches
1097,George Hirst,eng ENG,"MF,DF",Leicester City,eng Premier League,20,1999,0.1,0,0,0,0,0,0,0,,0,0,0,0,0,0,0,0,Matches
1098,Marwin Hitz,ch SUI,GK,Dortmund,de Bundesliga,31,1987,3.2,0,0,0,0,0,0,0,,0,0,0,0,0,0,0,0,Matches
1099,André Hoffmann,de GER,DF,Düsseldorf,de Bundesliga,26,1993,27.0,48,22,30,18,0,16,50,32.0,34,22,9,13,56,104,90,0,Matches
1100,Nicolas Höfler,de GER,MF,Freiburg,de Bundesliga,29,1990,30.9,65,40,31,28,6,22,64,34.4,42,58,18,40,71,136,59,3,Matches
1101,Jonas Hofmann,de GER,"MF,FW",Gladbach,de Bundesliga,27,1992,18.1,43,27,22,12,9,22,76,28.9,54,28,3,25,18,61,14,0,Matches
1102,Jonas Hofmann,de GER,MF,Schalke 04,de Bundesliga,22,1997,0.0,0,0,0,0,0,0,0,,0,0,0,0,0,0,2,0,Matches
1103,Marco Höger,de GER,MF,Köln,de Bundesliga,29,1989,7.5,10,6,4,5,1,6,16,37.5,10,14,4,10,6,16,15,0,Matches
1104,Rob Holding,eng ENG,DF,Arsenal,eng Premier League,23,1995,6.5,4,2,3,1,0,1,3,33.3,2,10,6,4,5,9,45,1,Matches
1105,José Holebas,gr GRE,DF,Watford,eng Premier League,35,1984,11.4,26,15,19,7,0,9,28,32.1,19,11,4,7,3,29,33,0,Matches
1106,Lucas Höler,de GER,"FW,MF",Freiburg,de Bundesliga,25,1994,27.6,35,15,11,16,8,11,46,23.9,35,30,9,21,12,47,38,0,Matches
1107,Mason Holgate,eng ENG,DF,Everton,eng Premier League,22,1996,22.8,44,26,30,13,1,21,31,67.7,10,26,13,13,34,78,97,0,Matches
1108,Nathan Holland,eng ENG,MF,West Ham,eng Premier League,21,1998,0.4,3,1,2,1,0,0,0,,0,1,0,1,0,3,0,0,Matches
1109,Gerrit Holtmann,ph PHI,"MF,DF",Paderborn 07,de Bundesliga,24,1995,11.8,24,14,14,6,4,15,37,40.5,22,21,1,20,6,30,8,0,Matches
1110,Josué Homawoo,fr FRA,DF,Nantes,fr Ligue 1,21,1997,0.5,6,2,3,3,0,2,2,100.0,0,3,2,1,2,8,2,0,Matches
1111,Franck Honorat,fr FRA,"FW,DF",Saint-Étienne,fr Ligue 1,22,1996,9.4,16,11,7,8,1,8,23,34.8,15,12,1,11,5,21,13,1,Matches
1112,Luca Horn,de GER,DF,Wolfsburg,de Bundesliga,20,1998,0.1,0,0,0,0,0,0,0,,0,0,0,0,0,0,0,0,Matches
1113,Timo Horn,de GER,GK,Köln,de Bundesliga,26,1993,34.0,0,0,0,0,0,0,5,0.0,5,0,0,0,2,2,15,1,Matches
1114,Krisztofer Horváth,hu HUN,"FW,DF",SPAL,it Serie A,17,2002,0.5,1,1,0,1,0,0,0,,0,0,0,0,0,1,0,0,Matches
1115,Conor Hourihane,ie IRL,MF,Aston Villa,eng Premier League,28,1991,17.0,16,10,4,8,4,10,25,40.0,15,19,4,15,9,25,31,0,Matches
1116,Lukáš Hrádecký,fi FIN,GK,Leverkusen,de Bundesliga,29,1989,34.0,0,0,0,0,0,0,1,0.0,1,0,0,0,2,2,19,2,Matches
1117,Benjamin Hübner,de GER,DF,Hoffenheim,de Bundesliga,30,1989,23.0,42,26,33,9,0,23,45,51.1,22,18,13,5,30,72,98,2,Matches
1118,Florian Hübner,de GER,DF,Union Berlin,de Bundesliga,28,1991,9.4,16,14,12,4,0,7,17,41.2,10,11,7,4,16,32,39,0,Matches
1119,Callum Hudson-Odoi,eng ENG,"FW,MF",Chelsea,eng Premier League,18,2000,9.6,10,4,4,5,1,1,7,14.3,6,9,0,9,5,15,4,1,Matches
1120,Will Hughes,eng ENG,MF,Watford,eng Premier League,24,1995,25.0,75,47,24,41,10,25,67,37.3,42,48,8,40,37,112,28,0,Matches
1121,Mats Hummels,de GER,DF,Dortmund,de Bundesliga,30,1988,28.7,57,30,30,26,1,20,38,52.6,18,41,18,23,59,116,110,1,Matches
1122,Uwe Hünemeier,de GER,DF,Paderborn 07,de Bundesliga,33,1986,13.4,20,15,9,11,0,10,20,50.0,10,22,12,10,24,44,63,0,Matches
1123,Adrien Hunou,fr FRA,"FW,MF",Rennes,fr Ligue 1,25,1994,13.4,21,18,5,11,5,4,21,19.0,17,16,1,15,5,26,5,0,Matches
1124,Jannik Huth,de GER,GK,Paderborn 07,de Bundesliga,25,1994,6.0,0,0,0,0,0,0,1,0.0,1,0,0,0,0,0,2,0,Matches
1125,Elseid Hysaj,al ALB,DF,Napoli,it Serie A,25,1994,16.5,18,9,13,4,1,12,26,46.2,14,16,3,13,24,42,26,0,Matches
1126,Suk Hyun-jun,kr KOR,"FW,MF",Reims,fr Ligue 1,28,1991,2.9,3,3,1,1,1,1,2,50.0,1,1,0,1,1,4,2,0,Matches
1127,Pierre Højbjerg,dk DEN,MF,Southampton,eng Premier League,23,1995,30.6,80,49,34,38,8,39,91,42.9,52,44,5,39,46,126,54,2,Matches
1128,Simone Iacoponi,it ITA,DF,Parma,it Serie A,32,1987,33.9,49,25,36,12,1,26,42,61.9,16,37,29,8,35,84,140,2,Matches
1129,Iago,br BRA,"DF,MF",Augsburg,de Bundesliga,22,1997,7.5,19,12,12,7,0,9,18,50.0,9,6,2,4,14,33,27,0,Matches
1130,Robert Ibáñez,es ESP,"MF,FW",Osasuna,es La Liga,26,1993,6.0,13,8,4,5,4,7,20,35.0,13,7,0,7,5,18,5,0,Matches
1131,Roger Ibanez,br BRA,DF,Roma,it Serie A,20,1998,6.8,11,8,6,3,2,5,7,71.4,2,9,6,3,18,29,21,1,Matches
1132,Jordon Ibe,eng ENG,DF,Bournemouth,eng Premier League,23,1995,0.6,2,2,2,0,0,1,1,100.0,0,0,0,0,0,2,1,0,Matches
1133,Vedad Ibišević,ba BIH,FW,Hertha BSC,de Bundesliga,34,1984,14.0,4,3,0,1,3,0,3,0.0,3,4,0,4,1,5,15,0,Matches
1134,Vicente Iborra,es ESP,MF,Villarreal,es La Liga,31,1988,29.4,61,42,31,25,5,30,67,44.8,37,35,16,19,40,101,63,1,Matches
1135,Didier Ibrahim Ndong,ga GAB,MF,Dijon,fr Ligue 1,25,1994,26.5,62,35,30,31,1,30,59,50.8,29,27,6,21,49,111,31,0,Matches
1136,Zlatan Ibrahimović,se SWE,FW,Milan,it Serie A,37,1981,15.1,5,1,0,2,3,1,13,7.7,12,4,3,1,5,10,21,0,Matches
1137,Mauro Icardi,ar ARG,FW,Paris S-G,fr Ligue 1,26,1993,14.1,4,2,1,3,0,1,10,10.0,9,7,1,6,2,6,11,0,Matches
1138,Adam Idah,ie IRL,"FW,MF",Norwich City,eng Premier League,18,2001,2.5,2,2,1,0,1,2,3,66.7,1,4,0,4,0,2,1,0,Matches
1139,Odion Ighalo,ng NGA,FW,Manchester Utd,eng Premier League,30,1989,1.1,2,2,0,2,0,1,3,33.3,2,1,1,0,0,2,0,0,Matches
1140,Borja Iglesias,es ESP,FW,Betis,es La Liga,26,1993,21.4,7,5,1,4,2,0,9,0.0,9,7,4,3,5,12,18,0,Matches
1141,Igor,br BRA,DF,SPAL,it Serie A,21,1998,14.9,24,16,13,10,1,14,20,70.0,6,17,9,8,24,48,37,1,Matches
1142,Igor,br BRA,DF,Fiorentina,it Serie A,21,1998,6.8,12,10,8,2,2,6,7,85.7,1,10,4,6,7,19,16,0,Matches
1143,Kelechi Iheanacho,ng NGA,FW,Leicester City,eng Premier League,22,1996,10.7,3,1,1,2,0,1,9,11.1,8,8,1,7,3,6,8,0,Matches
1144,Luc Ihorst,de GER,FW,Werder Bremen,de Bundesliga,19,2000,0.1,1,1,0,0,1,0,0,,0,1,0,1,0,1,0,0,Matches
1145,Jonathan Ikone,fr FRA,"MF,FW",Lille,fr Ligue 1,21,1998,22.9,15,7,3,7,5,6,24,25.0,18,26,2,24,5,20,3,0,Matches
1146,Yun Il-lok,kr KOR,"MF,FW",Montpellier,fr Ligue 1,27,1992,1.3,1,1,0,1,0,0,4,0.0,4,0,0,0,0,1,0,0,Matches
1147,Josip Iličić,si SVN,"FW,MF",Atalanta,it Serie A,31,1988,18.5,26,19,7,10,9,7,28,25.0,21,9,0,9,9,35,4,0,Matches
1148,Asier Illarramendi,es ESP,MF,Real Sociedad,es La Liga,29,1990,2.4,2,2,1,0,1,2,6,33.3,4,2,1,1,5,7,6,0,Matches
1149,Stefan Ilsanker,at AUT,DF,RB Leipzig,de Bundesliga,30,1989,4.6,3,1,3,0,0,3,6,50.0,3,6,3,3,7,10,21,0,Matches
1150,Stefan Ilsanker,at AUT,"DF,MF",Eint Frankfurt,de Bundesliga,30,1989,9.3,23,15,16,7,0,10,23,43.5,13,8,1,7,19,42,26,0,Matches
1151,Giannelli Imbula,cd COD,MF,Lecce,it Serie A,26,1992,1.4,2,0,2,0,0,0,1,0.0,1,4,1,3,2,4,0,0,Matches
1152,Ciro Immobile,it ITA,FW,Lazio,it Serie A,29,1990,35.2,8,6,2,4,2,0,24,0.0,24,10,2,8,11,19,7,0,Matches
1153,Roberto Inglese,it ITA,FW,Parma,it Serie A,27,1991,8.5,9,6,2,2,5,2,10,20.0,8,8,2,6,2,11,1,0,Matches
1154,Danny Ings,eng ENG,FW,Southampton,eng Premier League,27,1992,31.2,42,25,16,16,10,13,67,19.4,54,62,4,58,9,51,30,1,Matches
1155,Marcus Ingvartsen,dk DEN,"MF,FW",Union Berlin,de Bundesliga,23,1996,19.1,20,14,5,7,8,9,28,32.1,19,16,1,15,16,36,16,0,Matches
1156,Lorenzo Insigne,it ITA,"FW,MF",Napoli,it Serie A,28,1991,31.2,21,15,6,8,7,6,35,17.1,29,13,0,13,30,51,4,1,Matches
1157,Takashi Inui,jp JPN,"MF,FW",Eibar,es La Liga,31,1988,21.8,20,10,7,8,5,11,34,32.4,23,23,4,19,18,38,12,0,Matches
1158,Artur Ioniță,md MDA,MF,Cagliari,it Serie A,28,1990,21.1,38,23,12,22,4,12,37,32.4,25,32,10,22,18,56,24,2,Matches
1159,Alexander Isak,se SWE,FW,Real Sociedad,es La Liga,19,1999,16.7,7,2,0,3,4,1,8,12.5,7,8,0,8,3,10,6,0,Matches
1160,Isco,es ESP,"FW,MF",Real Madrid,es La Liga,27,1992,13.1,13,9,2,10,1,5,14,35.7,9,9,0,9,7,20,4,1,Matches
1161,Nicolas Isimat-Mirin,fr FRA,DF,Toulouse,fr Ligue 1,27,1991,14.0,14,8,8,6,0,5,11,45.5,6,18,12,6,22,36,71,0,Matches
1162,Jakub Iskra,pl POL,DF,SPAL,it Serie A,16,2002,0.9,0,0,0,0,0,0,0,,0,0,0,0,1,1,2,0,Matches
1163,Ismael,es ESP,MF,Betis,es La Liga,18,2000,0.9,2,1,1,1,0,1,2,50.0,1,2,1,1,2,4,2,0,Matches
1164,Gian-Luca Itter,de GER,"DF,MF",Freiburg,de Bundesliga,20,1999,0.4,1,1,1,0,0,1,1,100.0,0,0,0,0,1,2,4,0,Matches
1165,Ander Iturraspe,es ESP,MF,Espanyol,es La Liga,30,1989,2.7,2,0,1,1,0,2,5,40.0,3,0,0,0,1,3,7,0,Matches
1166,Alex Iwobi,ng NGA,"MF,FW",Everton,eng Premier League,23,1996,17.7,25,17,8,15,2,12,33,36.4,21,18,2,16,14,39,10,1,Matches
1167,Armando Izzo,it ITA,DF,Torino,it Serie A,27,1992,29.8,42,24,24,14,4,17,35,48.6,18,44,29,15,71,113,121,1,Matches
1168,Jacobo,es ESP,"DF,MF",Celta Vigo,es La Liga,22,1997,0.9,3,3,2,1,0,1,1,100.0,0,0,0,0,0,3,2,0,Matches
1169,Phil Jagielka,eng ENG,DF,Sheffield Utd,eng Premier League,36,1982,2.7,5,4,3,2,0,1,3,33.3,2,5,5,0,4,9,19,0,Matches
1170,Filip Jagiełło,pl POL,MF,Genoa,it Serie A,21,1997,6.1,7,2,0,3,4,3,7,42.9,4,4,0,4,5,12,4,0,Matches
1171,Alireza Jahanbakhsh,ir IRN,"FW,MF",Brighton,eng Premier League,25,1993,3.5,8,4,3,2,3,0,2,0.0,2,5,0,5,3,11,2,0,Matches
1172,Mato Jajalo,ba BIH,MF,Udinese,it Serie A,31,1988,18.3,44,19,19,22,3,14,38,36.8,24,20,7,13,19,63,19,2,Matches
1173,Ismail Jakobs,sn SEN,"FW,DF",Köln,de Bundesliga,19,1999,18.6,34,23,18,9,7,10,23,43.5,13,25,3,22,24,58,30,0,Matches
1174,Christophe Jallet,fr FRA,DF,Amiens,fr Ligue 1,35,1983,9.5,24,16,14,8,2,14,37,37.8,23,8,2,6,18,42,29,0,Matches
1175,Daniel James,wls WAL,FW,Manchester Utd,eng Premier League,21,1997,25.4,20,10,5,10,5,7,45,15.6,38,23,4,19,7,27,12,0,Matches
1176,Matty James,eng ENG,MF,Leicester City,eng Premier League,28,1991,0.1,0,0,0,0,0,0,0,,0,0,0,0,0,0,0,0,Matches
1177,Reece James,eng ENG,DF,Chelsea,eng Premier League,19,1999,16.8,36,23,18,14,4,11,29,37.9,18,19,8,11,22,58,28,0,Matches
1178,Marko Janković,me MNE,"FW,DF",SPAL,it Serie A,24,1995,1.3,2,1,0,0,2,1,2,50.0,1,2,1,1,0,2,0,0,Matches
1179,Jakub Jankto,cz CZE,"MF,FW",Sampdoria,it Serie A,23,1996,23.3,27,13,14,10,3,10,42,23.8,32,30,3,27,22,49,22,0,Matches
1180,Daryl Janmaat,nl NED,DF,Watford,eng Premier League,30,1989,6.7,14,10,8,6,0,6,13,46.2,7,7,2,5,7,21,23,0,Matches
1181,Laurent Jans,lu LUX,DF,Paderborn 07,de Bundesliga,26,1992,17.5,42,25,30,8,4,22,48,45.8,26,25,10,15,19,61,49,1,Matches
1182,Tony Jantschke,de GER,DF,Gladbach,de Bundesliga,29,1990,11.2,33,21,23,10,0,15,24,62.5,9,20,11,9,27,60,48,0,Matches
1183,Adnan Januzaj,be BEL,"FW,MF",Real Sociedad,es La Liga,24,1995,13.0,8,7,3,2,3,3,16,18.8,13,9,1,8,7,15,2,0,Matches
1184,Rune Jarstein,no NOR,GK,Hertha BSC,de Bundesliga,34,1984,28.3,4,1,4,0,0,2,3,66.7,1,0,0,0,1,5,11,3,Matches
1185,Jason,es ESP,MF,Getafe,es La Liga,25,1994,13.1,29,20,8,16,5,15,33,45.5,18,18,3,15,18,47,9,0,Matches
1186,Dennis Jastrzembski,pl POL,"MF,FW",Paderborn 07,de Bundesliga,19,2000,2.0,2,0,1,1,0,0,1,0.0,1,3,0,3,3,5,0,0,Matches
1187,Corentin Jean,fr FRA,DF,Toulouse,fr Ligue 1,24,1995,0.1,0,0,0,0,0,0,0,,0,0,0,0,0,0,1,0,Matches
1188,Benjamin Jeannot,fr FRA,"MF,FW",Dijon,fr Ligue 1,27,1992,1.9,2,1,0,1,1,0,4,0.0,4,2,0,2,2,4,4,0,Matches
1189,Tin Jedvaj,hr CRO,DF,Augsburg,de Bundesliga,23,1995,29.3,44,26,25,19,0,23,47,48.9,24,36,18,18,60,104,123,1,Matches
1190,Jemerson,br BRA,"DF,MF",Monaco,fr Ligue 1,26,1992,11.7,28,17,13,14,1,10,21,47.6,11,8,3,5,16,44,24,0,Matches
1191,Fredrik Jensen,fi FIN,"MF,FW",Augsburg,de Bundesliga,21,1997,5.1,3,1,2,1,0,2,7,28.6,5,7,1,6,1,4,3,0,Matches
1192,Jesé,es ESP,FW,Paris S-G,fr Ligue 1,26,1993,0.0,0,0,0,0,0,0,0,,0,0,0,0,0,0,0,0,Matches
1193,Gabriel Jesus,br BRA,FW,Manchester City,eng Premier League,22,1997,22.6,17,10,4,5,8,7,25,28.0,18,26,1,25,11,28,6,0,Matches
1194,Juan Jesus,br BRA,DF,Roma,it Serie A,28,1991,1.5,2,1,2,0,0,0,3,0.0,3,1,0,1,1,3,7,0,Matches
1195,Raúl Jiménez,mx MEX,FW,Wolves,eng Premier League,28,1991,36.0,20,12,6,10,4,3,31,9.7,28,26,0,26,16,36,34,1,Matches
1196,João Pedro,br BRA,"FW,MF",Watford,eng Premier League,17,2001,0.3,0,0,0,0,0,0,0,,0,0,0,0,0,0,0,0,Matches
1197,Joaquín,es ESP,"MF,FW",Betis,es La Liga,38,1981,22.9,14,7,4,8,2,4,11,36.4,7,10,2,8,15,29,22,1,Matches
1198,Joelinton,br BRA,FW,Newcastle Utd,eng Premier League,22,1996,29.8,34,20,7,22,5,9,32,28.1,23,32,6,26,11,45,30,0,Matches
1199,Ben Johnson,eng ENG,DF,West Ham,eng Premier League,19,2000,3.0,8,4,7,1,0,7,10,70.0,3,5,2,3,3,11,11,0,Matches
1200,Fabian Johnson,us USA,"MF,DF",Gladbach,de Bundesliga,31,1987,3.0,5,3,2,2,1,2,4,50.0,2,4,1,3,2,7,3,0,Matches
1201,Curtis Jones,eng ENG,MF,Liverpool,eng Premier League,18,2001,1.4,4,4,0,1,3,3,4,75.0,1,2,0,2,2,6,1,0,Matches
1202,Phil Jones,eng ENG,DF,Manchester Utd,eng Premier League,27,1992,1.5,2,2,1,1,0,1,1,100.0,0,2,0,2,2,4,9,1,Matches
1203,Frenkie de Jong,nl NED,MF,Barcelona,es La Liga,22,1997,23.5,26,19,7,12,7,7,22,31.8,15,17,7,10,21,47,9,0,Matches
1204,Luuk de Jong,nl NED,FW,Sevilla,es La Liga,28,1990,22.9,21,10,4,8,9,6,17,35.3,11,12,1,11,7,28,22,0,Matches
1205,Jony,es ESP,"DF,FW",Lazio,it Serie A,28,1991,13.1,13,9,7,4,2,5,23,21.7,18,11,2,9,14,27,17,0,Matches
1206,Joan Jordán,es ESP,MF,Sevilla,es La Liga,25,1994,25.0,64,34,27,31,6,21,76,27.6,55,25,5,20,26,90,20,4,Matches
1207,Bruno Jordão,pt POR,FW,Wolves,eng Premier League,20,1998,0.1,0,0,0,0,0,0,0,,0,1,0,1,0,0,0,0,Matches
1208,Jorginho,it ITA,MF,Chelsea,eng Premier League,27,1991,26.4,66,40,24,34,8,35,91,38.5,56,30,5,25,64,130,27,2,Matches
1209,Jesse Joronen,fi FIN,GK,Brescia,it Serie A,26,1993,29.0,3,1,3,0,0,3,3,100.0,0,0,0,0,6,9,22,0,Matches
1210,Willian José,br BRA,FW,Real Sociedad,es La Liga,27,1991,22.3,5,2,0,4,1,2,8,25.0,6,10,4,6,1,6,16,0,Matches
1211,Joselu,es ESP,FW,Alavés,es La Liga,29,1990,30.9,26,17,4,12,10,4,32,12.5,28,36,5,31,13,39,46,0,Matches
1212,Jota,es ESP,"FW,MF",Aston Villa,eng Premier League,28,1991,3.7,3,1,2,0,1,2,5,40.0,3,1,0,1,3,6,6,0,Matches
1213,Diogo Jota,pt POR,FW,Wolves,eng Premier League,22,1996,25.4,28,15,16,10,2,12,48,25.0,36,17,0,17,9,37,10,2,Matches
1214,Vukašin Jovanović,rs SRB,DF,Bordeaux,fr Ligue 1,23,1996,6.4,18,11,12,6,0,14,21,66.7,7,5,3,2,15,33,15,0,Matches
1215,Dejan Joveljić,rs SRB,FW,Eint Frankfurt,de Bundesliga,19,1999,1.7,2,2,1,1,0,0,1,0.0,1,0,0,0,0,2,1,0,Matches
1216,Stevan Jovetić,me MNE,"FW,MF",Monaco,fr Ligue 1,29,1989,5.3,2,1,0,1,1,1,5,20.0,4,1,0,1,1,3,5,0,Matches
1217,Luka Jović,rs SRB,FW,Real Madrid,es La Liga,21,1997,4.8,2,1,0,0,2,1,2,50.0,1,1,0,1,2,4,0,0,Matches
1218,Juanmi,es ESP,"FW,MF",Betis,es La Liga,26,1993,2.9,4,1,1,2,1,1,4,25.0,3,1,0,1,0,4,0,0,Matches
1219,David Juncà,es ESP,DF,Celta Vigo,es La Liga,25,1993,2.9,6,5,4,1,1,2,3,66.7,1,4,1,3,2,8,3,0,Matches
1220,Lago Junior,ci CIV,"MF,FW",Mallorca,es La Liga,28,1990,24.3,32,19,12,11,9,12,29,41.4,17,23,5,18,14,46,25,0,Matches
1221,Hamed Junior Traorè,ci CIV,"MF,FW",Sassuolo,it Serie A,19,2000,17.4,31,15,10,15,6,14,39,35.9,25,22,1,21,11,42,7,0,Matches
1222,Vinicius Júnior,br BRA,"FW,MF",Real Madrid,es La Liga,19,2000,15.2,26,16,13,8,5,8,32,25.0,24,14,0,14,3,29,2,0,Matches
1223,James Justin,eng ENG,"DF,MF",Leicester City,eng Premier League,21,1998,11.2,36,17,22,14,0,15,25,60.0,10,15,7,8,11,47,30,0,Matches
1224,Musa Juwara,gm GAM,"FW,MF",Bologna,it Serie A,17,2001,1.7,4,2,1,1,2,1,5,20.0,4,2,1,1,0,4,1,0,Matches
1225,Mathias Jørgensen,dk DEN,DF,Düsseldorf,de Bundesliga,29,1990,5.5,4,3,3,1,0,2,4,50.0,2,7,3,4,13,17,33,0,Matches
1226,Ozan Kabak,tr TUR,DF,Schalke 04,de Bundesliga,19,2000,19.7,37,23,28,9,0,14,21,66.7,7,33,19,14,37,74,97,0,Matches
1227,Christian Kabasele,be BEL,DF,Watford,eng Premier League,28,1991,25.0,37,24,26,11,0,17,32,53.1,15,31,23,8,36,73,127,0,Matches
1228,Abdoul Kader Bamba,fr FRA,"FW,MF",Nantes,fr Ligue 1,25,1994,16.3,19,15,5,9,5,9,30,30.0,21,8,2,6,16,35,8,0,Matches
1229,Pavel Kadeřábek,cz CZE,"DF,FW",Hoffenheim,de Bundesliga,27,1992,27.5,32,22,17,13,2,13,30,43.3,17,29,7,22,27,59,55,1,Matches
1230,Florian Kainz,at AUT,"FW,MF",Köln,de Bundesliga,26,1992,17.3,21,13,12,6,3,15,33,45.5,18,26,2,24,13,34,11,0,Matches
1231,Gaël Kakuta,cd COD,"MF,FW",Amiens,fr Ligue 1,28,1991,22.2,46,27,13,27,6,17,48,35.4,31,15,1,14,16,62,8,2,Matches
1232,Lovre Kalinić,hr CRO,GK,Toulouse,fr Ligue 1,29,1990,3.4,0,0,0,0,0,0,1,0.0,1,0,0,0,0,0,0,0,Matches
1233,Nikola Kalinić,hr CRO,FW,Roma,it Serie A,31,1988,6.3,2,1,0,2,0,0,0,,0,2,0,2,1,3,1,0,Matches
1234,Salomon Kalou,ci CIV,"FW,MF",Hertha BSC,de Bundesliga,33,1985,1.6,1,0,1,0,0,0,2,0.0,2,2,0,2,0,1,1,0,Matches
1235,Samuel Kalu,ng NGA,"DF,FW",Bordeaux,fr Ligue 1,21,1997,15.1,33,17,19,12,2,16,36,44.4,20,13,1,12,24,57,10,0,Matches
1236,Daichi Kamada,jp JPN,"MF,FW",Eint Frankfurt,de Bundesliga,22,1996,21.9,29,20,7,17,5,8,42,19.0,34,16,1,15,10,39,6,0,Matches
1237,François Kamano,gn GUI,"DF,MF",Bordeaux,fr Ligue 1,23,1996,7.2,12,6,5,4,3,8,15,53.3,7,5,0,5,3,15,2,0,Matches
1238,Boubacar Kamara,fr FRA,"DF,MF",Marseille,fr Ligue 1,19,1999,23.8,67,34,37,27,3,27,57,47.4,30,27,14,13,34,101,53,1,Matches
1239,Hassane Kamara,ci CIV,"DF,FW",Reims,fr Ligue 1,25,1994,19.0,58,47,40,14,4,24,35,68.6,11,17,2,15,58,116,58,0,Matches
1240,Kevin Kampl,si SVN,MF,RB Leipzig,de Bundesliga,28,1990,7.5,17,11,7,10,0,7,23,30.4,16,7,2,5,16,33,6,0,Matches
1241,Harry Kane,eng ENG,FW,Tottenham,eng Premier League,26,1993,28.7,18,12,3,12,3,4,17,23.5,13,17,7,10,6,24,30,0,Matches
1242,Lee Kang-in,kr KOR,"MF,FW",Valencia,es La Liga,18,2001,5.0,3,1,0,2,1,3,6,50.0,3,5,0,5,3,6,0,0,Matches
1243,Wilfried Kanga,ci CIV,FW,Angers,fr Ligue 1,21,1998,0.8,0,0,0,0,0,0,1,0.0,1,0,0,0,0,0,0,0,Matches
1244,N'Golo Kanté,fr FRA,MF,Chelsea,eng Premier League,28,1991,19.2,44,20,22,14,8,17,36,47.2,19,29,5,24,44,88,32,2,Matches
1245,Stefanos Kapino,gr GRE,GK,Werder Bremen,de Bundesliga,25,1994,1.0,0,0,0,0,0,0,0,,0,0,0,0,1,1,0,0,Matches
1246,Wilfrid Kaptoum,cm CMR,MF,Betis,es La Liga,23,1996,2.2,5,2,3,2,0,3,3,100.0,0,4,1,3,1,6,3,0,Matches
1247,Kenan Karaman,tr TUR,"FW,MF",Düsseldorf,de Bundesliga,25,1994,15.0,11,5,2,5,4,4,9,44.4,5,9,4,5,2,13,7,0,Matches
1248,Yann Karamoh,fr FRA,"FW,MF",Parma,it Serie A,21,1998,6.4,10,7,5,4,1,3,9,33.3,6,5,0,5,2,12,3,0,Matches
1249,Mamoudou Karamoko,fr FRA,MF,Wolfsburg,de Bundesliga,19,1999,0.1,0,0,0,0,0,0,0,,0,0,0,0,0,0,0,0,Matches
1250,Florian Kastenmeier,de GER,GK,Düsseldorf,de Bundesliga,22,1997,17.0,1,1,1,0,0,0,0,,0,0,0,0,2,3,3,1,Matches
1251,Noah Katterbach,de GER,DF,Köln,de Bundesliga,18,2001,14.6,29,23,21,8,0,11,28,39.3,17,12,1,11,29,58,26,0,Matches
1252,Moise Kean,it ITA,FW,Everton,eng Premier League,19,2000,9.5,6,6,5,1,0,0,0,,0,4,0,4,5,11,1,1,Matches
1253,Michael Keane,eng ENG,DF,Everton,eng Premier League,26,1993,28.4,31,16,18,12,1,14,24,58.3,10,35,28,7,44,75,152,0,Matches
1254,Thilo Kehrer,de GER,DF,Paris S-G,fr Ligue 1,22,1996,5.3,10,7,4,5,1,5,10,50.0,5,2,0,2,1,11,2,1,Matches
1255,Jules Keita,gn GUI,"MF,FW",Dijon,fr Ligue 1,21,1998,1.8,4,3,2,1,1,1,6,16.7,5,1,0,1,3,7,0,0,Matches
1256,Naby Keïta,gn GUI,MF,Liverpool,eng Premier League,24,1995,9.1,30,14,8,16,6,11,26,42.3,15,18,0,18,10,40,4,0,Matches
1257,Yannik Keitel,de GER,MF,Freiburg,de Bundesliga,19,2000,1.9,2,1,1,1,0,0,6,0.0,6,3,1,2,4,6,4,0,Matches
1258,Lloyd Kelly,eng ENG,DF,Bournemouth,eng Premier League,20,1998,7.1,7,3,3,4,0,6,7,85.7,1,9,5,4,6,13,15,1,Matches
1259,Martin Kelly,eng ENG,DF,Crystal Palace,eng Premier League,29,1990,17.2,23,18,19,4,0,14,31,45.2,17,18,10,8,16,39,86,1,Matches
1260,Kenedy,br BRA,MF,Getafe,es La Liga,23,1996,6.5,9,5,3,3,3,2,5,40.0,3,10,0,10,11,20,4,0,Matches
1261,Jonjoe Kenny,eng ENG,DF,Schalke 04,de Bundesliga,22,1997,30.2,49,29,24,19,6,26,51,51.0,25,45,10,35,26,75,79,0,Matches
1262,Franck Kessié,ci CIV,MF,Milan,it Serie A,22,1996,32.3,54,29,28,18,8,16,52,30.8,36,34,5,29,34,88,32,2,Matches
1263,Saîf-Eddine Khaoui,tn TUN,"MF,FW",Marseille,fr Ligue 1,24,1995,1.2,3,1,0,3,0,2,5,40.0,3,2,0,2,1,4,4,0,Matches
1264,Wahbi Khazri,tn TUN,"FW,MF",Saint-Étienne,fr Ligue 1,28,1991,12.8,17,9,5,7,5,9,27,33.3,18,11,0,11,4,21,0,0,Matches
1265,Rani Khedira,de GER,MF,Augsburg,de Bundesliga,25,1994,29.4,60,36,21,35,4,18,45,40.0,27,47,12,35,48,108,62,0,Matches
1266,Sami Khedira,de GER,MF,Juventus,it Serie A,32,1987,7.6,14,7,3,8,3,4,19,21.1,15,12,1,11,3,17,13,0,Matches
1267,Kiké,es ESP,FW,Eibar,es La Liga,29,1989,19.6,13,7,0,5,8,4,12,33.3,8,15,1,14,1,14,9,0,Matches
1268,Luca Kilian,de GER,DF,Paderborn 07,de Bundesliga,19,1999,14.0,33,24,27,6,0,22,41,53.7,19,20,9,11,12,45,67,0,Matches
1269,Max Kilman,eng ENG,DF,Wolves,eng Premier League,22,1997,2.1,4,2,1,3,0,2,2,100.0,0,1,1,0,4,8,7,0,Matches
1270,Joshua Kimmich,de GER,"MF,DF",Bayern Munich,de Bundesliga,24,1995,31.3,52,29,21,20,11,22,55,40.0,33,38,9,29,29,81,29,0,Matches
1271,Presnel Kimpembe,fr FRA,DF,Paris S-G,fr Ligue 1,23,1995,13.6,33,25,25,8,0,14,20,70.0,6,7,3,4,21,54,33,1,Matches
1272,Joshua King,no NOR,"FW,MF",Bournemouth,eng Premier League,27,1992,22.3,16,6,4,8,4,4,16,25.0,12,20,3,17,8,24,9,0,Matches
1273,Simon Kjær,dk DEN,DF,Atalanta,it Serie A,30,1989,3.2,9,6,1,8,0,3,4,75.0,1,5,4,1,7,16,10,1,Matches
1274,Simon Kjær,dk DEN,DF,Milan,it Serie A,30,1989,13.8,22,13,17,5,0,10,18,55.6,8,20,16,4,15,37,52,0,Matches
1275,Davy Klaassen,nl NED,MF,Werder Bremen,de Bundesliga,26,1993,32.6,55,43,19,23,13,19,57,33.3,38,46,18,28,38,93,45,2,Matches
1276,Felix Klaus,de GER,"MF,FW",Wolfsburg,de Bundesliga,26,1992,7.4,24,16,4,13,7,7,19,36.8,12,10,2,8,3,27,5,0,Matches
1277,Ragnar Klavan,ee EST,DF,Cagliari,it Serie A,33,1985,26.2,29,16,20,9,0,14,28,50.0,14,29,19,10,25,54,118,1,Matches
1278,Timm Klose,ch SUI,DF,Norwich City,eng Premier League,31,1988,6.5,8,2,5,2,1,7,11,63.6,4,6,6,0,7,15,29,0,Matches
1279,Lukas Klostermann,de GER,DF,RB Leipzig,de Bundesliga,23,1996,29.4,45,26,24,16,5,18,31,58.1,13,34,16,18,26,71,101,2,Matches
1280,Justin Kluivert,nl NED,FW,Roma,it Serie A,20,1999,16.8,17,11,4,8,5,7,16,43.8,9,15,0,15,6,23,7,0,Matches
1281,Lukas Klünter,de GER,DF,Hertha BSC,de Bundesliga,23,1996,20.9,44,31,26,16,2,20,30,66.7,10,16,4,12,27,71,61,1,Matches
1282,Robin Knoche,de GER,DF,Wolfsburg,de Bundesliga,27,1992,17.7,29,14,24,5,0,17,30,56.7,13,19,11,8,27,56,77,1,Matches
1283,Robin Koch,de GER,"DF,MF",Freiburg,de Bundesliga,23,1996,30.1,34,20,20,13,1,11,26,42.3,15,30,22,8,45,79,94,4,Matches
1284,Giorgi Kochorashvili,ge GEO,MF,Levante,es La Liga,20,1999,0.0,0,0,0,0,0,0,0,,0,0,0,0,0,0,0,0,Matches
1285,Jonathan Kodjia,ci CIV,FW,Aston Villa,eng Premier League,29,1989,1.3,0,0,0,0,0,0,1,0.0,1,0,0,0,0,0,1,0,Matches
1286,Kenan Kodro,ba BIH,"FW,MF",Athletic Club,es La Liga,25,1993,4.0,1,0,0,0,1,0,2,0.0,2,1,0,1,0,1,4,0,Matches
1287,Dominik Kohr,de GER,MF,Eint Frankfurt,de Bundesliga,25,1994,16.1,44,35,15,25,4,18,53,34.0,35,31,11,20,30,74,16,0,Matches
1288,Koke,es ESP,MF,Atlético Madrid,es La Liga,27,1992,30.0,70,42,27,30,13,29,89,32.6,60,33,8,25,29,99,28,2,Matches
1289,Aleksandar Kolarov,rs SRB,DF,Roma,it Serie A,33,1985,30.4,37,28,16,16,5,20,37,54.1,17,20,9,11,31,68,57,0,Matches
1290,Sead Kolašinac,ba BIH,DF,Arsenal,eng Premier League,26,1993,18.9,29,16,18,6,5,12,23,52.2,11,14,4,10,25,54,34,1,Matches
1291,Timothée Kolodziejczak,fr FRA,DF,Saint-Étienne,fr Ligue 1,27,1991,14.5,17,10,13,4,0,9,21,42.9,12,8,3,5,30,47,44,2,Matches
1292,Ghislain Konan,ci CIV,DF,Reims,fr Ligue 1,23,1995,14.8,43,26,28,14,1,19,28,67.9,9,13,3,10,24,67,34,0,Matches
1293,Ibrahima Konaté,fr FRA,DF,RB Leipzig,de Bundesliga,20,1999,6.3,11,6,10,1,0,2,7,28.6,5,9,4,5,5,16,35,1,Matches
1294,Moussa Konaté,sn SEN,FW,Amiens,fr Ligue 1,26,1993,6.8,3,0,0,3,0,0,2,0.0,2,2,0,2,1,4,1,0,Matches
1295,Geoffrey Kondogbia,cf CTA,MF,Valencia,es La Liga,26,1993,20.1,63,40,40,18,5,19,51,37.3,32,25,6,19,57,120,36,2,Matches
1296,Lamine Koné,ci CIV,DF,Strasbourg,fr Ligue 1,30,1989,16.4,31,21,20,10,1,12,17,70.6,5,8,5,3,25,56,47,1,Matches
1297,Manu Koné,fr FRA,MF,Toulouse,fr Ligue 1,18,2001,9.7,35,20,17,14,4,13,30,43.3,17,15,1,14,19,54,10,1,Matches
1298,Moussa Koné,sn SEN,"FW,MF",Nîmes,fr Ligue 1,22,1996,1.6,2,0,1,1,0,1,3,33.3,2,1,0,1,1,3,0,0,Matches
1299,Youssouf Koné,ml MLI,DF,Lyon,fr Ligue 1,24,1995,9.1,22,14,17,3,2,12,20,60.0,8,2,1,1,8,30,15,0,Matches
1300,Ezri Konsa,eng ENG,DF,Aston Villa,eng Premier League,21,1997,22.7,18,9,12,6,0,7,16,43.8,9,34,24,10,25,43,70,2,Matches
1301,Pascal Köpke,de GER,FW,Hertha BSC,de Bundesliga,23,1995,1.3,0,0,0,0,0,0,0,,0,0,0,0,0,0,0,0,Matches
1302,Laurent Koscielny,fr FRA,DF,Bordeaux,fr Ligue 1,33,1985,24.3,28,13,24,4,0,10,20,50.0,10,23,19,4,26,54,104,0,Matches
1303,Filip Kostić,rs SRB,"DF,FW",Eint Frankfurt,de Bundesliga,26,1992,32.9,59,38,30,20,9,22,59,37.3,37,45,2,43,23,82,16,0,Matches
1304,Christian Kouamé,ci CIV,"FW,MF",Fiorentina,it Serie A,21,1997,3.3,3,2,0,3,0,0,1,0.0,1,5,1,4,1,4,1,0,Matches
1305,Christian Kouamé,ci CIV,FW,Genoa,it Serie A,21,1997,10.2,2,1,0,1,1,0,8,0.0,8,8,2,6,1,3,13,0,Matches
1306,Tomáš Koubek,cz CZE,GK,Augsburg,de Bundesliga,26,1992,24.0,3,2,3,0,0,3,11,27.3,8,1,0,1,1,4,23,3,Matches
1307,Kalidou Koulibaly,sn SEN,DF,Napoli,it Serie A,28,1991,23.4,51,33,30,17,4,17,28,60.7,11,28,16,12,31,82,61,1,Matches
1308,Efthimis Koulouris,gr GRE,FW,Toulouse,fr Ligue 1,23,1996,17.1,13,8,5,5,3,3,13,23.1,10,8,4,4,3,16,16,0,Matches
1309,Jules Koundé,fr FRA,DF,Sevilla,es La Liga,20,1998,25.7,23,12,14,5,4,10,18,55.6,8,16,12,4,23,46,91,2,Matches
1310,Leonardo Koutris,gr GRE,DF,Mallorca,es La Liga,24,1995,1.0,1,1,0,0,1,1,2,50.0,1,1,1,0,1,2,6,0,Matches
1311,Cheikhou Kouyaté,sn SEN,"MF,DF",Crystal Palace,eng Premier League,29,1989,28.1,67,32,43,20,4,26,48,54.2,22,35,11,24,43,110,58,1,Matches
1312,Mateo Kovačić,hr CRO,MF,Chelsea,eng Premier League,25,1994,23.0,63,38,29,32,2,26,65,40.0,39,15,1,14,22,85,16,1,Matches
1313,Dawid Kownacki,pl POL,"FW,MF",Düsseldorf,de Bundesliga,22,1997,12.1,13,8,5,7,1,9,20,45.0,11,13,2,11,6,19,8,0,Matches
1314,İsmail Köybaşı,tr TUR,"DF,FW",Granada,es La Liga,30,1989,2.6,4,4,3,1,0,0,2,0.0,2,4,0,4,5,9,2,0,Matches
1315,Thomas Kraft,de GER,GK,Hertha BSC,de Bundesliga,31,1988,4.0,0,0,0,0,0,0,0,,0,0,0,0,1,1,0,0,Matches
1316,Emil Krafth,se SWE,DF,Newcastle Utd,eng Premier League,24,1994,11.3,18,12,15,2,1,9,20,45.0,11,11,8,3,8,26,45,0,Matches
1317,Andrej Kramarić,hr CRO,"FW,MF",Hoffenheim,de Bundesliga,28,1991,15.8,2,1,1,0,1,1,7,14.3,6,6,0,6,3,5,4,0,Matches
1318,Christoph Kramer,de GER,MF,Gladbach,de Bundesliga,28,1991,16.3,45,29,19,21,5,19,49,38.8,30,22,3,19,14,59,19,0,Matches
1319,Tom Krauß,de GER,MF,RB Leipzig,de Bundesliga,18,2001,0.0,1,1,0,1,0,1,2,50.0,1,0,0,0,0,1,0,0,Matches
1320,Ladislav Krejčí,cz CZE,DF,Bologna,it Serie A,27,1992,11.7,15,10,6,7,2,9,19,47.4,10,7,4,3,10,25,23,0,Matches
1321,Rene Krhin,si SVN,"DF,MF",Nantes,fr Ligue 1,29,1990,3.6,4,3,1,3,0,2,2,100.0,0,1,0,1,6,10,17,0,Matches
1322,Felix Kroos,de GER,"MF,DF",Union Berlin,de Bundesliga,28,1991,4.2,17,9,9,6,2,8,15,53.3,7,6,3,3,3,20,13,1,Matches
1323,Toni Kroos,de GER,MF,Real Madrid,es La Liga,29,1990,29.5,56,28,18,29,9,18,70,25.7,52,27,0,27,23,79,15,0,Matches
1324,Tim Krul,nl NED,GK,Norwich City,eng Premier League,31,1988,36.0,0,0,0,0,0,0,1,0.0,1,2,0,2,1,1,13,1,Matches
1325,Rade Krunić,ba BIH,"MF,FW",Milan,it Serie A,25,1993,6.0,16,8,8,5,3,9,16,56.3,7,5,0,5,9,25,5,0,Matches
1326,Lukas Kübler,de GER,DF,Freiburg,de Bundesliga,26,1992,2.3,1,1,0,1,0,1,5,20.0,4,2,0,2,1,2,6,0,Matches
1327,Takefusa Kubo,jp JPN,"MF,FW",Mallorca,es La Liga,18,2001,25.7,34,22,16,12,6,15,44,34.1,29,19,1,18,23,57,10,0,Matches
1328,Juraj Kucka,sk SVK,"MF,FW",Parma,it Serie A,32,1987,21.5,43,22,21,16,6,14,61,23.0,47,21,4,17,29,72,36,0,Matches
1329,Dejan Kulusevski,se SWE,"FW,MF",Parma,it Serie A,19,2000,32.6,41,21,10,24,7,19,64,29.7,45,25,1,24,23,64,17,0,Matches
1330,Marash Kumbulla,al ALB,DF,Hellas Verona,it Serie A,19,2000,21.7,40,24,21,17,2,19,36,52.8,17,33,24,9,50,90,86,3,Matches
1331,Pierre Kunde,cm CMR,MF,Mainz 05,de Bundesliga,24,1995,20.7,34,17,15,18,1,12,30,40.0,18,16,4,12,26,60,55,0,Matches
1332,Jasmin Kurtić,si SVN,MF,SPAL,it Serie A,30,1989,15.7,20,7,8,8,4,6,27,22.2,21,14,2,12,10,30,20,1,Matches
1333,Jasmin Kurtić,si SVN,"MF,FW",Parma,it Serie A,30,1989,18.5,32,23,19,10,3,13,35,37.1,22,19,5,14,15,47,27,2,Matches
1334,Layvin Kurzawa,fr FRA,DF,Paris S-G,fr Ligue 1,26,1992,9.5,23,16,5,14,4,11,23,47.8,12,12,1,11,18,41,24,1,Matches
1335,Dereck Kutesa,ch SUI,"FW,MF",Reims,fr Ligue 1,21,1997,5.9,6,5,3,2,1,3,9,33.3,6,5,0,5,1,7,1,0,Matches
1336,Ahmed Kutucu,tr TUR,"FW,MF",Schalke 04,de Bundesliga,19,2000,7.5,11,7,3,6,2,4,15,26.7,11,5,0,5,2,13,5,0,Matches
1337,Enock Kwateng,fr FRA,DF,Bordeaux,fr Ligue 1,22,1997,10.9,36,22,17,17,2,22,47,46.8,25,16,6,10,22,58,41,0,Matches
1338,Giorgos Kyriakopoulos,gr GRE,DF,Sassuolo,it Serie A,23,1996,18.3,35,18,22,7,6,18,32,56.3,14,19,6,13,18,53,41,0,Matches
1339,Antonino La Gumina,it ITA,FW,Sampdoria,it Serie A,23,1996,2.1,0,0,0,0,0,0,0,,0,0,0,0,0,0,1,0,Matches
1340,Andrea La Mantia,it ITA,FW,Lecce,it Serie A,28,1991,6.1,1,0,1,0,0,1,5,20.0,4,3,0,3,7,8,11,0,Matches
1341,Gaëtan Laborde,fr FRA,FW,Montpellier,fr Ligue 1,25,1994,24.9,21,12,4,10,7,9,38,23.7,29,21,0,21,7,28,32,1,Matches
1342,Alexandre Lacazette,fr FRA,FW,Arsenal,eng Premier League,28,1991,20.8,31,16,8,21,2,9,24,37.5,15,14,0,14,7,38,15,0,Matches
1343,Riccardo Ladinetti,it ITA,MF,Cagliari,it Serie A,18,2000,1.4,2,2,0,2,0,1,1,100.0,0,0,0,0,4,6,0,1,Matches
1344,Alban Lafont,fr FRA,GK,Nantes,fr Ligue 1,20,1999,27.0,1,1,1,0,0,1,1,100.0,0,0,0,0,0,1,12,0,Matches
1345,Víctor Laguardia,es ESP,DF,Alavés,es La Liga,29,1989,29.5,21,15,15,6,0,16,30,53.3,14,24,18,6,37,58,131,1,Matches
1346,Jack Lahne,se SWE,FW,Amiens,fr Ligue 1,17,2001,0.1,1,1,0,0,1,0,0,,0,0,0,0,0,1,0,0,Matches
1347,Konrad Laimer,at AUT,MF,RB Leipzig,de Bundesliga,22,1997,23.5,91,45,30,46,15,43,102,42.2,59,51,8,43,34,125,14,0,Matches
1348,Stefan Lainer,at AUT,DF,Gladbach,de Bundesliga,26,1992,30.1,51,30,25,19,7,24,54,44.4,30,38,7,31,29,80,71,0,Matches
1349,Diego Lainez,mx MEX,"MF,FW",Betis,es La Liga,19,2000,3.9,6,5,2,4,0,5,8,62.5,3,6,0,6,1,7,1,0,Matches
1350,Kenny Lala,mg MAD,"DF,MF",Strasbourg,fr Ligue 1,27,1991,22.7,29,16,17,11,1,11,27,40.7,16,14,5,9,20,49,40,1,Matches
1351,Adam Lallana,eng ENG,"MF,FW",Liverpool,eng Premier League,31,1988,4.2,19,9,7,9,3,6,21,28.6,15,7,0,7,5,24,3,0,Matches
1352,Érik Lamela,ar ARG,"MF,FW",Tottenham,eng Premier League,27,1992,13.5,24,20,9,13,2,2,21,9.5,19,12,3,9,8,32,10,0,Matches
1353,Tariq Lamptey,gh GHA,DF,Chelsea,eng Premier League,18,2000,0.4,2,2,1,1,0,2,2,100.0,0,0,0,0,0,2,0,0,Matches
1354,Tariq Lamptey,gh GHA,DF,Brighton,eng Premier League,18,2000,6.5,7,6,6,1,0,2,9,22.2,7,6,0,6,16,23,17,0,Matches
1355,Loïck Landre,fr FRA,DF,Nîmes,fr Ligue 1,27,1992,10.3,16,9,12,3,1,7,11,63.6,4,12,9,3,17,33,34,0,Matches
1356,Michael Lang,ch SUI,"DF,FW",Werder Bremen,de Bundesliga,28,1991,6.0,8,5,3,5,0,6,12,50.0,6,5,1,4,7,15,22,0,Matches
1357,Sebastian Langkamp,de GER,DF,Werder Bremen,de Bundesliga,31,1988,3.5,3,2,3,0,0,2,4,50.0,2,5,3,2,3,6,11,1,Matches
1358,Henri Lansbury,eng ENG,MF,Aston Villa,eng Premier League,28,1990,2.2,6,2,3,1,2,2,8,25.0,6,4,0,4,0,6,3,0,Matches
1359,Manuel Lanzini,ar ARG,"MF,FW",West Ham,eng Premier League,26,1993,15.3,14,9,6,6,2,7,39,17.9,32,9,1,8,10,24,3,0,Matches
1360,Gianluca Lapadula,pe PER,FW,Lecce,it Serie A,29,1990,19.8,15,8,6,8,1,5,16,31.3,11,2,0,2,1,16,14,0,Matches
1361,Aymeric Laporte,es ESP,DF,Manchester City,eng Premier League,25,1994,12.2,13,6,6,7,0,4,9,44.4,5,6,5,1,20,33,26,1,Matches
1362,Danilo Larangeira,br BRA,DF,Bologna,it Serie A,35,1984,29.3,34,17,19,15,0,16,28,57.1,12,54,39,15,30,64,99,0,Matches
1363,Larra,es ESP,"FW,MF",Athletic Club,es La Liga,21,1997,2.8,2,2,0,1,1,0,0,,0,1,0,1,0,2,0,0,Matches
1364,Gautier Larsonneur,fr FRA,GK,Brest,fr Ligue 1,22,1997,26.6,2,1,2,0,0,2,4,50.0,2,1,0,1,4,6,14,3,Matches
1365,Kevin Lasagna,it ITA,FW,Udinese,it Serie A,26,1992,28.5,27,14,7,13,7,6,31,19.4,25,23,1,22,10,37,18,1,Matches
1366,Jamaal Lascelles,eng ENG,DF,Newcastle Utd,eng Premier League,25,1993,23.1,14,3,10,4,0,4,9,44.4,5,23,20,3,28,42,116,1,Matches
1367,Paul Lasne,fr FRA,"MF,FW",Brest,fr Ligue 1,30,1989,13.6,25,13,13,11,1,6,20,30.0,14,7,2,5,7,32,5,0,Matches
1368,Toni Lato,es ESP,"DF,MF",Osasuna,es La Liga,21,1997,5.2,22,15,11,8,3,9,10,90.0,1,9,1,8,8,30,13,1,Matches
1369,Danny Latza,de GER,MF,Mainz 05,de Bundesliga,29,1989,15.3,33,19,15,17,1,16,49,32.7,33,22,5,17,17,50,24,0,Matches
1370,Vincent Laurini,fr FRA,DF,Parma,it Serie A,30,1989,9.8,26,22,11,11,4,14,18,77.8,4,10,3,7,11,37,29,0,Matches
1371,Wesley Lautoa,nc NCL,"MF,DF",Dijon,fr Ligue 1,31,1987,20.8,54,29,24,28,2,28,63,44.4,35,31,16,15,42,96,48,2,Matches
1372,Diego Laxalt,uy URU,"DF,MF",Torino,it Serie A,26,1993,6.6,19,10,10,6,3,6,20,30.0,14,12,4,8,6,25,20,0,Matches
1373,Diego Laxalt,uy URU,DF,Milan,it Serie A,26,1993,1.9,3,3,3,0,0,1,3,33.3,2,4,0,4,0,3,3,0,Matches
1374,Valentino Lazaro,at AUT,"DF,MF",Newcastle Utd,eng Premier League,23,1996,5.3,13,9,11,2,0,11,18,61.1,7,2,0,2,3,16,4,0,Matches
1375,Valentino Lazaro,at AUT,DF,Inter,it Serie A,23,1996,3.6,6,5,3,2,1,4,8,50.0,4,5,0,5,1,7,8,1,Matches
1376,Darko Lazović,rs SRB,DF,Hellas Verona,it Serie A,28,1990,36.0,26,16,14,8,4,14,27,51.9,13,15,4,11,23,49,53,0,Matches
1377,Manuel Lazzari,it ITA,DF,Lazio,it Serie A,25,1993,28.3,20,11,10,7,3,10,31,32.3,21,11,1,10,8,28,34,0,Matches
1378,Mickaël Le Bihan,fr FRA,"FW,DF",Nice,fr Ligue 1,29,1990,1.1,0,0,0,0,0,0,2,0.0,2,0,0,0,0,0,2,0,Matches
1379,Robin Le Normand,es ESP,DF,Real Sociedad,es La Liga,22,1996,26.6,48,27,33,15,0,26,35,74.3,9,20,7,13,20,68,99,0,Matches
1380,Damien Le Tallec,fr FRA,"MF,DF",Montpellier,fr Ligue 1,29,1990,27.3,52,27,20,28,4,24,69,34.8,45,38,18,20,38,90,59,0,Matches
1381,James Lea Siliki,cm CMR,MF,Rennes,fr Ligue 1,23,1996,12.0,28,16,19,9,0,16,29,55.2,13,15,4,11,12,40,12,0,Matches
1382,Rafael Leão,pt POR,FW,Milan,it Serie A,20,1999,15.6,7,4,2,5,0,3,9,33.3,6,4,0,4,0,7,5,0,Matches
1383,Adrien Lebeau,fr FRA,"MF,FW",Strasbourg,fr Ligue 1,20,1999,0.1,1,1,1,0,0,0,1,0.0,1,1,0,1,0,1,0,0,Matches
1384,Mathew Leckie,au AUS,"DF,FW",Hertha BSC,de Bundesliga,28,1991,2.2,3,1,1,2,0,2,3,66.7,1,6,0,6,2,5,2,1,Matches
1385,Benjamin Lecomte,fr FRA,GK,Monaco,fr Ligue 1,28,1991,28.0,0,0,0,0,0,0,1,0.0,1,1,0,1,0,0,10,5,Matches
1386,Pierre Lees-Melou,fr FRA,MF,Nice,fr Ligue 1,26,1993,25.0,63,27,34,21,8,31,88,35.2,57,38,12,26,32,95,43,0,Matches
1387,Jordan Lefort,fr FRA,DF,Amiens,fr Ligue 1,25,1993,9.4,3,2,2,1,0,3,5,60.0,2,4,1,3,9,12,29,0,Matches
1388,Wu Lei,cn CHN,"FW,MF",Espanyol,es La Liga,27,1991,19.1,13,8,5,6,2,4,38,10.5,34,32,1,31,15,28,19,1,Matches
1389,Toni Leistner,de GER,DF,Köln,de Bundesliga,28,1990,11.2,19,12,10,9,0,5,13,38.5,8,16,7,9,32,51,57,0,Matches
1390,Moritz Leitner,de GER,MF,Norwich City,eng Premier League,26,1992,7.6,16,9,8,7,1,9,25,36.0,16,14,4,10,9,25,10,1,Matches
1391,Lucas Leiva,br BRA,MF,Lazio,it Serie A,32,1987,20.1,60,35,25,31,4,28,72,38.9,44,29,6,23,47,107,34,1,Matches
1392,Florian Lejeune,fr FRA,DF,Newcastle Utd,eng Premier League,28,1991,4.9,8,2,6,2,0,4,7,57.1,3,6,2,4,10,18,15,2,Matches
1393,Iñigo Lekue,es ESP,"FW,DF",Athletic Club,es La Liga,26,1993,6.9,22,12,14,6,2,11,14,78.6,3,7,0,7,3,25,11,0,Matches
1394,Nicolas Lemaître,fr FRA,GK,Reims,fr Ligue 1,22,1997,1.0,0,0,0,0,0,0,1,0.0,1,0,0,0,1,1,1,1,Matches
1395,Thomas Lemar,fr FRA,MF,Atlético Madrid,es La Liga,23,1995,10.3,12,8,4,5,3,2,11,18.2,9,14,1,13,6,18,6,0,Matches
1396,Tim Lemperle,de GER,MF,Köln,de Bundesliga,17,2002,0.2,0,0,0,0,0,0,0,,0,0,0,0,0,0,0,0,Matches
1397,Clément Lenglet,fr FRA,DF,Barcelona,es La Liga,24,1995,26.9,44,31,29,15,0,16,32,50.0,16,29,15,14,35,79,79,1,Matches
1398,Aaron Lennon,eng ENG,MF,Burnley,eng Premier League,32,1987,5.5,14,8,7,4,3,7,10,70.0,3,6,1,5,8,22,3,0,Matches
1399,Bernd Leno,de GER,GK,Arsenal,eng Premier League,27,1992,29.4,0,0,0,0,0,0,2,0.0,2,0,0,0,0,0,9,2,Matches
1400,Christopher Lenz,de GER,"DF,MF",Union Berlin,de Bundesliga,24,1994,25.2,63,37,37,20,6,26,49,53.1,23,46,11,35,43,106,65,0,Matches
1401,Donovan Léon,gf GUF,GK,Brest,fr Ligue 1,26,1992,1.4,0,0,0,0,0,0,0,,0,1,0,1,0,0,0,0,Matches
1402,Pedro León,es ESP,"MF,FW",Eibar,es La Liga,32,1986,21.1,28,20,8,9,11,12,25,48.0,13,18,1,17,19,47,7,0,Matches
1403,Sergio León,es ESP,FW,Levante,es La Liga,30,1989,7.5,3,3,0,3,0,2,4,50.0,2,3,0,3,1,4,2,0,Matches
1404,Lukas Lerager,dk DEN,MF,Genoa,it Serie A,26,1993,15.4,29,19,13,12,4,10,34,29.4,24,20,5,15,8,37,15,1,Matches
1405,Mehdi Léris,dz ALG,"MF,FW",Sampdoria,it Serie A,21,1998,5.7,13,11,4,2,7,7,19,36.8,12,12,4,8,6,19,6,0,Matches
1406,Jefferson Lerma,co COL,MF,Bournemouth,eng Premier League,24,1994,30.0,54,32,17,31,6,22,48,45.8,26,28,12,16,57,111,54,1,Matches
1407,Karlo Letica,hr CRO,GK,SPAL,it Serie A,22,1997,10.0,0,0,0,0,0,0,2,0.0,2,0,0,0,0,0,4,3,Matches
1408,Robert Lewandowski,pl POL,FW,Bayern Munich,de Bundesliga,30,1988,30.7,18,9,3,9,6,3,15,20.0,12,13,1,12,7,25,13,0,Matches
1409,Jamal Lewis,nir NIR,DF,Norwich City,eng Premier League,21,1998,25.6,51,35,42,6,3,22,36,61.1,14,27,12,15,25,76,68,0,Matches
1410,Aaron Leya Iseka,be BEL,FW,Toulouse,fr Ligue 1,21,1997,8.6,2,0,0,2,0,0,3,0.0,3,5,0,5,1,3,7,0,Matches
1411,Stephan Lichtsteiner,ch SUI,DF,Augsburg,de Bundesliga,35,1984,14.9,23,14,16,5,2,10,22,45.5,12,15,7,8,16,39,35,0,Matches
1412,Dimitri Liénard,fr FRA,MF,Strasbourg,fr Ligue 1,31,1988,16.5,37,24,10,22,5,18,39,46.2,21,18,4,14,17,54,25,0,Matches
1413,Philipp Lienhart,at AUT,DF,Freiburg,de Bundesliga,23,1996,20.2,11,4,10,1,0,6,13,46.2,7,24,17,7,28,39,86,0,Matches
1414,Matthijs de Ligt,nl NED,DF,Juventus,it Serie A,19,1999,27.2,25,15,14,10,1,13,23,56.5,10,30,23,7,25,50,101,2,Matches
1415,Isaac Lihadji,fr FRA,MF,Marseille,fr Ligue 1,17,2002,0.3,0,0,0,0,0,0,0,,0,0,0,0,0,0,0,0,Matches
1416,Lillo,es ESP,DF,Osasuna,es La Liga,30,1989,2.2,4,2,2,2,0,1,1,100.0,0,2,1,1,2,6,8,0,Matches
1417,Anderson Lima,br BRA,"MF,DF",Lazio,it Serie A,19,1999,0.7,4,0,3,1,0,1,1,100.0,0,4,0,4,0,4,0,0,Matches
1418,Lucas Lima,br BRA,"FW,DF",Nantes,fr Ligue 1,27,1991,3.0,7,2,4,3,0,2,5,40.0,3,2,0,2,1,8,3,0,Matches
1419,Anthony Limbombe,be BEL,"FW,MF",Nantes,fr Ligue 1,25,1994,1.7,3,2,1,2,0,1,1,100.0,0,1,0,1,0,3,3,0,Matches
1420,Victor Lindelöf,se SWE,DF,Manchester Utd,eng Premier League,25,1994,34.4,29,15,16,12,1,17,20,85.0,3,25,16,9,26,55,129,0,Matches
1421,Karol Linetty,pl POL,MF,Sampdoria,it Serie A,24,1995,22.4,61,32,24,25,12,21,65,32.3,44,26,3,23,26,87,17,0,Matches
1422,Jesse Lingard,eng ENG,"MF,FW",Manchester Utd,eng Premier League,26,1992,10.4,15,8,6,4,5,5,18,27.8,13,5,0,5,3,18,0,0,Matches
1423,Pol Lirola,es ESP,DF,Fiorentina,it Serie A,21,1997,29.4,34,20,18,10,6,21,38,55.3,17,16,4,12,26,60,52,0,Matches
1424,Diego Llorente,es ESP,DF,Real Sociedad,es La Liga,25,1993,25.9,30,14,20,9,1,16,28,57.1,12,14,7,7,28,58,101,5,Matches
1425,Fernando Llorente,es ESP,FW,Napoli,it Serie A,34,1985,5.6,0,0,0,0,0,0,1,0.0,1,4,0,4,1,1,3,0,Matches
1426,Marcos Llorente,es ESP,"MF,FW",Atlético Madrid,es La Liga,24,1995,15.2,29,15,7,16,6,7,21,33.3,14,24,4,20,14,43,9,0,Matches
1427,Gautier Lloris,fr FRA,DF,Nice,fr Ligue 1,24,1995,3.0,5,3,5,0,0,4,5,80.0,1,3,3,0,2,7,11,0,Matches
1428,Hugo Lloris,fr FRA,GK,Tottenham,eng Premier League,32,1986,20.1,0,0,0,0,0,0,0,,0,0,0,0,1,1,3,2,Matches
1429,Giovani Lo Celso,ar ARG,"MF,FW",Tottenham,eng Premier League,23,1996,16.6,51,29,12,33,6,12,59,20.3,47,20,4,16,9,60,19,0,Matches
1430,Stanislav Lobotka,sk SVK,MF,Napoli,it Serie A,24,1994,8.4,11,9,3,5,3,5,12,41.7,7,3,1,2,9,20,2,0,Matches
1431,Stanislav Lobotka,sk SVK,MF,Celta Vigo,es La Liga,24,1994,15.4,19,11,13,5,1,4,19,21.1,15,8,2,6,8,27,7,0,Matches
1432,Jürgen Locadia,nl NED,"FW,MF",Brighton,eng Premier League,25,1993,1.0,0,0,0,0,0,0,0,,0,0,0,0,0,0,0,0,Matches
1433,Jürgen Locadia,nl NED,FW,Hoffenheim,de Bundesliga,25,1993,5.9,5,4,0,4,1,1,4,25.0,3,1,0,1,0,5,3,0,Matches
1434,Manuel Locatelli,it ITA,MF,Sassuolo,it Serie A,21,1998,28.7,76,50,35,37,4,33,69,47.8,36,42,14,28,33,109,36,0,Matches
1435,Renan Lodi,br BRA,DF,Atlético Madrid,es La Liga,21,1998,26.6,73,46,28,35,10,40,65,61.5,25,28,7,21,38,111,56,0,Matches
1436,Ruben Loftus-Cheek,eng ENG,"MF,FW",Chelsea,eng Premier League,23,1996,2.3,0,0,0,0,0,0,2,0.0,2,1,1,0,2,2,2,0,Matches
1437,Enzo Loiodice,fr FRA,MF,Dijon,fr Ligue 1,18,2000,2.1,6,4,1,4,1,1,3,33.3,2,2,0,2,2,8,1,0,Matches
1438,Kevin Long,ie IRL,DF,Burnley,eng Premier League,28,1990,6.3,7,5,6,1,0,4,9,44.4,5,9,7,2,4,11,31,0,Matches
1439,Shane Long,ie IRL,FW,Southampton,eng Premier League,32,1987,15.5,19,10,5,8,6,7,19,36.8,12,12,0,12,4,23,16,0,Matches
1440,Matthew Longstaff,eng ENG,MF,Newcastle Utd,eng Premier League,19,2000,6.4,3,1,2,1,0,3,14,21.4,11,4,1,3,5,8,3,0,Matches
1441,Sean Longstaff,eng ENG,MF,Newcastle Utd,eng Premier League,21,1997,15.3,35,19,17,16,2,20,50,40.0,30,23,5,18,19,54,20,2,Matches
1442,Ademola Lookman,ng NGA,"FW,MF",RB Leipzig,de Bundesliga,21,1997,3.4,6,4,3,1,2,1,1,100.0,0,3,0,3,1,7,0,1,Matches
1443,Anthony Lopes,pt POR,GK,Lyon,fr Ligue 1,28,1990,26.0,0,0,0,0,0,0,0,,0,0,0,0,1,1,11,0,Matches
1444,Rony Lopes,pt POR,FW,Sevilla,es La Liga,23,1995,1.5,0,0,0,0,0,0,0,,0,0,0,0,2,2,0,0,Matches
1445,Rony Lopes,pt POR,FW,Monaco,fr Ligue 1,23,1995,0.9,1,0,0,1,0,0,0,,0,0,0,0,0,1,0,0,Matches
1446,Adrián López,es ESP,FW,Osasuna,es La Liga,31,1988,16.0,7,5,1,5,1,2,19,10.5,17,6,2,4,4,11,8,0,Matches
1447,David López,es ESP,"DF,MF",Espanyol,es La Liga,29,1989,27.3,38,20,15,20,3,13,41,31.7,28,28,13,15,35,73,63,3,Matches
1448,Diego López,es ESP,GK,Espanyol,es La Liga,37,1981,35.9,2,2,2,0,0,1,2,50.0,1,0,0,0,2,4,8,1,Matches
1449,Javi López,es ESP,DF,Alavés,es La Liga,17,2002,1.0,6,5,4,2,0,4,5,80.0,1,1,1,0,1,7,5,0,Matches
1450,Javi López,es ESP,DF,Espanyol,es La Liga,33,1986,15.4,47,34,23,18,6,19,40,47.5,21,12,6,6,21,68,38,2,Matches
1451,Lluis López,es ESP,DF,Espanyol,es La Liga,22,1997,3.3,4,2,3,1,0,2,2,100.0,0,4,0,4,1,5,6,1,Matches
1452,Maxime Lopez,fr FRA,"MF,FW",Marseille,fr Ligue 1,21,1997,12.3,16,10,5,8,3,4,26,15.4,22,8,2,6,8,24,1,0,Matches
1453,Pau López,es ESP,GK,Roma,it Serie A,24,1994,32.0,1,0,1,0,0,1,5,20.0,4,0,0,0,1,2,10,3,Matches
1454,Roberto López,es ESP,"FW,MF",Real Sociedad,es La Liga,19,2000,0.6,4,2,1,1,2,2,2,100.0,0,0,0,0,0,4,0,0,Matches
1455,Unai López,es ESP,MF,Athletic Club,es La Liga,23,1995,19.9,30,22,8,18,4,10,41,24.4,31,13,2,11,18,48,12,1,Matches
1456,Iker Losada,es ESP,"MF,FW",Celta Vigo,es La Liga,17,2001,0.1,0,0,0,0,0,0,0,,0,0,0,0,0,0,0,0,Matches
1457,Albert Lottin,fr FRA,MF,Bordeaux,fr Ligue 1,17,2001,0.5,2,0,2,0,0,1,4,25.0,3,0,0,0,2,4,2,0,Matches
1458,Imran Louza,ma MAR,"MF,FW",Nantes,fr Ligue 1,20,1999,22.3,53,27,18,27,8,19,46,41.3,27,18,2,16,17,70,7,0,Matches
1459,Matteo Lovato,it ITA,DF,Hellas Verona,it Serie A,19,2000,0.1,0,0,0,0,0,0,0,,0,0,0,0,0,0,1,0,Matches
1460,Dejan Lovren,hr CRO,DF,Liverpool,eng Premier League,30,1989,8.6,13,8,10,3,0,7,12,58.3,5,9,6,3,10,23,42,0,Matches
1461,Eduard Löwen,de GER,MF,Augsburg,de Bundesliga,22,1997,7.5,10,8,6,2,2,6,18,33.3,12,11,2,9,5,15,7,0,Matches
1462,Eduard Löwen,de GER,MF,Hertha BSC,de Bundesliga,22,1997,3.5,9,6,3,6,0,5,11,45.5,6,2,1,1,7,16,2,0,Matches
1463,Matthew Lowton,eng ENG,DF,Burnley,eng Premier League,30,1989,17.0,41,22,20,18,3,22,33,66.7,11,20,6,14,27,68,57,1,Matches
1464,Hirving Lozano,mx MEX,"FW,MF",Napoli,it Serie A,24,1995,11.4,6,4,1,5,0,2,15,13.3,13,13,0,13,5,11,5,0,Matches
1465,Pol Lozano,es ESP,MF,Espanyol,es La Liga,19,1999,1.9,5,3,3,2,0,3,7,42.9,4,3,0,3,1,6,2,0,Matches
1466,Jan Luca Rumpf,de GER,DF,Paderborn 07,de Bundesliga,20,1999,1.0,0,0,0,0,0,0,0,,0,0,0,0,0,0,2,0,Matches
1467,Jean Lucas,br BRA,MF,Lyon,fr Ligue 1,21,1998,2.2,16,7,8,5,3,2,9,22.2,7,2,2,0,2,18,0,0,Matches
1468,Fabio Lucioni,it ITA,DF,Lecce,it Serie A,31,1987,34.8,29,13,20,9,0,14,32,43.8,18,48,38,10,36,65,169,5,Matches
1469,José Luis Gayà,es ESP,DF,Valencia,es La Liga,24,1995,22.1,44,30,29,12,3,28,41,68.3,13,22,9,13,18,62,48,1,Matches
1470,José Luis Morales,es ESP,"FW,MF",Levante,es La Liga,32,1987,28.0,17,8,5,9,3,6,34,17.6,28,14,1,13,6,23,5,1,Matches
1471,José Luis Palomino,ar ARG,DF,Atalanta,it Serie A,29,1990,27.6,81,44,46,33,2,28,54,51.9,26,39,14,25,61,142,74,2,Matches
1472,José Luis Rodríguez,pa PAN,FW,Alavés,es La Liga,21,1998,0.2,0,0,0,0,0,0,2,0.0,2,0,0,0,0,0,0,0,Matches
1473,David Luiz,br BRA,DF,Arsenal,eng Premier League,32,1987,31.2,28,16,14,14,0,13,24,54.2,11,42,37,5,32,60,133,2,Matches
1474,Douglas Luiz,br BRA,MF,Aston Villa,eng Premier League,21,1998,29.0,46,24,25,17,4,19,65,29.2,46,42,15,27,36,82,54,1,Matches
1475,Jordan Lukaku,be BEL,DF,Lazio,it Serie A,25,1994,4.4,4,2,1,1,2,2,4,50.0,2,2,1,1,0,4,9,0,Matches
1476,Romelu Lukaku,be BEL,FW,Inter,it Serie A,26,1993,33.1,13,7,4,7,2,3,10,30.0,7,14,6,8,1,14,28,0,Matches
1477,Dodi Lukebakio,be BEL,"FW,MF",Hertha BSC,de Bundesliga,21,1997,22.6,25,18,13,8,4,10,28,35.7,18,22,4,18,10,35,14,0,Matches
1478,Saša Lukić,rs SRB,MF,Torino,it Serie A,22,1996,20.7,29,17,8,19,2,10,35,28.6,25,21,7,14,29,58,15,0,Matches
1479,Senad Lulić,ba BIH,DF,Lazio,it Serie A,33,1986,17.5,21,13,10,7,4,11,41,26.8,30,20,4,16,21,42,28,1,Matches
1480,John Lundstram,eng ENG,MF,Sheffield Utd,eng Premier League,25,1994,27.3,46,30,18,21,7,21,65,32.3,44,18,4,14,33,79,46,1,Matches
1481,Sebastiano Luperto,it ITA,DF,Napoli,it Serie A,22,1996,5.9,12,9,7,3,2,6,9,66.7,3,5,3,2,6,18,16,0,Matches
1482,Arnaud Lusamba,cd COD,"MF,FW",Nice,fr Ligue 1,22,1997,10.9,20,11,8,10,2,7,23,30.4,16,9,0,9,5,25,6,1,Matches
1483,Andreas Luthe,de GER,GK,Augsburg,de Bundesliga,32,1987,10.0,1,0,1,0,0,1,2,50.0,1,0,0,0,0,1,5,1,Matches
1484,Lyanco,br BRA,DF,Torino,it Serie A,22,1997,13.1,23,13,9,12,2,7,13,53.8,6,29,19,10,23,46,54,2,Matches
1485,Charalambos Lykogiannis,gr GRE,DF,Cagliari,it Serie A,25,1993,14.9,14,9,9,3,2,7,18,38.9,11,25,9,16,23,37,71,0,Matches
1486,Yann M'Vila,fr FRA,"MF,DF",Saint-Étienne,fr Ligue 1,29,1990,21.6,29,14,12,16,1,12,43,27.9,31,14,4,10,40,69,47,1,Matches
1487,Alexis Mac Allister,ar ARG,"MF,FW",Brighton,eng Premier League,20,1998,3.9,9,5,4,3,2,5,9,55.6,4,12,0,12,1,10,2,0,Matches
1488,Darwin Machís,ve VEN,"FW,MF",Granada,es La Liga,26,1993,23.7,23,13,11,8,4,8,23,34.8,15,22,4,18,31,54,9,0,Matches
1489,Yvann Macon,fr FRA,DF,Saint-Étienne,fr Ligue 1,20,1998,1.1,0,0,0,0,0,0,1,0.0,1,2,0,2,3,3,4,0,Matches
1490,James Maddison,eng ENG,MF,Leicester City,eng Premier League,22,1996,29.2,59,30,13,31,15,23,68,33.8,45,16,0,16,9,68,7,1,Matches
1491,Gabriel Magalhães,br BRA,DF,Lille,fr Ligue 1,21,1997,23.2,41,29,27,11,3,15,22,68.2,7,27,18,9,22,63,86,2,Matches
1492,Lisandro Magallán,ar ARG,DF,Alavés,es La Liga,25,1993,13.3,22,15,10,12,0,8,14,57.1,6,17,6,11,16,38,43,1,Matches
1493,Francesco Magnanelli,it ITA,MF,Sassuolo,it Serie A,34,1984,15.5,25,13,9,12,4,11,35,31.4,24,12,6,6,19,44,23,1,Matches
1494,Giangiacomo Magnani,it ITA,DF,Brescia,it Serie A,23,1995,1.3,0,0,0,0,0,0,1,0.0,1,2,2,0,2,2,6,0,Matches
1495,Giangiacomo Magnani,it ITA,DF,Sassuolo,it Serie A,23,1995,1.6,0,0,0,0,0,0,0,,0,2,1,1,2,2,7,0,Matches
1496,Hugo Magnetti,fr FRA,MF,Brest,fr Ligue 1,21,1998,2.6,16,10,7,7,2,5,9,55.6,4,4,0,4,7,23,4,0,Matches
1497,Harry Maguire,eng ENG,DF,Manchester Utd,eng Premier League,26,1993,38.0,37,23,23,14,0,18,34,52.9,16,31,22,9,72,109,159,0,Matches
1498,Abdallahi Mahmoud,mr MTN,MF,Alavés,es La Liga,19,2000,1.7,4,4,2,1,1,1,6,16.7,5,0,0,0,5,9,2,0,Matches
1499,Riyad Mahrez,dz ALG,"FW,MF",Manchester City,eng Premier League,28,1991,21.6,28,14,11,9,8,11,38,28.9,27,31,1,30,18,46,8,2,Matches
1500,Thiago Maia,br BRA,MF,Lille,fr Ligue 1,22,1997,0.5,4,4,1,3,0,0,1,0.0,1,0,0,0,1,5,1,0,Matches
1501,Arne Maier,de GER,MF,Hertha BSC,de Bundesliga,20,1999,5.9,9,7,6,1,2,1,10,10.0,9,5,0,5,7,16,2,1,Matches
1502,Habib Maïga,ci CIV,MF,Metz,fr Ligue 1,23,1996,25.2,84,50,36,38,10,24,64,37.5,40,39,4,35,34,118,39,2,Matches
1503,Mike Maignan,fr FRA,GK,Lille,fr Ligue 1,24,1995,28.0,0,0,0,0,0,0,0,,0,0,0,0,2,2,5,0,Matches
1504,Ainsley Maitland-Niles,eng ENG,DF,Arsenal,eng Premier League,21,1997,15.4,41,23,34,5,2,22,43,51.2,21,12,3,9,28,69,38,0,Matches
1505,Josh Maja,ng NGA,FW,Bordeaux,fr Ligue 1,20,1998,8.2,5,2,0,2,3,1,10,10.0,9,8,4,4,1,6,3,0,Matches
1506,Abdul Majeed Waris,gh GHA,FW,Strasbourg,fr Ligue 1,27,1991,4.1,6,4,4,2,0,3,8,37.5,5,2,0,2,4,10,0,0,Matches
1507,Žan Majer,si SVN,MF,Lecce,it Serie A,27,1992,18.5,39,18,19,12,8,17,56,30.4,39,27,6,21,26,65,18,1,Matches
1508,Jean-Victor Makengo,fr FRA,MF,Toulouse,fr Ligue 1,21,1998,11.0,14,11,3,10,1,4,13,30.8,9,7,1,6,3,17,5,1,Matches
1509,Nemanja Maksimović,rs SRB,MF,Getafe,es La Liga,24,1995,32.2,49,28,12,31,6,10,44,22.7,34,37,7,30,56,105,30,1,Matches
1510,Nikola Maksimović,rs SRB,DF,Napoli,it Serie A,27,1991,20.0,35,24,21,14,0,10,21,47.6,11,19,11,8,30,65,64,1,Matches
1511,Kévin Malcuit,ma MAR,DF,Napoli,it Serie A,28,1991,2.8,8,6,4,3,1,5,6,83.3,1,4,1,3,3,11,2,0,Matches
1512,Daniel Maldini,it ITA,"FW,MF",Milan,it Serie A,17,2001,0.3,0,0,0,0,0,0,2,0.0,2,1,0,1,1,1,0,0,Matches
1513,Ruslan Malinovskyi,ua UKR,"MF,FW",Atalanta,it Serie A,26,1993,17.1,22,14,2,17,3,9,31,29.0,22,13,2,11,5,27,5,0,Matches
1514,Yunus Mallı,tr TUR,"MF,FW",Union Berlin,de Bundesliga,27,1992,7.5,8,3,1,5,2,5,10,50.0,5,2,0,2,7,15,7,0,Matches
1515,Hugo Mallo,es ESP,DF,Celta Vigo,es La Liga,28,1991,21.8,62,42,44,16,2,27,48,56.3,21,24,8,16,22,84,97,1,Matches
1516,Streli Mamba,de GER,FW,Paderborn 07,de Bundesliga,25,1994,16.9,15,9,0,9,6,1,13,7.7,12,12,2,10,6,21,2,0,Matches
1517,Hianga Mananga Mbock,fr FRA,MF,Brest,fr Ligue 1,19,1999,1.6,1,1,1,0,0,0,0,,0,0,0,0,4,5,0,0,Matches
1518,Vincent Manceau,fr FRA,DF,Angers,fr Ligue 1,30,1989,22.0,34,22,18,13,3,16,36,44.4,20,16,3,13,22,56,51,0,Matches
1519,Gianluca Mancini,it ITA,"DF,MF",Roma,it Serie A,23,1996,30.4,49,26,26,18,5,22,44,50.0,22,32,15,17,60,109,98,1,Matches
1520,Marco Mancosu,it ITA,"MF,FW",Lecce,it Serie A,30,1988,27.1,32,18,11,16,5,10,46,21.7,36,34,9,25,16,48,15,1,Matches
1521,Steve Mandanda,fr FRA,GK,Marseille,fr Ligue 1,34,1985,26.3,3,1,3,0,0,3,4,75.0,1,0,0,0,1,4,2,4,Matches
1522,Reinildo Mandava,mz MOZ,"DF,MF",Lille,fr Ligue 1,25,1994,12.3,37,21,23,11,3,25,41,61.0,16,16,1,15,19,56,20,0,Matches
1523,Aïssa Mandi,dz ALG,DF,Betis,es La Liga,27,1991,28.6,33,15,22,8,3,18,28,64.3,10,29,15,14,38,71,93,0,Matches
1524,Rolando Mandragora,it ITA,MF,Udinese,it Serie A,22,1997,22.8,47,24,15,25,7,15,55,27.3,40,30,5,25,26,73,25,0,Matches
1525,Sadio Mané,sn SEN,FW,Liverpool,eng Premier League,27,1992,30.5,44,32,9,20,15,13,40,32.5,27,19,0,19,13,57,11,2,Matches
1526,Eliaquim Mangala,fr FRA,DF,Valencia,es La Liga,28,1991,7.5,4,4,3,1,0,1,2,50.0,1,7,6,1,7,11,40,0,Matches
1527,Thomas Mangani,fr FRA,MF,Angers,fr Ligue 1,32,1987,20.8,33,23,15,16,2,14,47,29.8,33,17,2,15,12,45,20,1,Matches
1528,Massimiliano Mangraviti,it ITA,DF,Brescia,it Serie A,21,1998,10.8,8,6,1,6,1,3,6,50.0,3,11,6,5,8,16,43,0,Matches
1529,Kostas Manolas,gr GRE,DF,Napoli,it Serie A,28,1991,24.2,23,15,13,10,0,10,17,58.8,7,19,14,5,25,48,76,1,Matches
1530,Javier Manquillo,es ESP,DF,Newcastle Utd,eng Premier League,25,1994,17.8,39,26,27,8,4,24,38,63.2,14,14,2,12,18,57,56,0,Matches
1531,Giacomo Manzari,it ITA,"FW,MF",Sassuolo,it Serie A,18,2000,0.2,0,0,0,0,0,0,0,,0,0,0,0,0,0,0,0,Matches
1532,Myziane Maolida,km COM,"FW,MF",Nice,fr Ligue 1,20,1999,7.5,14,10,5,6,3,5,12,41.7,7,8,0,8,3,17,3,0,Matches
1533,Faitout Maouassa,fr FRA,DF,Rennes,fr Ligue 1,21,1998,20.0,51,33,27,20,4,14,26,53.8,12,13,5,8,23,74,59,0,Matches
1534,Fernando Marçal,br BRA,DF,Lyon,fr Ligue 1,30,1989,9.2,28,18,18,7,3,13,26,50.0,13,7,3,4,26,54,32,0,Matches
1535,Marcelo,br BRA,DF,Real Madrid,es La Liga,31,1988,14.4,19,11,8,8,3,9,28,32.1,19,19,2,17,18,37,21,0,Matches
1536,Marcelo,br BRA,DF,Lyon,fr Ligue 1,32,1987,16.7,27,18,18,8,1,16,23,69.6,7,12,11,1,22,49,77,0,Matches
1537,Solly March,eng ENG,"FW,MF",Brighton,eng Premier League,25,1994,12.7,25,12,16,6,3,9,19,47.4,10,16,4,12,20,45,14,2,Matches
1538,Gian Marco Ferrari,it ITA,DF,Sassuolo,it Serie A,27,1992,21.1,9,5,6,3,0,4,8,50.0,4,25,22,3,26,35,41,1,Matches
1539,Óscar de Marcos,es ESP,"DF,FW",Athletic Club,es La Liga,30,1989,6.0,5,3,2,1,2,3,6,50.0,3,6,0,6,8,13,8,0,Matches
1540,Dario Maresic,at AUT,DF,Reims,fr Ligue 1,19,1999,1.0,0,0,0,0,0,0,0,,0,1,1,0,1,1,6,0,Matches
1541,Miguel Marí,es ESP,MF,Eibar,es La Liga,22,1997,0.1,0,0,0,0,0,0,0,,0,0,0,0,0,0,0,0,Matches
1542,Pablo Marí,es ESP,DF,Arsenal,eng Premier League,25,1993,1.3,2,1,2,0,0,0,0,,0,0,0,0,1,3,10,0,Matches
1543,José María Giménez,uy URU,DF,Atlético Madrid,es La Liga,24,1995,19.5,20,16,18,1,1,7,11,63.6,4,14,7,7,23,43,75,1,Matches
1544,Mariano,do DOM,"FW,MF",Real Madrid,es La Liga,25,1993,0.5,0,0,0,0,0,0,1,0.0,1,0,0,0,0,0,0,0,Matches
1545,Adrian Mariappa,jm JAM,DF,Watford,eng Premier League,32,1986,16.8,20,14,15,4,1,11,30,36.7,19,22,7,15,11,31,73,0,Matches
1546,Jordan Marié,fr FRA,"MF,FW",Dijon,fr Ligue 1,27,1991,2.2,7,5,4,3,0,4,9,44.4,5,3,1,2,4,11,2,0,Matches
1547,Federico Marigosu,it ITA,MF,Cagliari,it Serie A,18,2001,0.3,0,0,0,0,0,0,0,,0,0,0,0,0,0,1,0,Matches
1548,Adrián Marín,es ESP,DF,Alavés,es La Liga,22,1997,9.5,22,15,14,6,2,13,15,86.7,2,13,4,9,13,35,32,0,Matches
1549,Guillermo Maripán,cl CHI,DF,Alavés,es La Liga,25,1994,1.0,1,1,1,0,0,1,2,50.0,1,0,0,0,2,3,10,0,Matches
1550,Guillermo Maripán,cl CHI,DF,Monaco,fr Ligue 1,25,1994,19.5,42,26,28,13,1,24,41,58.5,17,30,13,17,25,67,69,2,Matches
1551,Marlon,br BRA,DF,Sassuolo,it Serie A,23,1995,20.2,40,23,24,15,1,17,27,63.0,10,20,13,7,35,75,69,0,Matches
1552,Omar Marmoush,eg EGY,"MF,FW",Wolfsburg,de Bundesliga,20,1999,0.9,1,1,1,0,0,0,0,,0,1,0,1,1,2,0,0,Matches
1553,Gonzalo Maroni,ar ARG,"MF,FW",Sampdoria,it Serie A,20,1999,2.0,3,1,1,1,1,3,7,42.9,4,1,0,1,3,6,0,0,Matches
1554,Marquinhos,br BRA,"MF,DF",Paris S-G,fr Ligue 1,25,1994,16.4,39,20,17,18,4,11,26,42.3,15,25,8,17,25,64,31,1,Matches
1555,Bruno Martella,it ITA,DF,Brescia,it Serie A,26,1992,14.1,18,9,14,3,1,9,16,56.3,7,13,7,6,17,35,48,1,Matches
1556,Roger Martí,es ESP,FW,Levante,es La Liga,28,1991,25.2,18,11,8,7,3,7,29,24.1,22,14,0,14,6,24,17,0,Matches
1557,Anthony Martial,fr FRA,FW,Manchester Utd,eng Premier League,23,1995,29.2,15,12,1,4,10,1,16,6.3,15,18,1,17,5,20,17,0,Matches
1558,Aarón Martín,es ESP,DF,Mainz 05,de Bundesliga,22,1997,19.9,29,15,17,8,4,9,22,40.9,13,11,5,6,30,59,36,0,Matches
1559,Daniel Martín,es ESP,GK,Betis,es La Liga,21,1998,5.9,0,0,0,0,0,0,0,,0,0,0,0,0,0,3,0,Matches
1560,David Martin,eng ENG,GK,West Ham,eng Premier League,33,1986,4.8,0,0,0,0,0,0,0,,0,0,0,0,0,0,1,1,Matches
1561,Jonas Martin,fr FRA,MF,Rennes,fr Ligue 1,29,1990,1.3,6,2,4,0,2,1,1,100.0,0,2,2,0,0,6,0,0,Matches
1562,Jonas Martin,fr FRA,MF,Strasbourg,fr Ligue 1,29,1990,2.7,5,3,4,0,1,1,3,33.3,2,3,0,3,1,6,3,0,Matches
1563,Josh Martin,eng ENG,"FW,MF",Norwich City,eng Premier League,17,2001,0.4,1,0,0,0,1,0,0,,0,1,0,1,1,2,0,0,Matches
1564,Gabriel Martinelli,br BRA,FW,Arsenal,eng Premier League,18,2001,7.4,20,15,10,6,4,7,20,35.0,13,15,1,14,3,23,8,0,Matches
1565,Álex Martínez,es ESP,DF,Granada,es La Liga,28,1990,0.2,0,0,0,0,0,0,0,,0,0,0,0,0,0,0,0,Matches
1566,Emiliano Martínez,ar ARG,GK,Arsenal,eng Premier League,26,1992,8.6,0,0,0,0,0,0,0,,0,0,0,0,0,0,1,0,Matches
1567,Iñigo Martínez,es ESP,DF,Athletic Club,es La Liga,28,1991,33.0,48,30,33,13,2,27,47,57.4,20,28,13,15,39,87,140,0,Matches
1568,Javi Martínez,es ESP,MF,Osasuna,es La Liga,19,1999,0.1,0,0,0,0,0,0,0,,0,0,0,0,0,0,1,0,Matches
1569,Javi Martínez,es ESP,"DF,MF",Bayern Munich,de Bundesliga,30,1988,7.5,16,12,9,7,0,9,11,81.8,2,9,8,1,18,34,30,0,Matches
1570,José Martínez,es ESP,DF,Granada,es La Liga,26,1993,13.2,21,16,12,8,1,14,25,56.0,11,6,4,2,18,39,46,0,Matches
1571,Lautaro Martínez,ar ARG,FW,Inter,it Serie A,21,1997,27.2,22,7,2,8,12,4,34,11.8,30,30,2,28,15,37,11,0,Matches
1572,Pablo Martínez,es ESP,MF,Levante,es La Liga,21,1998,0.4,2,0,1,1,0,0,1,0.0,1,0,0,0,0,2,2,0,Matches
1573,Pablo Martinez,fr FRA,DF,Nîmes,fr Ligue 1,30,1989,26.0,42,21,26,15,1,21,40,52.5,19,34,22,12,58,100,97,0,Matches
1574,Gelson Martins,pt POR,"DF,FW",Monaco,fr Ligue 1,24,1995,18.6,30,22,11,15,4,17,42,40.5,25,9,2,7,19,49,10,1,Matches
1575,Adam Marušić,me MNE,DF,Lazio,it Serie A,26,1992,10.5,11,6,7,4,0,4,11,36.4,7,14,2,12,14,25,16,0,Matches
1576,Omar Mascarell,gq EQG,MF,Schalke 04,de Bundesliga,26,1993,22.5,42,23,17,22,3,21,57,36.8,36,46,14,32,62,104,40,0,Matches
1577,Andrea Masiello,it ITA,DF,Genoa,it Serie A,33,1986,14.7,26,15,17,8,1,16,32,50.0,16,8,2,6,26,52,55,2,Matches
1578,Andrea Masiello,it ITA,DF,Atalanta,it Serie A,33,1986,6.0,11,4,6,4,1,7,14,50.0,7,6,4,2,10,21,13,0,Matches
1579,Adam Masina,ma MAR,DF,Watford,eng Premier League,25,1994,20.2,38,22,24,11,3,14,37,37.8,23,26,12,14,28,66,66,0,Matches
1580,Jordi Masip,es ESP,GK,Valladolid,es La Liga,30,1989,35.0,1,1,1,0,0,0,2,0.0,2,0,0,0,1,2,7,3,Matches
1581,Arthur Masuaku,cd COD,DF,West Ham,eng Premier League,25,1993,10.4,41,23,24,13,4,23,39,59.0,16,19,5,14,14,55,23,0,Matches
1582,Jaime Mata,es ESP,FW,Getafe,es La Liga,30,1988,30.5,21,13,3,11,7,3,20,15.0,17,16,1,15,7,28,15,0,Matches
1583,Juan Mata,es ESP,"MF,FW",Manchester Utd,eng Premier League,31,1988,8.4,7,3,1,5,1,2,7,28.6,5,5,1,4,0,7,2,0,Matches
1584,Aleš Matějů,cz CZE,DF,Brescia,it Serie A,23,1996,28.3,48,27,33,9,6,23,45,51.1,22,41,24,17,37,85,109,3,Matches
1585,Jean-Philippe Mateta,fr FRA,FW,Mainz 05,de Bundesliga,22,1997,11.7,2,2,0,2,0,0,6,0.0,6,3,2,1,1,3,11,0,Matches
1586,Nemanja Matić,rs SRB,MF,Manchester Utd,eng Premier League,30,1988,17.6,46,24,23,19,4,20,43,46.5,23,21,8,13,22,68,28,1,Matches
1587,Joël Matip,cm CMR,DF,Liverpool,eng Premier League,27,1991,7.8,13,9,4,7,2,4,11,36.4,7,8,4,4,12,25,38,0,Matches
1588,Rabbi Matondo,wls WAL,"FW,MF",Schalke 04,de Bundesliga,18,2000,12.9,10,3,3,2,5,3,13,23.1,10,4,0,4,5,15,1,0,Matches
1589,Alessandro Matri,it ITA,"FW,MF",Brescia,it Serie A,34,1984,1.0,1,0,0,0,1,0,0,,0,1,0,1,0,1,1,0,Matches
1590,Federico Mattiello,it ITA,DF,Cagliari,it Serie A,24,1995,10.3,30,21,19,7,4,11,27,40.7,16,20,7,13,18,48,22,0,Matches
1591,Blaise Matuidi,fr FRA,MF,Juventus,it Serie A,32,1987,24.9,48,27,13,27,8,13,34,38.2,21,35,6,29,22,70,16,0,Matches
1592,Neal Maupay,fr FRA,FW,Brighton,eng Premier League,22,1996,30.7,20,12,1,13,6,9,29,31.0,20,24,0,24,4,24,10,0,Matches
1593,Stephy Mavididi,eng ENG,"FW,MF",Dijon,fr Ligue 1,21,1998,15.5,18,11,7,8,3,10,26,38.5,16,11,0,11,7,25,5,0,Matches
1594,Philipp Max,de GER,DF,Augsburg,de Bundesliga,25,1993,30.1,42,29,22,16,4,20,45,44.4,25,19,4,15,26,68,50,0,Matches
1595,Alexandru Maxim,ro ROU,"MF,DF",Mainz 05,de Bundesliga,29,1990,1.3,4,2,1,2,1,1,3,33.3,2,0,0,0,1,5,1,0,Matches
1596,Eric Maxim Choupo-Moting,cm CMR,"FW,MF",Paris S-G,fr Ligue 1,30,1989,5.0,12,9,3,4,5,4,8,50.0,4,3,0,3,1,13,3,0,Matches
1597,Kévin Mayi,ga GAB,"FW,MF",Brest,fr Ligue 1,26,1993,0.0,0,0,0,0,0,0,0,,0,0,0,0,0,0,0,0,Matches
1598,Borja Mayoral,es ESP,FW,Levante,es La Liga,22,1997,23.8,12,3,4,6,2,2,13,15.4,11,11,0,11,4,16,6,0,Matches
1599,Luca Mazzitelli,it ITA,MF,Sassuolo,it Serie A,23,1995,0.1,1,1,0,1,0,1,1,100.0,0,0,0,0,0,1,0,0,Matches
1600,Kevin Mbabu,ch SUI,DF,Wolfsburg,de Bundesliga,24,1995,18.8,69,48,39,24,6,35,54,64.8,19,33,10,23,23,92,53,0,Matches
1601,Kylian Mbappé,fr FRA,FW,Paris S-G,fr Ligue 1,20,1998,16.8,7,2,1,5,1,3,10,30.0,7,4,0,4,3,10,0,0,Matches
1602,Ibrahima Mbaye,sn SEN,DF,Bologna,it Serie A,24,1994,16.7,19,10,13,4,2,7,17,41.2,10,22,11,11,15,34,42,0,Matches
1603,Loïc Mbe Soh,fr FRA,DF,Paris S-G,fr Ligue 1,18,2001,0.6,2,2,2,0,0,2,2,100.0,0,0,0,0,1,3,0,0,Matches
1604,Isaac Mbenza,be BEL,FW,Amiens,fr Ligue 1,23,1996,0.9,0,0,0,0,0,0,1,0.0,1,0,0,0,0,0,0,0,Matches
1605,Nathanael Mbuku,fr FRA,"FW,MF",Reims,fr Ligue 1,17,2002,4.4,4,2,2,2,0,0,3,0.0,3,0,0,0,2,6,1,0,Matches
1606,James McArthur,sct SCO,MF,Crystal Palace,eng Premier League,31,1987,34.3,88,51,43,34,11,37,106,34.9,69,69,19,50,60,148,56,0,Matches
1607,Oliver McBurnie,sct SCO,FW,Sheffield Utd,eng Premier League,23,1996,23.5,37,22,6,27,4,11,40,27.5,29,25,3,22,15,52,43,0,Matches
1608,Alex McCarthy,eng ENG,GK,Southampton,eng Premier League,29,1989,28.0,1,1,1,0,0,1,1,100.0,0,1,0,1,0,1,11,3,Matches
1609,James McCarthy,ie IRL,MF,Crystal Palace,eng Premier League,28,1990,18.7,82,47,36,36,10,40,76,52.6,36,24,5,19,24,106,11,0,Matches
1610,John McGinn,sct SCO,MF,Aston Villa,eng Premier League,24,1994,25.7,53,35,19,23,11,18,62,29.0,44,25,1,24,25,78,18,0,Matches
1611,David McGoldrick,ie IRL,FW,Sheffield Utd,eng Premier League,31,1987,20.2,41,26,9,24,8,5,20,25.0,15,14,2,12,3,44,23,0,Matches
1612,Michael McGovern,nir NIR,GK,Norwich City,eng Premier League,35,1984,1.8,0,0,0,0,0,0,0,,0,0,0,0,0,0,1,1,Matches
1613,Weston McKennie,us USA,"MF,DF",Schalke 04,de Bundesliga,20,1998,23.0,38,20,17,16,5,13,40,32.5,27,38,12,26,46,84,39,0,Matches
1614,Kenny McLean,sct SCO,MF,Norwich City,eng Premier League,27,1992,33.0,44,29,20,18,6,14,42,33.3,28,32,7,25,38,82,67,2,Matches
1615,Dwight McNeil,eng ENG,MF,Burnley,eng Premier League,19,1999,37.1,47,33,18,22,7,23,71,32.4,48,60,8,52,30,77,34,0,Matches
1616,Scott McTominay,sct SCO,MF,Manchester Utd,eng Premier League,22,1996,19.7,43,22,14,25,4,17,32,53.1,15,25,5,20,31,74,34,2,Matches
1617,Biagio Meccariello,it ITA,DF,Lecce,it Serie A,28,1991,8.5,23,13,15,6,2,12,29,41.4,17,14,2,12,10,33,25,0,Matches
1618,Gary Medel,cl CHI,MF,Bologna,it Serie A,31,1987,19.8,43,22,15,24,4,16,43,37.2,27,24,8,16,34,77,31,2,Matches
1619,Ben Mee,eng ENG,DF,Burnley,eng Premier League,29,1989,32.0,41,22,25,16,0,17,29,58.6,12,42,31,11,42,83,165,2,Matches
1620,Joshua Mees,de GER,"MF,FW",Union Berlin,de Bundesliga,23,1996,3.6,8,5,3,4,1,4,12,33.3,8,3,0,3,2,10,4,0,Matches
1621,Admir Mehmedi,ch SUI,"MF,FW",Wolfsburg,de Bundesliga,28,1991,13.3,14,6,2,9,3,4,15,26.7,11,10,0,10,5,19,4,0,Matches
1622,Soualiho Meïté,fr FRA,MF,Torino,it Serie A,25,1994,24.5,32,18,14,13,5,12,35,34.3,23,31,6,25,24,56,36,0,Matches
1623,Farid El Melali,dz ALG,"MF,FW",Angers,fr Ligue 1,22,1997,3.4,7,5,2,2,3,4,14,28.6,10,5,0,5,2,9,4,0,Matches
1624,Óscar Melendo,es ESP,"MF,FW",Espanyol,es La Liga,21,1997,12.4,10,4,4,4,2,4,12,33.3,8,7,2,5,2,12,3,0,Matches
1625,Gonzalo Melero,es ESP,MF,Levante,es La Liga,25,1994,13.7,20,13,9,9,2,7,27,25.9,20,12,3,9,9,29,15,1,Matches
1626,Arthur Melo,br BRA,MF,Barcelona,es La Liga,22,1996,13.1,15,10,4,7,4,4,12,33.3,8,9,0,9,4,19,5,2,Matches
1627,Memphis,nl NED,"FW,MF",Lyon,fr Ligue 1,25,1994,11.3,4,3,2,0,2,0,5,0.0,5,0,0,0,2,6,2,0,Matches
1628,Pedro Mendes,pt POR,DF,Montpellier,fr Ligue 1,28,1990,15.3,28,17,15,13,0,15,24,62.5,9,19,12,7,28,56,42,1,Matches
1629,Thiago Mendes,br BRA,MF,Lyon,fr Ligue 1,27,1992,20.1,43,29,20,19,4,21,45,46.7,24,21,7,14,46,89,36,0,Matches
1630,Brais Méndez,es ESP,"MF,FW",Celta Vigo,es La Liga,22,1997,16.4,26,11,14,9,3,12,39,30.8,27,20,0,20,12,38,23,1,Matches
1631,Édgar Méndez,es ESP,"MF,FW",Alavés,es La Liga,29,1990,9.6,11,7,4,6,1,5,13,38.5,8,10,2,8,5,16,7,0,Matches
1632,Stiven Mendoza,co COL,"FW,MF",Amiens,fr Ligue 1,27,1992,12.2,12,7,4,5,3,4,22,18.2,18,13,2,11,9,21,3,1,Matches
1633,Alexandre Mendy,gw GNB,FW,Brest,fr Ligue 1,25,1994,10.0,5,1,1,0,4,1,4,25.0,3,4,1,3,0,5,10,0,Matches
1634,Benjamin Mendy,fr FRA,DF,Manchester City,eng Premier League,25,1994,16.6,18,15,7,7,4,9,27,33.3,18,10,2,8,16,34,21,3,Matches
1635,Edouard Mendy,sn SEN,GK,Rennes,fr Ligue 1,27,1992,24.0,0,0,0,0,0,0,0,,0,0,0,0,0,0,5,1,Matches
1636,Ferland Mendy,fr FRA,DF,Real Madrid,es La Liga,24,1995,20.1,32,26,20,9,3,14,18,77.8,4,19,5,14,22,54,30,1,Matches
1637,Nampalys Mendy,sn SEN,MF,Leicester City,eng Premier League,27,1992,3.2,7,5,4,1,2,4,5,80.0,1,4,1,3,6,13,6,0,Matches
1638,Hamza Mendyl,ma MAR,DF,Dijon,fr Ligue 1,21,1997,16.0,49,32,31,14,4,29,46,63.0,17,16,4,12,23,72,47,0,Matches
1639,Chris Mepham,wls WAL,DF,Bournemouth,eng Premier League,21,1997,10.1,20,9,13,7,0,11,14,78.6,3,17,11,6,17,37,62,1,Matches
1640,Levent Mercan,de GER,"MF,FW",Schalke 04,de Bundesliga,18,2000,0.8,0,0,0,0,0,0,0,,0,0,0,0,0,0,2,1,Matches
1641,Jorge Meré,es ESP,DF,Köln,de Bundesliga,22,1997,6.9,6,5,2,4,0,1,2,50.0,1,13,11,2,14,20,30,0,Matches
1642,Alex Meret,it ITA,GK,Napoli,it Serie A,22,1997,21.7,0,0,0,0,0,0,2,0.0,2,1,0,1,1,1,7,2,Matches
1643,Fran Mérida,es ESP,MF,Osasuna,es La Liga,29,1990,12.9,27,15,11,10,6,9,27,33.3,18,15,4,11,25,52,10,0,Matches
1644,Mikel Merino,es ESP,MF,Real Sociedad,es La Liga,23,1996,34.9,79,52,20,44,15,28,86,32.6,58,46,8,38,51,130,52,0,Matches
1645,Sabin Merino,es ESP,FW,Leganés,es La Liga,27,1992,0.9,0,0,0,0,0,0,0,,0,0,0,0,0,0,0,0,Matches
1646,Yıldırım Mert Çetin,tr TUR,DF,Roma,it Serie A,22,1997,2.9,5,1,4,1,0,3,5,60.0,2,4,3,1,4,9,8,1,Matches
1647,Dries Mertens,be BEL,FW,Napoli,it Serie A,32,1987,18.8,13,9,1,8,4,2,27,7.4,25,10,1,9,7,20,4,0,Matches
1648,Roque Mesa,es ESP,MF,Leganés,es La Liga,30,1989,22.4,40,21,17,18,5,13,44,29.5,31,13,4,9,11,51,8,0,Matches
1649,Lionel Messi,ar ARG,FW,Barcelona,es La Liga,32,1987,32.0,21,10,4,7,10,3,21,14.3,18,9,0,9,7,28,1,0,Matches
1650,Thomas Meunier,be BEL,DF,Paris S-G,fr Ligue 1,27,1991,13.8,27,21,9,12,6,16,26,61.5,10,17,5,12,18,45,19,1,Matches
1651,Mexer,mz MOZ,DF,Bordeaux,fr Ligue 1,30,1988,16.5,16,11,14,1,1,10,30,33.3,20,14,13,1,15,31,47,0,Matches
1652,Max Meyer,de GER,"MF,FW",Crystal Palace,eng Premier League,23,1995,7.3,19,11,10,9,0,8,18,44.4,10,6,1,5,7,26,4,0,Matches
1653,Kingsley Michael,ng NGA,MF,Bologna,it Serie A,19,1999,0.8,2,1,0,2,0,0,0,,0,0,0,0,1,3,1,0,Matches
1654,Míchel,es ESP,MF,Valladolid,es La Liga,31,1988,24.2,50,28,26,19,5,22,75,29.3,53,22,4,18,33,83,41,1,Matches
1655,Sven Michel,de GER,FW,Paderborn 07,de Bundesliga,29,1990,15.3,14,12,3,5,6,3,20,15.0,17,13,2,11,7,21,7,0,Matches
1656,Miguel,es ESP,FW,Valladolid,es La Liga,19,1999,2.6,2,1,1,0,1,1,2,50.0,1,3,1,2,0,2,1,0,Matches
1657,Florian Miguel,fr FRA,DF,Nîmes,fr Ligue 1,22,1996,22.8,51,25,27,20,4,31,52,59.6,21,19,4,15,33,84,32,0,Matches
1658,Georges Mikautadze,ge GEO,FW,Metz,fr Ligue 1,18,2000,0.1,1,0,0,0,1,0,0,,0,0,0,0,0,1,0,0,Matches
1659,Nikola Milenković,rs SRB,DF,Fiorentina,it Serie A,21,1997,36.2,46,25,30,16,0,11,31,35.5,20,39,21,18,29,75,129,1,Matches
1660,Arkadiusz Milik,pl POL,FW,Napoli,it Serie A,25,1994,19.4,12,5,4,1,7,3,11,27.3,8,11,1,10,2,14,12,0,Matches
1661,Sergej Milinković-Savić,rs SRB,MF,Lazio,it Serie A,24,1995,33.7,60,35,25,24,11,15,79,19.0,64,67,16,51,37,97,60,1,Matches
1662,Éder Militão,br BRA,DF,Real Madrid,es La Liga,21,1998,11.4,25,15,15,9,1,10,17,58.8,7,12,6,6,20,45,42,0,Matches
1663,Luka Milivojević,rs SRB,MF,Crystal Palace,eng Premier League,28,1991,27.9,61,32,32,25,4,35,84,41.7,49,30,7,23,42,103,39,4,Matches
1664,Vincenzo Millico,it ITA,"MF,FW",Torino,it Serie A,18,2000,2.4,1,0,1,0,0,1,3,33.3,2,2,0,2,0,1,1,0,Matches
1665,James Milner,eng ENG,"MF,DF",Liverpool,eng Premier League,33,1986,10.4,16,10,3,10,3,6,26,23.1,20,12,3,9,7,23,17,1,Matches
1666,Santi Mina,es ESP,"FW,MF",Celta Vigo,es La Liga,23,1995,21.6,13,8,8,5,0,5,38,13.2,33,19,2,17,10,23,27,0,Matches
1667,Yerry Mina,co COL,DF,Everton,eng Premier League,24,1994,25.4,39,22,25,12,2,18,24,75.0,6,20,14,6,28,67,102,1,Matches
1668,Takumi Minamino,jp JPN,"FW,MF",Liverpool,eng Premier League,24,1995,2.8,3,3,0,2,1,2,10,20.0,8,3,0,3,0,3,3,0,Matches
1669,Tyrone Mings,eng ENG,DF,Aston Villa,eng Premier League,26,1993,32.2,15,11,11,3,1,10,13,76.9,3,56,48,8,30,45,190,4,Matches
1670,Jorge Miramón,es ESP,DF,Levante,es La Liga,30,1989,27.0,52,27,35,13,4,26,45,57.8,19,30,8,22,46,98,61,1,Matches
1671,Juan Miranda,es ESP,DF,Schalke 04,de Bundesliga,19,2000,8.7,14,10,8,6,0,6,18,33.3,12,12,4,8,10,24,27,1,Matches
1672,Antonio Mirante,it ITA,GK,Roma,it Serie A,36,1983,5.0,0,0,0,0,0,0,1,0.0,1,0,0,0,0,0,2,1,Matches
1673,Simone Missiroli,it ITA,MF,SPAL,it Serie A,33,1986,31.1,42,27,18,20,4,13,43,30.2,30,42,27,15,54,96,62,1,Matches
1674,Tyrick Mitchell,eng ENG,DF,Crystal Palace,eng Premier League,19,1999,2.2,5,2,2,2,1,1,7,14.3,6,2,0,2,2,7,3,0,Matches
1675,Stefan Mitrović,rs SRB,DF,Strasbourg,fr Ligue 1,29,1990,22.8,15,9,10,5,0,6,14,42.9,8,14,9,5,23,38,90,3,Matches
1676,Maximilian Mittelstädt,de GER,"DF,FW",Hertha BSC,de Bundesliga,22,1997,21.0,61,38,31,25,5,26,54,48.1,28,38,6,32,53,114,64,0,Matches
1677,Henrikh Mkhitaryan,am ARM,FW,Arsenal,eng Premier League,30,1989,1.2,0,0,0,0,0,0,2,0.0,2,3,0,3,0,0,1,0,Matches
1678,Henrikh Mkhitaryan,am ARM,"MF,FW",Roma,it Serie A,30,1989,17.0,32,22,10,17,5,19,45,42.2,26,27,3,24,11,43,6,0,Matches
1679,Anthony Modeste,fr FRA,FW,Köln,de Bundesliga,31,1988,12.6,10,5,1,5,4,1,10,10.0,9,5,3,2,0,10,19,0,Matches
1680,Luka Modrić,hr CRO,MF,Real Madrid,es La Liga,33,1985,22.2,37,18,9,15,13,16,41,39.0,25,10,2,8,22,59,12,0,Matches
1681,Kevin Möhwald,de GER,MF,Werder Bremen,de Bundesliga,26,1993,0.8,2,1,1,1,0,1,2,50.0,1,0,0,0,0,2,1,0,Matches
1682,Niklas Moisander,fi FIN,DF,Werder Bremen,de Bundesliga,33,1985,22.0,27,15,19,6,2,11,26,42.3,15,37,19,18,49,76,85,0,Matches
1683,Jorge Molina,es ESP,FW,Getafe,es La Liga,37,1982,21.0,8,2,0,4,4,0,12,0.0,12,13,2,11,4,12,18,0,Matches
1684,Florent Mollet,fr FRA,"MF,FW",Montpellier,fr Ligue 1,27,1991,18.7,13,11,3,8,2,7,28,25.0,21,9,1,8,9,22,2,0,Matches
1685,Jon Moncayola,es ESP,"MF,DF",Osasuna,es La Liga,21,1998,16.6,52,30,26,22,4,27,54,50.0,27,29,5,24,16,68,23,1,Matches
1686,Gabriele Moncini,it ITA,"FW,MF",SPAL,it Serie A,23,1996,1.7,1,0,0,1,0,0,0,,0,2,1,1,1,2,0,0,Matches
1687,Thomas Monconduit,fr FRA,MF,Amiens,fr Ligue 1,28,1991,15.2,26,12,6,18,2,9,26,34.6,17,11,4,7,10,36,25,3,Matches
1688,Nacho Monreal,es ESP,DF,Arsenal,eng Premier League,33,1986,3.0,1,1,1,0,0,1,3,33.3,2,3,1,2,3,4,10,0,Matches
1689,Nacho Monreal,es ESP,DF,Real Sociedad,es La Liga,33,1986,26.6,38,16,26,9,3,22,42,52.4,20,20,4,16,43,81,66,0,Matches
1690,Joan Monterde,es ESP,MF,Levante,es La Liga,21,1997,0.1,0,0,0,0,0,0,0,,0,0,0,0,0,0,0,0,Matches
1691,Ilario Monterisi,it ITA,DF,Lecce,it Serie A,17,2001,0.0,0,0,0,0,0,0,0,,0,0,0,0,0,0,0,0,Matches
1692,Ángel Montoro,es ESP,MF,Granada,es La Liga,31,1988,10.8,19,8,8,9,2,3,13,23.1,10,10,1,9,13,32,15,0,Matches
1693,Martín Montoya,es ESP,"DF,MF",Brighton,eng Premier League,28,1991,21.1,57,29,31,20,6,30,56,53.6,26,19,5,14,24,81,40,0,Matches
1694,Simon Moore,eng ENG,GK,Sheffield Utd,eng Premier League,29,1990,2.0,1,0,1,0,0,1,1,100.0,0,0,0,0,0,1,0,1,Matches
1695,Aaron Mooy,au AUS,"MF,FW",Brighton,eng Premier League,28,1990,23.2,37,24,9,18,10,6,40,15.0,34,36,7,29,23,60,32,1,Matches
1696,Wesley Moraes,br BRA,FW,Aston Villa,eng Premier League,22,1996,19.8,15,8,3,8,4,0,5,0.0,5,10,2,8,4,19,23,0,Matches
1697,Alfredo Morales,us USA,MF,Düsseldorf,de Bundesliga,29,1990,19.2,31,15,11,16,4,11,35,31.4,24,17,6,11,18,49,37,0,Matches
1698,Álvaro Morata,es ESP,FW,Atlético Madrid,es La Liga,26,1992,23.3,17,8,4,9,4,1,13,7.7,12,12,2,10,5,22,23,0,Matches
1699,Jan Morávek,cz CZE,MF,Augsburg,de Bundesliga,29,1989,5.3,23,12,9,14,0,11,24,45.8,13,4,1,3,8,31,11,0,Matches
1700,Steven Moreira,cv CPV,DF,Toulouse,fr Ligue 1,24,1994,15.4,37,25,21,15,1,19,31,61.3,12,16,3,13,16,53,29,0,Matches
1701,Jérémy Morel,mg MAD,DF,Rennes,fr Ligue 1,35,1984,20.1,15,9,13,1,1,9,20,45.0,11,21,17,4,17,32,59,1,Matches
1702,Alberto Moreno,es ESP,DF,Villarreal,es La Liga,27,1992,16.3,27,16,15,11,1,9,25,36.0,16,15,3,12,25,52,36,0,Matches
1703,Álex Moreno,es ESP,DF,Betis,es La Liga,26,1993,25.2,37,20,27,8,2,12,32,37.5,20,21,8,13,23,60,47,1,Matches
1704,Gerard Moreno,es ESP,"FW,MF",Villarreal,es La Liga,27,1992,30.5,19,8,4,10,5,5,46,10.9,41,19,3,16,10,29,51,0,Matches
1705,Mateu Morey,es ESP,"DF,MF",Dortmund,de Bundesliga,19,2000,2.2,7,3,2,4,1,4,10,40.0,6,4,0,4,5,12,3,0,Matches
1706,Wes Morgan,jm JAM,DF,Leicester City,eng Premier League,35,1984,4.8,4,1,3,1,0,0,3,0.0,3,5,3,2,7,11,19,0,Matches
1707,Manu Morlanes,es ESP,MF,Villarreal,es La Liga,20,1999,2.8,7,3,3,4,0,2,9,22.2,7,1,1,0,2,9,2,0,Matches
1708,Raúl Moro,es ESP,FW,Lazio,it Serie A,16,2002,0.0,0,0,0,0,0,0,0,,0,0,0,0,0,0,0,0,Matches
1709,Loren Morón,es ESP,FW,Betis,es La Liga,25,1993,22.6,18,12,6,7,5,9,23,39.1,14,25,6,19,9,27,13,0,Matches
1710,Leonardo Morosini,it ITA,"FW,DF",Brescia,it Serie A,23,1995,0.3,1,1,1,0,0,0,0,,0,1,0,1,1,2,1,0,Matches
1711,Ravel Morrison,jm JAM,MF,Sheffield Utd,eng Premier League,26,1993,0.1,0,0,0,0,0,0,0,,0,0,0,0,0,0,0,0,Matches
1712,Victor Moses,ng NGA,DF,Inter,it Serie A,28,1990,4.7,4,3,1,2,1,2,8,25.0,6,4,0,4,0,4,4,0,Matches
1713,Lebo Mothiba,za RSA,FW,Strasbourg,fr Ligue 1,23,1996,11.6,4,3,1,1,2,1,6,16.7,5,5,0,5,3,7,1,0,Matches
1714,Harold Moukoudi,cm CMR,DF,Saint-Étienne,fr Ligue 1,21,1997,11.0,28,19,20,7,1,11,14,78.6,3,16,10,6,16,44,42,2,Matches
1715,Jessy Moulin,fr FRA,GK,Saint-Étienne,fr Ligue 1,33,1986,5.0,0,0,0,0,0,0,0,,0,0,0,0,1,1,2,0,Matches
1716,Mason Mount,eng ENG,"MF,FW",Chelsea,eng Premier League,20,1999,31.9,37,17,8,19,10,9,42,21.4,33,25,3,22,16,53,18,0,Matches
1717,Lucas Moura,br BRA,"FW,MF",Tottenham,eng Premier League,26,1992,24.9,57,33,25,22,10,16,58,27.6,42,29,2,27,15,72,27,0,Matches
1718,Lys Mousset,fr FRA,FW,Sheffield Utd,eng Premier League,23,1996,13.8,9,5,0,5,4,3,7,42.9,4,3,0,3,4,13,2,0,Matches
1719,Wesley Moustache,fr FRA,DF,Nantes,fr Ligue 1,20,1999,0.5,0,0,0,0,0,0,0,,0,1,0,1,0,0,2,0,Matches
1720,João Moutinho,pt POR,MF,Wolves,eng Premier League,32,1986,34.5,93,50,43,41,9,46,139,33.1,93,43,13,30,50,143,18,1,Matches
1721,Samuel Moutoussamy,cd COD,"DF,MF",Nantes,fr Ligue 1,22,1996,5.8,4,1,2,1,1,2,7,28.6,5,2,0,2,4,8,7,0,Matches
1722,Toni Moya,es ESP,MF,Atlético Madrid,es La Liga,21,1998,0.0,0,0,0,0,0,0,0,,0,0,0,0,0,0,0,0,Matches
1723,Javi Moyano,es ESP,DF,Valladolid,es La Liga,33,1986,24.7,19,8,11,8,0,8,20,40.0,12,18,5,13,27,46,63,0,Matches
1724,Nordi Mukiele,fr FRA,"DF,FW",RB Leipzig,de Bundesliga,21,1997,19.8,61,39,39,12,10,25,38,65.8,13,26,4,22,47,108,57,0,Matches
1725,Mert Müldür,tr TUR,DF,Sassuolo,it Serie A,20,1999,14.1,47,27,33,8,6,27,42,64.3,15,10,0,10,22,69,42,0,Matches
1726,Florian Müller,de GER,GK,Mainz 05,de Bundesliga,21,1997,12.5,0,0,0,0,0,0,0,,0,0,0,0,2,2,3,1,Matches
1727,Thomas Müller,de GER,"MF,FW",Bayern Munich,de Bundesliga,29,1989,25.1,45,27,7,26,12,22,69,31.9,47,27,3,24,12,57,8,0,Matches
1728,Marshall Munetsi,zw ZIM,MF,Reims,fr Ligue 1,23,1996,9.3,27,19,12,12,3,6,12,50.0,6,13,7,6,12,39,20,1,Matches
1729,Iker Muniain,es ESP,"FW,MF",Athletic Club,es La Liga,26,1992,26.5,26,19,11,10,5,4,24,16.7,20,9,0,9,12,38,7,0,Matches
1730,Aihen Muñoz,es ESP,DF,Real Sociedad,es La Liga,21,1997,10.9,28,18,13,12,3,18,27,66.7,9,13,2,11,2,30,19,0,Matches
1731,Javier Muñoz,es ESP,"FW,MF",Alavés,es La Liga,24,1995,0.6,0,0,0,0,0,0,0,,0,1,1,0,0,0,0,0,Matches
1732,Simone Muratore,it ITA,MF,Juventus,it Serie A,21,1998,1.8,2,0,0,1,1,1,3,33.3,2,1,0,1,3,5,0,0,Matches
1733,Alessandro Murgia,it ITA,MF,SPAL,it Serie A,22,1996,19.4,27,17,16,8,3,14,34,41.2,20,10,3,7,18,45,15,0,Matches
1734,Luis Muriel,co COL,FW,Atalanta,it Serie A,28,1991,14.0,15,9,3,8,4,3,14,21.4,11,12,0,12,4,19,0,0,Matches
1735,Jeison Murillo,co COL,DF,Sampdoria,it Serie A,27,1992,7.4,18,6,14,4,0,10,19,52.6,9,8,4,4,10,28,28,0,Matches
1736,Jeison Murillo,co COL,DF,Celta Vigo,es La Liga,27,1992,17.0,37,20,30,6,1,18,27,66.7,9,13,9,4,20,57,74,2,Matches
1737,Glenn Murray,eng ENG,FW,Brighton,eng Premier League,35,1983,8.9,5,2,0,3,2,2,9,22.2,7,6,2,4,1,6,12,0,Matches
1738,Nicola Murru,it ITA,DF,Sampdoria,it Serie A,24,1994,25.1,40,22,24,8,8,21,41,51.2,20,22,4,18,27,67,58,0,Matches
1739,Mateo Musacchio,ar ARG,DF,Milan,it Serie A,28,1990,16.3,15,8,11,4,0,7,20,35.0,13,10,7,3,22,37,50,0,Matches
1740,Torben Müsel,de GER,FW,Gladbach,de Bundesliga,20,1999,0.0,0,0,0,0,0,0,0,,0,0,0,0,1,1,0,0,Matches
1741,Jamal Musiala,de GER,MF,Bayern Munich,de Bundesliga,16,2003,0.0,0,0,0,0,0,0,0,,0,0,0,0,0,0,0,0,Matches
1742,Juan Musso,ar ARG,GK,Udinese,it Serie A,25,1994,38.0,0,0,0,0,0,0,1,0.0,1,0,0,0,1,1,18,2,Matches
1743,Shkodran Mustafi,de GER,DF,Arsenal,eng Premier League,27,1992,13.4,17,10,11,5,1,6,12,50.0,6,10,6,4,18,35,72,0,Matches
1744,Yoshinori Mutō,jp JPN,"MF,FW",Newcastle Utd,eng Premier League,27,1992,2.4,3,2,1,2,0,1,2,50.0,1,0,0,0,0,3,0,0,Matches
1745,Yvon Mvogo,ch SUI,GK,RB Leipzig,de Bundesliga,25,1994,2.0,0,0,0,0,0,0,0,,0,0,0,0,0,0,0,1,Matches
1746,Phillipp Mwene,at AUT,DF,Mainz 05,de Bundesliga,25,1994,3.5,11,5,9,2,0,7,12,58.3,5,10,1,9,3,14,11,0,Matches
1747,Obite N'Dicka,ci CIV,DF,Eint Frankfurt,de Bundesliga,19,1999,19.1,27,13,13,11,3,15,28,53.6,13,28,6,22,29,56,57,0,Matches
1748,Kévin N'Doram,fr FRA,MF,Metz,fr Ligue 1,23,1996,18.3,43,28,19,21,3,17,40,42.5,23,20,8,12,26,69,23,0,Matches
1749,Abdallah N'dour,sn SEN,DF,Strasbourg,fr Ligue 1,25,1993,4.1,5,4,2,3,0,5,10,50.0,5,4,1,3,4,9,5,1,Matches
1750,Ferris N'Goma,fr FRA,"MF,FW",Brest,fr Ligue 1,26,1993,0.3,0,0,0,0,0,0,0,,0,1,0,1,0,0,0,0,Matches
1751,Nathan N'Goumou,fr FRA,FW,Toulouse,fr Ligue 1,19,2000,0.1,0,0,0,0,0,0,0,,0,0,0,0,0,0,1,0,Matches
1752,Georges-Kévin N'Koudou,cm CMR,FW,Tottenham,eng Premier League,24,1995,0.0,0,0,0,0,0,0,1,0.0,1,0,0,0,0,0,0,0,Matches
1753,Stanley N'Soki,fr FRA,DF,Nice,fr Ligue 1,20,1999,14.1,40,29,24,16,0,23,42,54.8,19,14,6,8,32,72,37,0,Matches
1754,Nacho,es ESP,DF,Valladolid,es La Liga,30,1989,21.0,43,22,24,15,4,17,48,35.4,31,36,8,28,25,68,61,0,Matches
1755,Nacho,es ESP,DF,Real Madrid,es La Liga,29,1990,4.9,11,6,6,3,2,6,10,60.0,4,5,3,2,12,23,18,1,Matches
1756,Radja Nainggolan,be BEL,MF,Cagliari,it Serie A,31,1988,23.0,30,18,9,12,9,9,29,31.0,20,25,6,19,13,43,30,0,Matches
1757,Marvelous Nakamba,zw ZIM,MF,Aston Villa,eng Premier League,25,1994,20.4,55,28,28,20,7,24,67,35.8,43,50,11,39,39,94,38,3,Matches
1758,Naldo,br BRA,DF,Espanyol,es La Liga,30,1988,14.8,24,13,15,9,0,7,15,46.7,8,11,7,4,21,45,50,1,Matches
1759,Nahitan Nández,uy URU,"MF,DF",Cagliari,it Serie A,23,1995,32.2,58,38,37,17,4,25,69,36.2,44,30,1,29,25,83,26,0,Matches
1760,Matija Nastasić,rs SRB,DF,Schalke 04,de Bundesliga,26,1993,15.2,26,16,17,9,0,14,17,82.4,3,28,16,12,22,48,79,0,Matches
1761,Marc Navarro,es ESP,"FW,DF",Leganés,es La Liga,24,1995,2.4,3,3,2,1,0,1,1,100.0,0,2,1,1,0,3,3,0,Matches
1762,Ximo Navarro,es ESP,DF,Alavés,es La Liga,29,1990,21.1,34,19,17,15,2,16,28,57.1,12,20,7,13,52,86,76,2,Matches
1763,Jesús Navas,es ESP,DF,Sevilla,es La Liga,33,1985,37.4,27,15,16,7,4,15,32,46.9,17,20,7,13,31,58,70,0,Matches
1764,Keylor Navas,cr CRC,GK,Paris S-G,fr Ligue 1,32,1986,21.0,0,0,0,0,0,0,0,,0,1,0,1,0,0,4,2,Matches
1765,Raúl Navas,es ESP,DF,Osasuna,es La Liga,31,1988,7.9,10,5,4,6,0,4,13,30.8,9,10,4,6,18,28,30,0,Matches
1766,Michel Ndary Adopo,fr FRA,"DF,MF",Torino,it Serie A,19,2000,0.0,0,0,0,0,0,0,0,,0,1,1,0,0,0,0,0,Matches
1767,Papa Ndiaga Yade,mr MTN,FW,Metz,fr Ligue 1,19,2000,0.0,0,0,0,0,0,0,0,,0,0,0,0,0,0,0,0,Matches
1768,Wilfred Ndidi,ng NGA,MF,Leicester City,eng Premier League,22,1996,29.7,128,67,56,61,11,45,91,49.5,46,52,6,46,80,208,69,3,Matches
1769,Emanuele Ndoj,al ALB,MF,Brescia,it Serie A,22,1996,6.2,9,6,2,6,1,3,13,23.1,10,7,0,7,5,14,5,0,Matches
1770,Tanguy Ndombele,fr FRA,MF,Tottenham,eng Premier League,22,1996,11.2,24,16,10,13,1,9,22,40.9,13,20,3,17,14,38,7,0,Matches
1771,Reiss Nelson,eng ENG,FW,Arsenal,eng Premier League,19,1999,7.0,11,8,5,4,2,7,17,41.2,10,13,2,11,3,14,3,0,Matches
1772,Ilija Nestorovski,mk MKD,FW,Udinese,it Serie A,29,1990,13.9,10,7,5,5,0,6,21,28.6,15,13,2,11,4,14,12,0,Matches
1773,Neto,br BRA,GK,Barcelona,es La Liga,30,1989,2.0,0,0,0,0,0,0,0,,0,0,0,0,0,0,1,0,Matches
1774,Pedro Neto,pt POR,"FW,MF",Wolves,eng Premier League,19,2000,10.4,9,4,3,6,0,4,15,26.7,11,2,0,2,6,15,4,0,Matches
1775,Manuel Neuer,de GER,GK,Bayern Munich,de Bundesliga,33,1986,33.0,2,1,1,0,1,2,4,50.0,2,0,0,0,0,2,15,4,Matches
1776,Florian Neuhaus,de GER,MF,Gladbach,de Bundesliga,22,1997,26.2,42,23,13,22,7,12,54,22.2,42,24,4,20,27,69,8,0,Matches
1777,Carlos Neva,es ESP,DF,Granada,es La Liga,23,1996,24.5,16,11,12,3,1,9,21,42.9,12,15,2,13,28,44,60,0,Matches
1778,Rúben Neves,pt POR,MF,Wolves,eng Premier League,22,1997,34.0,62,33,27,32,3,34,86,39.5,52,38,9,29,56,118,34,1,Matches
1779,Neymar,br BRA,"MF,FW",Paris S-G,fr Ligue 1,27,1992,14.6,12,7,1,9,2,3,21,14.3,18,10,0,10,4,16,1,0,Matches
1780,Jeremy Ngakia,eng ENG,DF,West Ham,eng Premier League,18,2000,4.9,15,7,10,5,0,9,21,42.9,12,6,1,5,7,22,16,0,Matches
1781,Jessic Ngankam,de GER,"FW,MF",Hertha BSC,de Bundesliga,19,2000,0.9,2,2,1,1,0,2,2,100.0,0,2,0,2,0,2,1,0,Matches
1782,Muzinga Ngonda,cd COD,DF,Dijon,fr Ligue 1,24,1994,6.0,15,6,10,3,2,7,10,70.0,3,5,4,1,11,26,23,0,Matches
1783,Ahmad Ngouyamsa,cm CMR,DF,Dijon,fr Ligue 1,18,2000,0.6,1,0,1,0,0,0,3,0.0,3,1,1,0,1,2,5,0,Matches
1784,Opa Nguette,sn SEN,FW,Metz,fr Ligue 1,25,1994,20.3,44,28,23,15,6,11,39,28.2,28,17,3,14,12,56,12,0,Matches
1785,Moussa Niakhate,sn SEN,DF,Mainz 05,de Bundesliga,23,1996,33.0,35,22,29,6,0,16,29,55.2,13,40,26,14,40,75,124,4,Matches
1786,Ibrahima Niane,sn SEN,FW,Metz,fr Ligue 1,20,1999,10.6,8,7,2,5,1,5,16,31.3,11,5,1,4,10,18,11,1,Matches
1787,M'Baye Niang,sn SEN,FW,Rennes,fr Ligue 1,24,1994,23.6,17,10,3,11,3,6,21,28.6,15,10,1,9,5,22,20,0,Matches
1788,Tanguy Nianzou,fr FRA,"DF,MF",Paris S-G,fr Ligue 1,17,2002,5.0,2,1,0,1,1,1,3,33.3,2,4,2,2,3,5,6,0,Matches
1789,Cheikh Niasse,sn SEN,MF,Lille,fr Ligue 1,19,2000,0.2,0,0,0,0,0,0,0,,0,0,0,0,0,0,0,0,Matches
1790,Oumar Niasse,sn SEN,FW,Everton,eng Premier League,29,1990,0.2,4,0,0,2,2,0,0,,0,0,0,0,1,5,0,0,Matches
1791,Moritz Nicolas,de GER,GK,Union Berlin,de Bundesliga,21,1997,1.0,0,0,0,0,0,0,0,,0,0,0,0,0,0,0,0,Matches
1792,Florian Niederlechner,de GER,"FW,MF",Augsburg,de Bundesliga,28,1990,30.2,21,13,7,9,5,4,21,19.0,17,21,5,16,8,29,38,0,Matches
1793,Saúl Ñíguez,es ESP,"MF,DF",Atlético Madrid,es La Liga,24,1994,34.1,95,59,44,42,9,39,88,44.3,49,58,13,45,55,150,68,1,Matches
1794,Casimir Ninga,td CHA,"MF,FW",Angers,fr Ligue 1,26,1993,7.6,5,5,4,0,1,1,5,20.0,4,5,0,5,3,8,2,0,Matches
1795,Fernando Niño,es ESP,FW,Villarreal,es La Liga,18,2000,0.9,1,0,0,1,0,1,2,50.0,1,0,0,0,0,1,2,0,Matches
1796,Timothée Nkada,fr FRA,FW,Reims,fr Ligue 1,20,1999,1.6,1,0,1,0,0,0,1,0.0,1,0,0,0,0,1,1,0,Matches
1797,Eddie Nketiah,eng ENG,FW,Arsenal,eng Premier League,20,1999,7.0,7,5,3,4,0,2,6,33.3,4,9,0,9,2,9,5,0,Matches
1798,Nicolas Nkoulou,cm CMR,DF,Torino,it Serie A,29,1990,29.9,34,24,21,11,2,16,22,72.7,6,40,18,22,70,104,138,2,Matches
1799,Christopher Nkunku,fr FRA,"MF,FW",RB Leipzig,de Bundesliga,21,1997,21.4,21,13,4,11,6,9,33,27.3,24,25,2,23,20,41,8,0,Matches
1800,Lukas Nmecha,de GER,"MF,FW",Wolfsburg,de Bundesliga,20,1998,1.5,0,0,0,0,0,0,0,,0,0,0,0,0,0,0,0,Matches
1801,Mark Noble,eng ENG,MF,West Ham,eng Premier League,32,1987,29.7,52,30,19,28,5,22,64,34.4,42,20,6,14,20,72,10,1,Matches
1802,Nolito,es ESP,FW,Sevilla,es La Liga,32,1986,10.0,21,12,5,11,5,7,20,35.0,13,7,0,7,1,22,1,0,Matches
1803,Nolito,es ESP,"MF,FW",Celta Vigo,es La Liga,32,1986,3.6,7,5,5,2,0,3,8,37.5,5,4,1,3,1,8,4,0,Matches
1804,Arnaud Nordin,fr FRA,"FW,MF",Saint-Étienne,fr Ligue 1,21,1998,10.1,7,3,3,3,1,4,13,30.8,9,11,1,10,4,11,6,0,Matches
1805,Håvard Nordtveit,no NOR,DF,Hoffenheim,de Bundesliga,29,1990,7.8,4,1,3,1,0,3,7,42.9,4,17,12,5,13,17,45,0,Matches
1806,Oliver Norwood,nir NIR,MF,Sheffield Utd,eng Premier League,28,1991,34.3,66,37,35,24,7,28,97,28.9,69,34,12,22,47,113,40,1,Matches
1807,Alexander Nübel,de GER,GK,Schalke 04,de Bundesliga,22,1996,25.7,0,0,0,0,0,0,0,,0,0,0,0,2,2,9,6,Matches
1808,Kasim Nuhu,gh GHA,DF,Düsseldorf,de Bundesliga,24,1995,11.1,14,7,12,1,1,9,19,47.4,10,16,12,4,25,39,54,0,Matches
1809,Unai Núñez,es ESP,DF,Athletic Club,es La Liga,22,1997,17.5,13,10,10,2,1,6,16,37.5,10,25,17,8,23,36,71,0,Matches
1810,Bram Nuytinck,nl NED,DF,Udinese,it Serie A,29,1990,24.7,46,32,30,13,3,17,27,63.0,10,50,32,18,27,73,96,1,Matches
1811,Gerzino Nyamsi,fr FRA,DF,Rennes,fr Ligue 1,22,1997,1.3,1,0,1,0,0,0,0,,0,1,0,1,1,2,5,0,Matches
1812,Ørjan Nyland,no NOR,GK,Aston Villa,eng Premier League,28,1990,6.0,0,0,0,0,0,0,0,,0,0,0,0,0,0,1,1,Matches
1813,Allan Nyom,cm CMR,"DF,MF",Getafe,es La Liga,31,1988,26.9,45,25,26,15,4,20,37,54.1,17,24,5,19,14,59,50,1,Matches
1814,Steven Nzonzi,fr FRA,MF,Rennes,fr Ligue 1,30,1988,4.3,5,4,3,1,1,1,2,50.0,1,2,2,0,4,9,18,0,Matches
1815,Jack O'Connell,eng ENG,DF,Sheffield Utd,eng Premier League,25,1994,32.4,23,14,15,6,2,10,20,50.0,10,38,17,21,42,65,154,1,Matches
1816,Michael Obafemi,ie IRL,FW,Southampton,eng Premier League,19,2000,7.4,7,3,1,3,3,2,14,14.3,12,3,0,3,6,13,0,0,Matches
1817,Pedro Obiang,gq EQG,MF,Sassuolo,it Serie A,27,1992,18.6,46,31,21,19,6,19,40,47.5,21,24,10,14,21,67,31,1,Matches
1818,Jan Oblak,si SVN,GK,Atlético Madrid,es La Liga,26,1993,37.7,0,0,0,0,0,0,0,,0,0,0,0,1,1,4,2,Matches
1819,Rafel Obrador,es ESP,DF,Mallorca,es La Liga,15,2004,0.0,0,0,0,0,0,0,1,0.0,1,0,0,0,0,0,1,0,Matches
1820,Lucas Ocampos,ar ARG,"FW,MF",Sevilla,es La Liga,25,1994,30.5,54,31,30,19,5,30,72,41.7,42,33,2,31,22,76,27,0,Matches
1821,Bastian Oczipka,de GER,DF,Schalke 04,de Bundesliga,30,1989,33.5,72,50,42,21,9,36,62,58.1,26,35,6,29,37,109,68,0,Matches
1822,Álvaro Odriozola,es ESP,DF,Real Madrid,es La Liga,23,1995,3.8,5,2,4,0,1,5,8,62.5,3,4,0,4,2,7,8,0,Matches
1823,Álvaro Odriozola,es ESP,DF,Bayern Munich,de Bundesliga,23,1995,1.7,2,2,1,0,1,2,3,66.7,1,1,0,1,1,3,2,0,Matches
1824,Kelvin Ofori,gh GHA,MF,Düsseldorf,de Bundesliga,18,2001,0.4,0,0,0,0,0,0,0,,0,0,0,0,0,0,0,0,Matches
1825,Angelo Ogbonna,it ITA,DF,West Ham,eng Premier League,31,1988,31.0,38,24,20,14,4,18,32,56.3,14,50,32,18,27,65,134,1,Matches
1826,Stefano Okaka,it ITA,FW,Udinese,it Serie A,29,1989,26.8,19,11,6,8,5,7,27,25.9,20,23,2,21,8,27,28,0,Matches
1827,Kwasi Okyere Wriedt,gh GHA,FW,Bayern Munich,de Bundesliga,25,1994,0.2,0,0,0,0,0,0,0,,0,0,0,0,0,0,0,0,Matches
1828,Lucas Olaza,uy URU,DF,Celta Vigo,es La Liga,25,1994,34.9,56,39,36,17,3,39,59,66.1,20,37,10,27,31,87,60,1,Matches
1829,Oier Olazábal,es ESP,GK,Espanyol,es La Liga,29,1989,2.0,0,0,0,0,0,0,0,,0,1,0,1,0,0,0,0,Matches
1830,Christian Oliva,uy URU,MF,Cagliari,it Serie A,23,1996,5.2,13,7,9,4,0,5,15,33.3,10,5,0,5,7,20,14,0,Matches
1831,Kiko Olivas,es ESP,DF,Valladolid,es La Liga,30,1988,32.7,33,16,25,7,1,13,35,37.1,22,30,16,14,61,94,112,2,Matches
1832,Paulo Oliveira,pt POR,DF,Eibar,es La Liga,27,1992,23.2,31,19,22,8,1,18,30,60.0,12,23,13,10,42,73,107,1,Matches
1833,Cauly Oliveira Souza,br BRA,"MF,FW",Paderborn 07,de Bundesliga,23,1995,8.0,11,7,5,5,1,3,11,27.3,8,9,0,9,6,17,1,0,Matches
1834,Mathías Olivera,uy URU,DF,Getafe,es La Liga,21,1997,20.8,64,40,34,16,14,27,45,60.0,18,32,3,29,23,87,44,0,Matches
1835,Maximiliano Olivera,uy URU,MF,Fiorentina,it Serie A,27,1992,0.1,1,0,1,0,0,0,0,,0,0,0,0,0,1,0,0,Matches
1836,Marco Olivieri,it ITA,FW,Juventus,it Serie A,20,1999,0.3,1,1,1,0,0,1,2,50.0,1,0,0,0,0,1,0,0,Matches
1837,Dani Olmo,es ESP,"MF,FW",RB Leipzig,de Bundesliga,21,1998,8.3,20,14,5,10,5,1,13,7.7,12,7,1,6,4,24,6,0,Matches
1838,Robin Olsen,se SWE,GK,Cagliari,it Serie A,29,1990,16.9,0,0,0,0,0,0,1,0.0,1,0,0,0,0,0,8,0,Matches
1839,Kenneth Omeruo,ng NGA,DF,Leganés,es La Liga,25,1993,20.8,28,17,25,3,0,11,18,61.1,7,21,12,9,36,64,112,2,Matches
1840,Jean Onana,cm CMR,MF,Lille,fr Ligue 1,19,2000,0.9,0,0,0,0,0,0,2,0.0,2,1,0,1,1,1,0,0,Matches
1841,Karim Onisiwo,at AUT,FW,Mainz 05,de Bundesliga,27,1992,19.2,27,19,6,10,11,5,13,38.5,8,20,3,17,7,34,11,0,Matches
1842,Javier Ontiveros,es ESP,"FW,MF",Villarreal,es La Liga,21,1997,9.9,29,14,13,14,2,8,35,22.9,27,13,1,12,5,34,7,0,Matches
1843,Henry Onyekuru,ng NGA,"MF,FW",Monaco,fr Ligue 1,22,1997,1.8,1,1,1,0,0,0,0,,0,1,0,1,1,2,0,0,Matches
1844,Nicholas Opoku,gh GHA,DF,Udinese,it Serie A,21,1997,5.3,13,8,8,3,2,6,11,54.5,5,6,4,2,4,17,19,0,Matches
1845,Nicholas Opoku,gh GHA,DF,Amiens,fr Ligue 1,21,1997,7.0,7,5,6,1,0,7,14,50.0,7,6,2,4,7,14,32,0,Matches
1846,Willi Orban,hu HUN,DF,RB Leipzig,de Bundesliga,26,1992,9.5,20,12,13,7,0,12,20,60.0,8,14,3,11,16,36,52,1,Matches
1847,Fabián Orellana,cl CHI,"MF,FW",Eibar,es La Liga,33,1986,26.6,29,18,10,6,13,14,52,26.9,38,9,0,9,20,49,2,0,Matches
1848,Divock Origi,be BEL,FW,Liverpool,eng Premier League,24,1995,8.0,12,9,2,5,5,4,9,44.4,5,2,0,2,4,16,5,0,Matches
1849,Aimar Oroz,es ESP,FW,Osasuna,es La Liga,17,2001,0.1,0,0,0,0,0,0,0,,0,1,0,1,0,0,0,0,Matches
1850,Riccardo Orsolini,it ITA,"FW,MF",Bologna,it Serie A,22,1997,29.8,36,22,21,10,5,12,47,25.5,35,23,1,22,16,52,20,0,Matches
1851,Yuya Osako,jp JPN,"FW,MF",Werder Bremen,de Bundesliga,29,1990,20.5,29,16,5,19,5,3,29,10.3,26,10,1,9,6,35,13,1,Matches
1852,Ben Osborn,eng ENG,"MF,DF",Sheffield Utd,eng Premier League,24,1994,6.6,15,10,11,3,1,3,16,18.8,13,6,1,5,6,21,7,0,Matches
1853,Victor Osimhen,ng NGA,FW,Lille,fr Ligue 1,20,1998,25.4,8,4,1,0,7,1,11,9.1,10,8,0,8,11,19,32,0,Matches
1854,David Ospina,co COL,GK,Napoli,it Serie A,30,1988,16.3,0,0,0,0,0,0,0,,0,0,0,0,0,0,2,1,Matches
1855,Nicolás Otamendi,ar ARG,DF,Manchester City,eng Premier League,31,1988,19.1,28,14,21,6,1,16,33,48.5,17,15,9,6,21,49,76,2,Matches
1856,Otávio,br BRA,MF,Bordeaux,fr Ligue 1,25,1994,24.6,80,45,23,52,5,35,82,42.7,47,26,9,17,41,121,40,6,Matches
1857,Paulo Otávio,br BRA,DF,Wolfsburg,de Bundesliga,24,1994,4.2,21,16,11,9,1,10,13,76.9,3,12,2,10,9,30,11,0,Matches
1858,Abou Ouattara,bf BFA,FW,Lille,fr Ligue 1,19,1999,0.1,0,0,0,0,0,0,0,,0,0,0,0,0,0,1,0,Matches
1859,Remi Oudin,fr FRA,"FW,MF",Bordeaux,fr Ligue 1,22,1996,6.2,9,6,4,4,1,4,14,28.6,10,7,1,6,9,18,5,0,Matches
1860,Remi Oudin,fr FRA,"FW,MF",Reims,fr Ligue 1,22,1996,15.5,15,7,8,5,2,6,19,31.6,13,16,1,15,18,33,18,1,Matches
1861,Alexandre Oukidja,dz ALG,GK,Metz,fr Ligue 1,31,1988,26.5,0,0,0,0,0,0,1,0.0,1,1,0,1,0,0,15,1,Matches
1862,Zinédine Ould Khaled,fr FRA,MF,Angers,fr Ligue 1,19,2000,0.7,2,1,0,2,0,2,4,50.0,2,0,0,0,4,6,0,0,Matches
1863,Adam Ounas,dz ALG,"FW,MF",Nice,fr Ligue 1,22,1996,12.5,10,5,2,6,2,5,13,38.5,8,9,1,8,11,21,8,1,Matches
1864,Reece Oxford,eng ENG,MF,Augsburg,de Bundesliga,20,1998,4.2,7,4,2,4,1,2,8,25.0,6,8,5,3,5,12,10,1,Matches
1865,Alex Oxlade-Chamberlain,eng ENG,"MF,FW",Liverpool,eng Premier League,25,1993,16.5,18,9,4,6,8,5,21,23.8,16,26,1,25,22,40,10,0,Matches
1866,Mikel Oyarzabal,es ESP,"FW,MF",Real Sociedad,es La Liga,22,1997,33.9,36,15,13,15,8,16,46,34.8,30,32,2,30,13,49,19,1,Matches
1867,Ambroise Oyongo,cm CMR,"DF,FW",Montpellier,fr Ligue 1,28,1991,20.2,25,10,16,6,3,16,28,57.1,12,8,0,8,17,42,35,0,Matches
1868,Mesut Özil,de GER,MF,Arsenal,eng Premier League,30,1988,16.0,17,8,9,7,1,4,23,17.4,19,4,0,4,5,22,1,0,Matches
1869,Levin Öztunalı,de GER,"MF,FW",Mainz 05,de Bundesliga,23,1996,19.8,28,19,13,12,3,12,35,34.3,23,27,1,26,9,37,14,2,Matches
1870,Pablo,br BRA,DF,Bordeaux,fr Ligue 1,28,1991,24.1,27,15,22,5,0,16,31,51.6,15,25,14,11,40,67,130,2,Matches
1871,Fernando Pacheco,es ESP,GK,Alavés,es La Liga,27,1992,26.2,1,0,1,0,0,1,3,33.3,2,0,0,0,0,1,10,0,Matches
1872,Jon Pacheco,es ESP,DF,Real Sociedad,es La Liga,18,2001,0.9,0,0,0,0,0,0,0,,0,1,0,1,0,0,2,0,Matches
1873,Gonçalo Paciência,pt POR,FW,Eint Frankfurt,de Bundesliga,24,1994,14.3,9,5,1,4,4,3,13,23.1,10,9,1,8,1,10,11,0,Matches
1874,Daniele Padelli,it ITA,GK,Inter,it Serie A,33,1985,3.0,0,0,0,0,0,0,0,,0,0,0,0,0,0,1,1,Matches
1875,Marko Pajač,hr CRO,"DF,FW",Genoa,it Serie A,26,1993,8.4,8,4,4,3,1,7,16,43.8,9,6,0,6,8,16,9,0,Matches
1876,Vincent Pajot,fr FRA,MF,Angers,fr Ligue 1,28,1990,1.3,2,2,1,1,0,1,1,100.0,0,3,0,3,5,7,0,0,Matches
1877,Vincent Pajot,fr FRA,MF,Metz,fr Ligue 1,28,1990,5.8,16,11,8,7,1,2,4,50.0,2,5,1,4,9,25,13,0,Matches
1878,Rodrigo Palacio,ar ARG,FW,Bologna,it Serie A,37,1982,28.0,19,11,0,9,10,4,27,14.8,23,17,3,14,5,24,38,2,Matches
1879,Exequiel Palacios,ar ARG,MF,Leverkusen,de Bundesliga,20,1998,2.0,8,7,4,4,0,2,5,40.0,3,2,0,2,1,9,0,0,Matches
1880,Sergi Palencia,es ESP,DF,Saint-Étienne,fr Ligue 1,23,1996,5.2,16,10,6,10,0,5,7,71.4,2,6,1,5,8,24,4,0,Matches
1881,Nicolas Pallois,fr FRA,DF,Nantes,fr Ligue 1,31,1987,21.0,47,36,28,17,2,31,55,56.4,24,18,13,5,40,87,77,1,Matches
1882,Emerson Palmieri,it ITA,DF,Chelsea,eng Premier League,24,1994,11.4,23,12,8,11,4,10,15,66.7,5,13,1,12,18,41,19,0,Matches
1883,Alberto Paloschi,it ITA,FW,SPAL,it Serie A,29,1990,4.9,3,0,3,0,0,2,8,25.0,6,3,0,3,0,3,2,0,Matches
1884,Alberto Paloschi,it ITA,"FW,MF",Cagliari,it Serie A,29,1990,2.3,0,0,0,0,0,0,1,0.0,1,1,0,1,1,1,3,0,Matches
1885,Martin Palumbo,no NOR,MF,Udinese,it Serie A,17,2002,0.0,0,0,0,0,0,0,0,,0,0,0,0,0,0,0,0,Matches
1886,Goran Pandev,mk MKD,"FW,MF",Genoa,it Serie A,36,1983,18.7,12,8,2,7,3,3,25,12.0,22,4,1,3,0,12,5,1,Matches
1887,Jonathan Panzo,eng ENG,DF,Monaco,fr Ligue 1,18,2000,1.2,2,2,2,0,0,1,1,100.0,0,3,1,2,3,5,7,0,Matches
1888,Sokratis Papastathopoulos,gr GRE,DF,Arsenal,eng Premier League,31,1988,18.8,25,16,17,7,1,10,21,47.6,11,30,24,6,17,42,68,1,Matches
1889,Andrea Papetti,it ITA,DF,Brescia,it Serie A,17,2002,10.2,9,7,8,1,0,4,14,28.6,10,15,11,4,15,24,39,0,Matches
1890,Lucas Paquetá,br BRA,"MF,FW",Milan,it Serie A,21,1997,12.3,33,19,12,17,4,14,37,37.8,23,17,2,15,8,41,9,0,Matches
1891,Gaëtan Paquiez,fr FRA,DF,Nîmes,fr Ligue 1,25,1994,17.0,36,25,14,13,9,17,47,36.2,30,18,5,13,33,69,43,0,Matches
1892,Rubén Pardo,es ESP,MF,Bordeaux,fr Ligue 1,26,1992,2.1,3,2,2,1,0,2,3,66.7,1,0,0,0,1,4,2,1,Matches
1893,Leandro Paredes,ar ARG,MF,Paris S-G,fr Ligue 1,25,1994,9.0,22,14,7,14,1,13,29,44.8,16,7,1,6,15,37,7,0,Matches
1894,Daniel Parejo,es ESP,MF,Valencia,es La Liga,30,1989,33.6,67,41,29,32,6,32,101,31.7,69,38,11,27,22,89,20,2,Matches
1895,Michael Parensen,de GER,DF,Union Berlin,de Bundesliga,33,1986,7.0,11,6,5,6,0,5,10,50.0,5,14,8,6,12,23,17,0,Matches
1896,Miquel Parera,es ESP,GK,Mallorca,es La Liga,23,1996,1.0,0,0,0,0,0,0,0,,0,0,0,0,0,0,0,0,Matches
1897,Marco Parolo,it ITA,MF,Lazio,it Serie A,34,1985,18.9,54,26,19,27,8,18,46,39.1,28,44,15,29,26,80,49,0,Matches
1898,Troy Parrott,ie IRL,FW,Tottenham,eng Premier League,17,2002,0.1,0,0,0,0,0,0,0,,0,0,0,0,0,0,0,0,Matches
1899,Thomas Partey,gh GHA,MF,Atlético Madrid,es La Liga,26,1993,28.3,70,41,34,30,6,26,58,44.8,32,32,8,24,48,118,41,7,Matches
1900,Mario Pašalić,hr CRO,MF,Atalanta,it Serie A,24,1995,26.9,47,21,17,18,12,16,52,30.8,36,27,7,20,27,74,22,2,Matches
1901,Javier Pastore,ar ARG,MF,Roma,it Serie A,30,1989,5.7,14,10,3,5,6,5,12,41.7,7,4,0,4,5,19,5,0,Matches
1902,Patric,es ESP,DF,Lazio,it Serie A,26,1993,18.6,34,20,24,7,3,18,25,72.0,7,19,9,10,15,49,45,0,Matches
1903,Rui Patrício,pt POR,GK,Wolves,eng Premier League,31,1988,38.0,0,0,0,0,0,0,2,0.0,2,2,0,2,2,2,5,2,Matches
1904,Paulinho,br BRA,"MF,FW",Leverkusen,de Bundesliga,19,2000,3.4,4,3,3,1,0,1,2,50.0,1,5,1,4,1,5,0,0,Matches
1905,Paulino,es ESP,"FW,MF",Alavés,es La Liga,22,1997,0.8,0,0,0,0,0,0,1,0.0,1,1,0,1,1,1,0,0,Matches
1906,Gabriel Paulista,br BRA,DF,Valencia,es La Liga,28,1990,31.1,22,14,17,2,3,15,25,60.0,10,36,29,7,48,70,151,3,Matches
1907,Benjamin Pavard,fr FRA,DF,Bayern Munich,de Bundesliga,23,1996,31.0,34,22,15,10,9,16,28,57.1,12,28,10,18,52,86,60,0,Matches
1908,Jiří Pavlenka,cz CZE,GK,Werder Bremen,de Bundesliga,27,1992,33.0,1,0,1,0,0,1,2,50.0,1,1,0,1,5,6,11,3,Matches
1909,Mateo Pavlović,ba BIH,DF,Angers,fr Ligue 1,29,1990,9.0,8,2,6,2,0,5,7,71.4,2,4,2,2,5,13,38,1,Matches
1910,Leonardo Pavoletti,it ITA,FW,Cagliari,it Serie A,30,1988,0.5,0,0,0,0,0,0,0,,0,0,0,0,1,1,3,0,Matches
1911,Dimitri Payet,fr FRA,"FW,MF",Marseille,fr Ligue 1,32,1987,21.4,22,12,8,8,6,10,26,38.5,16,8,1,7,8,30,12,0,Matches
1912,Nehuén Paz,ar ARG,DF,Bologna,it Serie A,26,1993,1.3,1,1,0,1,0,0,2,0.0,2,3,3,0,5,6,12,0,Matches
1913,Nehuén Paz,ar ARG,DF,Lecce,it Serie A,26,1993,9.4,14,5,11,3,0,10,12,83.3,2,12,6,6,20,34,38,1,Matches
1914,Giampaolo Pazzini,it ITA,"FW,MF",Hellas Verona,it Serie A,34,1984,3.4,1,0,0,1,0,0,4,0.0,4,2,0,2,1,2,4,0,Matches
1915,Mads Pedersen,dk DEN,DF,Augsburg,de Bundesliga,22,1996,1.1,4,2,3,0,1,2,6,33.3,4,3,1,2,2,6,0,0,Matches
1916,Alfonso Pedraza,es ESP,DF,Betis,es La Liga,23,1996,15.0,30,19,16,11,3,19,33,57.6,14,18,6,12,16,46,26,1,Matches
1917,Marc Pedraza,es ESP,MF,Mallorca,es La Liga,32,1987,1.4,1,1,1,0,0,1,5,20.0,4,0,0,0,4,5,1,0,Matches
1918,Pedro,es ESP,"FW,MF",Chelsea,eng Premier League,32,1987,7.3,15,7,5,9,1,3,15,20.0,12,9,0,9,9,24,1,0,Matches
1919,Pedro,br BRA,FW,Fiorentina,it Serie A,22,1997,0.7,1,1,0,0,1,0,0,,0,1,0,1,0,1,0,0,Matches
1920,João Pedro,it ITA,"FW,MF",Cagliari,it Serie A,27,1992,35.0,17,11,5,7,5,4,24,16.7,20,35,8,27,9,26,39,0,Matches
1921,Adrià Pedrosa,es ESP,"DF,MF",Espanyol,es La Liga,21,1998,12.1,19,13,8,9,2,7,25,28.0,18,12,1,11,11,30,32,0,Matches
1922,Daouda Peeters,be BEL,MF,Juventus,it Serie A,20,1999,0.2,1,0,0,1,0,1,1,100.0,0,0,0,0,0,1,0,0,Matches
1923,Jordan Pefok,us USA,FW,Rennes,fr Ligue 1,23,1996,4.9,7,6,1,4,2,0,2,0.0,2,3,0,3,1,8,2,0,Matches
1924,Gianluca Pegolo,it ITA,GK,Sassuolo,it Serie A,38,1981,5.0,0,0,0,0,0,0,0,,0,0,0,0,0,0,4,0,Matches
1925,Peter Pekarík,sk SVK,"DF,FW",Hertha BSC,de Bundesliga,32,1986,8.5,14,7,7,3,4,8,20,40.0,12,11,4,7,7,21,31,0,Matches
1926,Yohann Pelé,fr FRA,GK,Marseille,fr Ligue 1,36,1982,1.7,0,0,0,0,0,0,0,,0,0,0,0,0,0,0,0,Matches
1927,Lorenzo Pellegrini,it ITA,MF,Roma,it Serie A,23,1996,23.3,30,13,9,13,8,12,33,36.4,21,28,0,28,15,45,18,0,Matches
1928,Luca Pellegrini,it ITA,DF,Cagliari,it Serie A,20,1999,21.2,31,15,20,7,4,15,38,39.5,23,19,2,17,21,52,45,2,Matches
1929,Théo Pellenard,fr FRA,DF,Angers,fr Ligue 1,25,1994,5.1,11,8,6,3,2,6,13,46.2,7,4,0,4,5,16,8,0,Matches
1930,Andy Pelmard,fr FRA,DF,Nice,fr Ligue 1,19,2000,8.5,22,14,13,9,0,9,11,81.8,2,12,4,8,15,37,28,1,Matches
1931,Federico Peluso,it ITA,DF,Sassuolo,it Serie A,35,1984,16.8,19,16,8,8,3,8,9,88.9,1,14,9,5,22,41,58,1,Matches
1932,Rubén Peña,es ESP,DF,Villarreal,es La Liga,28,1991,21.2,42,24,23,19,0,17,50,34.0,33,25,8,17,35,77,58,2,Matches
1933,Philipp Pentke,de GER,GK,Hoffenheim,de Bundesliga,34,1985,4.0,0,0,0,0,0,0,0,,0,0,0,0,0,0,2,0,Matches
1934,Nicolas Pépé,ci CIV,FW,Arsenal,eng Premier League,24,1995,22.3,32,17,15,13,4,8,16,50.0,8,15,2,13,8,40,5,0,Matches
1935,Luis Perea,es ESP,FW,Osasuna,es La Liga,21,1997,0.2,0,0,0,0,0,0,0,,0,0,0,0,0,0,1,0,Matches
1936,Andreas Pereira,br BRA,"MF,FW",Manchester Utd,eng Premier League,23,1996,16.5,24,13,8,9,7,10,39,25.6,29,13,0,13,7,31,7,0,Matches
1937,Mathias Pereira Lage,pt POR,MF,Angers,fr Ligue 1,22,1996,17.1,30,18,16,13,1,12,37,32.4,25,19,0,19,17,47,9,0,Matches
1938,Ricardo Pereira,pt POR,DF,Leicester City,eng Premier League,25,1993,28.0,119,68,65,36,18,53,106,50.0,53,38,6,32,49,168,86,0,Matches
1939,Gastón Pereiro,uy URU,"MF,FW",Cagliari,it Serie A,24,1995,3.9,2,2,2,0,0,1,4,25.0,3,1,0,1,0,2,1,1,Matches
1940,Bruno Peres,br BRA,DF,Roma,it Serie A,29,1990,11.7,14,10,10,3,1,8,21,38.1,13,12,3,9,15,29,19,2,Matches
1941,Roberto Pereyra,ar ARG,"FW,MF",Watford,eng Premier League,28,1991,18.3,20,8,11,7,2,9,28,32.1,19,21,0,21,14,34,12,1,Matches
1942,Ayoze Pérez,es ESP,"MF,FW",Leicester City,eng Premier League,26,1993,22.3,45,28,14,26,5,8,54,14.8,46,33,1,32,14,59,9,1,Matches
1943,Carles Pérez,es ESP,"FW,MF",Roma,it Serie A,21,1998,6.3,12,8,4,6,2,3,10,30.0,7,6,1,5,3,15,1,0,Matches
1944,Carles Pérez,es ESP,FW,Barcelona,es La Liga,21,1998,5.3,7,4,2,2,3,3,15,20.0,12,5,2,3,1,8,1,0,Matches
1945,Iñigo Pérez,es ESP,MF,Osasuna,es La Liga,31,1988,12.0,15,11,3,7,5,8,22,36.4,14,7,1,6,12,27,6,0,Matches
1946,Juan Pérez,es ESP,GK,Osasuna,es La Liga,23,1996,2.0,1,1,1,0,0,1,2,50.0,1,0,0,0,0,1,0,0,Matches
1947,Kike Pérez,es ESP,"MF,FW",Valladolid,es La Liga,22,1997,2.4,6,1,1,3,2,3,7,42.9,4,1,0,1,10,16,4,0,Matches
1948,Lucas Pérez,es ESP,FW,Alavés,es La Liga,30,1988,27.7,12,6,2,8,2,3,13,23.1,10,13,2,11,2,14,0,0,Matches
1949,Rubén Pérez,es ESP,MF,Leganés,es La Liga,30,1989,24.4,50,27,21,23,6,16,47,34.0,31,21,4,17,38,88,33,0,Matches
1950,Samu Pérez,es ESP,GK,Valladolid,es La Liga,22,1997,0.3,0,0,0,0,0,0,0,,0,0,0,0,0,0,0,0,Matches
1951,Mattia Perin,it ITA,GK,Genoa,it Serie A,26,1992,21.0,1,1,1,0,0,1,1,100.0,0,1,0,1,0,1,5,1,Matches
1952,Ivan Perišić,hr CRO,"FW,MF",Bayern Munich,de Bundesliga,30,1989,13.4,16,12,5,6,5,8,33,24.2,25,14,3,11,4,20,8,0,Matches
1953,Diego Perotti,ar ARG,"FW,MF",Roma,it Serie A,31,1988,9.7,16,13,5,8,3,5,20,25.0,15,14,0,14,3,19,6,0,Matches
1954,Romain Perraud,fr FRA,DF,Brest,fr Ligue 1,21,1997,18.6,29,14,18,9,2,14,28,50.0,14,24,9,15,27,56,50,0,Matches
1955,Loïc Perrin,fr FRA,DF,Saint-Étienne,fr Ligue 1,33,1985,19.0,27,20,16,11,0,11,14,78.6,3,23,17,6,39,66,59,0,Matches
1956,Lucas Perrin,fr FRA,DF,Marseille,fr Ligue 1,20,1998,4.0,5,2,3,2,0,2,7,28.6,5,3,2,1,10,15,17,0,Matches
1957,Pavao Pervan,at AUT,GK,Wolfsburg,de Bundesliga,31,1987,8.0,0,0,0,0,0,0,1,0.0,1,0,0,0,0,0,4,0,Matches
1958,Matteo Pessina,it ITA,MF,Hellas Verona,it Serie A,22,1997,27.7,35,21,9,20,6,12,33,36.4,21,28,8,20,25,60,40,2,Matches
1959,Andrea Petagna,it ITA,FW,SPAL,it Serie A,24,1995,33.7,9,4,2,7,0,3,17,17.6,14,11,5,6,1,10,27,0,Matches
1960,Nils Petersen,de GER,"FW,MF",Freiburg,de Bundesliga,30,1988,27.1,19,14,7,9,3,10,28,35.7,18,32,6,26,10,29,67,0,Matches
1961,Danijel Petković,me MNE,GK,Angers,fr Ligue 1,26,1993,2.0,0,0,0,0,0,0,0,,0,0,0,0,0,0,2,0,Matches
1962,Denis Petrić,rs SRB,GK,Nantes,fr Ligue 1,31,1988,1.0,1,1,1,0,0,1,1,100.0,0,0,0,0,0,1,0,0,Matches
1963,Jacopo Petriccione,it ITA,MF,Lecce,it Serie A,24,1995,23.8,38,20,29,9,0,15,57,26.3,42,20,7,13,28,66,25,2,Matches
1964,Germán Pezzella,ar ARG,DF,Fiorentina,it Serie A,28,1991,31.4,36,18,26,9,1,14,32,43.8,18,31,20,11,55,91,134,1,Matches
1965,Giuseppe Pezzella,it ITA,DF,Udinese,it Serie A,21,1997,0.9,0,0,0,0,0,0,0,,0,0,0,0,1,1,4,0,Matches
1966,Giuseppe Pezzella,it ITA,DF,Parma,it Serie A,21,1997,10.5,20,12,17,3,0,11,19,57.9,8,13,9,4,6,26,30,0,Matches
1967,Rayan Philippe,fr FRA,FW,Dijon,fr Ligue 1,18,2000,0.3,0,0,0,0,0,0,1,0.0,1,0,0,0,1,1,1,1,Matches
1968,Romain Philippoteaux,fr FRA,"FW,MF",Nîmes,fr Ligue 1,31,1988,22.2,23,12,11,11,1,9,43,20.9,34,22,1,21,13,36,10,0,Matches
1969,Krzysztof Piątek,pl POL,FW,Milan,it Serie A,24,1995,13.1,9,4,0,7,2,3,11,27.3,8,5,2,3,3,12,10,0,Matches
1970,Krzysztof Piątek,pl POL,FW,Hertha BSC,de Bundesliga,24,1995,10.1,5,4,1,1,3,0,11,0.0,11,7,0,7,5,10,3,0,Matches
1971,Pablo Piatti,ar ARG,"DF,MF",Espanyol,es La Liga,30,1989,0.6,2,2,1,1,0,1,2,50.0,1,1,0,1,0,2,1,0,Matches
1972,Cristiano Piccini,it ITA,DF,Valencia,es La Liga,26,1992,0.8,5,4,1,0,4,4,4,100.0,0,0,0,0,2,7,1,0,Matches
1973,Stefano Piccinini,it ITA,DF,Sassuolo,it Serie A,16,2002,0.1,0,0,0,0,0,0,0,,0,0,0,0,0,0,0,0,Matches
1974,Roberto Piccoli,it ITA,FW,Atalanta,it Serie A,18,2001,0.2,0,0,0,0,0,0,0,,0,1,0,1,0,0,0,0,Matches
1975,Jordan Pickford,eng ENG,GK,Everton,eng Premier League,25,1994,38.0,0,0,0,0,0,0,4,0.0,4,0,0,0,3,3,12,6,Matches
1976,Jérémy Pied,fr FRA,DF,Lille,fr Ligue 1,30,1989,5.0,18,10,6,11,1,11,16,68.8,5,8,0,8,7,25,10,0,Matches
1977,Ronaël Pierre-Gabriel,fr FRA,DF,Mainz 05,de Bundesliga,21,1998,6.4,16,10,9,6,1,7,13,53.8,6,7,0,7,8,24,31,1,Matches
1978,Brandon Pierrick,eng ENG,"MF,FW",Crystal Palace,eng Premier League,17,2001,0.2,0,0,0,0,0,0,0,,0,0,0,0,0,0,1,0,Matches
1979,Erik Pieters,nl NED,"DF,MF",Burnley,eng Premier League,30,1988,20.9,54,32,18,29,7,28,69,40.6,41,30,4,26,28,82,60,1,Matches
1980,Tomás Pina Isla,es ESP,MF,Alavés,es La Liga,31,1987,14.9,37,22,13,21,3,12,24,50.0,12,15,5,10,16,53,31,0,Matches
1981,Andrea Pinamonti,it ITA,FW,Genoa,it Serie A,20,1999,24.8,19,12,1,7,11,5,25,20.0,20,19,2,17,9,28,25,0,Matches
1982,Simone Pinna,it ITA,DF,Cagliari,it Serie A,21,1997,1.0,1,1,0,1,0,0,0,,0,3,1,2,5,6,4,1,Matches
1983,Carlo Pinsoglio,it ITA,GK,Juventus,it Serie A,29,1990,0.2,0,0,0,0,0,0,0,,0,0,0,0,0,0,0,0,Matches
1984,Pipa,es ESP,"DF,FW",Espanyol,es La Liga,21,1998,5.3,9,8,5,4,0,4,6,66.7,2,8,0,8,6,15,17,0,Matches
1985,Gerard Piqué,es ESP,DF,Barcelona,es La Liga,32,1987,34.4,32,23,20,11,1,16,26,61.5,10,39,24,15,36,68,157,0,Matches
1986,Lorenzo Pirola,it ITA,DF,Inter,it Serie A,17,2002,0.1,0,0,0,0,0,0,0,,0,0,0,0,1,1,0,0,Matches
1987,Fabio Pisacane,it ITA,DF,Cagliari,it Serie A,33,1986,27.1,32,21,22,10,0,21,37,56.8,16,36,28,8,27,59,110,2,Matches
1988,Łukasz Piszczek,pl POL,DF,Dortmund,de Bundesliga,34,1985,23.4,45,32,27,16,2,28,50,56.0,22,27,11,16,26,71,47,1,Matches
1989,Claudio Pizarro,pe PER,"FW,MF",Werder Bremen,de Bundesliga,40,1978,2.6,2,1,0,1,1,0,1,0.0,1,2,0,2,2,4,2,0,Matches
1990,Miralem Pjanić,ba BIH,MF,Juventus,it Serie A,29,1990,25.3,46,21,16,23,7,21,63,33.3,42,29,12,17,32,78,30,0,Matches
1991,Óscar Plano,es ESP,MF,Valladolid,es La Liga,28,1991,27.8,48,30,25,19,4,20,61,32.8,41,36,3,33,35,83,29,0,Matches
1992,Marvin Plattenhardt,de GER,DF,Hertha BSC,de Bundesliga,27,1992,15.5,18,12,13,4,1,12,17,70.6,5,18,7,11,11,29,47,0,Matches
1993,Alassane Pléa,fr FRA,FW,Gladbach,de Bundesliga,26,1993,23.8,16,7,5,6,5,8,28,28.6,20,21,2,19,9,25,7,0,Matches
1994,Thomas Pledl,de GER,"MF,FW",Düsseldorf,de Bundesliga,25,1994,1.0,4,2,2,2,0,0,1,0.0,1,0,0,0,0,4,1,0,Matches
1995,Daniel Podence,pt POR,"FW,MF",Wolves,eng Premier League,23,1995,3.2,3,3,2,0,1,0,2,0.0,2,4,1,3,2,5,1,0,Matches
1996,Paul Pogba,fr FRA,MF,Manchester Utd,eng Premier League,26,1993,13.4,20,9,8,8,4,8,16,50.0,8,12,4,8,7,27,10,2,Matches
1997,Joel Pohjanpalo,fi FIN,MF,Leverkusen,de Bundesliga,24,1994,0.0,0,0,0,0,0,0,0,,0,0,0,0,0,0,0,0,Matches
1998,Andrea Poli,it ITA,MF,Bologna,it Serie A,29,1989,21.3,44,24,19,21,4,16,52,30.8,36,19,3,16,40,84,11,0,Matches
1999,Matteo Politano,it ITA,FW,Napoli,it Serie A,25,1993,8.3,12,6,8,2,2,5,14,35.7,9,6,0,6,5,17,3,0,Matches
2000,Matteo Politano,it ITA,"FW,MF",Inter,it Serie A,25,1993,2.9,0,0,0,0,0,0,2,0.0,2,1,0,1,0,0,1,0,Matches
2001,Sebastian Polter,de GER,FW,Union Berlin,de Bundesliga,28,1991,3.7,2,2,0,1,1,1,3,33.3,2,2,0,2,1,3,1,0,Matches
2002,Marin Pongračić,hr CRO,DF,Wolfsburg,de Bundesliga,21,1997,10.3,14,9,11,2,1,9,10,90.0,1,11,7,4,19,33,21,1,Matches
2003,Pere Pons,es ESP,MF,Alavés,es La Liga,26,1993,12.1,28,16,14,12,2,12,26,46.2,14,16,3,13,12,40,8,1,Matches
2004,Nick Pope,eng ENG,GK,Burnley,eng Premier League,27,1992,38.0,1,1,1,0,0,1,2,50.0,1,0,0,0,3,4,15,3,Matches
2005,Pedro Porro,es ESP,"DF,MF",Valladolid,es La Liga,19,1999,8.2,18,10,11,7,0,10,18,55.6,8,3,0,3,7,25,19,1,Matches
2006,Francisco Portillo,es ESP,MF,Getafe,es La Liga,29,1990,4.2,11,6,3,6,2,4,12,33.3,8,2,0,2,2,13,3,0,Matches
2007,Portu,es ESP,"FW,MF",Real Sociedad,es La Liga,27,1992,26.6,32,21,10,15,7,13,33,39.4,20,28,3,25,13,45,5,0,Matches
2008,Stefan Posch,at AUT,DF,Hoffenheim,de Bundesliga,22,1997,25.6,63,34,35,27,1,35,63,55.6,28,57,25,32,40,103,101,1,Matches
2009,Sergio Postigo,es ESP,DF,Levante,es La Liga,30,1988,26.4,32,15,23,7,2,11,18,61.1,7,24,15,9,34,66,132,1,Matches
2010,Florent Poulolo,mq MTQ,DF,Getafe,es La Liga,22,1997,0.0,0,0,0,0,0,0,0,,0,0,0,0,0,0,1,0,Matches
2011,Yussuf Poulsen,dk DEN,FW,RB Leipzig,de Bundesliga,25,1994,13.6,14,10,2,10,2,4,21,19.0,17,12,0,12,4,18,15,0,Matches
2012,Maxime Poundjé,fr FRA,DF,Bordeaux,fr Ligue 1,26,1992,0.0,0,0,0,0,0,0,0,,0,0,0,0,0,0,0,0,Matches
2013,Darío Poveda,es ESP,MF,Atlético Madrid,es La Liga,22,1997,0.1,1,0,0,1,0,0,0,,0,0,0,0,0,1,0,0,Matches
2014,Alejandro Pozo Pozo,es ESP,DF,Mallorca,es La Liga,20,1999,16.6,38,24,30,6,2,19,38,50.0,19,23,2,21,23,61,29,1,Matches
2015,Alejandro Pozo Pozo,es ESP,"MF,FW",Sevilla,es La Liga,20,1999,0.4,1,1,1,0,0,1,1,100.0,0,0,0,0,0,1,1,0,Matches
2016,Percy Prado,pe PER,DF,Nantes,fr Ligue 1,23,1996,2.1,6,5,3,2,1,5,9,55.6,4,1,0,1,1,7,5,0,Matches
2017,Dennis Praet,be BEL,MF,Leicester City,eng Premier League,25,1994,12.6,33,18,8,21,4,9,29,31.0,20,19,1,18,17,50,12,0,Matches
2018,Abdón Prats,es ESP,FW,Mallorca,es La Liga,26,1992,3.1,1,1,0,0,1,0,1,0.0,1,1,0,1,0,1,1,0,Matches
2019,Sanjin Prcić,ba BIH,"MF,FW",Strasbourg,fr Ligue 1,25,1993,0.9,1,0,0,0,1,1,2,50.0,1,1,1,0,1,2,0,0,Matches
2020,Nicolas de Préville,fr FRA,"MF,FW",Bordeaux,fr Ligue 1,28,1991,22.2,35,21,9,22,4,18,56,32.1,38,15,3,12,6,41,19,0,Matches
2021,Sebastian Prödl,at AUT,DF,Watford,eng Premier League,32,1987,0.6,0,0,0,0,0,0,0,,0,0,0,0,0,0,4,0,Matches
2022,Kai Pröger,de GER,"MF,FW",Paderborn 07,de Bundesliga,27,1992,23.1,43,22,21,17,5,17,58,29.3,41,34,6,28,14,57,20,1,Matches
2023,Grischa Prömel,de GER,MF,Union Berlin,de Bundesliga,24,1995,10.3,14,11,6,6,2,7,19,36.8,12,10,2,8,14,28,9,0,Matches
2024,Davy Pröpper,nl NED,MF,Brighton,eng Premier League,27,1991,31.4,64,35,28,28,8,23,74,31.1,51,27,8,19,38,102,36,4,Matches
2025,Antonio Puertas,es ESP,"FW,MF",Granada,es La Liga,27,1992,28.5,37,24,8,18,11,16,53,30.2,37,21,3,18,12,49,21,0,Matches
2026,Riqui Puig,es ESP,MF,Barcelona,es La Liga,19,1999,5.7,11,7,1,9,1,5,17,29.4,12,2,0,2,5,16,1,0,Matches
2027,Teemu Pukki,fi FIN,FW,Norwich City,eng Premier League,29,1990,32.1,12,6,3,5,4,1,23,4.3,22,13,0,13,6,18,7,0,Matches
2028,Erick Pulgar,cl CHI,MF,Fiorentina,it Serie A,25,1994,32.8,73,46,25,41,7,22,96,22.9,74,45,15,30,49,122,53,1,Matches
2029,Christian Pulisic,us USA,FW,Chelsea,eng Premier League,20,1998,19.1,23,11,13,4,6,7,24,29.2,17,15,0,15,6,29,11,0,Matches
2030,Ignacio Pussetto,ar ARG,"FW,MF",Watford,eng Premier League,23,1995,0.8,7,4,4,2,1,3,8,37.5,5,2,1,1,3,10,4,0,Matches
2031,Ignacio Pussetto,ar ARG,"FW,MF",Udinese,it Serie A,23,1995,3.8,8,4,4,3,1,1,4,25.0,3,3,0,3,4,12,7,0,Matches
2032,Fabio Quagliarella,it ITA,FW,Sampdoria,it Serie A,36,1983,25.3,9,5,0,6,3,2,30,6.7,28,13,0,13,8,17,15,0,Matches
2033,Robin Quaison,se SWE,"FW,MF",Mainz 05,de Bundesliga,25,1993,28.9,25,17,15,7,3,11,32,34.4,21,27,5,22,11,36,8,0,Matches
2034,Domingos Quina,pt POR,"MF,FW",Watford,eng Premier League,19,1999,0.2,2,0,1,1,0,1,2,50.0,1,3,0,3,0,2,0,0,Matches
2035,Quini,es ESP,DF,Granada,es La Liga,29,1989,8.0,25,14,16,7,2,13,22,59.1,9,5,1,4,10,35,14,0,Matches
2036,Xavi Quintillà,es ESP,DF,Villarreal,es La Liga,22,1996,17.5,22,12,14,4,4,10,20,50.0,10,11,4,7,12,34,35,0,Matches
2037,Quique,es ESP,"FW,MF",Eibar,es La Liga,29,1990,5.4,2,1,1,0,1,0,0,,0,3,0,3,0,2,3,0,Matches
2038,Adrien Rabiot,fr FRA,MF,Juventus,it Serie A,24,1995,21.2,47,31,16,19,12,15,41,36.6,26,36,6,30,32,79,19,0,Matches
2039,Nemanja Radoja,rs SRB,MF,Levante,es La Liga,26,1993,22.1,43,19,27,16,0,15,46,32.6,31,21,4,17,23,66,24,0,Matches
2040,Nemanja Radonjić,rs SRB,"FW,MF",Marseille,fr Ligue 1,23,1996,9.8,10,3,4,3,3,6,17,35.3,11,7,0,7,2,12,7,0,Matches
2041,Ivan Radovanović,rs SRB,MF,Genoa,it Serie A,30,1988,14.6,27,14,18,9,0,10,26,38.5,16,17,3,14,8,35,39,0,Matches
2042,Ionuț Radu,ro ROU,GK,Genoa,it Serie A,22,1997,17.0,0,0,0,0,0,0,2,0.0,2,0,0,0,1,1,7,1,Matches
2043,Ștefan Radu,ro ROU,DF,Lazio,it Serie A,32,1986,25.6,43,25,24,15,4,28,43,65.1,15,19,9,10,34,77,85,0,Matches
2044,Boris Radunović,rs SRB,GK,Hellas Verona,it Serie A,23,1996,3.0,0,0,0,0,0,0,0,,0,0,0,0,0,0,1,0,Matches
2045,Rafael,br BRA,GK,Cagliari,it Serie A,37,1982,5.0,0,0,0,0,0,0,0,,0,0,0,0,0,0,3,0,Matches
2046,Rafael,br BRA,DF,Lyon,fr Ligue 1,29,1990,7.8,24,16,12,8,4,10,18,55.6,8,6,3,3,10,34,14,0,Matches
2047,Raffael,br BRA,"MF,FW",Gladbach,de Bundesliga,34,1985,0.7,0,0,0,0,0,0,2,0.0,2,2,0,2,0,0,0,0,Matches
2048,Rafinha,br BRA,"FW,MF",Barcelona,es La Liga,26,1993,2.1,3,2,1,1,1,1,2,50.0,1,0,0,0,1,4,0,0,Matches
2049,Rafinha,br BRA,MF,Celta Vigo,es La Liga,26,1993,23.5,71,37,29,37,5,20,62,32.3,42,37,4,33,33,104,25,0,Matches
2050,Daniele Ragatzu,it ITA,"MF,FW",Cagliari,it Serie A,27,1991,3.5,3,2,0,2,1,1,3,33.3,2,1,0,1,1,4,5,0,Matches
2051,Baba Rahman,gh GHA,DF,Mallorca,es La Liga,25,1994,1.2,3,2,2,0,1,0,0,,0,2,1,1,1,4,2,0,Matches
2052,Antonio Raillo,es ESP,DF,Mallorca,es La Liga,27,1991,30.8,31,21,24,7,0,13,19,68.4,6,31,26,5,22,53,112,1,Matches
2053,Predrag Rajković,rs SRB,GK,Reims,fr Ligue 1,23,1995,27.0,1,1,1,0,0,1,1,100.0,0,0,0,0,1,2,9,0,Matches
2054,Ivan Rakitić,hr CRO,MF,Barcelona,es La Liga,31,1988,17.7,27,14,8,15,4,10,28,35.7,18,19,6,13,15,42,18,1,Matches
2055,Benito Raman,be BEL,FW,Schalke 04,de Bundesliga,24,1994,17.8,18,9,4,9,5,7,24,29.2,17,11,1,10,7,25,1,0,Matches
2056,Gastón Ramírez,uy URU,"MF,FW",Sampdoria,it Serie A,28,1990,15.5,32,21,7,16,9,8,30,26.7,22,28,2,26,11,43,10,0,Matches
2057,Sandro Ramírez,es ESP,"FW,MF",Valladolid,es La Liga,24,1995,14.5,12,10,2,6,4,2,20,10.0,18,11,1,10,7,19,2,0,Matches
2058,Iván Ramis,es ESP,DF,Eibar,es La Liga,34,1984,5.1,3,2,2,1,0,1,4,25.0,3,2,0,2,4,7,23,2,Matches
2059,Adrián Ramos,co COL,"FW,MF",Granada,es La Liga,33,1986,2.5,6,2,0,2,4,2,3,66.7,1,2,0,2,1,7,1,0,Matches
2060,Sergio Ramos,es ESP,DF,Real Madrid,es La Liga,33,1986,33.5,46,31,26,17,3,20,42,47.6,22,22,9,13,49,95,102,4,Matches
2061,Aaron Ramsdale,eng ENG,GK,Bournemouth,eng Premier League,21,1998,37.0,4,3,4,0,0,3,3,100.0,0,0,0,0,0,4,25,1,Matches
2062,Aaron Ramsey,wls WAL,MF,Juventus,it Serie A,28,1990,11.7,20,15,6,8,6,6,24,25.0,18,18,3,15,11,31,12,0,Matches
2063,Darren Randolph,ie IRL,GK,West Ham,eng Premier League,32,1987,2.0,0,0,0,0,0,0,0,,0,0,0,0,0,0,2,0,Matches
2064,Luca Ranieri,it ITA,DF,Fiorentina,it Serie A,20,1999,2.6,2,2,2,0,0,2,3,66.7,1,1,0,1,2,4,7,0,Matches
2065,Andrea Ranocchia,it ITA,DF,Inter,it Serie A,31,1988,5.8,17,10,10,7,0,5,8,62.5,3,11,6,5,8,25,18,0,Matches
2066,Raphinha,br BRA,"MF,FW",Rennes,fr Ligue 1,22,1996,18.8,22,18,5,12,5,10,32,31.3,22,23,1,22,17,39,14,1,Matches
2067,Tobias Raschl,de GER,MF,Dortmund,de Bundesliga,19,2000,0.3,0,0,0,0,0,0,1,0.0,1,1,0,1,0,0,0,0,Matches
2068,Marcus Rashford,eng ENG,FW,Manchester Utd,eng Premier League,21,1997,29.4,13,9,1,6,6,9,23,39.1,14,23,0,23,10,23,19,0,Matches
2069,Milot Rashica,xk KVX,FW,Werder Bremen,de Bundesliga,23,1996,25.2,21,14,13,6,2,9,33,27.3,24,15,2,13,6,27,16,1,Matches
2070,Giacomo Raspadori,it ITA,"MF,FW",Sassuolo,it Serie A,19,2000,2.9,8,6,5,2,1,3,4,75.0,1,5,0,5,1,9,0,0,Matches
2071,Raúl,es ESP,"FW,MF",Betis,es La Liga,18,2000,0.2,0,0,0,0,0,0,2,0.0,2,0,0,0,0,0,0,0,Matches
2072,Ante Rebić,hr CRO,"FW,MF",Milan,it Serie A,25,1993,15.5,16,11,4,9,3,7,34,20.6,27,14,1,13,3,19,12,0,Matches
2073,Ante Rebić,hr CRO,"FW,MF",Eint Frankfurt,de Bundesliga,25,1993,1.0,1,0,0,1,0,0,0,,0,0,0,0,0,1,1,0,Matches
2074,Arkadiusz Reca,pl POL,DF,SPAL,it Serie A,24,1995,21.4,38,23,22,10,6,13,39,33.3,26,15,2,13,32,70,48,1,Matches
2075,Recio,es ESP,MF,Leganés,es La Liga,28,1991,17.4,30,19,13,12,5,10,40,25.0,30,14,3,11,22,52,9,0,Matches
2076,Daishawn Redan,nl NED,MF,Hertha BSC,de Bundesliga,18,2001,0.2,0,0,0,0,0,0,1,0.0,1,0,0,0,0,0,0,0,Matches
2077,Nathan Redmond,eng ENG,"MF,FW",Southampton,eng Premier League,25,1994,30.7,49,29,17,23,9,21,57,36.8,36,39,2,37,16,65,16,0,Matches
2078,Fabian Reese,de GER,FW,Schalke 04,de Bundesliga,21,1997,1.0,1,1,1,0,0,0,0,,0,1,1,0,0,1,1,0,Matches
2079,Vasco Regini,it ITA,DF,Sampdoria,it Serie A,28,1990,1.9,4,2,3,1,0,0,0,,0,4,2,2,1,5,6,0,Matches
2080,Vasco Regini,it ITA,DF,Parma,it Serie A,28,1990,0.6,0,0,0,0,0,0,0,,0,0,0,0,0,0,3,0,Matches
2081,Sergio Reguilón,es ESP,DF,Sevilla,es La Liga,22,1996,27.9,57,30,28,25,4,27,64,42.2,37,25,5,20,33,90,53,0,Matches
2082,Ken Reichel,de GER,DF,Union Berlin,de Bundesliga,32,1986,5.9,6,3,2,3,1,3,13,23.1,10,8,1,7,9,15,12,0,Matches
2083,Manolo Reina,es ESP,GK,Mallorca,es La Liga,34,1985,36.0,0,0,0,0,0,0,1,0.0,1,2,0,2,5,5,9,1,Matches
2084,Pepe Reina,es ESP,GK,Aston Villa,eng Premier League,36,1982,12.0,0,0,0,0,0,0,2,0.0,2,0,0,0,0,0,9,1,Matches
2085,Pepe Reina,es ESP,GK,Milan,it Serie A,36,1982,1.0,0,0,0,0,0,0,0,,0,0,0,0,0,0,0,1,Matches
2086,Jeff Reine-Adélaïde,fr FRA,MF,Angers,fr Ligue 1,21,1998,0.9,3,1,1,2,0,1,1,100.0,0,1,0,1,0,3,1,0,Matches
2087,Jeff Reine-Adélaïde,fr FRA,"MF,FW",Lyon,fr Ligue 1,21,1998,8.7,10,8,3,3,4,5,13,38.5,8,3,1,2,7,17,4,0,Matches
2088,Karim Rekik,nl NED,DF,Hertha BSC,de Bundesliga,24,1994,14.0,16,10,10,6,0,3,6,50.0,3,23,15,8,18,34,44,0,Matches
2089,Álex Remiro,es ESP,GK,Real Sociedad,es La Liga,24,1995,25.0,0,0,0,0,0,0,1,0.0,1,0,0,0,0,0,25,1,Matches
2090,Loïc Rémy,fr FRA,FW,Lille,fr Ligue 1,32,1987,10.7,4,1,0,3,1,0,4,0.0,4,1,1,0,0,4,7,0,Matches
2091,Panagiotis Retsos,gr GRE,DF,Leverkusen,de Bundesliga,20,1998,1.3,6,3,4,2,0,1,4,25.0,3,2,0,2,2,8,2,0,Matches
2092,Marco Reus,de GER,"MF,FW",Dortmund,de Bundesliga,30,1989,16.6,26,16,5,11,10,3,19,15.8,16,17,2,15,9,35,11,0,Matches
2093,Elvis Rexhbeçaj,de GER,MF,Köln,de Bundesliga,21,1997,6.9,16,12,9,5,2,5,13,38.5,8,7,0,7,3,19,4,0,Matches
2094,Gio Reyna,us USA,"MF,FW",Dortmund,de Bundesliga,16,2002,3.9,6,2,1,5,0,1,4,25.0,3,3,0,3,0,6,2,0,Matches
2095,Baptiste Reynet,fr FRA,GK,Toulouse,fr Ligue 1,28,1990,22.6,1,1,1,0,0,1,3,33.3,2,0,0,0,0,1,12,0,Matches
2096,Nico Ribaudo,es ESP,"FW,MF",Espanyol,es La Liga,18,2001,2.0,3,1,1,0,2,2,6,33.3,4,1,0,1,1,4,0,0,Matches
2097,Lucas Ribeiro,br BRA,MF,Hoffenheim,de Bundesliga,20,1999,0.7,1,0,1,0,0,0,3,0.0,3,1,0,1,1,2,1,0,Matches
2098,Franck Ribéry,fr FRA,FW,Fiorentina,it Serie A,36,1983,15.7,20,14,7,10,3,4,20,20.0,16,9,0,9,3,23,3,0,Matches
2099,Davide Riccardi,it ITA,DF,Lecce,it Serie A,23,1996,0.2,0,0,0,0,0,0,1,0.0,1,0,0,0,0,0,1,0,Matches
2100,Declan Rice,eng ENG,MF,West Ham,eng Premier League,20,1999,38.0,116,60,64,48,4,47,98,48.0,51,41,9,32,77,193,55,0,Matches
2101,Chris Richards,us USA,DF,Bayern Munich,de Bundesliga,19,2000,0.1,0,0,0,0,0,0,0,,0,0,0,0,0,0,1,0,Matches
2102,Richarlison,br BRA,"FW,MF",Everton,eng Premier League,22,1997,34.1,70,47,28,28,14,27,56,48.2,29,34,4,30,12,82,42,0,Matches
2103,Marco Richter,de GER,"MF,FW",Augsburg,de Bundesliga,21,1997,25.3,21,16,7,9,5,14,51,27.5,37,15,0,15,24,45,17,0,Matches
2104,Diego Rico,es ESP,DF,Bournemouth,eng Premier League,26,1993,25.9,61,39,32,24,5,29,59,49.2,30,31,7,24,84,145,91,0,Matches
2105,Sergio Rico,es ESP,GK,Paris S-G,fr Ligue 1,25,1993,2.0,0,0,0,0,0,0,0,,0,0,0,0,0,0,1,2,Matches
2106,Jaïro Riedewald,nl NED,"DF,MF",Crystal Palace,eng Premier League,22,1996,8.5,14,10,4,10,0,7,11,63.6,4,7,2,5,17,31,23,1,Matches
2107,Emiliano Rigoni,ar ARG,"MF,FW",Sampdoria,it Serie A,26,1993,4.8,5,4,2,1,2,3,10,30.0,7,5,1,4,3,8,1,0,Matches
2108,Tomás Rincón,ve VEN,MF,Torino,it Serie A,31,1988,30.0,56,25,23,25,8,23,65,35.4,42,20,3,17,36,92,62,0,Matches
2109,Luis Rioja,es ESP,MF,Alavés,es La Liga,25,1993,18.2,18,12,11,6,1,8,25,32.0,17,21,0,21,16,34,6,0,Matches
2110,Renaud Ripart,fr FRA,"FW,DF",Nîmes,fr Ligue 1,26,1993,22.5,39,23,17,20,2,18,46,39.1,28,17,2,15,12,51,37,0,Matches
2111,Rodrigo Riquelme,es ESP,"FW,MF",Atlético Madrid,es La Liga,19,2000,0.1,0,0,0,0,0,0,0,,0,0,0,0,0,0,0,0,Matches
2112,Andrea Rispoli,it ITA,DF,Lecce,it Serie A,30,1988,21.2,24,18,14,9,1,15,30,50.0,15,28,7,21,32,56,62,1,Matches
2113,Marcel Risse,de GER,"MF,FW",Köln,de Bundesliga,29,1989,1.5,3,2,3,0,0,1,1,100.0,0,1,0,1,1,4,1,0,Matches
2114,Mihailo Ristić,rs SRB,"DF,MF",Montpellier,fr Ligue 1,23,1995,9.0,18,14,7,11,0,9,20,45.0,11,7,2,5,7,25,18,0,Matches
2115,Matt Ritchie,sct SCO,"DF,MF",Newcastle Utd,eng Premier League,29,1989,14.6,22,15,9,10,3,3,15,20.0,12,20,5,15,14,36,31,1,Matches
2116,Marlon Ritter,de GER,MF,Paderborn 07,de Bundesliga,24,1994,4.8,7,5,5,2,0,4,9,44.4,5,7,0,7,8,15,3,0,Matches
2117,Cristian Rivera,es ESP,MF,Leganés,es La Liga,22,1997,3.5,6,4,3,2,1,2,4,50.0,2,4,3,1,4,10,7,0,Matches
2118,Maxence Rivera,fr FRA,"MF,FW",Saint-Étienne,fr Ligue 1,17,2002,0.3,0,0,0,0,0,0,1,0.0,1,1,0,1,0,0,0,0,Matches
2119,Rober,es ESP,DF,Levante,es La Liga,24,1995,2.1,3,1,2,0,1,2,2,100.0,0,0,0,0,3,6,2,0,Matches
2120,Roberto,es ESP,GK,West Ham,eng Premier League,33,1986,7.6,0,0,0,0,0,0,0,,0,0,0,0,0,0,2,2,Matches
2121,Roberto,es ESP,GK,Alavés,es La Liga,33,1986,8.8,1,1,1,0,0,1,1,100.0,0,0,0,0,0,1,2,0,Matches
2122,Sergi Roberto,es ESP,"DF,MF",Barcelona,es La Liga,27,1992,26.0,35,22,16,11,8,15,25,60.0,10,12,3,9,33,68,36,0,Matches
2123,Patrick Roberts,eng ENG,"FW,MF",Norwich City,eng Premier League,22,1997,0.3,0,0,0,0,0,0,0,,0,0,0,0,0,0,0,0,Matches
2124,Andrew Robertson,sct SCO,DF,Liverpool,eng Premier League,25,1994,34.6,54,31,17,25,12,27,61,44.3,34,29,7,22,38,92,72,1,Matches
2125,Callum Robinson,ie IRL,"FW,MF",Sheffield Utd,eng Premier League,24,1995,7.5,6,3,2,2,2,2,7,28.6,5,3,0,3,7,13,3,0,Matches
2126,Jack Robinson,eng ENG,DF,Sheffield Utd,eng Premier League,25,1993,5.6,10,5,5,5,0,1,6,16.7,5,12,5,7,8,18,24,0,Matches
2127,Joel Robles,es ESP,GK,Betis,es La Liga,29,1990,32.1,0,0,0,0,0,0,2,0.0,2,0,0,0,0,0,13,2,Matches
2128,Marc Roca,es ESP,MF,Espanyol,es La Liga,22,1996,33.4,82,52,29,44,9,29,82,35.4,53,28,10,18,31,113,53,2,Matches
2129,Rubén Rochina,es ESP,MF,Levante,es La Liga,28,1991,20.8,41,26,22,9,10,19,52,36.5,33,16,0,16,12,53,19,1,Matches
2130,Sebastian Rode,de GER,MF,Eint Frankfurt,de Bundesliga,28,1990,21.5,58,33,27,27,4,17,59,28.8,42,32,5,27,34,92,13,0,Matches
2131,Rodri,es ESP,MF,Manchester City,eng Premier League,23,1996,27.6,50,30,17,25,8,23,63,36.5,40,19,5,14,26,76,35,0,Matches
2132,Rodrigo,es ESP,FW,Valencia,es La Liga,28,1991,20.9,10,6,4,5,1,2,23,8.7,21,9,1,8,9,19,13,0,Matches
2133,Kévin Rodrigues,pt POR,"DF,MF",Leganés,es La Liga,25,1994,21.5,56,31,31,17,8,25,46,54.3,21,30,3,27,31,87,26,1,Matches
2134,Kévin Rodrigues,pt POR,DF,Real Sociedad,es La Liga,25,1994,0.1,1,0,1,0,0,1,1,100.0,0,0,0,0,0,1,0,0,Matches
2135,Ángel Rodríguez,es ESP,FW,Getafe,es La Liga,32,1987,15.6,14,8,2,8,4,2,18,11.1,16,10,1,9,3,17,10,0,Matches
2136,Óscar Rodríguez Arnaiz,es ESP,"MF,FW",Leganés,es La Liga,21,1998,21.3,23,10,11,7,5,13,41,31.7,28,19,0,19,14,37,13,0,Matches
2137,Dani Rodríguez,es ESP,"MF,FW",Mallorca,es La Liga,31,1988,33.8,59,32,24,28,7,18,61,29.5,43,35,3,32,38,97,27,1,Matches
2138,Guido Rodríguez,ar ARG,MF,Betis,es La Liga,25,1994,10.4,24,16,11,11,2,15,25,60.0,10,13,4,9,10,34,21,0,Matches
2139,James Rodríguez,co COL,"MF,FW",Real Madrid,es La Liga,28,1991,4.7,17,13,6,8,3,6,12,50.0,6,3,0,3,3,20,1,0,Matches
2140,Jay Rodriguez,eng ENG,FW,Burnley,eng Premier League,30,1989,22.4,29,19,4,13,12,8,33,24.2,25,33,6,27,5,34,12,0,Matches
2141,Mario Rodriguez,es ESP,MF,Granada,es La Liga,22,1997,0.0,0,0,0,0,0,0,0,,0,0,0,0,0,0,0,0,Matches
2142,Ricardo Rodríguez,ch SUI,DF,Milan,it Serie A,26,1992,4.3,6,1,2,2,2,2,6,33.3,4,3,2,1,5,11,17,0,Matches
2143,Rodrygo,br BRA,FW,Real Madrid,es La Liga,18,2001,11.3,6,1,2,3,1,2,21,9.5,19,13,0,13,10,16,5,0,Matches
2144,Jack Rodwell,eng ENG,MF,Sheffield Utd,eng Premier League,28,1991,0.2,0,0,0,0,0,0,0,,0,0,0,0,0,0,1,0,Matches
2145,Marko Rog,hr CRO,MF,Cagliari,it Serie A,24,1995,25.7,69,47,31,29,9,22,84,26.2,62,40,12,28,22,91,23,0,Matches
2146,Agustín Rogel,uy URU,DF,Toulouse,fr Ligue 1,21,1997,9.5,15,8,12,3,0,7,13,53.8,6,13,10,3,11,26,35,2,Matches
2147,Rogério,br BRA,DF,Sassuolo,it Serie A,21,1998,11.3,22,14,12,8,2,16,23,69.6,7,13,3,10,9,31,34,0,Matches
2148,Marcos Rojo,ar ARG,DF,Manchester Utd,eng Premier League,29,1990,1.4,3,1,2,1,0,1,2,50.0,1,2,1,1,0,3,6,0,Matches
2149,Filippo Romagna,it ITA,DF,Sassuolo,it Serie A,22,1997,16.4,7,6,2,5,0,5,6,83.3,1,24,17,7,10,17,69,0,Matches
2150,Alessio Romagnoli,it ITA,DF,Milan,it Serie A,24,1995,34.3,46,25,28,15,3,16,27,59.3,11,32,18,14,56,102,157,1,Matches
2151,Alaixys Romao,tg TOG,MF,Reims,fr Ligue 1,35,1984,19.8,46,29,31,14,1,17,57,29.8,40,12,3,9,26,72,38,3,Matches
2152,Cristian Romero,ar ARG,DF,Genoa,it Serie A,21,1998,28.6,52,35,36,12,4,12,41,29.3,29,59,33,26,75,127,116,2,Matches
2153,Luka Romero,ar ARG,FW,Mallorca,es La Liga,14,2004,0.1,0,0,0,0,0,0,0,,0,0,0,0,0,0,0,0,Matches
2154,Oriol Romeu,es ESP,MF,Southampton,eng Premier League,27,1991,20.7,55,35,23,30,2,27,75,36.0,48,35,13,22,34,89,32,0,Matches
2155,Rômulo,it ITA,MF,Brescia,it Serie A,32,1987,19.1,30,19,12,14,4,12,34,35.3,22,18,1,17,8,38,12,1,Matches
2156,Rômulo,it ITA,DF,Genoa,it Serie A,32,1987,0.2,2,1,1,1,0,0,0,,0,0,0,0,0,2,1,0,Matches
2157,Cristiano Ronaldo,pt POR,FW,Juventus,it Serie A,34,1985,32.4,14,10,3,3,8,4,20,20.0,16,10,3,7,6,20,21,1,Matches
2158,Facundo Roncaglia,ar ARG,DF,Osasuna,es La Liga,32,1987,14.2,24,20,12,10,2,11,20,55.0,9,18,3,15,22,46,46,0,Matches
2159,Valentin Rongier,fr FRA,MF,Marseille,fr Ligue 1,24,1994,19.9,76,51,25,41,10,22,63,34.9,41,30,4,26,36,112,16,2,Matches
2160,Valentin Rongier,fr FRA,MF,Nantes,fr Ligue 1,24,1994,3.0,5,4,0,2,3,3,5,60.0,2,4,0,4,2,7,0,0,Matches
2161,Marten de Roon,nl NED,"MF,DF",Atalanta,it Serie A,28,1991,30.2,77,43,36,29,12,34,75,45.3,41,32,8,24,46,123,45,0,Matches
2162,Roberto Rosales,ve VEN,DF,Leganés,es La Liga,30,1988,20.8,42,23,23,17,2,19,43,44.2,24,17,4,13,30,72,48,0,Matches
2163,Antonio Rosati,it ITA,GK,Torino,it Serie A,36,1983,1.0,0,0,0,0,0,0,0,,0,0,0,0,0,0,0,1,Matches
2164,Danny Rose,eng ENG,DF,Tottenham,eng Premier League,29,1990,9.9,18,11,6,10,2,9,20,45.0,11,14,6,8,8,26,34,2,Matches
2165,Danny Rose,eng ENG,DF,Newcastle Utd,eng Premier League,29,1990,9.6,21,12,11,8,2,12,21,57.1,9,11,4,7,10,31,14,1,Matches
2166,Luca Rossettini,it ITA,DF,Lecce,it Serie A,34,1985,25.1,25,14,18,7,0,17,34,50.0,17,31,22,9,35,60,126,1,Matches
2167,Francesco Rossi,it ITA,GK,Atalanta,it Serie A,28,1991,0.1,0,0,0,0,0,0,0,,0,0,0,0,0,0,0,0,Matches
2168,Jérôme Roussillon,fr FRA,DF,Wolfsburg,de Bundesliga,26,1993,26.3,48,29,26,18,4,15,29,51.7,14,33,5,28,30,78,58,0,Matches
2169,Nolan Roux,fr FRA,FW,Nîmes,fr Ligue 1,31,1988,6.5,5,2,1,3,1,1,3,33.3,2,2,0,2,4,9,5,0,Matches
2170,Nicolò Rovella,it ITA,MF,Genoa,it Serie A,17,2001,1.2,0,0,0,0,0,0,1,0.0,1,0,0,0,4,4,0,0,Matches
2171,Amir Rrahmani,xk KVX,DF,Hellas Verona,it Serie A,25,1994,35.9,50,31,26,19,5,26,46,56.5,20,50,31,19,30,80,151,1,Matches
2172,Rubén,es ESP,GK,Osasuna,es La Liga,35,1984,17.6,1,1,1,0,0,1,1,100.0,0,0,0,0,0,1,9,1,Matches
2173,Waldo Rubio,es ESP,"MF,FW",Valladolid,es La Liga,23,1995,9.8,13,8,10,3,0,5,31,16.1,26,12,0,12,7,20,7,0,Matches
2174,Antonio Rüdiger,de GER,DF,Chelsea,eng Premier League,26,1993,19.0,28,18,19,7,2,16,25,64.0,9,15,9,6,16,44,59,1,Matches
2175,Sebastian Rudy,de GER,"MF,DF",Hoffenheim,de Bundesliga,29,1990,30.4,73,49,31,29,13,28,75,37.3,47,26,5,21,27,100,38,0,Matches
2176,Stéphane Ruffier,fr FRA,GK,Saint-Étienne,fr Ligue 1,32,1986,22.0,0,0,0,0,0,0,0,,0,0,0,0,0,0,5,3,Matches
2177,Dion Ruffo Luci,it ITA,MF,Bologna,it Serie A,18,2001,0.0,0,0,0,0,0,0,0,,0,0,0,0,0,0,0,0,Matches
2178,Daniele Rugani,it ITA,DF,Juventus,it Serie A,25,1994,7.7,8,6,4,4,0,4,5,80.0,1,4,4,0,11,19,18,0,Matches
2179,Mário Rui,pt POR,DF,Napoli,it Serie A,28,1991,21.8,31,17,12,12,7,11,29,37.9,18,24,5,19,21,52,43,0,Matches
2180,Aitor Ruibal,es ESP,"DF,MF",Leganés,es La Liga,23,1996,13.6,27,17,14,11,2,16,39,41.0,23,18,1,17,8,35,11,0,Matches
2181,Fabián Ruiz Peña,es ESP,MF,Napoli,it Serie A,23,1996,29.8,43,26,19,18,6,24,65,36.9,41,32,4,28,32,75,18,2,Matches
2182,Gerónimo Rulli,ar ARG,GK,Montpellier,fr Ligue 1,27,1992,25.0,3,1,3,0,0,3,4,75.0,1,1,0,1,2,5,9,1,Matches
2183,Lukas Rupp,de GER,"FW,MF",Norwich City,eng Premier League,28,1991,7.7,15,9,7,5,3,5,17,29.4,12,11,0,11,15,30,4,0,Matches
2184,Lukas Rupp,de GER,MF,Hoffenheim,de Bundesliga,28,1991,3.8,9,4,3,5,1,3,6,50.0,3,5,0,5,5,14,3,0,Matches
2185,Mathew Ryan,au AUS,GK,Brighton,eng Premier League,27,1992,38.0,1,1,1,0,0,1,4,25.0,3,0,0,0,2,3,13,2,Matches
2186,Julian Ryerson,no NOR,"DF,MF",Union Berlin,de Bundesliga,21,1997,4.1,7,5,2,1,4,3,6,50.0,3,5,3,2,5,12,9,0,Matches
2187,Frederik Rønnow,dk DEN,GK,Eint Frankfurt,de Bundesliga,26,1992,9.0,0,0,0,0,0,0,1,0.0,1,0,0,0,0,0,1,0,Matches
2188,João Victor Santos Sá,br BRA,"MF,FW",Wolfsburg,de Bundesliga,25,1994,18.1,35,22,12,17,6,10,38,26.3,28,31,1,30,9,44,9,0,Matches
2189,Roli Pereira de Sa,fr FRA,MF,Nantes,fr Ligue 1,22,1996,0.1,0,0,0,0,0,0,0,,0,0,0,0,0,0,0,0,Matches
2190,Youssouf Sabaly,sn SEN,DF,Bordeaux,fr Ligue 1,26,1993,10.1,18,11,9,4,5,6,22,27.3,16,8,1,7,18,36,23,0,Matches
2191,Stefano Sabelli,it ITA,DF,Brescia,it Serie A,26,1993,35.2,83,44,51,28,4,50,106,47.2,56,40,13,27,58,141,107,0,Matches
2192,Abdelhamid Sabiri,ma MAR,MF,Paderborn 07,de Bundesliga,22,1996,11.6,20,16,6,11,3,9,27,33.3,18,9,2,7,8,28,18,1,Matches
2193,Marcel Sabitzer,at AUT,"MF,FW",RB Leipzig,de Bundesliga,25,1994,27.8,39,25,15,18,6,19,56,33.9,37,27,4,23,23,62,25,0,Matches
2194,Ihsan Sacko,fr FRA,FW,Nice,fr Ligue 1,22,1997,1.6,1,1,1,0,0,0,1,0.0,1,0,0,0,0,1,0,0,Matches
2195,Alexis Saelemaekers,be BEL,"FW,DF",Milan,it Serie A,20,1999,7.6,14,8,5,7,2,6,20,30.0,14,13,1,12,8,22,1,0,Matches
2196,Jorge Sáenz,es ESP,DF,Celta Vigo,es La Liga,22,1996,4.1,6,1,4,2,0,3,5,60.0,2,5,2,3,10,16,15,0,Matches
2197,Nuri Şahin,tr TUR,MF,Werder Bremen,de Bundesliga,30,1988,13.9,27,16,10,14,3,11,35,31.4,24,15,7,8,37,64,38,0,Matches
2198,Wesley Saïd,fr FRA,"MF,FW",Toulouse,fr Ligue 1,24,1995,12.9,20,9,8,10,2,2,13,15.4,11,6,0,6,9,29,8,0,Matches
2199,Allan Saint-Maximin,fr FRA,"MF,FW",Newcastle Utd,eng Premier League,22,1997,20.7,13,8,7,4,2,4,18,22.2,14,5,2,3,9,22,6,0,Matches
2200,Théo Sainte-Luce,fr FRA,"MF,DF",Nîmes,fr Ligue 1,20,1998,0.2,0,0,0,0,0,0,0,,0,0,0,0,0,0,0,0,Matches
2201,Borja Sainz,es ESP,"MF,FW",Alavés,es La Liga,18,2001,6.4,16,9,4,9,3,8,26,30.8,18,14,0,14,3,19,0,0,Matches
2202,Romain Saïss,ma MAR,DF,Wolves,eng Premier League,29,1990,30.1,55,38,37,15,3,32,46,69.6,14,31,16,15,55,110,127,3,Matches
2203,Bukayo Saka,eng ENG,"DF,FW",Arsenal,eng Premier League,17,2001,19.5,36,21,21,8,7,19,37,51.4,18,12,3,9,12,48,19,0,Matches
2204,Hiroki Sakai,jp JPN,DF,Marseille,fr Ligue 1,29,1990,18.0,57,36,26,24,7,25,40,62.5,15,20,5,15,23,80,34,1,Matches
2205,Mamadou Sakho,fr FRA,DF,Crystal Palace,eng Premier League,29,1990,10.3,7,5,5,1,1,2,5,40.0,3,12,5,7,20,27,46,2,Matches
2206,Jacopo Sala,it ITA,DF,SPAL,it Serie A,27,1991,9.5,29,24,17,11,1,17,31,54.8,14,4,0,4,13,42,15,1,Matches
2207,Mohamed Salah,eg EGY,FW,Liverpool,eng Premier League,27,1992,32.0,16,6,1,4,11,5,22,22.7,17,3,1,2,8,24,2,1,Matches
2208,Bartosz Salamon,pl POL,DF,SPAL,it Serie A,28,1991,3.8,2,1,2,0,0,1,2,50.0,1,4,4,0,6,8,14,0,Matches
2209,Eddie Salcedo,it ITA,"FW,MF",Hellas Verona,it Serie A,17,2001,7.6,3,1,2,0,1,0,5,0.0,5,4,0,4,1,4,2,0,Matches
2210,William Saliba,fr FRA,DF,Saint-Étienne,fr Ligue 1,18,2001,11.0,19,9,15,3,1,5,10,50.0,5,13,4,9,21,40,36,1,Matches
2211,Yannis Salibur,fr FRA,"MF,FW",Mallorca,es La Liga,28,1991,0.9,0,0,0,0,0,0,4,0.0,4,0,0,0,1,1,1,0,Matches
2212,Romain Salin,fr FRA,GK,Rennes,fr Ligue 1,35,1984,4.0,0,0,0,0,0,0,1,0.0,1,0,0,0,0,0,3,0,Matches
2213,Mohammed Salisu,gh GHA,DF,Valladolid,es La Liga,20,1999,30.3,41,24,28,13,0,21,34,61.8,13,32,26,6,35,76,158,3,Matches
2214,Roland Sallai,hu HUN,"MF,FW",Freiburg,de Bundesliga,22,1997,12.9,17,10,4,9,4,7,20,35.0,13,12,2,10,7,24,4,0,Matches
2215,Lazar Samardzic,rs SRB,"MF,FW",Hertha BSC,de Bundesliga,17,2002,0.4,4,4,2,2,0,1,4,25.0,3,2,1,1,0,4,0,0,Matches
2216,Diadie Samassékou,ml MLI,MF,Hoffenheim,de Bundesliga,23,1996,14.6,37,18,14,17,6,12,34,35.3,22,25,8,17,40,77,27,1,Matches
2217,Mbwana Samatta,tz TAN,FW,Aston Villa,eng Premier League,26,1992,10.5,6,4,0,3,3,1,8,12.5,7,7,0,7,1,7,6,0,Matches
2218,Mama Samba Baldé,gw GNB,"FW,MF",Dijon,fr Ligue 1,23,1995,18.6,24,13,9,8,7,7,30,23.3,23,17,0,17,7,31,24,0,Matches
2219,Junior Sambia,fr FRA,"DF,MF",Montpellier,fr Ligue 1,22,1996,6.5,8,6,4,2,2,3,13,23.1,10,4,0,4,8,16,6,0,Matches
2220,Frédéric Sammaritano,fr FRA,"MF,FW",Dijon,fr Ligue 1,33,1986,5.8,9,7,4,4,1,4,11,36.4,7,6,1,5,2,11,3,1,Matches
2221,Fede San Emeterio,es ESP,MF,Valladolid,es La Liga,22,1997,19.5,26,13,18,6,2,7,29,24.1,22,20,8,12,28,54,13,1,Matches
2222,Mikel San José,es ESP,MF,Athletic Club,es La Liga,30,1989,4.0,9,4,2,4,3,2,10,20.0,8,3,1,2,9,18,12,0,Matches
2223,Antonio Sanabria,py PAR,FW,Genoa,it Serie A,23,1996,15.4,14,11,2,7,5,3,14,21.4,11,13,1,12,5,19,12,1,Matches
2224,Oihan Sancet,es ESP,"MF,FW",Athletic Club,es La Liga,19,2000,8.2,11,7,5,4,2,4,11,36.4,7,6,0,6,2,13,2,0,Matches
2225,Renato Sanches,pt POR,"MF,FW",Lille,fr Ligue 1,21,1997,16.5,28,15,9,15,4,8,33,24.2,25,19,1,18,15,43,10,1,Matches
2226,Renato Sanches,pt POR,MF,Bayern Munich,de Bundesliga,21,1997,0.1,0,0,0,0,0,0,0,,0,0,0,0,0,0,0,0,Matches
2227,Alexis Sánchez,cl CHI,FW,Inter,it Serie A,30,1988,10.3,9,7,1,4,4,5,13,38.5,8,7,0,7,3,12,1,0,Matches
2228,Carlos Sánchez,co COL,MF,West Ham,eng Premier League,33,1986,1.3,1,0,0,1,0,1,1,100.0,0,1,0,1,2,3,1,0,Matches
2229,Davinson Sánchez,co COL,DF,Tottenham,eng Premier League,23,1996,27.0,44,27,32,12,0,22,44,50.0,22,40,28,12,34,78,128,5,Matches
2230,Germán Sánchez,es ESP,DF,Granada,es La Liga,32,1986,25.5,16,10,12,4,0,6,16,37.5,10,29,23,6,33,49,115,2,Matches
2231,Javi Sánchez,es ESP,DF,Valladolid,es La Liga,22,1997,5.5,5,4,3,2,0,1,3,33.3,2,4,2,2,4,9,24,0,Matches
2232,Manu Sánchez,es ESP,DF,Atlético Madrid,es La Liga,18,2000,3.6,13,7,2,7,4,8,15,53.3,7,3,0,3,7,20,1,0,Matches
2233,Víctor Sánchez,es ESP,MF,Espanyol,es La Liga,31,1987,18.8,66,36,36,23,7,30,71,42.3,41,31,8,23,27,93,23,1,Matches
2234,Jadon Sancho,eng ENG,"FW,MF",Dortmund,de Bundesliga,19,2000,25.4,14,11,6,6,2,8,24,33.3,16,8,0,8,14,28,6,0,Matches
2235,Alex Sandro,br BRA,DF,Juventus,it Serie A,28,1991,26.5,44,26,23,14,7,12,33,36.4,21,26,6,20,47,91,46,3,Matches
2236,Leroy Sané,de GER,FW,Manchester City,eng Premier League,23,1996,0.1,0,0,0,0,0,0,0,,0,0,0,0,0,0,0,0,Matches
2237,Salif Sané,sn SEN,DF,Schalke 04,de Bundesliga,28,1990,12.5,16,9,12,4,0,11,19,57.9,8,19,7,12,21,37,50,0,Matches
2238,Luca Sangalli,es ESP,MF,Real Sociedad,es La Liga,24,1995,4.1,1,0,0,1,0,1,8,12.5,7,3,0,3,1,2,0,0,Matches
2239,Ibrahim Sangaré,ci CIV,MF,Toulouse,fr Ligue 1,21,1997,24.2,84,54,37,42,5,33,74,44.6,41,28,10,18,39,123,49,4,Matches
2240,Oier Sanjurjo,es ESP,MF,Osasuna,es La Liga,33,1986,25.8,65,34,21,34,10,28,64,43.8,36,33,8,25,35,100,39,1,Matches
2241,Yaya Sanogo,fr FRA,FW,Toulouse,fr Ligue 1,26,1993,10.1,6,3,2,3,1,1,2,50.0,1,4,1,3,7,13,14,0,Matches
2242,Morgan Sanson,fr FRA,MF,Marseille,fr Ligue 1,24,1994,24.1,60,28,20,29,11,13,52,25.0,39,39,5,34,23,83,9,0,Matches
2243,Nicola Sansone,it ITA,"FW,MF",Bologna,it Serie A,27,1991,25.2,34,20,12,18,4,15,59,25.4,44,21,0,21,11,45,9,0,Matches
2244,Baptiste Santamaria,fr FRA,MF,Angers,fr Ligue 1,24,1995,27.8,91,53,39,43,9,35,79,44.3,44,27,5,22,43,134,36,0,Matches
2245,Federico Santander,py PAR,FW,Bologna,it Serie A,28,1991,8.6,13,8,3,0,10,1,4,25.0,3,3,0,3,7,20,12,0,Matches
2246,Davide Santon,it ITA,DF,Roma,it Serie A,28,1991,6.9,11,6,6,5,0,6,17,35.3,11,2,1,1,11,22,13,0,Matches
2247,Samir Santos,br BRA,DF,Udinese,it Serie A,24,1994,17.2,35,27,24,8,3,12,23,52.2,11,16,6,10,33,68,64,1,Matches
2248,Riccardo Saponara,it ITA,"MF,FW",Genoa,it Serie A,27,1991,1.9,4,3,2,2,0,0,2,0.0,2,2,1,1,0,4,2,0,Matches
2249,Riccardo Saponara,it ITA,"MF,FW",Lecce,it Serie A,27,1991,10.5,12,8,4,8,0,6,13,46.2,7,2,0,2,5,17,7,0,Matches
2250,Ivan Šaponjić,rs SRB,"DF,FW",Atlético Madrid,es La Liga,21,1997,0.1,0,0,0,0,0,0,0,,0,0,0,0,0,0,0,0,Matches
2251,Pablo Sarabia,es ESP,"FW,MF",Paris S-G,fr Ligue 1,27,1992,12.9,12,7,3,6,3,4,25,16.0,21,19,1,18,10,22,5,0,Matches
2252,Marcelo Saracchi,uy URU,DF,RB Leipzig,de Bundesliga,21,1998,2.0,8,6,2,5,1,5,6,83.3,1,3,1,2,1,9,5,0,Matches
2253,Josh Sargent,us USA,FW,Werder Bremen,de Bundesliga,19,2000,15.7,11,6,5,4,2,2,12,16.7,10,17,1,16,14,25,21,0,Matches
2254,Bouna Sarr,sn SEN,"DF,FW",Marseille,fr Ligue 1,27,1992,24.0,60,37,30,19,11,30,53,56.6,23,17,1,16,32,92,38,0,Matches
2255,Ismaila Sarr,sn SEN,"FW,MF",Watford,eng Premier League,21,1998,22.5,11,10,5,2,4,5,23,21.7,18,9,1,8,18,29,10,0,Matches
2256,Malang Sarr,fr FRA,DF,Nice,fr Ligue 1,20,1999,16.2,19,11,13,6,0,9,22,40.9,13,10,4,6,38,57,31,4,Matches
2257,Sidy Sarr,sn SEN,MF,Nîmes,fr Ligue 1,23,1996,12.9,35,18,15,16,4,11,34,32.4,23,13,3,10,15,50,18,0,Matches
2258,Joan Sastre Vanrell,es ESP,DF,Mallorca,es La Liga,22,1997,15.1,30,17,26,3,1,17,39,43.6,22,8,2,6,23,53,27,1,Matches
2259,Téji Savanier,fr FRA,MF,Montpellier,fr Ligue 1,27,1991,16.9,52,39,16,30,6,25,77,32.5,52,10,0,10,35,87,21,1,Matches
2260,Stefan Savić,me MNE,DF,Atlético Madrid,es La Liga,28,1991,22.0,22,17,11,10,1,11,18,61.1,7,16,9,7,24,46,91,1,Matches
2261,Fabian Schär,ch SUI,"DF,MF",Newcastle Utd,eng Premier League,27,1991,18.6,39,21,25,14,0,19,40,47.5,21,35,18,17,47,86,74,2,Matches
2262,Louis Schaub,at AUT,MF,Köln,de Bundesliga,24,1994,6.9,15,12,2,9,4,5,14,35.7,9,10,1,9,3,18,2,0,Matches
2263,Ezequiel Schelotto,it ITA,DF,Brighton,eng Premier League,30,1989,4.0,4,3,1,2,1,2,8,25.0,6,3,0,3,7,11,14,0,Matches
2264,Patrik Schick,cz CZE,FW,RB Leipzig,de Bundesliga,23,1996,14.4,7,3,1,3,3,2,9,22.2,7,8,2,6,2,9,17,0,Matches
2265,Julian Schieber,de GER,FW,Augsburg,de Bundesliga,30,1989,0.5,1,1,0,1,0,0,0,,0,0,0,0,0,1,0,0,Matches
2266,Kingsley Schindler,gh GHA,"FW,MF",Köln,de Bundesliga,26,1993,9.4,8,5,3,5,0,4,12,33.3,8,6,1,5,6,14,17,0,Matches
2267,Xaver Schlager,at AUT,MF,Wolfsburg,de Bundesliga,21,1997,19.1,47,29,13,30,4,14,44,31.8,30,16,2,14,17,64,12,0,Matches
2268,Keven Schlotterbeck,de GER,DF,Union Berlin,de Bundesliga,22,1997,21.5,52,27,36,15,1,17,29,58.6,12,40,21,19,40,92,113,1,Matches
2269,Nico Schlotterbeck,de GER,DF,Freiburg,de Bundesliga,19,1999,4.1,6,3,4,2,0,2,5,40.0,3,7,5,2,3,9,20,1,Matches
2270,Jeffrey Schlupp,gh GHA,"FW,MF",Crystal Palace,eng Premier League,26,1992,11.5,18,9,10,7,1,6,16,37.5,10,11,3,8,13,31,15,0,Matches
2271,Kasper Schmeichel,dk DEN,GK,Leicester City,eng Premier League,32,1986,38.0,1,1,1,0,0,1,2,50.0,1,0,0,0,1,2,4,2,Matches
2272,Marcel Schmelzer,de GER,DF,Dortmund,de Bundesliga,31,1988,0.7,2,1,1,1,0,1,1,100.0,0,0,0,0,1,3,2,0,Matches
2273,Jonathan Schmid,fr FRA,DF,Freiburg,de Bundesliga,29,1990,31.5,42,27,19,19,4,19,37,51.4,18,23,8,15,35,77,84,0,Matches
2274,Manuel Schmiedebach,de GER,MF,Union Berlin,de Bundesliga,30,1988,2.0,4,1,0,3,1,1,7,14.3,6,1,1,0,3,7,3,0,Matches
2275,Benno Schmitz,de GER,DF,Köln,de Bundesliga,24,1994,12.9,28,17,13,11,4,16,36,44.4,20,11,1,10,16,44,27,0,Matches
2276,Morgan Schneiderlin,fr FRA,MF,Everton,eng Premier League,29,1989,11.1,31,22,13,16,2,8,24,33.3,16,13,3,10,21,52,20,1,Matches
2277,Lasse Schöne,dk DEN,MF,Genoa,it Serie A,33,1986,27.0,42,26,16,22,4,15,48,31.3,33,22,6,16,37,79,25,2,Matches
2278,Sebastian Schonlau,de GER,DF,Paderborn 07,de Bundesliga,24,1994,23.0,64,43,50,14,0,41,66,62.1,25,36,15,21,40,104,138,1,Matches
2279,Alessandro Schöpf,at AUT,MF,Schalke 04,de Bundesliga,25,1994,15.9,29,16,11,10,8,12,33,36.4,21,17,1,16,26,55,8,0,Matches
2280,Jerdy Schouten,nl NED,MF,Bologna,it Serie A,22,1997,12.0,26,16,13,11,2,10,26,38.5,16,19,7,12,26,52,22,0,Matches
2281,Markus Schubert,de GER,GK,Schalke 04,de Bundesliga,21,1998,8.2,0,0,0,0,0,0,1,0.0,1,0,0,0,0,0,9,4,Matches
2282,Nico Schulz,de GER,"DF,MF",Dortmund,de Bundesliga,26,1993,6.6,11,7,3,6,2,8,13,61.5,5,14,4,10,9,20,9,0,Matches
2283,Alexander Schwolow,de GER,GK,Freiburg,de Bundesliga,27,1992,23.2,0,0,0,0,0,0,0,,0,2,0,2,1,1,8,3,Matches
2284,Matteo Scozzarella,it ITA,MF,Parma,it Serie A,31,1988,10.2,23,15,8,13,2,14,29,48.3,15,19,14,5,27,50,28,0,Matches
2285,Aleksandar Sedlar,rs SRB,DF,Mallorca,es La Liga,27,1991,9.0,13,6,10,2,1,7,11,63.6,4,17,11,6,16,29,31,0,Matches
2286,Davie Selke,de GER,FW,Hertha BSC,de Bundesliga,24,1995,10.7,6,3,2,2,2,4,7,57.1,3,7,1,6,1,7,11,0,Matches
2287,Davie Selke,de GER,FW,Werder Bremen,de Bundesliga,24,1995,5.1,2,0,1,1,0,0,2,0.0,2,1,0,1,0,2,2,0,Matches
2288,Matz Sels,be BEL,GK,Strasbourg,fr Ligue 1,27,1992,27.0,0,0,0,0,0,0,1,0.0,1,0,0,0,1,1,6,0,Matches
2289,Ken Sema,se SWE,"DF,MF",Udinese,it Serie A,25,1993,27.3,59,41,43,15,1,36,68,52.9,32,26,6,20,17,76,41,1,Matches
2290,Nélson Semedo,pt POR,DF,Barcelona,es La Liga,25,1993,23.3,51,30,27,18,6,21,36,58.3,15,18,3,15,22,73,30,0,Matches
2291,Alessandro Semprini,it ITA,DF,Brescia,it Serie A,21,1998,7.0,10,4,7,3,0,7,9,77.8,2,10,3,7,9,19,16,0,Matches
2292,Josep Señé,es ESP,MF,Mallorca,es La Liga,27,1991,1.7,2,1,2,0,0,2,5,40.0,3,2,1,1,0,2,2,0,Matches
2293,Stefano Sensi,it ITA,MF,Inter,it Serie A,23,1995,8.0,18,10,10,7,1,6,22,27.3,16,15,1,14,9,27,4,0,Matches
2294,Luigi Sepe,it ITA,GK,Parma,it Serie A,28,1991,34.0,1,0,1,0,0,1,2,50.0,1,0,0,0,0,1,6,2,Matches
2295,Suat Serdar,de GER,MF,Schalke 04,de Bundesliga,22,1997,17.8,56,37,16,33,7,18,61,29.5,43,39,7,32,24,80,7,0,Matches
2296,Ryan Sessegnon,eng ENG,"DF,FW",Tottenham,eng Premier League,19,2000,3.8,6,4,2,4,0,3,6,50.0,3,0,0,0,3,9,12,0,Matches
2297,Salva Sevilla,es ESP,MF,Mallorca,es La Liga,35,1984,28.5,27,21,11,16,0,9,30,30.0,21,17,5,12,29,56,17,1,Matches
2298,Yevhen Shakhov,ua UKR,"MF,FW",Lecce,it Serie A,28,1990,12.1,28,16,12,13,3,8,27,29.6,19,11,3,8,14,42,9,1,Matches
2299,Xherdan Shaqiri,ch SUI,"FW,MF",Liverpool,eng Premier League,27,1991,2.1,1,0,0,1,0,0,1,0.0,1,0,0,0,0,1,0,0,Matches
2300,Billy Sharp,eng ENG,FW,Sheffield Utd,eng Premier League,33,1986,11.7,6,5,2,1,3,1,6,16.7,5,2,0,2,1,7,2,0,Matches
2301,Luke Shaw,eng ENG,DF,Manchester Utd,eng Premier League,24,1995,19.3,34,18,19,11,4,19,33,57.6,14,26,6,20,24,58,56,1,Matches
2302,Khiry Shelton,us USA,FW,Paderborn 07,de Bundesliga,26,1993,0.4,1,1,1,0,0,0,0,,0,0,0,0,0,1,0,0,Matches
2303,Jonjo Shelvey,eng ENG,MF,Newcastle Utd,eng Premier League,27,1992,23.5,29,19,17,12,0,11,42,26.2,31,14,5,9,23,52,38,0,Matches
2304,Gen Shoji,jp JPN,DF,Toulouse,fr Ligue 1,26,1992,0.5,2,2,2,0,0,1,1,100.0,0,0,0,0,0,2,2,0,Matches
2305,Djibril Sidibé,fr FRA,"DF,MF",Everton,eng Premier League,27,1992,20.3,83,44,48,25,10,43,72,59.7,29,19,3,16,40,123,41,0,Matches
2306,Kalidou Sidibé,fr FRA,MF,Toulouse,fr Ligue 1,20,1999,1.0,3,3,0,3,0,2,5,40.0,3,0,0,0,1,4,0,0,Matches
2307,Sidnei,br BRA,DF,Betis,es La Liga,29,1989,13.1,23,19,17,6,0,9,14,64.3,5,15,12,3,21,44,57,0,Matches
2308,Kaj Sierhuis,nl NED,FW,Reims,fr Ligue 1,21,1998,0.1,0,0,0,0,0,0,0,,0,0,0,0,0,0,0,0,Matches
2309,Gylfi Sigurðsson,is ISL,MF,Everton,eng Premier League,29,1989,28.4,50,26,15,24,11,19,70,27.1,51,30,4,26,37,87,17,1,Matches
2310,Luca Siligardi,it ITA,"MF,FW",Parma,it Serie A,31,1988,3.7,6,2,3,2,1,4,8,50.0,4,3,0,3,3,9,5,0,Matches
2311,Adrien Silva,pt POR,MF,Monaco,fr Ligue 1,30,1989,13.6,37,22,14,19,4,10,37,27.0,27,19,6,13,12,49,14,2,Matches
2312,André Silva,pt POR,FW,Milan,it Serie A,23,1995,0.7,2,1,0,0,2,0,1,0.0,1,0,0,0,0,2,0,0,Matches
2313,André Silva,pt POR,FW,Eint Frankfurt,de Bundesliga,23,1995,17.5,7,2,0,5,2,2,14,14.3,12,9,0,9,8,15,4,0,Matches
2314,Bernardo Silva,pt POR,"FW,MF",Manchester City,eng Premier League,24,1994,22.6,36,18,8,21,7,13,44,29.5,31,25,1,24,24,60,13,0,Matches
2315,David Silva,es ESP,MF,Manchester City,eng Premier League,33,1986,20.3,26,14,3,15,8,10,28,35.7,18,18,3,15,13,39,5,0,Matches
2316,Gabriel Silva,br BRA,DF,Saint-Étienne,fr Ligue 1,28,1991,2.6,4,1,1,2,1,2,3,66.7,1,2,0,2,4,8,8,0,Matches
2317,Jonathan Silva,ar ARG,DF,Leganés,es La Liga,25,1994,30.9,60,34,32,22,6,27,52,51.9,25,12,4,8,34,94,46,0,Matches
2318,Matheus Pereira da Silva,br BRA,"MF,FW",Dijon,fr Ligue 1,21,1998,5.2,10,6,1,6,3,4,10,40.0,6,11,0,11,6,16,5,0,Matches
2319,Rui Silva,pt POR,GK,Granada,es La Liga,25,1994,35.0,2,1,2,0,0,2,2,100.0,0,0,0,0,2,4,22,3,Matches
2320,Thiago Silva,br BRA,DF,Paris S-G,fr Ligue 1,34,1984,17.5,28,16,15,13,0,13,16,81.3,3,18,15,3,26,54,54,0,Matches
2321,Marco Silvestri,it ITA,GK,Hellas Verona,it Serie A,28,1991,35.0,1,0,1,0,0,1,2,50.0,1,0,0,0,4,5,11,1,Matches
2322,Mohamed Simakan,fr FRA,DF,Strasbourg,fr Ligue 1,19,2000,16.7,54,32,35,16,3,22,34,64.7,12,14,3,11,31,85,25,0,Matches
2323,Giovanni Simeone,ar ARG,FW,Cagliari,it Serie A,24,1995,32.5,24,13,9,10,5,5,32,15.6,27,24,7,17,11,35,16,1,Matches
2324,Moses Simon,ng NGA,"FW,MF",Nantes,fr Ligue 1,24,1995,24.2,15,7,5,4,6,6,21,28.6,15,6,0,6,8,23,6,0,Matches
2325,Unai Simón,es ESP,GK,Athletic Club,es La Liga,22,1997,33.2,0,0,0,0,0,0,1,0.0,1,1,0,1,1,1,10,1,Matches
2326,Jack Simpson,eng ENG,DF,Bournemouth,eng Premier League,22,1996,2.7,5,2,4,1,0,2,8,25.0,6,1,0,1,2,7,12,1,Matches
2327,Sarpreet Singh,nz NZL,"FW,MF",Bayern Munich,de Bundesliga,20,1999,0.8,1,0,0,1,0,0,1,0.0,1,0,0,0,0,1,0,0,Matches
2328,Wilfried Singo,ci CIV,DF,Torino,it Serie A,18,2000,1.5,1,0,0,1,0,0,0,,0,0,0,0,1,2,2,0,Matches
2329,Daley Sinkgraven,nl NED,"DF,MF",Leverkusen,de Bundesliga,24,1995,10.1,20,16,11,6,3,8,24,33.3,16,12,3,9,10,30,16,0,Matches
2330,Dimitris Siovas,gr GRE,DF,Leganés,es La Liga,30,1988,21.3,42,31,24,15,3,19,28,67.9,9,14,1,13,46,88,69,0,Matches
2331,Salvatore Sirigu,it ITA,GK,Torino,it Serie A,32,1987,36.0,0,0,0,0,0,0,0,,0,0,0,0,2,2,12,0,Matches
2332,Ibrahima Sissoko,ml MLI,MF,Strasbourg,fr Ligue 1,21,1997,17.8,46,27,21,21,4,16,48,33.3,32,14,5,9,20,66,25,0,Matches
2333,Moussa Sissoko,fr FRA,MF,Tottenham,eng Premier League,29,1989,27.2,39,25,25,12,2,20,48,41.7,28,19,4,15,27,66,43,2,Matches
2334,Sambou Sissoko,fr FRA,"MF,FW",Reims,fr Ligue 1,20,1999,0.4,0,0,0,0,0,0,0,,0,0,0,0,1,1,2,0,Matches
2335,Pione Sisto,dk DEN,"FW,MF",Celta Vigo,es La Liga,24,1995,9.9,17,8,5,6,6,4,19,21.1,15,18,0,18,6,23,4,1,Matches
2336,Antonio Sivera,es ESP,GK,Alavés,es La Liga,22,1996,3.0,0,0,0,0,0,0,0,,0,0,0,0,0,0,2,0,Matches
2337,Ellyes Skhiri,tn TUN,MF,Köln,de Bundesliga,24,1995,29.7,74,52,30,37,7,29,77,37.7,48,47,9,38,67,141,33,0,Matches
2338,Oliver Skipp,eng ENG,MF,Tottenham,eng Premier League,18,2000,0.9,2,2,0,2,0,1,4,25.0,3,3,2,1,0,2,0,0,Matches
2339,Łukasz Skorupski,pl POL,GK,Bologna,it Serie A,28,1991,37.0,1,0,1,0,0,0,1,0.0,1,0,0,0,2,3,15,5,Matches
2340,Andreas Skov Olsen,dk DEN,"FW,MF",Bologna,it Serie A,19,1999,8.4,11,8,5,5,1,4,12,33.3,8,10,1,9,8,19,5,0,Matches
2341,Robert Skov,dk DEN,"DF,FW",Hoffenheim,de Bundesliga,23,1996,29.0,41,28,30,9,2,26,50,52.0,24,26,6,20,20,61,40,0,Matches
2342,Simon Skrabb,fi FIN,"FW,MF",Brescia,it Serie A,24,1995,2.9,7,6,2,4,1,6,12,50.0,6,4,1,3,0,7,3,0,Matches
2343,Milan Škriniar,sk SVK,DF,Inter,it Serie A,24,1995,29.2,39,20,24,14,1,14,33,42.4,19,19,11,8,28,67,85,1,Matches
2344,Steven Skrzybski,de GER,"FW,MF",Düsseldorf,de Bundesliga,26,1992,5.9,4,4,2,1,1,0,16,0.0,16,10,0,10,10,14,4,0,Matches
2345,Petar Škuletić,rs SRB,"FW,MF",Montpellier,fr Ligue 1,29,1990,1.2,6,4,2,2,2,2,4,50.0,2,0,0,0,0,6,1,0,Matches
2346,Islam Slimani,dz ALG,FW,Monaco,fr Ligue 1,31,1988,14.3,8,4,0,2,6,4,15,26.7,11,5,0,5,1,9,11,1,Matches
2347,William Smallbone,ie IRL,MF,Southampton,eng Premier League,19,2000,4.4,10,5,2,8,0,5,10,50.0,5,7,1,6,1,11,2,0,Matches
2348,Chris Smalling,eng ENG,DF,Roma,it Serie A,29,1989,28.5,25,16,15,9,1,10,13,76.9,3,44,35,9,56,81,126,2,Matches
2349,Dennis Smarsch,de GER,GK,Hertha BSC,de Bundesliga,20,1999,1.7,0,0,0,0,0,0,0,,0,0,0,0,0,0,1,0,Matches
2350,Adam Smith,eng ENG,DF,Bournemouth,eng Premier League,28,1991,22.8,47,32,29,16,2,23,50,46.0,27,27,6,21,25,72,64,1,Matches
2351,Emile Smith Rowe,eng ENG,MF,Arsenal,eng Premier League,19,2000,1.1,1,1,1,0,0,1,3,33.3,2,0,0,0,1,2,2,0,Matches
2352,Fyodor Smolov,ru RUS,FW,Celta Vigo,es La Liga,29,1990,8.3,2,1,0,2,0,1,9,11.1,8,6,0,6,7,9,9,0,Matches
2353,Robert Snodgrass,sct SCO,"MF,FW",West Ham,eng Premier League,31,1987,16.8,29,16,17,10,2,13,44,29.5,31,12,1,11,4,33,11,0,Matches
2354,Cédric Soares,pt POR,"MF,DF",Arsenal,eng Premier League,27,1991,2.8,8,6,2,6,0,1,3,33.3,2,3,0,3,3,11,4,0,Matches
2355,Cédric Soares,pt POR,DF,Southampton,eng Premier League,27,1991,14.5,45,26,19,24,2,25,41,61.0,16,18,4,14,19,64,51,0,Matches
2356,Rafa Soares,pt POR,DF,Eibar,es La Liga,24,1995,4.8,6,5,5,0,1,5,11,45.5,6,1,0,1,2,8,6,0,Matches
2357,Lasse Sobiech,de GER,DF,Köln,de Bundesliga,28,1991,1.0,1,0,0,0,1,0,0,,0,0,0,0,4,5,6,0,Matches
2358,Marcel Sobottka,de GER,MF,Düsseldorf,de Bundesliga,25,1994,7.8,15,10,6,8,1,4,13,30.8,9,9,1,8,9,24,12,0,Matches
2359,Rubén Sobrino,es ESP,"FW,MF",Valencia,es La Liga,27,1992,1.9,7,5,3,2,2,2,3,66.7,1,1,0,1,0,7,1,0,Matches
2360,Dominic Solanke,eng ENG,FW,Bournemouth,eng Premier League,21,1997,18.3,8,4,2,5,1,5,33,15.2,28,9,1,8,8,16,18,1,Matches
2361,Roberto Soldado,es ESP,FW,Granada,es La Liga,34,1985,26.1,16,9,2,7,7,7,24,29.2,17,16,4,12,4,20,16,0,Matches
2362,Carlos Soler,es ESP,MF,Valencia,es La Liga,22,1997,23.0,21,10,10,10,1,9,39,23.1,30,16,6,10,9,30,14,0,Matches
2363,Oumar Solet,fr FRA,DF,Lyon,fr Ligue 1,19,2000,0.1,0,0,0,0,0,0,0,,0,1,1,0,0,0,1,0,Matches
2364,Yann Sommer,ch SUI,GK,Gladbach,de Bundesliga,30,1988,34.0,0,0,0,0,0,0,1,0.0,1,0,0,0,1,1,11,6,Matches
2365,Kévin Soni,cm CMR,FW,Espanyol,es La Liga,21,1998,0.0,0,0,0,0,0,0,0,,0,0,0,0,0,0,0,0,Matches
2366,David Soria,es ESP,GK,Getafe,es La Liga,26,1993,38.0,2,1,2,0,0,2,4,50.0,2,0,0,0,3,5,17,5,Matches
2367,Bruno Soriano,es ESP,"MF,FW",Villarreal,es La Liga,35,1984,2.9,4,0,1,2,1,1,1,100.0,0,4,0,4,1,5,7,0,Matches
2368,Juan Soriano,es ESP,GK,Leganés,es La Liga,21,1997,11.0,0,0,0,0,0,0,0,,0,0,0,0,0,0,1,1,Matches
2369,Roberto Soriano,it ITA,MF,Bologna,it Serie A,28,1991,27.4,43,25,15,21,7,10,46,21.7,36,19,0,19,17,60,23,1,Matches
2370,Riccardo Sottil,it ITA,"FW,DF",Fiorentina,it Serie A,20,1999,5.7,6,4,4,2,0,3,10,30.0,7,4,0,4,0,6,0,0,Matches
2371,Tomáš Souček,cz CZE,MF,West Ham,eng Premier League,24,1995,11.6,29,15,13,15,1,10,23,43.5,13,7,1,6,22,51,35,0,Matches
2372,Adama Soumaoro,fr FRA,DF,Genoa,it Serie A,27,1992,7.1,3,2,3,0,0,1,3,33.3,2,12,12,0,11,14,32,0,Matches
2373,Adama Soumaoro,fr FRA,DF,Lille,fr Ligue 1,27,1992,4.6,1,1,0,1,0,0,0,,0,6,5,1,4,5,17,0,Matches
2374,Boubakary Soumaré,fr FRA,MF,Lille,fr Ligue 1,20,1999,13.5,19,12,6,13,0,9,19,47.4,10,6,0,6,16,35,9,0,Matches
2375,Bryan Soumaré,fr FRA,"MF,FW",Dijon,fr Ligue 1,20,1999,4.3,12,1,6,5,1,6,9,66.7,3,1,0,1,2,14,1,0,Matches
2376,Arnaud Souquet,fr FRA,"DF,FW",Montpellier,fr Ligue 1,27,1992,22.4,62,40,45,13,4,30,67,44.8,37,20,6,14,17,79,44,0,Matches
2377,Djibril Sow,ch SUI,MF,Eint Frankfurt,de Bundesliga,22,1997,19.4,56,33,26,17,13,16,47,34.0,31,15,3,12,30,86,9,0,Matches
2378,Çağlar Söyüncü,tr TUR,DF,Leicester City,eng Premier League,23,1996,33.7,60,40,41,18,1,27,46,58.7,19,35,19,16,43,103,156,1,Matches
2379,Nikolas Špalek,sk SVK,"MF,FW",Brescia,it Serie A,22,1997,17.5,24,10,6,11,7,7,31,22.6,24,15,1,14,6,30,10,0,Matches
2380,Leonardo Spinazzola,it ITA,DF,Roma,it Serie A,26,1993,17.2,24,12,11,8,5,12,21,57.1,9,13,5,8,20,44,41,0,Matches
2381,Marco Sportiello,it ITA,GK,Atalanta,it Serie A,27,1992,5.8,0,0,0,0,0,0,0,,0,0,0,0,0,0,3,0,Matches
2382,Mattia Sprocati,it ITA,"FW,MF",Parma,it Serie A,26,1993,6.6,4,2,3,1,0,0,1,0.0,1,5,1,4,2,6,2,0,Matches
2383,Bassem Srarfi,tn TUN,"FW,MF",Nice,fr Ligue 1,22,1997,1.5,0,0,0,0,0,0,2,0.0,2,0,0,0,2,2,0,0,Matches
2384,Dennis Srbeny,de GER,"MF,FW",Norwich City,eng Premier League,25,1994,0.5,5,5,3,2,0,1,3,33.3,2,1,0,1,0,5,1,0,Matches
2385,Dennis Srbeny,de GER,"FW,MF",Paderborn 07,de Bundesliga,25,1994,12.4,11,6,4,4,3,5,18,27.8,13,11,1,10,3,14,9,0,Matches
2386,Jerry St. Juste,nl NED,DF,Mainz 05,de Bundesliga,22,1996,23.5,46,25,34,10,2,14,34,41.2,20,35,19,16,52,98,86,1,Matches
2387,Jack Stacey,eng ENG,DF,Bournemouth,eng Premier League,23,1996,17.2,21,11,9,11,1,8,22,36.4,14,27,11,16,18,39,64,1,Matches
2388,Kostas Stafylidis,gr GRE,DF,Hoffenheim,de Bundesliga,25,1993,4.4,10,3,7,2,1,4,10,40.0,6,10,3,7,2,12,17,0,Matches
2389,Benjamin Stambouli,fr FRA,DF,Schalke 04,de Bundesliga,28,1990,9.0,31,19,14,15,2,11,21,52.4,10,16,6,10,12,43,28,1,Matches
2390,Junior Stanislas,eng ENG,"MF,FW",Bournemouth,eng Premier League,29,1989,7.9,10,7,2,3,5,3,8,37.5,5,6,0,6,4,14,6,0,Matches
2391,Niklas Stark,de GER,DF,Hertha BSC,de Bundesliga,24,1995,19.2,36,20,24,10,2,9,21,42.9,12,27,12,15,21,57,97,2,Matches
2392,Jed Steer,eng ENG,GK,Aston Villa,eng Premier League,26,1992,0.1,0,0,0,0,0,0,0,,0,0,0,0,0,0,0,0,Matches
2393,Renato Steffen,ch SUI,"MF,FW",Wolfsburg,de Bundesliga,27,1991,17.6,25,18,4,14,7,14,39,35.9,25,25,2,23,23,48,10,0,Matches
2394,Zack Steffen,us USA,GK,Düsseldorf,de Bundesliga,24,1995,17.0,0,0,0,0,0,0,0,,0,0,0,0,0,0,5,4,Matches
2395,Dale Stephens,eng ENG,MF,Brighton,eng Premier League,30,1989,28.1,73,44,30,37,6,25,75,33.3,50,31,11,20,58,131,42,2,Matches
2396,Jack Stephens,eng ENG,DF,Southampton,eng Premier League,25,1994,27.2,44,27,30,13,1,24,46,52.2,22,38,22,16,31,75,120,2,Matches
2397,Mariusz Stępiński,pl POL,"FW,MF",Hellas Verona,it Serie A,24,1995,7.8,5,3,2,1,2,1,2,50.0,1,3,1,2,1,6,7,0,Matches
2398,Raheem Sterling,eng ENG,FW,Manchester City,eng Premier League,24,1994,29.5,27,15,8,10,9,6,28,21.4,22,16,2,14,15,42,4,0,Matches
2399,Enda Stevens,ie IRL,DF,Sheffield Utd,eng Premier League,29,1990,37.2,81,46,48,26,7,42,96,43.8,54,27,8,19,35,116,71,3,Matches
2400,Marco Stiepermann,de GER,MF,Norwich City,eng Premier League,28,1991,13.1,20,8,8,9,3,5,21,23.8,16,11,3,8,5,25,16,0,Matches
2401,Lars Stindl,de GER,"MF,FW",Gladbach,de Bundesliga,30,1988,15.9,27,16,4,15,8,10,28,35.7,18,18,2,16,10,37,7,0,Matches
2402,Kevin Stöger,at AUT,MF,Düsseldorf,de Bundesliga,25,1993,14.1,21,15,10,7,4,6,24,25.0,18,24,2,22,26,47,7,1,Matches
2403,Vlatko Stojanovski,mk MKD,FW,Nîmes,fr Ligue 1,22,1997,1.4,3,3,0,3,0,1,1,100.0,0,0,0,0,0,3,1,0,Matches
2404,John Stones,eng ENG,DF,Manchester City,eng Premier League,25,1994,12.5,16,10,8,7,1,3,5,60.0,2,5,3,2,9,25,32,2,Matches
2405,Thomas Strakosha,al ALB,GK,Lazio,it Serie A,24,1995,38.0,0,0,0,0,0,0,1,0.0,1,0,0,0,0,0,7,2,Matches
2406,Gabriel Strefezza,br BRA,"DF,MF",SPAL,it Serie A,22,1997,23.4,64,40,28,26,10,22,54,40.7,32,29,3,26,21,85,17,0,Matches
2407,Tobias Strobl,de GER,"MF,DF",Gladbach,de Bundesliga,29,1990,6.8,9,6,5,4,0,3,8,37.5,5,8,4,4,11,20,5,0,Matches
2408,Christian Strohdiek,de GER,DF,Paderborn 07,de Bundesliga,31,1988,15.1,26,22,21,5,0,20,42,47.6,22,16,10,6,25,51,92,0,Matches
2409,Kevin Strootman,nl NED,MF,Marseille,fr Ligue 1,29,1990,15.7,39,27,13,23,3,20,49,40.8,29,16,1,15,17,56,24,0,Matches
2410,Jens Stryger Larsen,dk DEN,DF,Udinese,it Serie A,28,1991,31.0,27,19,15,9,3,17,30,56.7,13,20,5,15,20,47,52,0,Matches
2411,Stefano Sturaro,it ITA,MF,Genoa,it Serie A,26,1993,13.9,38,22,14,19,5,15,39,38.5,24,16,4,12,10,48,26,1,Matches
2412,Damián Suárez,uy URU,DF,Getafe,es La Liga,31,1988,28.8,62,32,32,21,9,38,72,52.8,34,25,2,23,27,89,41,0,Matches
2413,Denis Suárez,es ESP,"MF,FW",Celta Vigo,es La Liga,25,1994,18.1,22,15,14,7,1,10,37,27.0,27,9,1,8,14,36,12,1,Matches
2414,Luis Suárez,uy URU,FW,Barcelona,es La Liga,32,1987,22.2,4,0,0,1,3,2,12,16.7,10,6,1,5,1,5,11,0,Matches
2415,Mathías Suárez,uy URU,DF,Montpellier,fr Ligue 1,23,1996,0.7,2,2,2,0,0,2,3,66.7,1,0,0,0,1,3,3,0,Matches
2416,Neven Subotić,rs SRB,DF,Union Berlin,de Bundesliga,30,1988,21.8,30,18,12,16,2,8,32,25.0,24,21,8,13,34,64,89,0,Matches
2417,Isaac Success,ng NGA,"FW,MF",Watford,eng Premier League,23,1996,0.8,0,0,0,0,0,0,0,,0,0,0,0,1,1,0,0,Matches
2418,Marek Suchý,cz CZE,DF,Augsburg,de Bundesliga,31,1988,4.4,7,5,7,0,0,4,6,66.7,2,4,1,3,6,13,15,0,Matches
2419,Niklas Süle,de GER,DF,Bayern Munich,de Bundesliga,23,1995,7.1,10,6,8,2,0,4,5,80.0,1,8,6,2,8,18,22,1,Matches
2420,Ki Sung-yueng,kr KOR,MF,Newcastle Utd,eng Premier League,30,1989,1.5,1,1,0,1,0,1,3,33.3,2,1,0,1,3,4,2,0,Matches
2421,Ki Sung-yueng,kr KOR,MF,Mallorca,es La Liga,30,1989,0.1,0,0,0,0,0,0,1,0.0,1,0,0,0,0,0,0,0,Matches
2422,Stoppila Sunzu,zm ZAM,DF,Metz,fr Ligue 1,30,1989,15.0,16,8,12,4,0,10,15,66.7,5,22,15,7,24,40,63,0,Matches
2423,Andrew Surman,eng ENG,MF,Bournemouth,eng Premier League,32,1986,2.6,4,2,2,2,0,1,3,33.3,2,1,0,1,1,5,5,1,Matches
2424,Sam Surridge,eng ENG,"FW,MF",Bournemouth,eng Premier League,21,1998,0.3,0,0,0,0,0,0,0,,0,1,0,1,1,1,0,0,Matches
2425,Suso,es ESP,"FW,MF",Milan,it Serie A,25,1993,15.1,7,3,2,3,2,2,10,20.0,8,5,0,5,8,15,3,0,Matches
2426,Suso,es ESP,"FW,MF",Sevilla,es La Liga,25,1993,8.7,9,4,4,4,1,7,16,43.8,9,6,0,6,2,11,0,0,Matches
2427,Bosko Sutalo,hr CRO,DF,Atalanta,it Serie A,19,2000,3.1,3,2,2,1,0,0,2,0.0,2,4,0,4,6,9,6,1,Matches
2428,Markus Suttner,at AUT,DF,Düsseldorf,de Bundesliga,32,1987,14.9,21,16,11,9,1,11,24,45.8,13,22,7,15,13,34,33,0,Matches
2429,Mattias Svanberg,se SWE,MF,Bologna,it Serie A,20,1999,11.7,13,8,9,4,0,6,31,19.4,25,15,4,11,13,26,10,0,Matches
2430,Issiaga Sylla,gn GUI,DF,Toulouse,fr Ligue 1,25,1994,28.0,73,49,44,21,8,40,69,58.0,29,31,7,24,67,140,90,2,Matches
2431,Moussa Sylla,fr FRA,FW,Monaco,fr Ligue 1,19,1999,0.1,0,0,0,0,0,0,0,,0,0,0,0,0,0,0,0,Matches
2432,Eddy Sylvestre,fr FRA,MF,Nice,fr Ligue 1,19,1999,0.4,0,0,0,0,0,0,1,0.0,1,0,0,0,0,0,0,0,Matches
2433,Ádám Szalai,hu HUN,FW,Mainz 05,de Bundesliga,31,1987,12.7,8,4,0,6,2,1,11,9.1,10,9,0,9,2,10,14,0,Matches
2434,Wojciech Szczęsny,pl POL,GK,Juventus,it Serie A,29,1990,28.8,0,0,0,0,0,0,0,,0,0,0,0,1,1,10,1,Matches
2435,Andrea Tabanelli,it ITA,MF,Lecce,it Serie A,29,1990,10.7,22,13,10,9,3,8,28,28.6,20,13,2,11,11,33,19,0,Matches
2436,Tachi,es ESP,DF,Alavés,es La Liga,21,1997,2.6,2,1,2,0,0,1,4,25.0,3,5,4,1,4,6,12,0,Matches
2437,Panagiotis Tachtsidis,gr GRE,MF,Lecce,it Serie A,28,1991,22.3,52,27,26,20,6,20,56,35.7,36,27,11,16,35,87,32,2,Matches
2438,Jonathan Tah,de GER,DF,Leverkusen,de Bundesliga,23,1996,23.2,36,26,23,11,2,18,29,62.1,11,25,13,12,27,63,98,2,Matches
2439,Flavien Tait,fr FRA,"MF,FW",Rennes,fr Ligue 1,26,1993,9.8,20,13,12,6,2,9,28,32.1,19,7,0,7,9,29,5,1,Matches
2440,Mahdi Talal,fr FRA,FW,Amiens,fr Ligue 1,21,1997,0.2,0,0,0,0,0,0,1,0.0,1,1,0,1,0,0,2,0,Matches
2441,Adrien Tameze,cm CMR,MF,Atalanta,it Serie A,25,1994,2.3,4,3,1,1,2,1,2,50.0,1,3,1,2,3,7,4,1,Matches
2442,Adrien Tameze,cm CMR,MF,Nice,fr Ligue 1,25,1994,5.8,6,2,2,3,1,4,16,25.0,12,7,2,5,7,13,1,1,Matches
2443,Japhet Tanganga,eng ENG,DF,Tottenham,eng Premier League,20,1999,5.8,17,9,10,6,1,10,17,58.8,7,7,6,1,11,28,31,2,Matches
2444,Adil Taoui,fr FRA,MF,Toulouse,fr Ligue 1,17,2001,0.3,2,2,0,2,0,0,2,0.0,2,0,0,0,2,4,0,0,Matches
2445,Edmond Tapsoba,bf BFA,DF,Leverkusen,de Bundesliga,20,1999,11.8,24,15,17,5,2,15,25,60.0,10,9,5,4,9,33,44,0,Matches
2446,Matt Targett,eng ENG,"DF,MF",Aston Villa,eng Premier League,23,1995,25.5,52,29,37,11,4,22,53,41.5,31,28,8,20,56,108,82,0,Matches
2447,Rodrigo Tarín,es ESP,DF,Leganés,es La Liga,23,1996,10.6,10,7,8,2,0,9,14,64.3,5,7,3,4,9,19,51,0,Matches
2448,James Tarkowski,eng ENG,DF,Burnley,eng Premier League,26,1992,38.0,66,43,47,19,0,31,54,57.4,23,63,47,16,63,129,204,4,Matches
2449,Ciprian Tătărușanu,ro ROU,GK,Lyon,fr Ligue 1,33,1986,2.0,0,0,0,0,0,0,0,,0,0,0,0,0,0,0,1,Matches
2450,Júlio Tavares,cv CPV,FW,Dijon,fr Ligue 1,30,1988,22.2,12,8,1,6,5,4,17,23.5,13,9,2,7,8,20,29,0,Matches
2451,Charlie Taylor,eng ENG,DF,Burnley,eng Premier League,25,1993,21.6,39,24,26,9,4,19,39,48.7,20,29,9,20,29,68,78,1,Matches
2452,Neil Taylor,wls WAL,DF,Aston Villa,eng Premier League,30,1989,12.1,16,11,12,4,0,11,20,55.0,9,15,5,10,20,36,43,0,Matches
2453,Aurélien Tchouaméni,fr FRA,MF,Bordeaux,fr Ligue 1,19,2000,12.3,30,14,15,13,2,11,27,40.7,16,11,3,8,13,43,19,1,Matches
2454,Aurélien Tchouaméni,fr FRA,MF,Monaco,fr Ligue 1,19,2000,0.7,0,0,0,0,0,0,2,0.0,2,0,0,0,0,0,2,1,Matches
2455,Georg Teigl,at AUT,"DF,MF",Augsburg,de Bundesliga,28,1991,1.2,3,1,1,2,0,2,4,50.0,2,0,0,0,3,6,1,0,Matches
2456,Álvaro Tejero,es ESP,DF,Eibar,es La Liga,23,1996,16.1,30,18,17,10,3,14,23,60.9,9,17,4,13,28,58,38,0,Matches
2457,Bernard Tekpetey,gh GHA,"FW,MF",Düsseldorf,de Bundesliga,21,1997,5.0,4,4,1,2,1,0,2,0.0,2,5,0,5,2,6,0,0,Matches
2458,Nathan Tella,ng NGA,FW,Southampton,eng Premier League,20,1999,0.0,0,0,0,0,0,0,0,,0,0,0,0,0,0,0,0,Matches
2459,Cristian Tello,es ESP,"MF,FW",Betis,es La Liga,27,1991,8.7,8,5,2,2,4,4,8,50.0,4,5,0,5,4,12,0,0,Matches
2460,Lino Tempelmann,de GER,MF,Freiburg,de Bundesliga,20,1999,0.4,1,0,1,0,0,1,1,100.0,0,1,1,0,0,1,0,0,Matches
2461,Łukasz Teodorczyk,pl POL,FW,Udinese,it Serie A,28,1991,2.5,7,5,1,5,1,3,7,42.9,4,2,0,2,0,7,1,0,Matches
2462,Hidde ter Avest,nl NED,DF,Udinese,it Serie A,22,1997,7.6,18,9,13,3,2,14,17,82.4,3,6,1,5,9,27,27,0,Matches
2463,Marc-André ter Stegen,de GER,GK,Barcelona,es La Liga,27,1992,36.0,2,2,2,0,0,2,3,66.7,1,0,0,0,2,4,17,6,Matches
2464,Simon Terodde,de GER,FW,Köln,de Bundesliga,31,1988,9.0,8,5,4,3,1,3,13,23.1,10,14,3,11,2,10,14,0,Matches
2465,Pietro Terracciano,it ITA,GK,Fiorentina,it Serie A,29,1990,6.9,0,0,0,0,0,0,0,,0,0,0,0,0,0,4,0,Matches
2466,Martin Terrier,fr FRA,"FW,MF",Lyon,fr Ligue 1,22,1997,13.3,20,15,7,10,3,3,14,21.4,11,14,1,13,10,30,11,0,Matches
2467,Aleksa Terzić,rs SRB,MF,Fiorentina,it Serie A,19,1999,0.1,0,0,0,0,0,0,0,,0,0,0,0,0,0,0,0,Matches
2468,Kenny Tete,nl NED,DF,Lyon,fr Ligue 1,23,1995,11.9,33,21,12,16,5,15,23,65.2,8,12,3,9,19,52,34,0,Matches
2469,Alexander Tettey,no NOR,"MF,DF",Norwich City,eng Premier League,33,1986,26.0,23,18,7,16,0,11,39,28.2,28,20,9,11,43,66,72,1,Matches
2470,Florian Thauvin,fr FRA,FW,Marseille,fr Ligue 1,26,1993,0.2,1,0,0,1,0,0,1,0.0,1,0,0,0,0,1,0,0,Matches
2471,Demba Thiam,sn SEN,GK,SPAL,it Serie A,21,1998,2.0,0,0,0,0,0,0,0,,0,0,0,0,1,1,0,0,Matches
2472,Malick Thiaw,de GER,DF,Schalke 04,de Bundesliga,17,2001,0.8,2,0,1,1,0,1,2,50.0,1,2,2,0,2,4,4,1,Matches
2473,Niclas Thiede,de GER,GK,Freiburg,de Bundesliga,20,1999,0.8,0,0,0,0,0,0,0,,0,0,0,0,0,0,1,0,Matches
2474,Jan Thielmann,de GER,"FW,MF",Köln,de Bundesliga,17,2002,6.2,9,6,2,6,1,5,12,41.7,7,8,0,8,8,17,6,0,Matches
2475,Sada Thioub,sn SEN,"MF,FW",Angers,fr Ligue 1,24,1995,16.8,20,12,8,9,3,5,18,27.8,13,9,1,8,4,24,5,0,Matches
2476,Jordan Thomas,eng ENG,FW,Norwich City,eng Premier League,18,2001,0.0,0,0,0,0,0,0,0,,0,0,0,0,0,0,0,0,Matches
2477,Luke Thomas,eng ENG,"MF,DF",Leicester City,eng Premier League,18,2001,3.0,1,0,0,1,0,0,3,0.0,3,2,0,2,3,4,7,0,Matches
2478,Romain Thomas,fr FRA,DF,Angers,fr Ligue 1,31,1988,26.0,24,17,16,7,1,8,18,44.4,10,35,18,17,39,63,118,1,Matches
2479,Adrien Thomasson,fr FRA,"MF,FW",Strasbourg,fr Ligue 1,25,1993,23.0,36,21,11,16,9,15,47,31.9,32,21,1,20,9,45,9,0,Matches
2480,Erik Thommy,de GER,"MF,FW",Düsseldorf,de Bundesliga,24,1994,25.1,40,23,16,16,8,15,39,38.5,24,23,2,21,16,56,20,1,Matches
2481,Max Thompson,eng ENG,FW,Burnley,eng Premier League,17,2002,0.0,0,0,0,0,0,0,0,,0,0,0,0,0,0,0,0,Matches
2482,Morten Thorsby,no NOR,"MF,DF",Sampdoria,it Serie A,23,1996,20.7,53,34,17,23,13,27,52,51.9,25,24,6,18,17,70,34,0,Matches
2483,Khéphren Thuram,fr FRA,MF,Nice,fr Ligue 1,18,2001,6.6,22,7,14,8,0,6,17,35.3,11,12,2,10,7,29,13,0,Matches
2484,Marcus Thuram,fr FRA,FW,Gladbach,de Bundesliga,21,1997,24.5,26,18,7,8,11,11,29,37.9,18,20,1,19,12,38,18,0,Matches
2485,Youri Tielemans,be BEL,MF,Leicester City,eng Premier League,22,1997,31.4,52,29,17,30,5,24,74,32.4,50,43,4,39,22,74,18,0,Matches
2486,Kieran Tierney,sct SCO,"DF,MF",Arsenal,eng Premier League,22,1997,11.0,20,16,13,6,1,11,15,73.3,4,10,4,6,9,29,37,1,Matches
2487,Cheick Timite,ci CIV,"MF,FW",Amiens,fr Ligue 1,21,1997,1.3,1,0,0,1,0,0,1,0.0,1,0,0,0,2,3,1,0,Matches
2488,David Timor,es ESP,"MF,DF",Getafe,es La Liga,29,1989,10.5,9,6,4,5,0,5,16,31.3,11,8,3,5,18,27,23,0,Matches
2489,Marcel Tisserand,cd COD,DF,Wolfsburg,de Bundesliga,26,1993,13.4,21,10,14,5,2,7,12,58.3,5,13,4,9,32,53,49,2,Matches
2490,Jean-Clair Todibo,fr FRA,DF,Barcelona,es La Liga,19,1999,0.9,1,0,1,0,0,0,1,0.0,1,0,0,0,0,1,6,0,Matches
2491,Jean-Clair Todibo,fr FRA,DF,Schalke 04,de Bundesliga,19,1999,4.1,15,10,10,5,0,8,9,88.9,1,2,0,2,15,30,24,0,Matches
2492,Karl Toko Ekambi,cm CMR,FW,Villarreal,es La Liga,26,1992,11.0,5,3,0,3,2,1,4,25.0,3,2,0,2,3,8,2,0,Matches
2493,Karl Toko Ekambi,cm CMR,"FW,MF",Lyon,fr Ligue 1,26,1992,6.0,5,2,0,1,4,3,5,60.0,2,2,0,2,5,10,1,0,Matches
2494,Corentin Tolisso,fr FRA,MF,Bayern Munich,de Bundesliga,24,1994,7.1,9,4,4,3,2,1,9,11.1,8,9,3,6,4,13,2,1,Matches
2495,Jeremy Toljan,de GER,DF,Sassuolo,it Serie A,24,1994,24.3,37,21,24,10,3,18,35,51.4,17,23,12,11,18,55,58,1,Matches
2496,Rafael Tolói,it ITA,DF,Atalanta,it Serie A,28,1990,29.0,56,29,28,23,5,33,76,43.4,43,31,17,14,45,101,80,0,Matches
2497,Raúl de Tomás,es ESP,FW,Espanyol,es La Liga,24,1994,11.9,9,7,3,4,2,4,13,30.8,9,8,1,7,10,19,4,0,Matches
2498,Takehiro Tomiyasu,jp JPN,DF,Bologna,it Serie A,20,1998,28.1,42,24,25,13,4,22,41,53.7,19,34,9,25,49,91,78,1,Matches
2499,James Tomkins,eng ENG,DF,Crystal Palace,eng Premier League,30,1989,17.6,29,17,21,8,0,18,25,72.0,7,17,15,2,21,50,103,0,Matches
2500,Fikayo Tomori,eng ENG,DF,Chelsea,eng Premier League,21,1997,14.3,29,16,21,8,0,10,15,66.7,5,13,7,6,22,51,48,2,Matches
2501,Nenad Tomović,rs SRB,DF,SPAL,it Serie A,31,1987,19.5,26,19,18,6,2,10,21,47.6,11,32,23,9,30,56,65,1,Matches
2502,Sandro Tonali,it ITA,MF,Brescia,it Serie A,19,2000,33.5,39,25,16,20,3,16,55,29.1,39,36,14,22,41,80,42,0,Matches
2503,Lorenzo Tonelli,it ITA,DF,Sampdoria,it Serie A,29,1990,7.8,13,9,13,0,0,4,10,40.0,6,10,7,3,4,17,23,0,Matches
2504,Toño,es ESP,DF,Levante,es La Liga,29,1989,17.7,26,19,18,7,1,15,28,53.6,13,11,3,8,13,39,34,1,Matches
2505,Ömer Toprak,tr TUR,DF,Werder Bremen,de Bundesliga,30,1989,7.9,7,2,4,2,1,3,6,50.0,3,6,4,2,12,19,41,0,Matches
2506,Ernesto Torregrossa,ve VEN,FW,Brescia,it Serie A,27,1992,20.5,17,7,5,10,2,6,22,27.3,16,10,2,8,5,22,22,0,Matches
2507,Lucas Torreira,uy URU,MF,Arsenal,eng Premier League,23,1996,16.8,31,16,11,15,5,16,39,41.0,23,24,8,16,34,65,24,0,Matches
2508,Ferrán Torres,es ESP,"MF,FW",Valencia,es La Liga,19,2000,25.0,23,15,6,16,1,8,30,26.7,22,20,3,17,14,37,12,0,Matches
2509,Óliver Torres,es ESP,"MF,FW",Sevilla,es La Liga,24,1994,17.7,45,27,12,26,7,23,60,38.3,37,23,1,22,13,58,9,1,Matches
2510,Pau Torres,es ESP,DF,Villarreal,es La Liga,22,1997,33.0,34,21,24,10,0,16,24,66.7,8,39,23,16,27,61,153,1,Matches
2511,Roberto Torres,es ESP,"MF,FW",Osasuna,es La Liga,30,1989,30.2,33,16,12,18,3,21,49,42.9,28,41,2,39,31,64,37,0,Matches
2512,Lucas Torró,es ESP,MF,Eint Frankfurt,de Bundesliga,25,1994,3.7,12,7,6,6,0,8,16,50.0,8,2,1,1,8,20,3,0,Matches
2513,Jordan Torunarigha,de GER,DF,Hertha BSC,de Bundesliga,21,1997,16.2,32,19,21,11,0,18,27,66.7,9,33,18,15,31,63,75,0,Matches
2514,Cenk Tosun,tr TUR,FW,Crystal Palace,eng Premier League,28,1991,2.0,2,2,2,0,0,0,2,0.0,2,0,0,0,0,2,1,0,Matches
2515,Cenk Tosun,tr TUR,FW,Everton,eng Premier League,28,1991,3.2,2,0,0,0,2,0,1,0.0,1,1,0,1,0,2,1,0,Matches
2516,Abdoulaye Touré,gn GUI,MF,Nantes,fr Ligue 1,25,1994,24.7,32,21,10,21,1,10,30,33.3,20,31,11,20,29,61,18,1,Matches
2517,Almamy Touré,ml MLI,DF,Eint Frankfurt,de Bundesliga,23,1996,16.6,32,19,18,11,3,11,22,50.0,11,18,7,11,23,55,54,1,Matches
2518,Lucas Tousart,fr FRA,MF,Lyon,fr Ligue 1,22,1997,19.6,58,32,19,34,5,17,56,30.4,39,19,7,12,31,89,27,1,Matches
2519,Andros Townsend,eng ENG,"FW,MF",Crystal Palace,eng Premier League,28,1991,14.4,34,21,12,17,5,15,37,40.5,22,18,0,18,15,49,10,1,Matches
2520,Aleksandar Trajkovski,mk MKD,"MF,FW",Mallorca,es La Liga,26,1992,3.7,2,0,1,1,0,1,7,14.3,6,2,0,2,3,5,1,0,Matches
2521,Adama Traoré,es ESP,"FW,DF",Wolves,eng Premier League,23,1996,28.9,33,21,6,14,13,8,23,34.8,15,19,3,16,13,46,14,2,Matches
2522,Adama Traoré,ml MLI,"FW,MF",Metz,fr Ligue 1,24,1995,11.2,3,1,1,2,0,3,12,25.0,9,7,2,5,3,6,5,0,Matches
2523,Adama Traoré,ml MLI,MF,Monaco,fr Ligue 1,24,1995,0.3,0,0,0,0,0,0,0,,0,0,0,0,1,1,0,0,Matches
2524,Bertrand Traoré,bf BFA,"FW,MF",Lyon,fr Ligue 1,23,1995,13.9,27,14,8,12,7,8,19,42.1,11,17,2,15,21,48,16,0,Matches
2525,Charles Traore,ml MLI,DF,Nantes,fr Ligue 1,27,1992,19.3,48,35,27,19,2,36,61,59.0,25,21,4,17,39,87,64,0,Matches
2526,Hamari Traoré,ml MLI,DF,Rennes,fr Ligue 1,27,1992,26.8,55,26,34,18,3,32,64,50.0,32,22,5,17,48,103,59,1,Matches
2527,Ibrahima Traoré,gn GUI,"FW,MF",Gladbach,de Bundesliga,31,1988,1.7,4,3,1,1,2,1,7,14.3,6,1,0,1,1,5,3,0,Matches
2528,Ismaël Traoré,ci CIV,DF,Angers,fr Ligue 1,32,1986,22.8,23,12,14,7,2,10,17,58.8,7,23,13,10,27,50,85,1,Matches
2529,Kevin Trapp,de GER,GK,Eint Frankfurt,de Bundesliga,29,1990,22.0,0,0,0,0,0,0,1,0.0,1,0,0,0,3,3,5,0,Matches
2530,Miguel Trauco,pe PER,DF,Saint-Étienne,fr Ligue 1,26,1992,16.4,32,20,16,12,4,19,44,43.2,25,8,1,7,23,55,25,0,Matches
2531,Mark Travers,ie IRL,GK,Bournemouth,eng Premier League,20,1999,1.0,0,0,0,0,0,0,0,,0,0,0,0,0,0,1,1,Matches
2532,Luca Tremolada,it ITA,MF,Brescia,it Serie A,27,1991,0.2,0,0,0,0,0,0,0,,0,0,0,0,0,0,0,0,Matches
2533,Trézéguet,eg EGY,"FW,MF",Aston Villa,eng Premier League,24,1994,21.7,38,16,18,15,5,9,44,20.5,35,23,2,21,25,63,18,0,Matches
2534,Manu Trigueros,es ESP,MF,Villarreal,es La Liga,27,1991,17.2,34,21,10,17,7,12,45,26.7,33,23,12,11,4,38,21,0,Matches
2535,Christopher Trimmel,at AUT,"DF,MF",Union Berlin,de Bundesliga,32,1987,31.8,71,41,35,32,4,32,54,59.3,22,31,10,21,51,122,88,1,Matches
2536,Alessandro Tripaldelli,it ITA,DF,Sassuolo,it Serie A,20,1999,1.5,4,4,1,3,0,1,3,33.3,2,1,0,1,3,7,3,0,Matches
2537,Kieran Trippier,eng ENG,DF,Atlético Madrid,es La Liga,28,1990,22.0,52,34,24,21,7,34,53,64.2,19,33,7,26,24,76,46,0,Matches
2538,William Troost-Ekong,ng NGA,DF,Udinese,it Serie A,25,1993,28.6,37,19,25,12,0,10,18,55.6,8,41,29,12,31,68,135,2,Matches
2539,Leandro Trossard,be BEL,"FW,MF",Brighton,eng Premier League,24,1994,22.3,22,17,7,12,3,6,38,15.8,32,16,1,15,9,31,8,0,Matches
2540,Tom Trybull,de GER,MF,Norwich City,eng Premier League,26,1993,12.6,39,25,15,18,6,16,60,26.7,44,20,5,15,16,55,35,0,Matches
2541,Axel Tuanzebe,cd COD,DF,Manchester Utd,eng Premier League,21,1997,2.1,2,2,0,2,0,1,2,50.0,1,1,0,1,5,7,5,1,Matches
2542,Georgi Tunjov,ee EST,MF,SPAL,it Serie A,18,2001,3.2,4,4,3,1,0,1,11,9.1,10,3,1,2,1,5,0,0,Matches
2543,Stefano Turati,it ITA,GK,Sassuolo,it Serie A,17,2001,2.0,0,0,0,0,0,0,0,,0,0,0,0,0,0,1,0,Matches
2544,Gennaro Tutino,it ITA,"FW,MF",Hellas Verona,it Serie A,22,1996,2.5,0,0,0,0,0,0,0,,0,0,0,0,2,2,1,0,Matches
2545,Matthieu Udol,fr FRA,DF,Metz,fr Ligue 1,23,1996,12.2,29,19,19,8,2,13,24,54.2,11,21,4,17,23,52,43,0,Matches
2546,Hwang Ui-jo,kr KOR,"FW,MF",Bordeaux,fr Ligue 1,26,1992,18.1,9,7,2,5,2,4,20,20.0,16,7,0,7,5,14,5,0,Matches
2547,Anthony Ujah,ng NGA,"FW,MF",Union Berlin,de Bundesliga,28,1990,10.5,8,6,4,2,2,1,6,16.7,5,0,0,0,3,11,10,0,Matches
2548,Samir Ujkani,xk KVX,GK,Torino,it Serie A,31,1988,1.0,0,0,0,0,0,0,0,,0,0,0,0,0,0,1,0,Matches
2549,Sven Ulreich,de GER,GK,Bayern Munich,de Bundesliga,30,1988,1.0,0,0,0,0,0,0,0,,0,0,0,0,0,0,0,0,Matches
2550,Samuel Umtiti,fr FRA,DF,Barcelona,es La Liga,25,1993,10.5,11,5,5,5,1,5,8,62.5,3,4,2,2,22,33,32,0,Matches
2551,Enes Ünal,tr TUR,FW,Valladolid,es La Liga,22,1997,26.0,20,12,6,11,3,6,28,21.4,22,17,5,12,6,26,13,0,Matches
2552,Cengiz Ünder,tr TUR,FW,Roma,it Serie A,22,1997,9.7,10,6,4,4,2,2,9,22.2,7,7,2,5,8,18,7,0,Matches
2553,Dayot Upamecano,fr FRA,DF,RB Leipzig,de Bundesliga,20,1998,26.2,52,31,37,15,0,23,43,53.5,20,31,17,14,43,95,88,1,Matches
2554,Mark Uth,de GER,"MF,FW",Köln,de Bundesliga,27,1991,12.9,19,12,4,10,5,9,32,28.1,23,15,0,15,7,26,3,0,Matches
2555,Mark Uth,de GER,"FW,MF",Schalke 04,de Bundesliga,27,1991,3.9,3,2,1,1,1,0,3,0.0,3,4,0,4,1,4,0,0,Matches
2556,Tomáš Vaclík,cz CZE,GK,Sevilla,es La Liga,30,1989,32.5,0,0,0,0,0,0,1,0.0,1,0,0,0,0,0,7,0,Matches
2557,Álvaro Vadillo,es ESP,"FW,MF",Granada,es La Liga,24,1994,13.5,16,11,6,8,2,9,16,56.3,7,12,0,12,7,23,2,0,Matches
2558,William Vainqueur,fr FRA,MF,Toulouse,fr Ligue 1,30,1988,19.1,68,36,30,32,6,22,60,36.7,38,21,5,16,29,97,23,0,Matches
2559,Mirko Valdifiori,it ITA,MF,SPAL,it Serie A,33,1986,15.6,31,15,14,17,0,16,33,48.5,17,8,3,5,4,35,25,0,Matches
2560,Pierrick Valdivia,fr FRA,MF,Nîmes,fr Ligue 1,31,1988,0.8,1,1,0,0,1,0,1,0.0,1,0,0,0,0,1,0,0,Matches
2561,Germán Valera,es ESP,FW,Atlético Madrid,es La Liga,17,2002,0.0,0,0,0,0,0,0,0,,0,1,0,1,0,0,0,0,Matches
2562,Antoine Valerio,fr FRA,MF,Nîmes,fr Ligue 1,19,1999,1.0,1,1,0,1,0,0,2,0.0,2,2,0,2,3,4,1,0,Matches
2563,Borja Valero,es ESP,MF,Inter,it Serie A,34,1985,10.3,18,7,9,3,6,6,24,25.0,18,12,3,9,8,26,9,0,Matches
2564,Yan Valery,tn TUN,DF,Southampton,eng Premier League,20,1999,8.7,20,7,9,7,4,11,19,57.9,8,9,1,8,13,33,32,2,Matches
2565,Martin Valjent,sk SVK,DF,Mallorca,es La Liga,23,1995,35.4,25,17,14,10,1,13,25,52.0,12,39,27,12,37,62,146,1,Matches
2566,Jesús Vallejo,es ESP,DF,Wolves,eng Premier League,22,1997,1.8,1,1,1,0,0,1,2,50.0,1,4,3,1,2,3,8,1,Matches
2567,Jesús Vallejo,es ESP,DF,Granada,es La Liga,22,1997,7.0,6,5,4,2,0,3,4,75.0,1,7,4,3,5,11,28,0,Matches
2568,Manu Vallejo,es ESP,"MF,FW",Valencia,es La Liga,22,1997,4.6,7,3,0,3,4,5,9,55.6,4,4,0,4,2,9,2,0,Matches
2569,Luca Valls,fr FRA,MF,Nîmes,fr Ligue 1,20,1998,0.1,1,0,1,0,0,1,1,100.0,0,1,0,1,0,1,0,0,Matches
2570,Theo Valls,fr FRA,MF,Nîmes,fr Ligue 1,23,1995,18.1,39,16,12,26,1,16,50,32.0,34,17,0,17,13,52,6,0,Matches
2571,Mattia Valoti,it ITA,"MF,FW",SPAL,it Serie A,25,1993,17.0,48,30,21,25,2,16,43,37.2,27,27,6,21,16,64,18,0,Matches
2572,Federico Valverde,uy URU,MF,Real Madrid,es La Liga,21,1998,21.2,38,19,9,19,10,12,36,33.3,24,38,4,34,21,59,12,2,Matches
2573,Virgil van Dijk,nl NED,DF,Liverpool,eng Premier League,28,1991,38.0,23,12,18,5,0,6,13,46.2,7,20,15,5,40,63,166,2,Matches
2574,Raphaël Varane,fr FRA,DF,Real Madrid,es La Liga,26,1993,31.4,30,17,15,14,1,12,23,52.2,11,32,16,16,31,61,124,0,Matches
2575,Jamie Vardy,eng ENG,FW,Leicester City,eng Premier League,32,1987,33.7,15,12,0,9,6,2,4,50.0,2,22,4,18,2,17,22,0,Matches
2576,Matías Vargas,ar ARG,"FW,MF",Espanyol,es La Liga,22,1997,11.4,13,5,7,3,3,4,23,17.4,19,12,2,10,3,16,5,0,Matches
2577,Ruben Vargas,ch SUI,"FW,MF",Augsburg,de Bundesliga,20,1998,28.1,32,16,18,7,7,8,36,22.2,28,26,1,25,26,58,35,0,Matches
2578,Thibaut Vargas,fr FRA,"DF,MF",Montpellier,fr Ligue 1,19,2000,1.7,3,1,3,0,0,2,5,40.0,3,1,1,0,0,3,3,0,Matches
2579,Sebastian Vasiliadis,gr GRE,MF,Paderborn 07,de Bundesliga,21,1997,31.2,73,45,34,31,8,28,81,34.6,53,47,6,41,34,107,50,0,Matches
2580,Indiana Vassilev,us USA,"FW,MF",Aston Villa,eng Premier League,18,2001,0.6,0,0,0,0,0,0,0,,0,0,0,0,0,0,0,0,Matches
2581,Denis Vavro,sk SVK,DF,Lazio,it Serie A,23,1996,3.6,3,3,2,1,0,1,3,33.3,2,8,6,2,5,8,10,0,Matches
2582,Franco Vázquez,ar ARG,"MF,FW",Sevilla,es La Liga,30,1989,12.2,25,17,9,14,2,6,36,16.7,30,13,0,13,10,35,10,0,Matches
2583,Kevin Vázquez,es ESP,DF,Celta Vigo,es La Liga,26,1993,14.7,26,15,16,6,4,15,28,53.6,13,18,1,17,26,52,28,0,Matches
2584,Lucas Vázquez,es ESP,"MF,FW",Real Madrid,es La Liga,28,1991,9.4,23,17,10,13,0,11,26,42.3,15,10,0,10,10,33,8,1,Matches
2585,Matías Vecino,uy URU,MF,Inter,it Serie A,27,1991,14.2,31,20,14,11,6,9,36,25.0,27,20,3,17,15,46,26,0,Matches
2586,Koke Vegas,es ESP,GK,Levante,es La Liga,23,1995,2.0,0,0,0,0,0,0,1,0.0,1,0,0,0,0,0,3,0,Matches
2587,Miloš Veljković,rs SRB,DF,Werder Bremen,de Bundesliga,23,1995,22.8,55,33,36,18,1,33,53,62.3,20,25,11,14,26,81,92,1,Matches
2588,Miguel Veloso,pt POR,MF,Hellas Verona,it Serie A,33,1986,31.2,52,29,20,28,4,18,60,30.0,42,36,12,24,32,84,46,1,Matches
2589,Unai Vencedor Paris,es ESP,MF,Athletic Club,es La Liga,18,2000,0.8,0,0,0,0,0,0,0,,0,0,0,0,0,0,0,0,Matches
2590,Lorenzo Venuti,it ITA,"DF,MF",Fiorentina,it Serie A,24,1995,9.5,20,10,12,6,2,13,19,68.4,6,5,1,4,11,31,15,0,Matches
2591,Brayan Vera,co COL,"DF,FW",Lecce,it Serie A,20,1999,1.7,4,1,2,1,1,3,7,42.9,4,1,0,1,1,5,4,0,Matches
2592,Simone Verdi,it ITA,"MF,FW",Torino,it Serie A,27,1992,23.0,19,10,4,12,3,9,38,23.7,29,14,0,14,7,26,1,0,Matches
2593,Jordan Veretout,fr FRA,MF,Roma,it Serie A,26,1993,29.2,36,18,13,16,7,14,43,32.6,29,35,5,30,18,54,31,1,Matches
2594,Marco Verratti,it ITA,MF,Paris S-G,fr Ligue 1,26,1992,16.5,54,32,22,22,10,20,56,35.7,36,23,3,20,19,73,9,0,Matches
2595,Valerio Verre,it ITA,"MF,FW",Hellas Verona,it Serie A,25,1994,19.7,25,15,4,11,10,9,23,39.1,14,5,0,5,13,38,9,0,Matches
2596,Birger Verstraete,be BEL,MF,Köln,de Bundesliga,25,1994,7.4,20,11,9,10,1,11,21,52.4,10,8,1,7,4,24,10,1,Matches
2597,Jan Vertonghen,be BEL,DF,Tottenham,eng Premier League,32,1987,18.3,40,24,25,14,1,20,31,64.5,11,18,10,8,33,73,68,0,Matches
2598,Mikel Vesga,es ESP,MF,Athletic Club,es La Liga,26,1993,14.1,25,17,7,12,6,9,45,20.0,36,18,7,11,31,56,24,1,Matches
2599,Jannik Vestergaard,dk DEN,DF,Southampton,eng Premier League,26,1992,16.6,19,12,14,5,0,11,28,39.3,17,15,9,6,26,45,99,2,Matches
2600,Rúben Vezo,pt POR,DF,Levante,es La Liga,25,1994,29.0,41,24,28,13,0,19,35,54.3,16,37,29,8,42,83,144,2,Matches
2601,Francesco Vicari,it ITA,DF,SPAL,it Serie A,24,1994,32.2,27,13,20,6,1,12,25,48.0,13,48,37,11,38,65,145,1,Matches
2602,Fede Vico,es ESP,"MF,FW",Granada,es La Liga,25,1994,9.7,5,1,2,3,0,2,11,18.2,9,12,1,11,5,10,2,0,Matches
2603,Aleix Vidal,es ESP,MF,Alavés,es La Liga,29,1989,24.1,21,14,8,11,2,8,37,21.6,29,14,1,13,23,44,18,0,Matches
2604,Arturo Vidal,cl CHI,MF,Barcelona,es La Liga,32,1987,18.6,63,38,22,30,11,24,58,41.4,34,31,7,24,17,80,16,1,Matches
2605,Clément Vidal,fr FRA,DF,Montpellier,fr Ligue 1,19,2000,1.0,0,0,0,0,0,0,2,0.0,2,1,1,0,0,0,6,0,Matches
2606,Nacho Vidal,es ESP,DF,Osasuna,es La Liga,24,1995,25.9,45,29,26,13,6,21,38,55.3,17,24,6,18,44,89,70,1,Matches
2607,Ronaldo Vieira,eng ENG,MF,Sampdoria,it Serie A,21,1998,20.2,33,19,13,17,3,6,28,21.4,22,14,2,12,21,54,31,0,Matches
2608,Mauro Vigorito,it ITA,GK,Lecce,it Serie A,29,1990,4.7,0,0,0,0,0,0,0,,0,0,0,0,0,0,3,1,Matches
2609,Dídac Vilà,es ESP,DF,Espanyol,es La Liga,30,1989,27.7,73,42,44,23,6,25,61,41.0,36,31,5,26,40,113,63,0,Matches
2610,Toni Villa,es ESP,MF,Valladolid,es La Liga,24,1995,15.0,31,16,13,14,4,13,50,26.0,37,16,1,15,8,39,11,0,Matches
2611,Asier Villalibre,es ESP,FW,Athletic Club,es La Liga,21,1997,5.9,0,0,0,0,0,0,3,0.0,3,3,0,3,1,1,4,0,Matches
2612,Gonzalo Villar,es ESP,MF,Roma,it Serie A,21,1998,3.3,5,3,4,0,1,2,4,50.0,2,2,0,2,2,7,3,0,Matches
2613,Iván Villar,es ESP,GK,Celta Vigo,es La Liga,22,1997,3.1,0,0,0,0,0,0,0,,0,0,0,0,0,0,5,0,Matches
2614,Juan Villar,es ESP,FW,Osasuna,es La Liga,31,1988,2.7,1,0,0,1,0,0,2,0.0,2,4,1,3,1,2,0,0,Matches
2615,Rúben Vinagre,pt POR,"MF,DF",Wolves,eng Premier League,20,1999,7.2,23,13,15,6,2,12,15,80.0,3,7,2,5,11,34,22,0,Matches
2616,Luigi Vitale,it ITA,DF,Hellas Verona,it Serie A,31,1987,0.5,1,0,0,1,0,0,0,,0,1,0,1,0,1,0,0,Matches
2617,Vitolo,es ESP,"FW,MF",Atlético Madrid,es La Liga,29,1989,13.6,15,12,7,7,1,5,17,29.4,12,9,0,9,10,25,9,0,Matches
2618,Mattia Viviani,it ITA,MF,Brescia,it Serie A,18,2000,3.8,3,1,0,3,0,1,8,12.5,7,3,3,0,9,12,2,1,Matches
2619,Dušan Vlahović,rs SRB,FW,Fiorentina,it Serie A,19,2000,16.7,6,2,1,4,1,4,13,30.8,9,5,2,3,7,13,6,0,Matches
2620,Kevin Vogt,de GER,DF,Hoffenheim,de Bundesliga,27,1991,10.7,7,5,4,3,0,3,9,33.3,6,12,6,6,8,15,52,1,Matches
2621,Kevin Vogt,de GER,"DF,MF",Werder Bremen,de Bundesliga,27,1991,12.3,14,10,8,6,0,8,16,50.0,8,15,12,3,25,39,37,1,Matches
2622,Jake Vokins,eng ENG,DF,Southampton,eng Premier League,19,2000,1.0,2,2,0,0,2,1,1,100.0,0,0,0,0,0,2,1,0,Matches
2623,Kevin Volland,de GER,FW,Leverkusen,de Bundesliga,27,1992,22.7,16,6,5,6,5,5,16,31.3,11,14,2,12,5,21,7,0,Matches
2624,Mario Vrančić,ba BIH,MF,Norwich City,eng Premier League,30,1989,7.1,27,16,14,11,2,16,27,59.3,11,9,0,9,10,37,4,2,Matches
2625,Stefan de Vrij,nl NED,DF,Inter,it Serie A,27,1992,31.4,33,18,20,12,1,14,27,51.9,13,34,24,10,52,85,121,1,Matches
2626,Giacomo Vrioni,al ALB,FW,Juventus,it Serie A,20,1998,0.1,0,0,0,0,0,0,0,,0,0,0,0,0,0,0,0,Matches
2627,Šime Vrsaljko,hr CRO,DF,Atlético Madrid,es La Liga,27,1992,4.0,6,5,6,0,0,5,6,83.3,1,5,3,2,8,14,11,0,Matches
2628,Nikola Vukčević,me MNE,MF,Levante,es La Liga,27,1991,17.4,41,26,17,17,7,15,40,37.5,25,19,7,12,12,53,16,0,Matches
2629,Matěj Vydra,cz CZE,FW,Burnley,eng Premier League,27,1992,9.1,4,3,0,3,1,3,6,50.0,3,7,3,4,1,5,6,0,Matches
2630,Molla Wagué,ml MLI,DF,Nantes,fr Ligue 1,28,1991,7.6,15,12,11,4,0,7,7,100.0,0,10,8,2,15,30,42,0,Matches
2631,Moussa Wagué,sn SEN,DF,Barcelona,es La Liga,20,1998,1.0,2,1,1,0,1,1,1,100.0,0,0,0,0,1,3,0,0,Matches
2632,Moussa Wagué,sn SEN,"DF,MF",Nice,fr Ligue 1,20,1998,2.2,6,4,3,3,0,2,3,66.7,1,2,1,1,2,8,2,0,Matches
2633,Wakaso,gh GHA,MF,Alavés,es La Liga,29,1990,14.3,54,31,25,24,5,16,33,48.5,17,23,5,18,17,71,17,1,Matches
2634,Walace,br BRA,MF,Udinese,it Serie A,24,1995,12.7,28,9,19,6,3,13,42,31.0,29,14,6,8,33,61,19,0,Matches
2635,Theo Walcott,eng ENG,"MF,FW",Everton,eng Premier League,30,1989,14.3,13,8,6,5,2,3,15,20.0,12,13,0,13,8,21,1,0,Matches
2636,Luca Waldschmidt,de GER,"FW,MF",Freiburg,de Bundesliga,23,1996,14.1,10,7,3,5,2,2,18,11.1,16,11,2,9,4,14,4,0,Matches
2637,Kyle Walker,eng ENG,DF,Manchester City,eng Premier League,29,1990,26.6,28,18,12,15,1,12,29,41.4,17,15,6,9,28,56,42,1,Matches
2638,Kyle Walker-Peters,eng ENG,DF,Southampton,eng Premier League,22,1997,7.8,13,8,5,6,2,6,16,37.5,10,10,3,7,14,27,21,1,Matches
2639,Kyle Walker-Peters,eng ENG,DF,Tottenham,eng Premier League,22,1997,2.7,8,5,8,0,0,5,9,55.6,4,4,2,2,3,11,5,1,Matches
2640,Rémi Walter,fr FRA,MF,Nice,fr Ligue 1,24,1995,0.6,1,1,0,1,0,1,1,100.0,0,0,0,0,0,1,0,0,Matches
2641,Sebastian Walukiewicz,pl POL,DF,Cagliari,it Serie A,19,2000,12.9,25,11,17,8,0,14,22,63.6,8,21,14,7,14,39,41,0,Matches
2642,Aaron Wan-Bissaka,eng ENG,DF,Manchester Utd,eng Premier League,21,1997,34.1,129,80,71,50,8,64,86,74.4,22,46,13,33,66,195,83,0,Matches
2643,Victor Wanyama,ke KEN,MF,Tottenham,eng Premier League,28,1991,0.3,0,0,0,0,0,0,0,,0,0,0,0,0,0,0,0,Matches
2644,Joel Ward,eng ENG,DF,Crystal Palace,eng Premier League,29,1989,26.5,69,42,48,16,5,39,56,69.6,17,13,6,7,48,117,93,1,Matches
2645,James Ward-Prowse,eng ENG,"MF,DF",Southampton,eng Premier League,24,1994,38.0,92,48,39,39,14,39,94,41.5,55,48,14,34,60,152,75,1,Matches
2646,Daniel Wass,dk DEN,"DF,MF",Valencia,es La Liga,30,1989,30.4,44,25,25,13,6,25,57,43.9,32,22,5,17,31,75,91,1,Matches
2647,Kelland Watts,eng ENG,DF,Newcastle Utd,eng Premier League,19,1999,0.2,1,0,1,0,0,1,1,100.0,0,0,0,0,0,1,0,0,Matches
2648,Timothy Weah,us USA,"MF,FW",Lille,fr Ligue 1,19,2000,0.9,0,0,0,0,0,0,1,0.0,1,0,0,0,0,0,1,0,Matches
2649,Adam Webster,eng ENG,DF,Brighton,eng Premier League,24,1995,29.6,30,17,21,8,1,14,32,43.8,18,43,26,17,45,75,110,2,Matches
2650,Wout Weghorst,nl NED,FW,Wolfsburg,de Bundesliga,26,1992,30.4,15,8,4,5,6,1,17,5.9,16,17,4,13,2,17,30,0,Matches
2651,Julian Weigl,de GER,"MF,DF",Dortmund,de Bundesliga,23,1995,11.3,16,9,12,3,1,9,16,56.3,7,10,0,10,8,24,21,0,Matches
2652,Mitchell Weiser,de GER,"DF,MF",Leverkusen,de Bundesliga,25,1994,13.0,41,29,20,17,4,18,30,60.0,12,19,2,17,24,65,22,1,Matches
2653,Danny Welbeck,eng ENG,"FW,MF",Watford,eng Premier League,28,1990,9.1,14,6,6,5,3,3,11,27.3,8,12,1,11,5,19,7,0,Matches
2654,Wendell,br BRA,"DF,MF",Leverkusen,de Bundesliga,26,1993,21.1,64,42,26,26,12,41,66,62.1,25,30,4,26,36,100,36,0,Matches
2655,Oscar Wendt,se SWE,DF,Gladbach,de Bundesliga,33,1985,18.7,26,14,16,8,2,12,31,38.7,19,27,6,21,20,46,45,0,Matches
2656,Timo Werner,de GER,FW,RB Leipzig,de Bundesliga,23,1996,31.1,20,9,6,7,7,3,16,18.8,13,16,0,16,5,25,2,0,Matches
2657,Ashley Westwood,eng ENG,MF,Burnley,eng Premier League,29,1990,35.0,54,33,15,32,7,17,48,35.4,31,23,11,12,32,86,32,3,Matches
2658,Connor Wickham,eng ENG,"FW,MF",Crystal Palace,eng Premier League,26,1993,1.1,1,1,1,0,0,0,0,,0,1,0,1,1,2,0,0,Matches
2659,Felix Wiedwald,de GER,GK,Eint Frankfurt,de Bundesliga,29,1990,3.0,0,0,0,0,0,0,0,,0,0,0,0,0,0,2,1,Matches
2660,Georginio Wijnaldum,nl NED,MF,Liverpool,eng Premier League,28,1990,32.6,38,20,12,21,5,10,40,25.0,30,18,4,14,17,55,34,3,Matches
2661,Jetro Willems,nl NED,DF,Newcastle Utd,eng Premier League,25,1994,16.6,37,19,29,6,2,18,39,46.2,21,20,5,15,17,54,42,1,Matches
2662,William,br BRA,DF,Wolfsburg,de Bundesliga,24,1995,15.2,55,26,34,14,7,27,59,45.8,32,10,3,7,24,79,38,1,Matches
2663,Brandon Williams,eng ENG,DF,Manchester Utd,eng Premier League,18,2000,11.2,21,15,11,6,4,9,29,31.0,20,9,4,5,16,37,27,0,Matches
2664,Iñaki Williams,gh GHA,FW,Athletic Club,es La Liga,25,1994,32.7,15,5,0,7,8,5,18,27.8,13,18,2,16,5,20,29,0,Matches
2665,Neco Williams,wls WAL,DF,Liverpool,eng Premier League,18,2001,2.6,5,3,1,3,1,4,5,80.0,1,3,1,2,9,14,6,0,Matches
2666,Willian,br BRA,"FW,MF",Chelsea,eng Premier League,30,1988,28.9,45,27,14,24,7,14,43,32.6,29,15,0,15,20,65,7,0,Matches
2667,Joe Willock,eng ENG,"MF,FW",Arsenal,eng Premier League,19,1999,9.5,25,16,9,12,4,8,21,38.1,13,16,2,14,4,29,11,2,Matches
2668,Jack Wilshere,eng ENG,MF,West Ham,eng Premier League,27,1992,2.4,1,0,1,0,0,0,4,0.0,4,3,0,3,1,2,0,0,Matches
2669,Callum Wilson,eng ENG,FW,Bournemouth,eng Premier League,27,1992,32.3,12,9,3,6,3,2,17,11.8,15,16,2,14,4,16,16,0,Matches
2670,Harry Wilson,wls WAL,"MF,FW",Bournemouth,eng Premier League,22,1997,18.3,23,13,8,10,5,11,34,32.4,23,26,2,24,11,34,15,1,Matches
2671,Harry Winks,eng ENG,MF,Tottenham,eng Premier League,23,1996,24.7,40,24,18,20,2,17,54,31.5,37,27,8,19,36,76,32,1,Matches
2672,Florian Wirtz,de GER,FW,Leverkusen,de Bundesliga,16,2003,4.1,4,2,0,4,0,2,4,50.0,2,4,0,4,2,6,1,0,Matches
2673,Axel Witsel,be BEL,MF,Dortmund,de Bundesliga,30,1989,24.9,28,20,10,17,1,14,33,42.4,19,26,7,19,31,59,19,1,Matches
2674,Hannes Wolf,at AUT,"FW,MF",RB Leipzig,de Bundesliga,20,1999,0.6,3,0,0,1,2,1,4,25.0,3,0,0,0,0,3,0,0,Matches
2675,Marius Wolf,de GER,"FW,MF",Hertha BSC,de Bundesliga,24,1995,15.7,19,11,9,7,3,10,27,37.0,17,14,1,13,17,36,13,0,Matches
2676,Nick Woltemade,de GER,"FW,MF",Werder Bremen,de Bundesliga,17,2002,1.0,2,1,0,2,0,0,1,0.0,1,1,0,1,0,2,2,0,Matches
2677,Chris Wood,nz NZL,FW,Burnley,eng Premier League,27,1991,27.1,7,4,2,4,1,5,15,33.3,10,15,2,13,4,11,18,0,Matches
2678,Xeka,pt POR,MF,Lille,fr Ligue 1,24,1994,7.9,18,10,3,13,2,9,29,31.0,20,11,1,10,4,22,7,1,Matches
2679,Granit Xhaka,ch SUI,MF,Arsenal,eng Premier League,26,1992,28.7,45,25,20,19,6,25,55,45.5,30,32,16,16,21,66,59,3,Matches
2680,Jawad El Yamiq,ma MAR,DF,Genoa,it Serie A,27,1992,2.2,3,2,3,0,0,1,4,25.0,3,3,2,1,1,4,3,0,Matches
2681,Andriy Yarmolenko,ua UKR,"MF,FW",West Ham,eng Premier League,29,1989,11.0,13,8,5,6,2,5,20,25.0,15,3,1,2,6,19,4,0,Matches
2682,Yusuf Yazıcı,tr TUR,"MF,FW",Lille,fr Ligue 1,22,1997,9.4,17,8,2,11,4,5,13,38.5,8,6,1,5,5,22,1,1,Matches
2683,DeAndre Yedlin,us USA,DF,Newcastle Utd,eng Premier League,26,1993,10.4,18,13,10,6,2,8,16,50.0,8,13,7,6,10,28,20,0,Matches
2684,Yoel,es ESP,GK,Eibar,es La Liga,30,1988,3.0,0,0,0,0,0,0,0,,0,0,0,0,1,1,1,0,Matches
2685,Okay Yokuşlu,tr TUR,MF,Celta Vigo,es La Liga,25,1994,21.9,41,27,18,21,2,20,42,47.6,22,12,5,7,28,69,71,1,Matches
2686,Maya Yoshida,jp JPN,DF,Southampton,eng Premier League,30,1988,6.2,8,5,4,1,3,3,7,42.9,4,6,2,4,4,12,27,1,Matches
2687,Maya Yoshida,jp JPN,DF,Sampdoria,it Serie A,30,1988,13.2,4,3,2,2,0,2,6,33.3,4,15,12,3,27,31,72,0,Matches
2688,Elie Youan,fr FRA,"FW,MF",Nantes,fr Ligue 1,20,1999,1.8,0,0,0,0,0,0,7,0.0,7,2,0,2,0,0,3,0,Matches
2689,Amin Younes,de GER,"FW,MF",Napoli,it Serie A,25,1993,2.0,3,2,1,2,0,2,4,50.0,2,2,0,2,0,3,1,0,Matches
2690,Ashley Young,eng ENG,DF,Manchester Utd,eng Premier League,34,1985,10.6,14,7,7,4,3,5,17,29.4,12,8,2,6,11,25,29,0,Matches
2691,Ashley Young,eng ENG,DF,Inter,it Serie A,34,1985,13.2,11,5,3,5,3,6,19,31.6,13,11,3,8,14,25,24,0,Matches
2692,Zaydou Youssouf,fr FRA,MF,Saint-Étienne,fr Ligue 1,20,1999,12.0,40,22,12,26,2,15,35,42.9,20,7,1,6,16,56,13,0,Matches
2693,Pablo Zabaleta,ar ARG,DF,West Ham,eng Premier League,34,1985,6.6,18,10,12,5,1,6,13,46.2,7,5,3,2,14,32,21,0,Matches
2694,Mattia Zaccagni,it ITA,"MF,FW",Hellas Verona,it Serie A,24,1995,23.5,20,11,10,5,5,3,15,20.0,12,14,3,11,20,40,21,0,Matches
2695,Dan-Axel Zagadou,fr FRA,DF,Dortmund,de Bundesliga,20,1999,10.9,16,10,12,4,0,6,8,75.0,2,12,8,4,15,31,38,0,Matches
2696,Arthur Zagre,fr FRA,MF,Paris S-G,fr Ligue 1,17,2001,0.3,1,0,1,0,0,0,0,,0,1,0,1,1,2,0,0,Matches
2697,Wilfried Zaha,ci CIV,"FW,MF",Crystal Palace,eng Premier League,26,1992,36.4,43,19,18,12,13,12,49,24.5,37,22,2,20,18,61,4,0,Matches
2698,Denis Zakaria,ch SUI,"MF,DF",Gladbach,de Bundesliga,22,1996,21.6,49,30,23,23,3,20,39,51.3,19,39,12,27,37,86,31,1,Matches
2699,Joseba Zaldúa,es ESP,DF,Real Sociedad,es La Liga,27,1992,28.3,62,43,39,18,5,31,59,52.5,28,31,7,24,37,99,71,0,Matches
2700,Andre-Frank Zambo Anguissa,cm CMR,MF,Villarreal,es La Liga,23,1995,28.7,76,49,29,40,7,26,78,33.3,52,42,6,36,44,120,30,0,Matches
2701,Luca Zanimacchia,it ITA,"FW,MF",Juventus,it Serie A,21,1998,1.3,5,1,1,2,2,1,2,50.0,1,1,0,1,0,5,0,0,Matches
2702,Nicolò Zaniolo,it ITA,"FW,MF",Roma,it Serie A,20,1999,16.7,15,11,4,7,4,3,24,12.5,21,14,0,14,5,20,5,0,Matches
2703,Cristián Zapata,co COL,DF,Genoa,it Serie A,32,1986,19.1,23,17,16,7,0,8,16,50.0,8,29,17,12,24,47,75,0,Matches
2704,Duván Zapata,co COL,FW,Atalanta,it Serie A,28,1991,22.5,7,3,1,2,4,1,6,16.7,5,18,7,11,2,9,11,0,Matches
2705,Davide Zappacosta,it ITA,DF,Roma,it Serie A,27,1992,5.0,7,3,2,3,2,4,8,50.0,4,3,1,2,6,13,8,1,Matches
2706,Simone Zaza,it ITA,FW,Torino,it Serie A,28,1991,18.2,15,10,6,4,5,3,10,30.0,7,11,0,11,9,24,13,1,Matches
2707,Marvin Zeegelaar,nl NED,DF,Udinese,it Serie A,28,1990,6.6,15,9,8,4,3,6,11,54.5,5,9,2,7,5,20,10,0,Matches
2708,Mootaz Zemzemi,tn TUN,MF,Strasbourg,fr Ligue 1,19,1999,0.3,0,0,0,0,0,0,0,,0,0,0,0,1,1,0,0,Matches
2709,Arber Zeneli,xk KVX,MF,Reims,fr Ligue 1,24,1995,0.1,0,0,0,0,0,0,0,,0,0,0,0,0,0,0,0,Matches
2710,Robin Zentner,de GER,GK,Mainz 05,de Bundesliga,24,1994,21.5,1,1,1,0,0,1,1,100.0,0,0,0,0,0,1,11,0,Matches
2711,Piotr Zieliński,pl POL,MF,Napoli,it Serie A,25,1994,32.5,26,16,10,11,5,12,30,40.0,18,28,5,23,21,47,15,0,Matches
2712,Jean Zimmer,de GER,"DF,FW",Düsseldorf,de Bundesliga,25,1993,8.0,11,6,5,5,1,5,10,50.0,5,3,1,2,3,14,0,0,Matches
2713,Christoph Zimmermann,de GER,DF,Norwich City,eng Premier League,26,1993,15.9,32,21,26,6,0,21,30,70.0,9,22,18,4,19,51,87,2,Matches
2714,Matthias Zimmermann,de GER,"DF,MF",Düsseldorf,de Bundesliga,27,1992,32.5,62,47,26,27,9,31,64,48.4,33,41,15,26,43,105,59,0,Matches
2715,Oleksandr Zinchenko,ua UKR,DF,Manchester City,eng Premier League,22,1996,14.2,31,19,16,11,4,17,32,53.1,15,9,0,9,17,48,21,1,Matches
2716,Leopold Zingerle,de GER,GK,Paderborn 07,de Bundesliga,25,1994,28.0,3,1,3,0,0,2,4,50.0,2,0,0,0,0,3,7,2,Matches
2717,Joshua Zirkzee,nl NED,FW,Bayern Munich,de Bundesliga,18,2001,3.3,5,2,0,2,3,2,4,50.0,2,2,0,2,1,6,0,0,Matches
2718,Richairo Živković,cw CUW,FW,Sheffield Utd,eng Premier League,22,1996,1.2,2,2,0,2,0,1,2,50.0,1,1,0,1,0,2,0,0,Matches
2719,Jaromír Zmrhal,cz CZE,MF,Brescia,it Serie A,25,1993,12.5,10,4,2,5,3,5,18,27.8,13,8,1,7,4,14,11,0,Matches
2720,Kévin Zohi,ml MLI,"FW,MF",Strasbourg,fr Ligue 1,22,1996,5.9,8,6,3,3,2,3,6,50.0,3,1,0,1,4,12,2,0,Matches
2721,Ben Zolinski,de GER,"FW,MF",Paderborn 07,de Bundesliga,27,1992,13.4,17,9,7,9,1,7,27,25.9,20,12,0,12,8,25,4,0,Matches
2722,Kurt Zouma,fr FRA,DF,Chelsea,eng Premier League,24,1994,26.0,23,14,17,6,0,9,16,56.3,7,22,14,8,58,81,116,2,Matches
2723,Igor Zubeldia,es ESP,"MF,DF",Real Sociedad,es La Liga,22,1997,29.3,42,21,18,19,5,17,35,48.6,18,38,21,17,26,68,82,2,Matches
2724,Steven Zuber,ch SUI,"DF,FW",Hoffenheim,de Bundesliga,27,1991,8.3,11,10,7,2,2,9,19,47.4,10,4,1,3,9,20,12,0,Matches
2725,Martín Zubimendi,es ESP,MF,Real Sociedad,es La Liga,20,1999,5.8,16,12,9,7,0,6,12,50.0,6,7,0,7,9,25,2,0,Matches
2726,Ervin Zukanović,ba BIH,DF,SPAL,it Serie A,32,1987,2.3,1,0,0,0,1,1,1,100.0,0,3,1,2,3,4,15,0,Matches
2727,Bongani Zungu,za RSA,MF,Amiens,fr Ligue 1,26,1992,11.0,27,11,10,13,4,18,31,58.1,13,8,2,6,16,43,21,0,Matches
2728,Szymon Żurkowski,pl POL,MF,Fiorentina,it Serie A,21,1997,0.1,1,0,0,0,1,0,2,0.0,2,0,0,0,0,1,1,0,Matches
2729,David Zurutuza,es ESP,MF,Real Sociedad,es La Liga,33,1986,1.7,4,3,0,3,1,1,2,50.0,1,1,0,1,4,8,3,0,Matches
2730,Martin Ødegaard,no NOR,MF,Real Sociedad,es La Liga,20,1998,28.1,27,19,5,14,8,7,34,20.6,27,13,0,13,17,44,5,0,Matches
2731,Filip Đuričić,rs SRB,"MF,FW",Sassuolo,it Serie A,27,1992,18.1,23,14,2,10,11,3,19,15.8,16,20,3,17,8,31,14,0,Matches
