,Player,Nation,Pos,Squad,Comp,Age,Born,90s,Tackles,Tackles_Won,Tackles_Def_3rd,Tackles_Mid_3rd,Tackles_Att_3rd,Dribblers_Tackled,Dribblers_Challenged,Dribblers_Tackle_W%,Dribblers_Tackle_Lost,Blocks,Shots_Blocked,Passes_Blocked,Interceptions,Tackles+Interceptions,Clearances,Errors_Shots,Matches
0,Ismael Aaneba,fr FRA,DF,Strasbourg,fr Ligue 1,21,1999,0.1,0,0,0,0,0,0,0,,0,0,0,0,1,1,1,0,Matches
1,Patrick van Aanholt,nl NED,DF,Crystal Palace,eng Premier League,29,1990,19.7,35,22,18,17,0,19,43,44.2,24,18,6,12,30,65,40,2,Matches
2,Yunis Abdelhamid,ma MAR,DF,Reims,fr Ligue 1,32,1987,32.1,59,37,36,23,0,26,42,61.9,16,34,15,19,61,120,132,0,Matches
3,Sabit Abdulai,gh GHA,MF,Getafe,es La Liga,21,1999,0.7,2,0,1,1,0,1,3,33.3,2,0,0,0,0,2,0,0,Matches
4,Mehdi Abeid,dz ALG,MF,Nantes,fr Ligue 1,27,1992,14.7,34,19,16,14,4,15,30,50.0,15,9,2,7,20,54,10,0,Matches
5,Laurent Abergel,fr FRA,MF,Lorient,fr Ligue 1,27,1993,32.9,145,84,64,69,12,54,162,33.3,108,64,6,58,46,191,12,0,Matches
6,Charles Abi,fr FRA,"FW,MF",Saint-Étienne,fr Ligue 1,20,2000,10.1,8,2,5,0,3,3,12,25.0,9,6,2,4,4,12,5,0,Matches
7,Matthis Abline,fr FRA,FW,Rennes,fr Ligue 1,17,2003,0.0,0,0,0,0,0,0,0,,0,0,0,0,0,0,0,0,Matches
8,Pape Abou Cissé,sn SEN,DF,Saint-Étienne,fr Ligue 1,24,1995,14.0,15,13,10,5,0,6,10,60.0,4,7,4,3,27,42,87,0,Matches
9,David Abraham,ar ARG,DF,Eint Frankfurt,de Bundesliga,34,1986,13.6,18,12,13,3,2,11,17,64.7,6,13,4,9,17,35,34,0,Matches
10,Tammy Abraham,eng ENG,FW,Chelsea,eng Premier League,22,1997,11.6,7,5,3,3,1,1,7,14.3,6,6,0,6,5,12,17,0,Matches
11,Amir Abrashi,al ALB,"MF,DF",Freiburg,de Bundesliga,30,1990,0.7,1,1,1,0,0,0,0,,0,1,1,0,2,3,1,0,Matches
12,Gennaro Acampora,it ITA,"MF,FW",Spezia,it Serie A,26,1994,4.9,6,4,1,4,1,2,7,28.6,5,4,1,3,4,10,4,0,Matches
13,Francesco Acerbi,it ITA,DF,Lazio,it Serie A,32,1988,31.3,51,32,34,13,4,18,40,45.0,22,24,15,9,76,127,121,2,Matches
14,Ragnar Ache,de GER,"FW,DF",Eint Frankfurt,de Bundesliga,22,1998,1.1,2,0,0,1,1,0,0,,0,1,0,1,1,3,1,0,Matches
15,Marcos Acuña,ar ARG,DF,Sevilla,es La Liga,28,1991,25.9,62,42,34,20,8,23,41,56.1,18,23,2,21,23,85,30,1,Matches
16,Che Adams,sct SCO,FW,Southampton,eng Premier League,24,1996,29.6,25,16,4,15,6,6,17,35.3,11,20,2,18,4,29,19,1,Matches
17,Tyler Adams,us USA,"MF,DF",RB Leipzig,de Bundesliga,21,1999,20.6,35,24,12,15,8,17,31,54.8,14,22,5,17,29,64,30,0,Matches
18,Sargis Adamyan,am ARM,"FW,MF",Hoffenheim,de Bundesliga,27,1993,5.3,9,4,4,3,2,7,14,50.0,7,2,0,2,6,15,1,0,Matches
19,Tosin Adarabioyo,eng ENG,DF,Fulham,eng Premier League,22,1997,32.8,37,19,30,6,1,19,40,47.5,21,26,20,6,42,79,197,2,Matches
20,Bobby Adekanye,nl NED,"FW,MF",Cádiz,es La Liga,21,1999,0.4,0,0,0,0,0,0,1,0.0,1,0,0,0,0,0,1,0,Matches
21,Yacine Adli,fr FRA,MF,Bordeaux,fr Ligue 1,20,2000,26.9,74,37,30,33,11,35,92,38.0,57,27,2,25,39,113,17,2,Matches
22,Andrea Adorante,it ITA,FW,Parma,it Serie A,20,2000,0.1,0,0,0,0,0,0,0,,0,0,0,0,0,0,0,0,Matches
23,Adrián,es ESP,GK,Liverpool,eng Premier League,33,1987,3.0,0,0,0,0,0,0,0,,0,0,0,0,0,0,3,1,Matches
24,Martin Agirregabiria,es ESP,"DF,MF",Alavés,es La Liga,24,1996,17.3,32,18,17,12,3,17,33,51.5,16,9,3,6,27,59,36,0,Matches
25,Lucien Agoume,fr FRA,MF,Spezia,it Serie A,18,2002,8.9,18,10,11,7,0,6,19,31.6,13,10,5,5,15,33,10,0,Matches
26,Felix Agu,de GER,DF,Werder Bremen,de Bundesliga,20,1999,7.8,20,9,10,9,1,10,18,55.6,8,14,3,11,12,32,18,0,Matches
27,Kevin Agudelo,co COL,FW,Spezia,it Serie A,21,1998,15.1,39,28,9,15,15,12,34,35.3,22,30,0,30,10,49,2,0,Matches
28,Nayef Aguerd,ma MAR,DF,Rennes,fr Ligue 1,24,1996,35.0,37,30,28,9,0,21,33,63.6,12,34,22,12,47,84,102,0,Matches
29,Sergio Agüero,ar ARG,FW,Manchester City,eng Premier League,32,1988,6.2,4,1,0,2,2,2,11,18.2,9,2,0,2,2,6,0,0,Matches
30,Ruben Aguilar,fr FRA,"DF,MF",Monaco,fr Ligue 1,27,1993,24.7,63,37,32,21,10,32,52,61.5,20,30,3,27,47,110,43,1,Matches
31,Naouirou Ahamada,fr FRA,MF,Stuttgart,de Bundesliga,18,2002,2.8,4,1,3,1,0,1,1,100.0,0,2,0,2,1,5,1,0,Matches
32,Matteo Ahlinvi,bj BEN,MF,Nîmes,fr Ligue 1,21,1999,10.0,26,20,10,14,2,11,39,28.2,28,6,0,6,2,28,8,0,Matches
33,Jean-Eudes Aholou,ci CIV,MF,Strasbourg,fr Ligue 1,26,1994,23.8,46,25,18,25,3,19,48,39.6,29,17,5,12,53,99,32,0,Matches
34,Jean-Eudes Aholou,ci CIV,MF,Monaco,fr Ligue 1,26,1994,0.4,1,0,0,1,0,1,3,33.3,2,0,0,0,1,2,1,0,Matches
35,Joseph Aidoo,gh GHA,DF,Celta Vigo,es La Liga,24,1995,14.3,26,17,17,9,0,12,21,57.1,9,7,4,3,25,51,88,1,Matches
36,Ola Aina,ng NGA,DF,Fulham,eng Premier League,23,1996,29.6,37,20,22,7,8,21,43,48.8,22,22,6,16,45,82,94,2,Matches
37,Rayan Aït-Nouri,dz ALG,DF,Wolves,eng Premier League,19,2001,15.6,29,16,18,10,1,13,27,48.1,14,14,1,13,15,44,25,0,Matches
38,Rayan Aït-Nouri,dz ALG,DF,Angers,fr Ligue 1,19,2001,2.1,3,2,1,2,0,3,5,60.0,2,2,1,1,4,7,1,0,Matches
39,Semi Ajayi,ng NGA,DF,West Brom,eng Premier League,26,1993,30.9,40,14,34,6,0,23,41,56.1,18,51,32,19,42,82,122,2,Matches
40,Ludovic Ajorque,fr FRA,FW,Strasbourg,fr Ligue 1,26,1994,33.0,30,18,6,18,6,7,31,22.6,24,14,5,9,11,41,54,0,Matches
41,Manuel Akanji,ch SUI,DF,Dortmund,de Bundesliga,25,1995,26.1,41,22,23,12,6,19,31,61.3,12,23,10,13,49,90,70,1,Matches
42,Carlos Akapo,gq EQG,DF,Cádiz,es La Liga,27,1993,9.6,18,14,14,4,0,10,18,55.6,8,16,3,13,19,37,33,0,Matches
43,Marley Aké,fr FRA,FW,Marseille,fr Ligue 1,19,2001,1.6,3,3,1,0,2,0,1,0.0,1,2,0,2,0,3,1,0,Matches
44,Nathan Aké,nl NED,DF,Manchester City,eng Premier League,25,1995,8.9,10,5,3,6,1,3,4,75.0,1,2,1,1,9,19,23,0,Matches
45,Paul Akouokou,ci CIV,MF,Betis,es La Liga,22,1997,4.2,11,8,2,8,1,5,8,62.5,3,3,1,2,6,17,7,0,Matches
46,Jean-Daniel Akpa-Akpro,ci CIV,MF,Lazio,it Serie A,27,1992,11.7,38,25,13,22,3,8,27,29.6,19,24,6,18,18,56,13,0,Matches
47,Kevin Akpoguma,ng NGA,DF,Hoffenheim,de Bundesliga,25,1995,13.2,18,12,11,6,1,8,14,57.1,6,28,15,13,13,31,32,2,Matches
48,David Alaba,at AUT,"DF,MF",Bayern Munich,de Bundesliga,28,1992,29.7,37,21,14,19,4,17,32,53.1,15,29,13,16,43,80,60,0,Matches
49,Sofiane Alakouch,ma MAR,DF,Nîmes,fr Ligue 1,22,1998,16.7,53,33,30,16,7,29,45,64.4,16,17,2,15,21,74,38,0,Matches
50,Jony Álamo,es ESP,MF,Elche,es La Liga,18,2001,0.8,2,1,1,0,1,0,1,0.0,1,0,0,0,1,3,0,0,Matches
51,Lucas Alario,ar ARG,FW,Leverkusen,de Bundesliga,27,1992,13.8,8,2,2,5,1,2,4,50.0,2,9,1,8,2,10,10,0,Matches
52,Jordi Alba,es ESP,"DF,FW",Barcelona,es La Liga,31,1989,33.6,45,30,22,16,7,24,52,46.2,28,21,2,19,49,94,48,0,Matches
53,Luis Alberto,es ESP,MF,Lazio,it Serie A,27,1992,29.1,43,24,15,19,9,15,73,20.5,58,41,2,39,13,56,11,1,Matches
54,Raúl Albiol,es ESP,DF,Villarreal,es La Liga,34,1985,34.6,22,15,19,3,0,13,18,72.2,5,32,22,10,22,44,146,2,Matches
55,Marc Albrighton,eng ENG,"DF,FW",Leicester City,eng Premier League,30,1989,19.4,33,19,14,15,4,16,45,35.6,29,29,3,26,17,50,27,1,Matches
56,Paco Alcácer,es ESP,FW,Villarreal,es La Liga,26,1993,17.2,6,3,1,2,3,3,7,42.9,4,8,0,8,9,15,6,0,Matches
57,Pedro Alcalá,es ESP,DF,Cádiz,es La Liga,31,1989,10.1,8,4,6,2,0,3,5,60.0,2,19,13,6,16,24,50,0,Matches
58,Thiago Alcántara,es ESP,MF,Liverpool,eng Premier League,29,1991,20.6,61,36,20,30,11,17,49,34.7,32,26,0,26,30,91,14,0,Matches
59,Rubén Alcaraz,es ESP,MF,Valladolid,es La Liga,29,1991,24.1,54,29,32,21,1,30,80,37.5,50,35,8,27,31,85,28,0,Matches
60,Omar Alderete,py PAR,DF,Hertha BSC,de Bundesliga,23,1996,14.4,16,10,11,5,0,7,16,43.8,9,14,10,4,21,37,61,1,Matches
61,Toby Alderweireld,be BEL,DF,Tottenham,eng Premier League,31,1989,24.9,35,22,22,11,2,18,30,60.0,12,40,28,12,10,45,121,0,Matches
62,Iván Alejo,es ESP,"MF,FW",Cádiz,es La Liga,25,1995,9.2,14,10,8,4,2,4,23,17.4,19,14,1,13,3,17,10,0,Matches
63,Carles Aleñá,es ESP,MF,Barcelona,es La Liga,22,1998,0.5,1,0,1,0,0,0,0,,0,0,0,0,0,1,0,0,Matches
64,Carles Aleñá,es ESP,"MF,FW",Getafe,es La Liga,22,1998,15.2,15,10,3,9,3,7,25,28.0,18,14,1,13,2,17,2,0,Matches
65,Rúnar Alex Rúnarsson,is ISL,GK,Arsenal,eng Premier League,25,1995,0.2,0,0,0,0,0,0,0,,0,0,0,0,0,0,0,0,Matches
66,Trent Alexander-Arnold,eng ENG,DF,Liverpool,eng Premier League,21,1998,33.7,56,33,31,18,7,36,56,64.3,20,24,3,21,49,105,50,3,Matches
67,Alfon,es ESP,MF,Celta Vigo,es La Liga,21,1999,0.4,0,0,0,0,0,0,0,,0,0,0,0,0,0,0,0,Matches
68,Mohamed Ali Cho,fr FRA,"FW,MF",Angers,fr Ligue 1,16,2004,3.9,9,7,2,6,1,4,9,44.4,5,4,0,4,3,12,0,0,Matches
69,Ezgjan Alioski,mk MKD,"DF,MF",Leeds United,eng Premier League,28,1992,27.3,74,31,38,28,8,32,74,43.2,42,17,2,15,23,97,50,2,Matches
70,Rachid Alioui,ma MAR,FW,Angers,fr Ligue 1,28,1992,0.2,0,0,0,0,0,0,1,0.0,1,0,0,0,0,0,0,0,Matches
71,Alisson,br BRA,GK,Liverpool,eng Premier League,27,1992,33.0,3,2,3,0,0,3,4,75.0,1,0,0,0,2,5,26,7,Matches
72,Saturnin Allagbé,bj BEN,GK,Dijon,fr Ligue 1,26,1993,12.0,0,0,0,0,0,0,1,0.0,1,0,0,0,0,0,9,3,Matches
73,Allan,br BRA,MF,Everton,eng Premier League,29,1991,22.8,80,45,39,37,4,28,95,29.5,67,31,12,19,19,99,25,1,Matches
74,Dele Alli,eng ENG,MF,Tottenham,eng Premier League,24,1996,6.9,18,11,8,6,4,7,19,36.8,12,9,0,9,7,25,3,0,Matches
75,Miguel Almirón,py PAR,"MF,FW",Newcastle Utd,eng Premier League,26,1994,27.0,49,29,21,25,3,14,56,25.0,42,23,4,19,25,74,20,1,Matches
76,Marcos Alonso,es ESP,DF,Chelsea,eng Premier League,29,1990,10.7,13,3,6,4,3,7,14,50.0,7,12,1,11,12,25,30,0,Matches
77,Sergio Álvarez,es ESP,"MF,DF",Eibar,es La Liga,28,1992,17.4,42,25,13,26,3,8,22,36.4,14,22,5,17,22,64,24,2,Matches
78,Yeray Álvarez,es ESP,DF,Athletic Club,es La Liga,25,1995,21.6,19,12,11,8,0,9,21,42.9,12,12,5,7,53,72,73,0,Matches
79,Bruno Alves,pt POR,DF,Parma,it Serie A,38,1981,18.1,13,10,10,3,0,7,9,77.8,2,17,12,5,26,39,81,0,Matches
80,Steven Alzate,co COL,MF,Brighton,eng Premier League,21,1998,10.0,17,8,10,4,3,6,15,40.0,9,8,1,7,8,25,10,0,Matches
81,Ibrahim Amadou,fr FRA,MF,Angers,fr Ligue 1,27,1993,16.7,39,26,18,19,2,15,38,39.5,23,14,4,10,23,62,25,0,Matches
82,Romain Amalfitano,fr FRA,"FW,DF",Dijon,fr Ligue 1,30,1989,1.3,4,2,3,1,0,1,3,33.3,2,2,1,1,1,5,1,0,Matches
83,Emmanuel Amankwaa Akurugu,gh GHA,DF,Getafe,es La Liga,18,2001,0.5,0,0,0,0,0,0,1,0.0,1,1,0,1,2,2,1,0,Matches
84,Daniel Amartey,gh GHA,DF,Leicester City,eng Premier League,25,1994,8.0,11,7,6,4,1,8,12,66.7,4,8,4,4,12,23,26,0,Matches
85,Jordan Amavi,fr FRA,DF,Marseille,fr Ligue 1,26,1994,9.0,11,9,9,1,1,9,12,75.0,3,12,2,10,27,38,33,1,Matches
86,Thierry Ambrose,gp GLP,FW,Metz,fr Ligue 1,23,1997,8.4,7,4,1,1,5,2,12,16.7,10,2,0,2,2,9,4,0,Matches
87,Wisdom Amey,it ITA,DF,Bologna,it Serie A,14,2005,0.0,0,0,0,0,0,0,0,,0,0,0,0,0,0,0,0,Matches
88,Nadiem Amiri,de GER,MF,Leverkusen,de Bundesliga,23,1996,21.0,12,7,4,8,0,7,33,21.2,26,18,3,15,12,24,7,0,Matches
89,Ethan Ampadu,wls WAL,"DF,MF",Sheffield Utd,eng Premier League,19,2000,23.2,57,36,31,24,2,20,46,43.5,26,40,19,21,49,106,87,3,Matches
90,Sofyan Amrabat,ma MAR,MF,Fiorentina,it Serie A,23,1996,27.1,39,22,11,24,4,18,48,37.5,30,30,5,25,23,62,12,0,Matches
91,Jon Ander Garrido,es ESP,MF,Cádiz,es La Liga,30,1989,8.9,18,10,8,7,3,10,26,38.5,16,12,4,8,14,32,13,0,Matches
92,Joachim Andersen,dk DEN,DF,Fulham,eng Premier League,24,1996,30.3,33,19,18,11,4,15,28,53.6,13,24,13,11,44,77,151,1,Matches
93,Joachim Andersen,dk DEN,DF,Lyon,fr Ligue 1,24,1996,2.1,2,1,1,1,0,2,2,100.0,0,1,1,0,2,4,6,0,Matches
94,Djavan Anderson,nl NED,DF,Lazio,it Serie A,25,1995,0.8,0,0,0,0,0,0,1,0.0,1,1,0,1,1,1,0,0,Matches
95,Elliot Anderson,sct SCO,MF,Newcastle Utd,eng Premier League,17,2002,0.0,0,0,0,0,0,0,0,,0,0,0,0,0,0,0,0,Matches
96,Felipe Anderson,br BRA,"FW,MF",West Ham,eng Premier League,27,1993,0.0,1,1,0,1,0,0,0,,0,0,0,0,0,1,0,0,Matches
97,Sebastian Andersson,se SWE,FW,Köln,de Bundesliga,29,1991,12.5,3,2,0,3,0,1,8,12.5,7,10,3,7,2,5,9,0,Matches
98,Nícolas Andrade,br BRA,GK,Udinese,it Serie A,32,1988,2.0,0,0,0,0,0,0,0,,0,0,0,0,0,0,0,0,Matches
99,Benjamin André,fr FRA,MF,Lille,fr Ligue 1,29,1990,32.1,114,68,47,61,6,53,122,43.4,69,39,10,29,76,190,49,0,Matches
100,Marcos André,br BRA,FW,Valladolid,es La Liga,23,1996,13.1,8,2,2,2,4,0,8,0.0,8,15,2,13,2,10,9,0,Matches
101,Robert Andrich,de GER,MF,Union Berlin,de Bundesliga,25,1994,28.1,51,24,22,27,2,24,53,45.3,29,40,6,34,51,102,31,2,Matches
102,Victorien Angban,ci CIV,MF,Metz,fr Ligue 1,23,1996,18.6,36,24,17,15,4,17,42,40.5,25,17,4,13,19,55,9,1,Matches
103,Ángel,es ESP,GK,Granada,es La Liga,18,2002,1.0,0,0,0,0,0,0,0,,0,0,0,0,0,0,1,0,Matches
104,José Ángel,es ESP,DF,Eibar,es La Liga,30,1989,10.0,15,8,9,4,2,8,12,66.7,4,7,0,7,13,28,17,1,Matches
105,Miguel Ángel Rubio,es ESP,DF,Valladolid,es La Liga,22,1998,1.5,0,0,0,0,0,0,0,,0,2,2,0,3,3,11,0,Matches
106,Angeliño,es ESP,"DF,FW",RB Leipzig,de Bundesliga,23,1997,24.0,31,19,10,18,3,13,24,54.2,11,22,1,21,30,61,40,0,Matches
107,Davide Angelo Ghislandi,it ITA,DF,Atalanta,it Serie A,19,2001,0.1,0,0,0,0,0,0,0,,0,0,0,0,0,0,1,0,Matches
108,Philip Ankhrah,gh GHA,MF,Hellas Verona,it Serie A,17,2002,0.1,0,0,0,0,0,0,0,,0,1,0,1,0,0,0,0,Matches
109,Cristian Ansaldi,ar ARG,"DF,FW",Torino,it Serie A,33,1986,21.6,48,33,25,14,9,24,38,63.2,14,21,7,14,16,64,38,0,Matches
110,Waldemar Anton,de GER,DF,Stuttgart,de Bundesliga,24,1996,30.1,31,20,17,14,0,12,31,38.7,19,28,18,10,47,78,114,0,Matches
111,Michail Antonio,jm JAM,FW,West Ham,eng Premier League,30,1990,21.9,7,4,1,5,1,1,7,14.3,6,20,3,17,7,14,7,0,Matches
112,José Antonio Miranda,gq EQG,"MF,DF",Getafe,es La Liga,22,1998,0.3,0,0,0,0,0,0,1,0.0,1,1,0,1,0,0,0,0,Matches
113,Valentin Antov,bg BUL,DF,Bologna,it Serie A,19,2000,2.6,4,2,3,1,0,3,10,30.0,7,6,5,1,4,8,13,0,Matches
114,Houssem Aouar,dz ALG,"MF,FW",Lyon,fr Ligue 1,22,1998,19.8,17,12,0,13,4,8,25,32.0,17,17,1,16,17,34,4,0,Matches
115,Adil Aouchiche,fr FRA,"MF,FW",Saint-Étienne,fr Ligue 1,18,2002,19.2,38,20,12,17,9,13,49,26.5,36,15,1,14,10,48,6,0,Matches
116,Dennis Appiah,fr FRA,DF,Nantes,fr Ligue 1,28,1992,17.3,55,34,33,15,7,32,59,54.2,27,23,6,17,25,80,43,0,Matches
117,Aritz Arambarri,es ESP,DF,Real Sociedad,es La Liga,22,1998,0.3,1,1,0,1,0,1,2,50.0,1,0,0,0,0,1,0,0,Matches
118,Mauro Arambarri,uy URU,MF,Getafe,es La Liga,24,1995,33.1,64,39,22,35,7,23,80,28.8,57,40,5,35,42,106,28,0,Matches
119,Charles Aránguiz,cl CHI,MF,Leverkusen,de Bundesliga,31,1989,18.5,41,23,16,21,4,17,43,39.5,26,32,4,28,33,74,17,0,Matches
120,Luiz Araújo,br BRA,MF,Lille,fr Ligue 1,24,1996,16.6,38,25,12,18,8,8,28,28.6,20,23,1,22,11,49,3,0,Matches
121,Néstor Araujo,mx MEX,DF,Celta Vigo,es La Liga,28,1991,27.0,24,16,14,9,1,7,15,46.7,8,23,18,5,43,67,89,2,Matches
122,Ronald Araújo,uy URU,DF,Barcelona,es La Liga,21,1999,16.8,22,11,12,8,2,9,9,100.0,0,24,15,9,20,42,47,1,Matches
123,Anaitz Arbilla,es ESP,DF,Eibar,es La Liga,33,1987,31.2,45,26,31,11,3,27,54,50.0,27,36,11,25,69,114,73,1,Matches
124,Alphonse Areola,fr FRA,GK,Fulham,eng Premier League,27,1993,36.0,1,0,1,0,0,1,5,20.0,4,0,0,0,1,2,13,3,Matches
125,Santiago Arias,co COL,DF,Leverkusen,de Bundesliga,28,1992,1.0,2,1,0,1,1,1,1,100.0,0,0,0,0,1,3,4,0,Matches
126,Karim Aribi,dz ALG,FW,Nîmes,fr Ligue 1,26,1994,3.3,2,2,0,1,1,0,5,0.0,5,1,0,1,0,2,3,0,Matches
127,Unai Arietaleanizbeaskoa,es ESP,"FW,MF",Eibar,es La Liga,21,1999,0.5,1,0,0,0,1,0,0,,0,0,0,0,0,1,0,0,Matches
128,Nicolò Armini,it ITA,DF,Lazio,it Serie A,19,2001,0.1,0,0,0,0,0,0,0,,0,0,0,0,0,0,0,0,Matches
129,Stuart Armstrong,sct SCO,MF,Southampton,eng Premier League,28,1992,30.7,60,41,19,32,9,27,75,36.0,48,26,1,25,24,84,19,0,Matches
130,Maximilian Arnold,de GER,MF,Wolfsburg,de Bundesliga,26,1994,28.7,47,32,20,26,1,18,49,36.7,31,24,3,21,49,96,57,0,Matches
131,Tolu Arokodare,ng NGA,"FW,MF",Köln,de Bundesliga,19,2000,1.2,1,1,0,0,1,0,0,,0,1,0,1,1,2,0,0,Matches
132,Sergio Arribas,es ESP,"MF,FW",Real Madrid,es La Liga,18,2001,1.5,3,1,2,1,0,1,3,33.3,2,2,0,2,4,7,2,0,Matches
133,Kepa Arrizabalaga,es ESP,GK,Chelsea,eng Premier League,25,1994,6.5,0,0,0,0,0,0,1,0.0,1,0,0,0,0,0,0,3,Matches
134,Tolgay Arslan,de GER,MF,Udinese,it Serie A,29,1990,20.2,52,32,24,24,4,25,54,46.3,29,22,2,20,22,74,15,1,Matches
135,Kwadwo Asamoah,gh GHA,"DF,MF",Cagliari,it Serie A,31,1988,2.5,4,3,2,2,0,2,3,66.7,1,5,1,4,4,8,2,1,Matches
136,Santiago Ascacíbar,ar ARG,MF,Hertha BSC,de Bundesliga,23,1997,8.5,30,15,15,14,1,15,28,53.6,13,23,2,21,13,43,14,0,Matches
137,Sergio Asenjo,es ESP,GK,Villarreal,es La Liga,31,1989,36.0,0,0,0,0,0,0,1,0.0,1,0,0,0,0,0,13,2,Matches
138,Marco Asensio,es ESP,"FW,MF",Real Madrid,es La Liga,24,1996,20.8,12,6,7,4,1,3,24,12.5,21,15,0,15,11,23,10,0,Matches
139,Kristoffer Askildsen,no NOR,MF,Sampdoria,it Serie A,19,2001,1.1,0,0,0,0,0,0,0,,0,2,0,2,3,3,3,0,Matches
140,Iago Aspas,es ESP,FW,Celta Vigo,es La Liga,32,1987,31.8,11,3,2,7,2,2,23,8.7,21,25,2,23,16,27,21,0,Matches
141,Roger Assalé,ci CIV,"FW,MF",Dijon,fr Ligue 1,26,1993,9.2,10,8,3,5,2,4,12,33.3,8,7,3,4,2,12,2,0,Matches
142,Youcef Atal,dz ALG,"DF,FW",Nice,fr Ligue 1,24,1996,10.6,25,12,11,14,0,13,26,50.0,13,10,2,8,26,51,12,0,Matches
143,Miguel Atienza,es ESP,MF,Eibar,es La Liga,21,1999,9.3,20,9,5,15,0,8,23,34.8,15,14,1,13,9,29,12,0,Matches
144,Pierre-Emerick Aubameyang,ga GAB,FW,Arsenal,eng Premier League,31,1989,25.9,12,8,7,4,1,3,20,15.0,17,18,0,18,7,19,17,0,Matches
145,Emil Audero,it ITA,GK,Sampdoria,it Serie A,23,1997,37.0,1,1,1,0,0,1,2,50.0,1,0,0,0,1,2,16,0,Matches
146,Tommaso Augello,it ITA,DF,Sampdoria,it Serie A,25,1994,35.7,42,30,27,10,5,23,39,59.0,16,22,2,20,32,74,76,1,Matches
147,Jean-Kévin Augustin,fr FRA,FW,Nantes,fr Ligue 1,23,1997,0.4,2,0,0,2,0,2,2,100.0,0,0,0,0,0,2,0,0,Matches
148,Ludwig Augustinsson,se SWE,"DF,FW",Werder Bremen,de Bundesliga,26,1994,21.7,37,20,19,14,4,17,29,58.6,12,21,7,14,20,57,62,0,Matches
149,Serge Aurier,ci CIV,DF,Tottenham,eng Premier League,27,1992,17.8,55,33,33,17,5,15,40,37.5,25,28,5,23,19,74,44,3,Matches
150,Charlie Austin,eng ENG,"FW,MF",West Brom,eng Premier League,31,1989,1.5,4,2,1,2,1,1,3,33.3,2,0,0,0,3,7,4,0,Matches
151,Ezequiel Ávila,ar ARG,"FW,MF",Osasuna,es La Liga,26,1994,2.2,6,2,3,1,2,2,4,50.0,2,1,0,1,1,7,0,0,Matches
152,Taiwo Awoniyi,ng NGA,FW,Union Berlin,de Bundesliga,22,1997,15.1,5,3,2,3,0,1,14,7.1,13,9,0,9,3,8,4,0,Matches
153,Mehmet Aydin,de GER,DF,Schalke 04,de Bundesliga,18,2002,5.6,15,7,9,6,0,4,10,40.0,6,6,1,5,6,21,16,0,Matches
154,Jordan Ayew,gh GHA,"FW,MF",Crystal Palace,eng Premier League,28,1991,23.3,38,26,8,16,14,16,44,36.4,28,28,2,26,16,54,12,0,Matches
155,Kaan Ayhan,tr TUR,DF,Sassuolo,it Serie A,25,1994,8.8,15,9,8,5,2,8,13,61.5,5,9,5,4,16,31,33,0,Matches
156,Luke Ayling,eng ENG,DF,Leeds United,eng Premier League,28,1991,37.8,108,61,69,30,9,49,87,56.3,38,53,36,17,36,144,96,5,Matches
157,Ramon Azeez,ng NGA,MF,Granada,es La Liga,27,1992,1.1,1,1,0,1,0,0,0,,0,0,0,0,1,2,1,0,Matches
158,César Azpilicueta,es ESP,DF,Chelsea,eng Premier League,30,1989,24.3,53,28,22,24,7,19,37,51.4,18,30,5,25,28,81,62,2,Matches
159,Ludovic Baal,gf GUF,"DF,MF",Brest,fr Ligue 1,34,1986,3.3,6,5,4,1,1,2,5,40.0,3,4,1,3,5,11,5,0,Matches
160,Carlos Bacca,co COL,FW,Villarreal,es La Liga,33,1986,8.7,9,5,5,3,1,3,5,60.0,2,5,0,5,3,12,2,0,Matches
161,Loïc Bade,fr FRA,DF,Lens,fr Ligue 1,20,2000,29.0,57,34,47,10,0,30,55,54.5,25,43,17,26,74,131,135,2,Matches
162,Milan Badelj,hr CRO,MF,Genoa,it Serie A,31,1989,26.8,56,27,27,22,7,26,84,31.0,58,51,10,41,87,143,45,1,Matches
163,Édgar Badía,es ESP,GK,Elche,es La Liga,28,1992,30.0,1,0,1,0,0,1,3,33.3,2,0,0,0,0,1,17,3,Matches
164,Benoît Badiashile,fr FRA,DF,Monaco,fr Ligue 1,19,2001,31.9,24,17,15,9,0,13,28,46.4,15,21,12,9,58,82,102,4,Matches
165,Alex Baena,es ESP,MF,Villarreal,es La Liga,19,2001,1.5,4,3,1,2,1,1,3,33.3,2,1,1,0,1,5,1,0,Matches
166,Miguel Baeza,es ESP,"MF,FW",Celta Vigo,es La Liga,20,2000,6.0,7,6,5,2,0,5,13,38.5,8,3,0,3,3,10,2,0,Matches
167,Stéphane Bahoken,cm CMR,FW,Angers,fr Ligue 1,28,1992,18.0,9,6,1,7,1,4,12,33.3,8,9,0,9,9,18,9,0,Matches
168,Leon Bailey,jm JAM,"FW,MF",Leverkusen,de Bundesliga,22,1997,23.8,14,8,3,7,4,4,15,26.7,11,13,0,13,9,23,3,0,Matches
169,Eric Bailly,ci CIV,DF,Manchester Utd,eng Premier League,26,1994,10.2,5,5,3,1,1,0,1,0.0,1,13,11,2,13,18,36,2,Matches
170,Stefan Bajic,fr FRA,GK,Saint-Étienne,fr Ligue 1,18,2001,1.0,0,0,0,0,0,0,0,,0,0,0,0,0,0,1,0,Matches
171,Tiemoué Bakayoko,fr FRA,MF,Napoli,it Serie A,25,1994,21.8,69,41,21,41,7,23,40,57.5,17,24,2,22,36,105,13,2,Matches
172,Mitchel Bakker,nl NED,DF,Paris S-G,fr Ligue 1,20,2000,18.8,38,30,15,14,9,17,26,65.4,9,22,2,20,22,60,20,0,Matches
173,Ridle Baku,de GER,"FW,DF",Wolfsburg,de Bundesliga,22,1998,29.8,50,31,20,20,10,22,53,41.5,31,54,4,50,40,90,33,1,Matches
174,Ridle Baku,de GER,DF,Mainz 05,de Bundesliga,22,1998,2.0,4,2,3,1,0,2,6,33.3,4,3,1,2,3,7,6,0,Matches
175,Dilane Bakwa,fr FRA,"FW,MF",Bordeaux,fr Ligue 1,17,2002,0.6,2,2,1,1,0,0,1,0.0,1,2,0,2,1,3,0,0,Matches
176,Fabián Balbuena,py PAR,DF,West Ham,eng Premier League,28,1991,13.3,24,12,23,1,0,14,23,60.9,9,23,6,17,25,49,63,0,Matches
177,Keita Baldé,sn SEN,FW,Sampdoria,it Serie A,25,1995,13.3,9,6,2,6,1,4,10,40.0,6,10,1,9,0,9,3,0,Matches
178,George Baldock,gr GRE,DF,Sheffield Utd,eng Premier League,27,1993,31.0,47,34,28,14,5,21,50,42.0,29,26,7,19,25,72,70,1,Matches
179,Gareth Bale,wls WAL,FW,Tottenham,eng Premier League,31,1989,10.2,17,10,4,9,4,7,14,50.0,7,13,2,11,8,25,16,0,Matches
180,Mikel Balenziaga,es ESP,DF,Athletic Club,es La Liga,32,1988,18.8,26,15,11,12,3,9,18,50.0,9,22,7,15,7,33,46,0,Matches
181,Leonardo Balerdi,ar ARG,DF,Marseille,fr Ligue 1,21,1999,18.2,29,18,19,7,3,14,31,45.2,17,17,9,8,28,57,65,3,Matches
182,Fodé Ballo-Touré,sn SEN,DF,Monaco,fr Ligue 1,23,1997,7.4,21,17,9,11,1,6,13,46.2,7,7,0,7,6,27,11,1,Matches
183,Botond Balogh,hu HUN,DF,Parma,it Serie A,18,2002,1.8,9,7,9,0,0,2,5,40.0,3,4,3,1,2,11,8,0,Matches
184,Abdoulaye Bamba,ci CIV,DF,Angers,fr Ligue 1,30,1990,15.0,27,17,19,7,1,19,28,67.9,9,7,1,6,19,46,34,0,Matches
185,Jonathan Bamba,ci CIV,MF,Lille,fr Ligue 1,24,1996,33.2,45,23,15,19,11,24,84,28.6,60,24,2,22,24,69,15,0,Matches
186,Robson Bambu,br BRA,DF,Nice,fr Ligue 1,22,1997,11.6,16,11,14,2,0,11,14,78.6,3,8,7,1,10,26,57,0,Matches
187,Patrick Bamford,eng ENG,FW,Leeds United,eng Premier League,26,1993,33.9,21,9,2,11,8,8,27,29.6,19,14,4,10,10,31,37,0,Matches
188,Mattia Bani,it ITA,DF,Genoa,it Serie A,26,1993,10.2,10,5,5,5,0,5,12,41.7,7,16,11,5,27,37,44,0,Matches
189,Mattia Bani,it ITA,DF,Parma,it Serie A,26,1993,12.7,20,11,15,4,1,4,8,50.0,4,10,6,4,33,53,50,0,Matches
190,Simon Banza,cd COD,FW,Lens,fr Ligue 1,23,1996,15.2,13,6,0,4,9,1,14,7.1,13,16,1,15,7,20,15,0,Matches
191,Antonín Barák,cz CZE,MF,Hellas Verona,it Serie A,25,1994,30.7,30,19,8,16,6,14,47,29.8,33,26,7,19,12,42,38,1,Matches
192,Federico Barba,it ITA,DF,Benevento,it Serie A,26,1993,29.5,31,16,22,8,1,21,35,60.0,14,39,18,21,48,79,94,4,Matches
193,Danilo Barbosa,br BRA,DF,Nice,fr Ligue 1,24,1996,2.8,6,3,5,1,0,4,6,66.7,2,2,1,1,2,8,11,2,Matches
194,Barcia,es ESP,DF,Granada,es La Liga,19,2000,1.0,1,1,1,0,0,0,0,,0,1,1,0,3,4,9,0,Matches
195,Melvin Bard,fr FRA,DF,Lyon,fr Ligue 1,19,2000,4.8,12,8,7,4,1,6,11,54.5,5,10,2,8,6,18,14,0,Matches
196,Enis Bardhi,mk MKD,MF,Levante,es La Liga,25,1995,18.7,28,12,8,16,4,10,36,27.8,26,8,2,6,21,49,14,0,Matches
197,Phil Bardsley,sct SCO,DF,Burnley,eng Premier League,35,1985,3.0,6,5,4,2,0,3,6,50.0,3,3,1,2,6,12,12,0,Matches
198,Nicolò Barella,it ITA,MF,Inter,it Serie A,23,1997,32.2,58,31,23,29,6,23,72,31.9,49,29,4,25,26,84,14,0,Matches
199,Philipp Bargfrede,de GER,MF,Werder Bremen,de Bundesliga,31,1989,0.3,0,0,0,0,0,0,0,,0,0,0,0,0,0,3,0,Matches
200,Kike Barja,es ESP,"MF,FW",Osasuna,es La Liga,23,1997,15.9,10,5,6,1,3,5,24,20.8,19,10,1,9,16,26,8,0,Matches
201,Ross Barkley,eng ENG,MF,Aston Villa,eng Premier League,26,1993,17.0,6,2,2,4,0,3,15,20.0,12,9,1,8,5,11,6,1,Matches
202,Ross Barkley,eng ENG,"FW,MF",Chelsea,eng Premier League,26,1993,0.5,0,0,0,0,0,0,0,,0,0,0,0,0,0,0,0,Matches
203,Aymen Barkok,ma MAR,"MF,DF",Eint Frankfurt,de Bundesliga,22,1998,10.9,29,15,11,9,9,10,31,32.3,21,15,1,14,10,39,9,1,Matches
204,Ashley Barnes,eng ENG,FW,Burnley,eng Premier League,30,1989,14.8,12,6,2,6,4,3,13,23.1,10,14,2,12,5,17,11,0,Matches
205,Harvey Barnes,eng ENG,"FW,MF",Leicester City,eng Premier League,22,1997,21.6,19,9,11,3,5,5,22,22.7,17,16,3,13,8,27,11,0,Matches
206,Marc Baró,es ESP,DF,Cádiz,es La Liga,20,1999,1.0,2,1,2,0,0,0,2,0.0,2,1,0,1,2,4,2,1,Matches
207,Antonio Barragán,es ESP,DF,Elche,es La Liga,33,1987,24.8,28,14,21,5,2,12,21,57.1,9,22,8,14,33,61,67,1,Matches
208,Antonio Barreca,it ITA,DF,Fiorentina,it Serie A,25,1995,0.9,1,0,0,1,0,1,1,100.0,0,0,0,0,0,1,1,0,Matches
209,Leandro Barreiro Martins,lu LUX,MF,Mainz 05,de Bundesliga,20,2000,25.6,58,32,19,26,13,20,50,40.0,30,34,9,25,57,115,55,0,Matches
210,Ander Barrenetxea,es ESP,"MF,FW",Real Sociedad,es La Liga,18,2001,14.5,29,19,5,18,6,9,24,37.5,15,20,0,20,6,35,8,0,Matches
211,Jacob Barrett Laursen,dk DEN,DF,Arminia,de Bundesliga,25,1994,12.3,23,12,13,8,2,10,16,62.5,6,14,4,10,24,47,37,0,Matches
212,Musa Barrow,gm GAM,"FW,MF",Bologna,it Serie A,21,1998,32.5,26,10,8,10,8,10,25,40.0,15,37,2,35,11,37,15,0,Matches
213,Kyle Bartley,eng ENG,DF,West Brom,eng Premier League,29,1991,28.7,27,16,14,10,3,11,23,47.8,12,50,35,15,38,65,159,1,Matches
214,Paolo Bartolomei,it ITA,MF,Spezia,it Serie A,30,1989,3.6,6,2,3,1,2,4,7,57.1,3,1,0,1,1,7,2,0,Matches
215,Marc Bartra,es ESP,DF,Betis,es La Liga,29,1991,18.8,27,16,18,8,1,12,22,54.5,10,19,5,14,40,67,74,3,Matches
216,Daniele Baselli,it ITA,MF,Torino,it Serie A,28,1992,4.4,12,7,3,6,3,6,10,60.0,4,2,0,2,9,21,5,0,Matches
217,Chris Basham,eng ENG,"DF,MF",Sheffield Utd,eng Premier League,32,1988,28.6,69,42,41,23,5,41,67,61.2,26,36,15,21,49,118,105,1,Matches
218,Toma Bašić,hr CRO,MF,Bordeaux,fr Ligue 1,23,1996,28.9,33,22,15,16,2,16,58,27.6,42,21,5,16,32,65,42,1,Matches
219,Álvaro Bastida,es ESP,MF,Cádiz,es La Liga,16,2004,0.4,0,0,0,0,0,0,0,,0,0,0,0,0,0,0,0,Matches
220,Alessandro Bastoni,it ITA,DF,Inter,it Serie A,21,1999,32.5,36,22,13,21,2,17,27,63.0,10,34,16,18,40,76,75,0,Matches
221,Simone Bastoni,it ITA,DF,Spezia,it Serie A,23,1996,16.9,50,29,26,22,2,27,52,51.9,25,19,1,18,16,66,31,0,Matches
222,Bastos,ao ANG,DF,Lazio,it Serie A,29,1991,0.7,3,1,2,0,1,3,5,60.0,2,1,0,1,0,3,3,0,Matches
223,Michy Batshuayi,be BEL,FW,Crystal Palace,eng Premier League,26,1993,8.1,5,3,1,2,2,1,9,11.1,8,5,1,4,4,9,5,0,Matches
224,Rodrigo Battaglia,ar ARG,MF,Alavés,es La Liga,29,1991,27.7,38,16,21,14,3,16,50,32.0,34,30,14,16,29,67,40,1,Matches
225,Cristian Battocchio,it ITA,MF,Brest,fr Ligue 1,28,1992,3.9,5,2,1,4,0,2,9,22.2,7,0,0,0,4,9,5,0,Matches
226,Oliver Baumann,de GER,GK,Hoffenheim,de Bundesliga,30,1990,31.0,0,0,0,0,0,0,1,0.0,1,0,0,0,2,2,14,0,Matches
227,Julian Baumgartlinger,at AUT,MF,Leverkusen,de Bundesliga,32,1988,11.9,43,20,14,26,3,16,31,51.6,15,12,0,12,12,55,10,1,Matches
228,Christoph Baumgartner,at AUT,"MF,FW",Hoffenheim,de Bundesliga,20,1999,26.3,44,31,13,24,7,14,51,27.5,37,40,8,32,24,68,24,0,Matches
229,Jon Bautista,es ESP,FW,Real Sociedad,es La Liga,25,1995,4.1,5,3,0,2,3,0,3,0.0,3,3,1,2,2,7,4,0,Matches
230,Paul Baysse,fr FRA,DF,Bordeaux,fr Ligue 1,32,1988,29.0,35,18,21,13,1,16,21,76.2,5,33,24,9,52,87,123,1,Matches
231,Noah Joel Sarenren Bazee,ng NGA,"FW,MF",Augsburg,de Bundesliga,23,1996,0.4,0,0,0,0,0,0,1,0.0,1,0,0,0,1,1,0,0,Matches
232,Ihlas Bebou,tg TOG,"FW,MF",Hoffenheim,de Bundesliga,26,1994,24.4,24,9,5,10,9,8,14,57.1,6,18,4,14,17,41,16,0,Matches
233,Rodrigo Becão,br BRA,DF,Udinese,it Serie A,24,1996,30.9,59,33,36,20,3,27,49,55.1,22,48,27,21,68,127,94,2,Matches
234,Sheraldo Becker,sr SUR,"FW,MF",Union Berlin,de Bundesliga,25,1995,12.3,5,4,2,2,1,3,5,60.0,2,4,0,4,6,11,7,0,Matches
235,Timo Becker,de GER,DF,Schalke 04,de Bundesliga,23,1997,18.2,34,23,28,6,0,16,25,64.0,9,18,4,14,22,56,58,0,Matches
236,Jan Bednarek,pl POL,DF,Southampton,eng Premier League,24,1996,34.4,37,19,25,11,1,25,49,51.0,24,44,27,17,84,121,132,0,Matches
237,Donny van de Beek,nl NED,"MF,FW",Manchester Utd,eng Premier League,23,1997,5.8,15,10,2,11,2,7,15,46.7,8,10,1,9,6,21,7,0,Matches
238,Valon Behrami,ch SUI,MF,Genoa,it Serie A,35,1985,9.9,21,9,9,10,2,9,26,34.6,17,13,5,8,9,30,13,0,Matches
239,Brian Behrendt,de GER,DF,Arminia,de Bundesliga,28,1991,0.9,0,0,0,0,0,0,1,0.0,1,0,0,0,0,0,1,0,Matches
240,Maximilian Beier,de GER,"FW,DF",Hoffenheim,de Bundesliga,17,2002,0.1,0,0,0,0,0,0,1,0.0,1,0,0,0,0,0,0,0,Matches
241,Ishak Belfodil,dz ALG,"FW,MF",Hoffenheim,de Bundesliga,28,1992,6.6,3,2,0,0,3,0,2,0.0,2,1,0,1,1,4,3,0,Matches
242,Erwan Belhadji,fr FRA,MF,Dijon,fr Ligue 1,19,2001,0.3,3,0,3,0,0,3,5,60.0,2,1,0,1,0,3,0,0,Matches
243,Haris Belkebla,dz ALG,MF,Brest,fr Ligue 1,26,1994,30.3,69,39,32,28,9,31,66,47.0,35,26,5,21,57,126,34,0,Matches
244,Stefan Bell,de GER,DF,Mainz 05,de Bundesliga,28,1991,14.1,24,18,15,9,0,14,23,60.9,9,19,11,8,27,51,76,1,Matches
245,Karim Bellarabi,de GER,"FW,MF",Leverkusen,de Bundesliga,30,1990,8.9,12,10,3,4,5,4,17,23.5,13,12,0,12,12,24,4,0,Matches
246,Jean-Ricner Bellegarde,fr FRA,"MF,FW",Strasbourg,fr Ligue 1,22,1998,23.2,56,39,22,25,9,14,23,60.9,9,20,2,18,19,75,16,0,Matches
247,Héctor Bellerín,es ESP,"DF,MF",Arsenal,eng Premier League,25,1995,23.2,29,19,14,12,3,12,41,29.3,29,26,8,18,33,62,33,0,Matches
248,Jude Bellingham,eng ENG,MF,Dortmund,de Bundesliga,17,2003,18.9,49,31,11,29,9,19,46,41.3,27,37,5,32,24,73,13,0,Matches
249,Andrea Belotti,it ITA,FW,Torino,it Serie A,26,1993,32.1,30,18,4,16,10,11,35,31.4,24,27,4,23,12,42,21,0,Matches
250,Fran Beltrán,es ESP,"MF,FW",Celta Vigo,es La Liga,21,1999,15.5,30,22,15,12,3,8,24,33.3,16,14,1,13,16,46,24,0,Matches
251,Sami Ben Amar,ma MAR,MF,Nîmes,fr Ligue 1,22,1998,0.1,0,0,0,0,0,0,0,,0,1,0,1,0,0,0,0,Matches
252,Hatem Ben Arfa,fr FRA,"MF,FW",Bordeaux,fr Ligue 1,33,1987,18.9,11,7,1,7,3,2,9,22.2,7,3,0,3,2,13,0,0,Matches
253,Salim Ben Seghir,fr FRA,DF,Nice,fr Ligue 1,17,2003,0.1,0,0,0,0,0,0,0,,0,0,0,0,0,0,0,0,Matches
254,Wissam Ben Yedder,fr FRA,FW,Monaco,fr Ligue 1,29,1990,29.0,18,9,2,10,6,3,13,23.1,10,16,0,16,13,31,3,0,Matches
255,Ahmad Benali,ly LBY,MF,Crotone,it Serie A,28,1992,13.5,19,11,10,9,0,11,38,28.9,27,15,2,13,6,25,15,0,Matches
256,Samy Benchamma,fr FRA,"DF,MF",Montpellier,fr Ligue 1,20,2000,0.5,1,1,1,0,0,0,0,,0,0,0,0,0,1,1,0,Matches
257,Lars Bender,de GER,DF,Leverkusen,de Bundesliga,31,1989,10.4,19,13,12,6,1,9,21,42.9,12,19,5,14,16,35,19,0,Matches
258,Sven Bender,de GER,DF,Leverkusen,de Bundesliga,31,1989,13.0,17,9,8,8,1,7,20,35.0,13,20,9,11,21,38,41,1,Matches
259,Darío Benedetto,ar ARG,FW,Marseille,fr Ligue 1,30,1990,17.5,6,4,1,4,1,5,13,38.5,8,9,2,7,3,9,17,0,Matches
260,László Bénes,sk SVK,MF,Augsburg,de Bundesliga,22,1997,7.3,8,6,4,4,0,2,8,25.0,6,6,2,4,7,15,1,1,Matches
261,László Bénes,sk SVK,MF,Gladbach,de Bundesliga,22,1997,1.7,6,2,5,1,0,2,4,50.0,2,0,0,0,2,8,1,0,Matches
262,Walter Benítez,ar ARG,GK,Nice,fr Ligue 1,27,1993,38.0,1,1,1,0,0,1,3,33.3,2,1,0,1,1,2,7,2,Matches
263,Loris Benito,ch SUI,DF,Bordeaux,fr Ligue 1,28,1992,29.5,42,26,27,12,3,22,48,45.8,26,33,10,23,42,84,70,0,Matches
264,Sergio Benito,es ESP,FW,Valladolid,es La Liga,21,1999,0.0,0,0,0,0,0,0,0,,0,0,0,0,0,0,0,0,Matches
265,Bilal Benkhedim,fr FRA,FW,Saint-Étienne,fr Ligue 1,19,2001,0.8,0,0,0,0,0,0,1,0.0,1,1,0,1,0,0,0,0,Matches
266,Djamel Benlamri,dz ALG,DF,Lyon,fr Ligue 1,30,1989,1.7,5,3,5,0,0,3,6,50.0,3,3,2,1,6,11,11,0,Matches
267,Ismaël Bennacer,dz ALG,MF,Milan,it Serie A,22,1997,14.7,39,18,17,21,1,15,32,46.9,17,10,1,9,20,59,12,0,Matches
268,Saïd Benrahma,dz ALG,"FW,MF",West Ham,eng Premier League,24,1995,15.5,24,15,8,11,5,8,28,28.6,20,10,0,10,8,32,8,0,Matches
269,Yassine Benrahou,fr FRA,MF,Nîmes,fr Ligue 1,21,1999,13.8,16,9,8,6,2,7,25,28.0,18,9,0,9,4,20,5,1,Matches
270,Ramy Bensebaini,dz ALG,DF,Gladbach,de Bundesliga,25,1995,20.1,43,24,27,13,3,26,42,61.9,16,39,7,32,47,90,66,0,Matches
271,Josh Benson,eng ENG,MF,Burnley,eng Premier League,20,1999,2.9,5,1,3,0,2,1,6,16.7,5,3,0,3,3,8,2,0,Matches
272,Nabil Bentaleb,dz ALG,MF,Schalke 04,de Bundesliga,25,1994,6.1,14,8,7,6,1,4,15,26.7,11,5,2,3,6,20,8,0,Matches
273,Rodrigo Bentancur,uy URU,MF,Juventus,it Serie A,23,1997,25.8,63,33,21,37,5,20,59,33.9,39,35,12,23,47,110,46,1,Matches
274,Christian Benteke,be BEL,FW,Crystal Palace,eng Premier League,29,1990,20.2,15,7,1,7,7,2,9,22.2,7,17,6,11,4,19,39,0,Matches
275,Karim Benzema,fr FRA,FW,Real Madrid,es La Liga,32,1987,32.2,8,6,4,2,2,5,15,33.3,10,9,2,7,8,16,24,0,Matches
276,Yassine Benzia,dz ALG,"MF,FW",Dijon,fr Ligue 1,25,1994,4.5,10,5,5,3,2,2,10,20.0,8,3,0,3,6,16,2,0,Matches
277,Alessandro Berardi,it ITA,GK,Hellas Verona,it Serie A,29,1991,0.3,0,0,0,0,0,0,0,,0,0,0,0,0,0,0,0,Matches
278,Domenico Berardi,it ITA,FW,Sassuolo,it Serie A,25,1994,27.5,42,22,17,11,14,21,62,33.9,41,23,1,22,26,68,34,0,Matches
279,Gaetano Berardi,ch SUI,DF,Leeds United,eng Premier League,31,1988,1.3,2,2,1,0,1,0,0,,0,2,1,1,1,3,2,0,Matches
280,Yuri Berchiche,es ESP,DF,Athletic Club,es La Liga,30,1990,18.7,24,19,14,5,5,10,24,41.7,14,14,0,14,11,35,29,0,Matches
281,Álex Berenguer,es ESP,MF,Torino,it Serie A,25,1995,1.5,2,0,0,0,2,2,5,40.0,3,2,0,2,0,2,1,0,Matches
282,Álex Berenguer,es ESP,"MF,FW",Athletic Club,es La Liga,25,1995,25.3,47,31,21,20,6,9,51,17.6,42,48,3,45,18,65,27,0,Matches
283,Bartosz Bereszyński,pl POL,DF,Sampdoria,it Serie A,28,1992,29.0,66,44,37,22,7,41,73,56.2,32,40,20,20,42,108,88,0,Matches
284,Jóhann Berg Guðmundsson,is ISL,MF,Burnley,eng Premier League,29,1990,15.1,19,11,6,9,4,11,23,47.8,12,11,2,9,17,36,19,0,Matches
285,Sander Berge,no NOR,MF,Sheffield Utd,eng Premier League,22,1998,12.4,16,7,8,5,3,7,15,46.7,8,11,2,9,4,20,18,0,Matches
286,Steven Bergwijn,nl NED,"FW,MF",Tottenham,eng Premier League,22,1997,13.4,15,7,8,3,4,7,20,35.0,13,7,1,6,5,20,9,0,Matches
287,Valon Berisha,xk KVX,MF,Reims,fr Ligue 1,27,1993,18.3,40,23,19,17,4,11,47,23.4,36,14,2,12,25,65,21,1,Matches
288,Bernard,br BRA,"MF,FW",Everton,eng Premier League,27,1992,5.1,8,3,3,3,2,7,15,46.7,8,5,0,5,8,16,6,0,Matches
289,Federico Bernardeschi,it ITA,"MF,DF",Juventus,it Serie A,26,1994,10.8,9,4,3,5,1,4,20,20.0,16,6,2,4,14,23,7,1,Matches
290,Bernardo,br BRA,"DF,MF",Brighton,eng Premier League,25,1995,2.3,10,8,8,1,1,4,6,66.7,2,2,0,2,1,11,1,0,Matches
291,Paul Bernardoni,fr FRA,GK,Angers,fr Ligue 1,23,1997,38.0,1,1,1,0,0,1,2,50.0,1,0,0,0,2,3,23,1,Matches
292,Juan Bernat,es ESP,DF,Paris S-G,fr Ligue 1,27,1993,2.2,5,3,0,4,1,3,5,60.0,2,4,0,4,1,6,6,0,Matches
293,Dimitry Bertaud,cd COD,GK,Montpellier,fr Ligue 1,22,1998,8.3,0,0,0,0,0,0,0,,0,0,0,0,1,1,2,0,Matches
294,Marco Bertini,it ITA,MF,Lazio,it Serie A,17,2002,0.1,1,0,1,0,0,0,0,,0,0,0,0,0,1,0,0,Matches
295,Ryan Bertrand,eng ENG,DF,Southampton,eng Premier League,30,1989,28.9,60,32,26,27,7,30,48,62.5,18,19,1,18,30,90,41,1,Matches
296,Daniel Bessa,it ITA,MF,Hellas Verona,it Serie A,27,1993,6.8,15,8,3,11,1,6,14,42.9,8,5,1,4,2,17,0,0,Matches
297,Loïc Bessile,tg TOG,DF,Bordeaux,fr Ligue 1,21,1999,1.0,0,0,0,0,0,0,0,,0,2,1,1,1,1,3,0,Matches
298,Jordan Beyer,de GER,DF,Gladbach,de Bundesliga,20,2000,2.1,2,1,2,0,0,1,2,50.0,1,5,4,1,5,7,5,0,Matches
299,Giulian Biancone,fr FRA,"DF,MF",Monaco,fr Ligue 1,20,2000,1.0,3,3,1,1,1,2,3,66.7,1,1,0,1,1,4,4,0,Matches
300,Bartosz Białek,pl POL,"FW,MF",Wolfsburg,de Bundesliga,18,2001,3.0,6,5,1,4,1,4,4,100.0,0,5,1,4,3,9,4,0,Matches
301,Ermin Bičakčić,ba BIH,DF,Hoffenheim,de Bundesliga,30,1990,1.4,1,1,0,1,0,1,1,100.0,0,1,1,0,3,4,9,0,Matches
302,Pedro Bigas,es ESP,DF,Eibar,es La Liga,29,1990,17.0,11,9,7,4,0,7,14,50.0,7,12,6,6,23,34,54,0,Matches
303,El Bilal Touré,ml MLI,FW,Reims,fr Ligue 1,18,2001,13.8,22,12,3,16,3,8,18,44.4,10,8,3,5,6,28,10,1,Matches
304,Cristiano Biraghi,it ITA,DF,Fiorentina,it Serie A,27,1992,31.1,42,23,19,15,8,27,45,60.0,18,23,9,14,27,69,56,3,Matches
305,Davide Biraschi,it ITA,DF,Genoa,it Serie A,26,1994,10.2,17,9,12,5,0,5,10,50.0,5,12,6,6,21,38,26,0,Matches
306,Yves Bissouma,ml MLI,MF,Brighton,eng Premier League,23,1996,34.6,104,68,50,48,6,33,67,49.3,34,42,6,36,64,168,67,0,Matches
307,Leonardo Bittencourt,de GER,"MF,FW",Werder Bremen,de Bundesliga,26,1993,16.8,58,32,24,28,6,16,51,31.4,35,29,2,27,13,71,10,0,Matches
308,Alejandro Blanco,es ESP,MF,Valencia,es La Liga,21,1998,6.4,8,4,4,4,0,3,18,16.7,15,5,0,5,8,16,9,0,Matches
309,Antonio Blanco,es ESP,"MF,FW",Real Madrid,es La Liga,20,2000,2.4,7,2,4,2,1,3,7,42.9,4,6,2,4,3,10,5,0,Matches
310,Rubén Blanco,es ESP,GK,Celta Vigo,es La Liga,25,1995,18.2,0,0,0,0,0,0,0,,0,0,0,0,0,0,7,3,Matches
311,Ludovic Blas,fr FRA,"MF,FW",Nantes,fr Ligue 1,22,1997,31.0,58,30,18,37,3,23,54,42.6,31,33,4,29,21,79,19,0,Matches
312,Alejandro Blesa,es ESP,MF,Levante,es La Liga,18,2002,0.1,0,0,0,0,0,0,0,,0,0,0,0,0,0,0,0,Matches
313,Jérôme Boateng,de GER,DF,Bayern Munich,de Bundesliga,31,1988,26.3,26,16,17,8,1,14,32,43.8,18,24,17,7,40,66,63,1,Matches
314,Antonin Bobichon,fr FRA,"MF,FW",Angers,fr Ligue 1,24,1995,10.1,23,14,10,8,5,9,15,60.0,6,4,1,3,2,25,1,0,Matches
315,Yann Bodiger,fr FRA,MF,Cádiz,es La Liga,25,1995,2.8,2,2,1,1,0,1,6,16.7,5,7,3,4,8,10,4,0,Matches
316,Jean-Paul Boëtius,nl NED,"MF,FW",Mainz 05,de Bundesliga,26,1994,22.9,42,28,13,15,14,17,47,36.2,30,37,3,34,33,75,14,0,Matches
317,Sacha Boey,fr FRA,DF,Dijon,fr Ligue 1,19,2000,20.7,54,40,30,23,1,27,55,49.1,28,25,5,20,41,95,62,0,Matches
318,Sacha Boey,fr FRA,DF,Rennes,fr Ligue 1,19,2000,1.4,3,3,2,1,0,3,4,75.0,1,0,0,0,2,5,2,0,Matches
319,Jeremie Boga,ci CIV,"FW,MF",Sassuolo,it Serie A,23,1997,19.8,11,9,5,0,6,3,11,27.3,8,10,0,10,8,19,7,0,Matches
320,Melayro Bogarde,nl NED,"DF,MF",Hoffenheim,de Bundesliga,18,2002,3.1,7,3,3,3,1,5,9,55.6,4,0,0,0,5,12,1,0,Matches
321,Jayden Bogle,eng ENG,"DF,MF",Sheffield Utd,eng Premier League,20,2000,12.3,33,23,21,10,2,20,39,51.3,19,14,4,10,14,47,22,0,Matches
322,Quentin Boisgard,fr FRA,"MF,FW",Lorient,fr Ligue 1,23,1997,14.6,24,17,3,15,6,11,24,45.8,13,17,2,15,15,39,1,0,Matches
323,Willy Boly,ci CIV,DF,Wolves,eng Premier League,29,1991,20.9,33,20,26,7,0,13,24,54.2,11,18,12,6,32,65,84,1,Matches
324,Giacomo Bonaventura,it ITA,MF,Fiorentina,it Serie A,30,1989,25.1,34,19,16,13,5,16,53,30.2,37,26,2,24,39,73,12,0,Matches
325,Federico Bonazzoli,it ITA,FW,Torino,it Serie A,23,1997,6.3,6,4,0,4,2,2,13,15.4,11,3,0,3,2,8,3,0,Matches
326,Federico Bonazzoli,it ITA,FW,Sampdoria,it Serie A,23,1997,1.5,0,0,0,0,0,0,0,,0,1,0,1,0,0,0,0,Matches
327,Kevin Bonifazi,it ITA,DF,Udinese,it Serie A,24,1996,27.4,32,21,24,6,2,8,23,34.8,15,33,20,13,50,82,85,1,Matches
328,Leonardo Bonucci,it ITA,DF,Juventus,it Serie A,33,1987,22.5,19,14,10,8,1,6,14,42.9,8,24,13,11,33,52,67,0,Matches
329,Elias Bördner,de GER,GK,Eint Frankfurt,de Bundesliga,18,2002,1.0,1,0,1,0,0,1,1,100.0,0,0,0,0,2,3,1,0,Matches
330,Dennis Borkowski,de GER,"MF,FW",RB Leipzig,de Bundesliga,18,2002,0.1,0,0,0,0,0,0,0,,0,1,0,1,0,0,0,0,Matches
331,Sebastiaan Bornauw,be BEL,DF,Köln,de Bundesliga,21,1999,23.1,29,20,25,4,0,14,25,56.0,11,33,26,7,40,69,104,0,Matches
332,Sven Botman,nl NED,DF,Lille,fr Ligue 1,20,2000,36.8,31,21,18,12,1,14,26,53.8,12,31,21,10,57,88,126,2,Matches
333,Denis Bouanga,ga GAB,"MF,FW",Saint-Étienne,fr Ligue 1,25,1994,30.2,52,28,22,24,6,16,58,27.6,42,32,3,29,20,72,36,0,Matches
334,Hicham Boudaoui,dz ALG,MF,Nice,fr Ligue 1,20,1999,19.3,52,35,20,24,8,26,68,38.2,42,14,4,10,23,75,26,1,Matches
335,Ryad Boudebouz,dz ALG,"MF,FW",Saint-Étienne,fr Ligue 1,30,1990,7.2,9,4,1,7,1,4,8,50.0,4,3,0,3,5,14,5,0,Matches
336,Sofiane Boufal,ma MAR,"FW,MF",Angers,fr Ligue 1,26,1993,8.1,17,11,8,6,3,8,28,28.6,20,8,0,8,3,20,1,0,Matches
337,Nassim Boujellab,ma MAR,"MF,FW",Schalke 04,de Bundesliga,21,1999,6.7,13,9,2,10,1,2,12,16.7,10,10,3,7,7,20,9,0,Matches
338,Farid Boulaya,dz ALG,"MF,FW",Metz,fr Ligue 1,27,1993,31.3,24,16,4,17,3,13,51,25.5,38,19,3,16,12,36,7,0,Matches
339,Yassine Bounou,ma MAR,GK,Sevilla,es La Liga,29,1991,33.0,1,1,1,0,0,0,2,0.0,2,0,0,0,0,1,12,2,Matches
340,Ismaëlben Boura,km COM,DF,Lens,fr Ligue 1,19,2000,9.1,11,7,8,2,1,3,9,33.3,6,7,2,5,21,32,12,0,Matches
341,Mehdi Bourabia,ma MAR,MF,Sassuolo,it Serie A,28,1991,5.9,6,5,1,4,1,2,7,28.6,5,14,6,8,12,18,8,0,Matches
342,Benjamin Bourigeaud,fr FRA,"MF,FW",Rennes,fr Ligue 1,26,1994,28.4,40,23,17,16,7,21,71,29.6,50,37,1,36,19,59,25,0,Matches
343,Edoardo Bove,it ITA,MF,Roma,it Serie A,18,2002,0.1,0,0,0,0,0,0,1,0.0,1,0,0,0,0,0,0,0,Matches
344,Jarrod Bowen,eng ENG,"FW,MF",West Ham,eng Premier League,23,1996,28.5,26,15,12,7,7,10,29,34.5,19,19,1,18,22,48,10,0,Matches
345,Dedryck Boyata,be BEL,DF,Hertha BSC,de Bundesliga,29,1990,17.2,14,7,10,3,1,7,15,46.7,8,23,20,3,26,40,68,1,Matches
346,John Boye,gh GHA,DF,Metz,fr Ligue 1,33,1987,33.8,58,34,43,13,2,31,54,57.4,23,36,20,16,80,138,146,1,Matches
347,Lucas Boyé,ar ARG,FW,Elche,es La Liga,24,1996,29.9,47,31,13,27,7,10,49,20.4,39,37,2,35,19,66,21,0,Matches
348,Can Bozdogan,de GER,"MF,FW",Schalke 04,de Bundesliga,19,2001,7.2,13,5,6,6,1,4,15,26.7,11,10,2,8,7,20,5,0,Matches
349,Umut Bozok,tr TUR,"MF,FW",Lorient,fr Ligue 1,23,1996,0.7,0,0,0,0,0,0,2,0.0,2,0,0,0,0,0,0,0,Matches
350,Jayden Braaf,nl NED,FW,Udinese,it Serie A,17,2002,1.3,0,0,0,0,0,0,1,0.0,1,0,0,0,0,0,0,0,Matches
351,Domagoj Bradarić,hr CRO,DF,Lille,fr Ligue 1,20,1999,14.0,28,18,11,13,4,12,27,44.4,15,14,4,10,26,54,21,0,Matches
352,Robbie Brady,ie IRL,MF,Burnley,eng Premier League,28,1992,11.7,22,15,12,6,4,12,35,34.3,23,16,0,16,9,31,29,1,Matches
353,Martin Braithwaite,dk DEN,FW,Barcelona,es La Liga,29,1991,13.1,8,4,2,3,3,1,6,16.7,5,2,0,2,6,14,7,0,Matches
354,Julian Brandt,de GER,"FW,MF",Dortmund,de Bundesliga,24,1996,16.6,27,14,13,9,5,12,43,27.9,31,25,1,24,17,44,7,1,Matches
355,Darko Brašanac,rs SRB,MF,Osasuna,es La Liga,28,1992,10.1,10,6,6,4,0,5,16,31.3,11,8,1,7,7,17,10,0,Matches
356,Lilian Brassier,fr FRA,DF,Brest,fr Ligue 1,20,1999,10.7,19,10,12,4,3,7,11,63.6,4,13,6,7,23,42,38,1,Matches
357,Álvaro Bravo,es ESP,MF,Granada,es La Liga,22,1998,0.2,1,1,1,0,0,1,2,50.0,1,0,0,0,1,2,0,0,Matches
358,Claudio Bravo,cl CHI,GK,Betis,es La Liga,37,1983,20.0,0,0,0,0,0,0,1,0.0,1,0,0,0,0,0,11,0,Matches
359,Fabian Bredlow,de GER,GK,Stuttgart,de Bundesliga,25,1995,1.0,0,0,0,0,0,0,0,,0,0,0,0,0,0,0,0,Matches
360,Josip Brekalo,hr CRO,FW,Wolfsburg,de Bundesliga,22,1998,20.2,22,10,10,7,5,8,29,27.6,21,18,0,18,17,39,3,1,Matches
361,Gleison Bremer,br BRA,DF,Torino,it Serie A,23,1997,32.6,51,34,36,14,1,21,36,58.3,15,54,21,33,70,121,142,1,Matches
362,Joshua Brenet,cw CUW,DF,Hoffenheim,de Bundesliga,26,1994,0.0,0,0,0,0,0,0,0,,0,0,0,0,0,0,0,0,Matches
363,Rhian Brewster,eng ENG,"FW,MF",Sheffield Utd,eng Premier League,20,2000,12.5,8,5,1,4,3,1,13,7.7,12,15,2,13,5,13,5,0,Matches
364,Anthony Briançon,fr FRA,DF,Nîmes,fr Ligue 1,25,1994,13.6,12,7,9,3,0,9,19,47.4,10,19,12,7,33,45,57,2,Matches
365,Jimmy Briand,fr FRA,FW,Bordeaux,fr Ligue 1,34,1985,6.3,7,3,3,2,2,1,1,100.0,0,2,0,2,1,8,3,0,Matches
366,Yan Brice Eteki,cm CMR,MF,Granada,es La Liga,22,1997,14.7,23,15,10,12,1,8,19,42.1,11,13,3,10,13,36,16,1,Matches
367,Nathan Broadhead,wls WAL,FW,Everton,eng Premier League,22,1998,0.0,1,1,0,1,0,0,0,,0,0,0,0,0,1,0,0,Matches
368,Dylan Bronn,tn TUN,DF,Metz,fr Ligue 1,25,1995,37.9,57,37,38,19,0,24,44,54.5,20,31,14,17,44,101,112,0,Matches
369,John Brooks,us USA,DF,Wolfsburg,de Bundesliga,27,1993,30.8,47,29,33,14,0,30,54,55.6,24,35,10,25,55,102,134,0,Matches
370,Daniel Brosinski,de GER,"DF,FW",Mainz 05,de Bundesliga,32,1988,15.9,19,14,10,7,2,12,31,38.7,19,18,1,17,14,33,33,0,Matches
371,Josh Brownhill,eng ENG,MF,Burnley,eng Premier League,24,1995,31.3,45,27,9,29,7,15,44,34.1,29,33,11,22,69,114,39,0,Matches
372,Marcelo Brozović,hr CRO,MF,Inter,it Serie A,27,1992,28.7,54,29,23,24,7,20,61,32.8,41,43,17,26,40,94,38,0,Matches
373,Gastón Brugman,uy URU,MF,Parma,it Serie A,27,1992,18.0,35,19,18,15,2,11,44,25.0,33,33,4,29,45,80,34,0,Matches
374,Juan Brunet,ar ARG,MF,Granada,es La Liga,22,1998,0.3,0,0,0,0,0,0,0,,0,0,0,0,0,0,1,0,Matches
375,Juan Brunetta,ar ARG,"FW,MF",Parma,it Serie A,23,1997,5.3,2,2,0,2,0,1,6,16.7,5,5,0,5,1,3,2,0,Matches
376,Cédric Brunner,ch SUI,DF,Arminia,de Bundesliga,26,1994,29.5,42,22,24,15,3,27,40,67.5,13,30,10,20,42,84,96,0,Matches
377,Jacob Bruun Larsen,dk DEN,"MF,FW",Hoffenheim,de Bundesliga,21,1998,1.0,0,0,0,0,0,0,0,,0,0,0,0,0,0,0,0,Matches
378,Joe Bryan,eng ENG,"DF,MF",Fulham,eng Premier League,26,1993,7.4,15,8,7,5,3,7,12,58.3,5,8,2,6,14,29,16,0,Matches
379,Kean Bryan,eng ENG,DF,Sheffield Utd,eng Premier League,23,1996,11.2,20,10,9,11,0,9,19,47.4,10,16,10,6,13,33,39,1,Matches
380,Lucas Buadés,fr FRA,MF,Nîmes,fr Ligue 1,22,1997,0.2,1,0,0,1,0,0,0,,0,0,0,0,0,1,0,0,Matches
381,Ante Budimir,hr CRO,FW,Osasuna,es La Liga,29,1991,18.1,20,12,2,11,7,4,15,26.7,11,17,4,13,2,22,17,1,Matches
382,Gianluigi Buffon,it ITA,GK,Juventus,it Serie A,42,1978,8.0,0,0,0,0,0,0,0,,0,0,0,0,0,0,3,1,Matches
383,Marius Bülter,de GER,"FW,MF",Union Berlin,de Bundesliga,27,1993,10.9,15,8,6,6,3,5,17,29.4,12,17,2,15,12,27,11,0,Matches
384,Alessandro Buongiorno,it ITA,DF,Torino,it Serie A,21,1999,9.5,12,5,8,4,0,7,12,58.3,5,15,9,6,11,23,44,1,Matches
385,Esteban Burgos,ar ARG,DF,Eibar,es La Liga,28,1992,12.3,7,6,4,3,0,1,5,20.0,4,8,7,1,23,30,54,2,Matches
386,Burgui,es ESP,MF,Alavés,es La Liga,26,1993,0.2,3,1,2,1,0,1,1,100.0,0,0,0,0,0,3,0,0,Matches
387,Jonathan Burkardt,de GER,"FW,MF",Mainz 05,de Bundesliga,20,2000,15.3,27,13,15,10,2,11,19,57.9,8,20,3,17,8,35,15,0,Matches
388,Nishan Burkart,ch SUI,MF,Freiburg,de Bundesliga,20,2000,0.2,0,0,0,0,0,0,1,0.0,1,0,0,0,0,0,0,0,Matches
389,Oliver Burke,sct SCO,FW,Sheffield Utd,eng Premier League,23,1997,14.1,16,8,6,9,1,5,24,20.8,19,24,0,24,2,18,6,0,Matches
390,Roman Bürki,ch SUI,GK,Dortmund,de Bundesliga,29,1990,18.5,0,0,0,0,0,0,0,,0,0,0,0,0,0,5,1,Matches
391,Dan Burn,eng ENG,DF,Brighton,eng Premier League,28,1992,22.9,50,26,33,14,3,27,53,50.9,26,30,7,23,31,81,75,0,Matches
392,Patrick Burner,mq MTQ,DF,Nice,fr Ligue 1,24,1996,0.0,0,0,0,0,0,0,0,,0,0,0,0,0,0,0,0,Matches
393,Patrick Burner,mq MTQ,DF,Nîmes,fr Ligue 1,24,1996,14.6,25,11,14,10,1,13,26,50.0,13,10,3,7,24,49,41,1,Matches
394,Maxime Busi,be BEL,DF,Parma,it Serie A,20,1999,13.3,23,13,19,3,1,11,28,39.3,17,14,1,13,16,39,32,0,Matches
395,Sergio Busquets,es ESP,MF,Barcelona,es La Liga,32,1988,28.0,63,35,21,29,13,27,76,35.5,49,27,4,23,53,116,18,2,Matches
396,Jack Butland,eng ENG,GK,Crystal Palace,eng Premier League,27,1993,1.0,0,0,0,0,0,0,0,,0,0,0,0,0,0,0,0,Matches
397,David Button,eng ENG,GK,West Brom,eng Premier League,31,1989,1.0,0,0,0,0,0,0,0,,0,0,0,0,0,0,0,0,Matches
398,Oskar Buur,dk DEN,DF,Wolves,eng Premier League,22,1998,0.2,0,0,0,0,0,0,2,0.0,2,0,0,0,0,0,0,0,Matches
399,Marcin Bułka,pl POL,GK,Paris S-G,fr Ligue 1,20,1999,1.0,0,0,0,0,0,0,0,,0,0,0,0,0,0,0,1,Matches
400,Erick Cabaco,uy URU,DF,Getafe,es La Liga,25,1995,14.7,24,14,11,12,1,12,22,54.5,10,8,6,2,13,37,51,1,Matches
401,Willy Caballero,ar ARG,GK,Chelsea,eng Premier League,38,1981,1.0,0,0,0,0,0,0,0,,0,0,0,0,0,0,0,0,Matches
402,Jimmy Cabot,fr FRA,"FW,MF",Angers,fr Ligue 1,26,1994,10.5,26,13,8,14,4,11,36,30.6,25,8,0,8,12,38,6,0,Matches
403,Martín Cáceres,uy URU,DF,Fiorentina,it Serie A,33,1987,24.9,28,12,16,11,1,15,35,42.9,20,20,14,6,14,42,52,1,Matches
404,Anthony Caci,fr FRA,DF,Strasbourg,fr Ligue 1,23,1997,31.1,80,46,47,27,6,35,69,50.7,34,30,4,26,55,135,65,1,Matches
405,Mathieu Cafaro,fr FRA,"MF,FW",Reims,fr Ligue 1,23,1997,23.0,40,17,15,19,6,13,43,30.2,30,11,0,11,17,57,12,0,Matches
406,Gary Cahill,eng ENG,DF,Crystal Palace,eng Premier League,34,1985,20.0,13,9,10,3,0,7,11,63.6,4,27,22,5,13,26,88,0,Matches
407,Yannick Cahuzac,fr FRA,MF,Lens,fr Ligue 1,35,1985,25.0,26,12,12,10,4,9,27,33.3,18,18,5,13,33,59,72,0,Matches
408,Felipe Caicedo,ec ECU,FW,Lazio,it Serie A,31,1988,10.3,10,7,4,4,2,1,8,12.5,7,7,0,7,4,14,2,0,Matches
409,Marc-Aurèle Caillard,fr FRA,GK,Metz,fr Ligue 1,26,1994,4.0,0,0,0,0,0,0,0,,0,0,0,0,0,0,2,0,Matches
410,Tom Cairney,sct SCO,MF,Fulham,eng Premier League,29,1991,8.4,9,3,1,4,4,1,4,25.0,3,6,0,6,0,9,3,0,Matches
411,Cala,es ESP,DF,Cádiz,es La Liga,30,1989,25.2,21,12,15,6,0,11,21,52.4,10,18,8,10,35,56,91,0,Matches
412,Arturo Calabresi,it ITA,"DF,FW",Bologna,it Serie A,24,1996,0.2,0,0,0,0,0,0,0,,0,0,0,0,0,0,2,0,Matches
413,Arturo Calabresi,it ITA,DF,Cagliari,it Serie A,24,1996,0.2,0,0,0,0,0,0,1,0.0,1,0,0,0,0,0,0,0,Matches
414,Davide Calabria,it ITA,DF,Milan,it Serie A,23,1996,29.4,101,64,61,32,8,54,90,60.0,36,42,9,33,37,138,82,1,Matches
415,Riccardo Calafiori,it ITA,DF,Roma,it Serie A,18,2002,0.7,1,0,1,0,0,1,4,25.0,3,1,0,1,0,1,0,0,Matches
416,Mattia Caldara,it ITA,DF,Atalanta,it Serie A,26,1994,1.2,1,0,0,1,0,1,1,100.0,0,3,2,1,4,5,3,0,Matches
417,Luca Caldirola,it ITA,DF,Benevento,it Serie A,29,1991,17.5,21,13,13,6,2,10,22,45.5,12,20,15,5,20,41,56,0,Matches
418,Duje Ćaleta-Car,hr CRO,DF,Marseille,fr Ligue 1,23,1996,31.3,29,17,19,9,1,17,30,56.7,13,29,22,7,44,73,130,0,Matches
419,Hakan Çalhanoğlu,tr TUR,"MF,FW",Milan,it Serie A,26,1994,29.0,26,7,3,17,6,7,28,25.0,21,21,6,15,15,41,24,1,Matches
420,Kerim Calhanoglu,de GER,DF,Schalke 04,de Bundesliga,17,2002,3.3,3,3,1,1,1,0,3,0.0,3,4,0,4,7,10,6,0,Matches
421,Fabrizio Caligara,it ITA,"MF,FW",Cagliari,it Serie A,20,2000,2.0,6,4,2,2,2,6,9,66.7,3,9,2,7,3,9,3,0,Matches
422,Daniel Caligiuri,it ITA,"MF,FW",Augsburg,de Bundesliga,32,1988,29.6,71,46,29,31,11,29,92,31.5,63,45,6,39,38,109,41,0,Matches
423,José Callejón,es ESP,"FW,MF",Fiorentina,it Serie A,33,1987,7.4,10,7,0,6,4,5,9,55.6,4,4,1,3,4,14,5,0,Matches
424,Jonathan Calleri,ar ARG,FW,Osasuna,es La Liga,26,1993,17.2,15,6,2,4,9,3,17,17.6,14,18,2,16,1,16,10,1,Matches
425,Dominic Calvert-Lewin,eng ENG,FW,Everton,eng Premier League,23,1997,31.9,17,8,1,8,8,6,12,50.0,6,22,6,16,6,23,33,0,Matches
426,Dani Calvo,es ESP,DF,Elche,es La Liga,26,1994,19.8,20,13,13,7,0,7,10,70.0,3,18,12,6,11,31,71,0,Matches
427,Drissa Camara,ci CIV,MF,Parma,it Serie A,18,2002,0.2,0,0,0,0,0,0,0,,0,0,0,0,0,0,0,0,Matches
428,Mahdi Camara,fr FRA,"MF,DF",Saint-Étienne,fr Ligue 1,22,1998,36.6,99,67,43,46,10,33,60,55.0,27,50,12,38,78,177,51,0,Matches
429,Eduardo Camavinga,fr FRA,MF,Rennes,fr Ligue 1,17,2002,26.7,98,58,39,48,11,38,77,49.4,39,36,2,34,23,121,15,1,Matches
430,José Campaña,es ESP,MF,Levante,es La Liga,27,1993,8.3,14,6,3,6,5,5,14,35.7,9,2,0,2,13,27,4,0,Matches
431,Emre Can,de GER,"DF,MF",Dortmund,de Bundesliga,26,1994,23.7,43,34,20,20,3,20,37,54.1,17,35,10,25,48,91,52,0,Matches
432,Sergio Canales,es ESP,"MF,FW",Betis,es La Liga,29,1991,27.8,16,9,9,6,1,3,21,14.3,18,18,0,18,13,29,5,0,Matches
433,João Cancelo,pt POR,"DF,MF",Manchester City,eng Premier League,26,1994,25.5,68,41,42,19,7,43,83,51.8,40,23,2,21,41,109,33,2,Matches
434,Antonio Candreva,it ITA,MF,Sampdoria,it Serie A,33,1987,27.8,28,19,17,9,2,21,53,39.6,32,24,3,21,9,37,27,1,Matches
435,Álex Cantero,es ESP,FW,Levante,es La Liga,20,2000,2.6,2,1,0,2,0,1,2,50.0,1,1,0,1,0,2,3,0,Matches
436,Ander Capa,es ESP,DF,Athletic Club,es La Liga,28,1992,23.7,37,18,22,13,2,18,37,48.6,19,21,8,13,25,62,57,0,Matches
437,Pierrick Capelle,fr FRA,"MF,DF",Angers,fr Ligue 1,33,1987,22.8,53,28,24,17,12,31,79,39.2,48,25,1,24,47,100,32,0,Matches
438,Étienne Capoue,fr FRA,MF,Villarreal,es La Liga,32,1988,13.2,20,10,14,6,0,8,18,44.4,10,7,1,6,20,40,23,0,Matches
439,Elio Capradossi,ug UGA,DF,Spezia,it Serie A,24,1996,1.0,2,1,2,0,0,2,2,100.0,0,0,0,0,1,3,5,0,Matches
440,Gianluca Caprari,it ITA,"MF,FW",Benevento,it Serie A,27,1993,20.7,16,11,5,5,6,6,31,19.4,25,19,1,18,18,34,8,0,Matches
441,Francesco Caputo,it ITA,FW,Sassuolo,it Serie A,32,1987,18.9,0,0,0,0,0,0,2,0.0,2,4,0,4,1,1,3,0,Matches
442,Maxence Caqueret,fr FRA,MF,Lyon,fr Ligue 1,20,2000,19.6,72,45,17,39,16,35,106,33.0,71,35,3,32,23,95,5,2,Matches
443,Andrea Carboni,it ITA,DF,Cagliari,it Serie A,19,2001,12.1,34,23,23,11,0,15,28,53.6,13,15,4,11,14,48,52,0,Matches
444,Isaac Carcelen,es ESP,DF,Cádiz,es La Liga,27,1993,28.7,68,43,36,25,7,33,60,55.0,27,37,12,25,49,117,89,0,Matches
445,Cárdenas,es ESP,GK,Levante,es La Liga,23,1997,8.0,0,0,0,0,0,0,1,0.0,1,0,0,0,3,3,5,1,Matches
446,Irvin Cardona,fr FRA,FW,Brest,fr Ligue 1,22,1997,22.5,10,5,3,6,1,4,22,18.2,18,17,3,14,9,19,23,2,Matches
447,Marc Cardona,es ESP,"FW,DF",Osasuna,es La Liga,25,1995,0.6,1,0,1,0,0,1,1,100.0,0,0,0,0,0,1,0,0,Matches
448,Ian Carlo Poveda,eng ENG,MF,Leeds United,eng Premier League,20,2000,3.9,5,4,3,0,2,1,7,14.3,6,5,1,4,1,6,2,0,Matches
449,Diego Carlos,br BRA,DF,Sevilla,es La Liga,27,1993,31.0,22,13,17,4,1,8,16,50.0,8,35,27,8,31,53,114,1,Matches
450,Juan Carlos,es ESP,"MF,FW",Huesca,es La Liga,29,1991,3.2,5,3,4,1,0,2,15,13.3,13,7,0,7,1,6,1,0,Matches
451,Lionel Carole,fr FRA,DF,Strasbourg,fr Ligue 1,29,1991,14.9,37,25,18,14,5,16,29,55.2,13,3,1,2,38,75,28,0,Matches
452,Yannick Carrasco,be BEL,"DF,MF",Atlético Madrid,es La Liga,26,1993,24.2,27,15,14,6,7,15,34,44.1,19,24,0,24,17,44,16,1,Matches
453,Sergio Carreira,es ESP,DF,Celta Vigo,es La Liga,19,2000,2.9,3,0,2,1,0,1,1,100.0,0,2,0,2,1,4,7,0,Matches
454,Guido Carrillo,ar ARG,FW,Elche,es La Liga,29,1991,11.1,9,8,1,7,1,2,8,25.0,6,2,1,1,4,13,14,0,Matches
455,Andy Carroll,eng ENG,FW,Newcastle Utd,eng Premier League,31,1989,4.4,3,1,1,1,1,1,8,12.5,7,1,0,1,0,3,14,0,Matches
456,Scott Carson,eng ENG,GK,Manchester City,eng Premier League,34,1985,1.0,0,0,0,0,0,0,0,,0,0,0,0,0,0,0,0,Matches
457,Dani Carvajal,es ESP,DF,Real Madrid,es La Liga,28,1992,10.6,27,20,12,10,5,11,20,55.0,9,19,1,18,13,40,27,0,Matches
458,Fabio Carvalho,pt POR,"MF,FW",Fulham,eng Premier League,17,2002,2.8,9,6,4,4,1,5,9,55.6,4,2,0,2,1,10,1,1,Matches
459,William Carvalho,pt POR,MF,Betis,es La Liga,28,1992,13.6,19,12,7,11,1,5,21,23.8,16,11,3,8,11,30,14,1,Matches
460,Casemiro,br BRA,MF,Real Madrid,es La Liga,28,1992,32.2,84,49,50,30,4,33,73,45.2,40,50,17,33,70,154,62,0,Matches
461,Matty Cash,pl POL,DF,Aston Villa,eng Premier League,22,1997,26.4,71,40,43,22,6,41,74,55.4,33,50,11,39,60,131,95,0,Matches
462,Kiko Casilla,es ESP,GK,Leeds United,eng Premier League,33,1986,3.0,0,0,0,0,0,0,0,,0,0,0,0,0,0,0,0,Matches
463,Giuseppe Caso,it ITA,"DF,FW",Genoa,it Serie A,21,1998,0.6,0,0,0,0,0,0,0,,0,0,0,0,0,0,0,0,Matches
464,Moreto Cassamã,gw GNB,MF,Reims,fr Ligue 1,22,1998,22.6,49,36,24,23,2,27,49,55.1,22,19,6,13,36,85,33,4,Matches
465,Francesco Cassata,it ITA,"DF,FW",Genoa,it Serie A,23,1997,2.5,7,6,7,0,0,4,7,57.1,3,0,0,0,3,10,1,0,Matches
466,Timothy Castagne,be BEL,DF,Leicester City,eng Premier League,24,1995,26.1,52,32,29,18,5,24,44,54.5,20,29,5,24,29,81,62,1,Matches
467,Koen Casteels,be BEL,GK,Wolfsburg,de Bundesliga,28,1992,32.0,0,0,0,0,0,0,1,0.0,1,1,0,1,2,2,9,2,Matches
468,Jean-Charles Castelletto,cm CMR,DF,Nantes,fr Ligue 1,25,1995,21.6,32,18,20,11,1,18,31,58.1,13,25,19,6,42,74,79,0,Matches
469,Samu Castillejo,es ESP,FW,Milan,it Serie A,25,1995,13.1,24,12,9,14,1,14,40,35.0,26,21,0,21,6,30,9,0,Matches
470,Gonzalo Castro,de GER,MF,Stuttgart,de Bundesliga,33,1987,19.2,21,7,6,9,6,8,23,34.8,15,16,3,13,8,29,12,0,Matches
471,Jonny Castro,es ESP,"MF,DF",Wolves,eng Premier League,26,1994,5.5,11,5,6,4,1,6,13,46.2,7,9,3,6,9,20,7,0,Matches
472,Gaetano Castrovilli,it ITA,MF,Fiorentina,it Serie A,23,1997,25.9,33,19,15,11,7,11,42,26.2,31,25,2,23,34,67,14,0,Matches
473,Danilo Cataldi,it ITA,MF,Lazio,it Serie A,25,1994,6.3,7,2,1,5,1,4,18,22.2,14,3,1,2,9,16,7,0,Matches
474,Ivan Cavaleiro,pt POR,FW,Fulham,eng Premier League,26,1993,27.5,23,14,9,11,3,12,34,35.3,22,25,1,24,19,42,14,0,Matches
475,Edinson Cavani,uy URU,FW,Manchester Utd,eng Premier League,33,1987,15.3,12,8,1,8,3,2,13,15.4,11,2,0,2,6,18,11,0,Matches
476,Dani Ceballos,es ESP,MF,Arsenal,eng Premier League,23,1996,17.9,37,22,20,11,6,21,51,41.2,30,23,6,17,35,72,14,1,Matches
477,Federico Ceccherini,it ITA,DF,Hellas Verona,it Serie A,28,1992,19.3,16,12,10,6,0,2,7,28.6,5,15,8,7,40,56,60,0,Matches
478,Federico Ceccherini,it ITA,DF,Fiorentina,it Serie A,28,1992,3.0,4,1,1,3,0,1,1,100.0,0,6,5,1,7,11,15,0,Matches
479,Zeki Çelik,tr TUR,DF,Lille,fr Ligue 1,23,1997,26.5,72,33,30,30,12,44,81,54.3,37,32,6,26,38,110,52,0,Matches
480,Bersant Celina,xk KVX,"MF,FW",Dijon,fr Ligue 1,23,1996,25.5,20,12,8,8,4,7,38,18.4,31,20,2,18,8,28,10,0,Matches
481,Fabien Centonze,fr FRA,DF,Metz,fr Ligue 1,24,1996,35.8,104,68,64,30,10,43,73,58.9,30,62,17,45,112,216,119,1,Matches
482,Luca Ceppitelli,it ITA,DF,Cagliari,it Serie A,30,1989,16.3,25,19,13,10,2,14,26,53.8,12,23,12,11,25,50,58,1,Matches
483,Alberto Cerri,it ITA,FW,Cagliari,it Serie A,24,1996,4.1,3,2,0,2,1,0,5,0.0,5,4,2,2,2,5,6,0,Matches
484,Sava Cestic,rs SRB,DF,Köln,de Bundesliga,19,2001,10.0,20,9,12,6,2,8,17,47.1,9,13,4,9,18,38,40,0,Matches
485,Julian Chabot,de GER,DF,Spezia,it Serie A,22,1998,18.4,48,34,28,16,4,23,37,62.2,14,25,13,12,37,85,43,1,Matches
486,Nassim Chadli,fr FRA,"FW,MF",Nîmes,fr Ligue 1,19,2001,0.3,2,1,2,0,0,0,1,0.0,1,1,0,1,0,2,0,0,Matches
487,Fouad Chafik,ma MAR,DF,Dijon,fr Ligue 1,33,1986,18.0,39,24,29,8,2,16,35,45.7,19,19,10,9,21,60,41,0,Matches
488,Mehdi Chahiri,ma MAR,"FW,MF",Strasbourg,fr Ligue 1,24,1996,8.9,18,8,7,5,6,8,20,40.0,12,9,0,9,6,24,5,0,Matches
489,Sofian Chakla,ma MAR,DF,Villarreal,es La Liga,26,1993,0.1,0,0,0,0,0,0,0,,0,0,0,0,0,0,0,0,Matches
490,Sofian Chakla,ma MAR,DF,Getafe,es La Liga,26,1993,10.0,12,8,10,1,1,5,7,71.4,2,3,2,1,14,26,48,1,Matches
491,Aníbal Chalá,ec ECU,DF,Dijon,fr Ligue 1,24,1996,8.3,10,7,6,3,1,6,12,50.0,6,5,3,2,14,24,15,1,Matches
492,Trevoh Chalobah,eng ENG,"DF,MF",Lorient,fr Ligue 1,21,1999,24.9,45,26,32,13,0,24,50,48.0,26,20,7,13,69,114,56,0,Matches
493,Calum Chambers,eng ENG,DF,Arsenal,eng Premier League,25,1995,8.4,7,3,3,2,2,3,8,37.5,5,6,2,4,10,17,37,0,Matches
494,Timothy Chandler,us USA,DF,Eint Frankfurt,de Bundesliga,30,1990,4.8,4,0,2,1,1,1,4,25.0,3,5,2,3,3,7,5,0,Matches
495,Kwon Chang-hoon,kr KOR,"MF,FW",Freiburg,de Bundesliga,26,1994,2.4,3,1,1,0,2,1,3,33.3,2,3,1,2,7,10,2,1,Matches
496,Gaëtan Charbonnier,fr FRA,"MF,FW",Brest,fr Ligue 1,31,1988,17.4,24,15,6,11,7,12,32,37.5,20,15,1,14,9,33,19,0,Matches
497,Brendan Chardonnet,fr FRA,DF,Brest,fr Ligue 1,25,1994,30.2,51,29,31,19,1,27,41,65.9,14,54,41,13,64,115,151,0,Matches
498,Xavier Chavalerin,fr FRA,MF,Reims,fr Ligue 1,29,1991,28.3,92,50,47,38,7,26,74,35.1,48,43,9,34,43,135,29,1,Matches
499,Pape Cheikh Diop,sn SEN,MF,Dijon,fr Ligue 1,22,1997,12.1,24,14,15,6,3,13,33,39.4,20,14,2,12,6,30,6,0,Matches
500,Chema,es ESP,"DF,MF",Getafe,es La Liga,28,1992,6.2,11,5,6,5,0,5,7,71.4,2,1,0,1,10,21,23,0,Matches
501,Rayan Cherki,fr FRA,"FW,MF",Lyon,fr Ligue 1,16,2003,7.8,5,3,0,3,2,1,11,9.1,10,3,0,3,4,9,0,0,Matches
502,Denis Cheryshev,ru RUS,MF,Valencia,es La Liga,29,1990,12.2,19,15,6,7,6,6,26,23.1,20,15,1,14,12,31,15,0,Matches
503,Giorgio Chiellini,it ITA,DF,Juventus,it Serie A,35,1984,15.4,12,9,9,3,0,5,11,45.5,6,18,13,5,27,39,56,0,Matches
504,Federico Chiesa,it ITA,DF,Fiorentina,it Serie A,22,1997,2.7,6,2,2,2,2,3,8,37.5,5,3,1,2,1,7,3,0,Matches
505,Federico Chiesa,it ITA,"MF,DF",Juventus,it Serie A,22,1997,24.6,47,26,21,14,12,19,50,38.0,31,23,1,22,12,59,16,0,Matches
506,Ben Chilwell,eng ENG,DF,Chelsea,eng Premier League,23,1996,25.4,42,22,16,22,4,15,33,45.5,18,28,3,25,24,66,58,0,Matches
507,Vlad Chiricheș,ro ROU,DF,Sassuolo,it Serie A,30,1989,20.4,38,23,34,3,1,21,35,60.0,14,31,21,10,50,88,59,2,Matches
508,Pedro Chirivella,es ESP,MF,Nantes,fr Ligue 1,23,1997,25.3,26,8,7,13,6,14,49,28.6,35,23,4,19,41,67,19,0,Matches
509,Tahith Chong,nl NED,"MF,FW",Werder Bremen,de Bundesliga,20,1999,4.3,11,6,1,9,1,4,8,50.0,4,4,0,4,5,16,1,0,Matches
510,Joris Chotard,fr FRA,MF,Montpellier,fr Ligue 1,18,2001,12.9,12,8,5,6,1,6,31,19.4,25,12,3,9,11,23,15,0,Matches
511,Hamza Choudhury,eng ENG,MF,Leicester City,eng Premier League,22,1997,3.5,8,7,3,5,0,4,10,40.0,6,4,1,3,4,12,9,1,Matches
512,Mounir Chouiar,fr FRA,"FW,MF",Dijon,fr Ligue 1,21,1999,14.3,22,12,10,9,3,6,18,33.3,12,10,0,10,11,33,8,0,Matches
513,Andreas Christensen,dk DEN,DF,Chelsea,eng Premier League,24,1996,15.2,11,6,8,3,0,0,8,0.0,8,19,14,5,20,31,51,1,Matches
514,Carney Chukwuemeka,eng ENG,"MF,FW",Aston Villa,eng Premier League,16,2003,0.2,2,2,1,0,1,1,3,33.3,2,0,0,0,0,2,0,0,Matches
515,Samuel Chukwueze,ng NGA,"MF,FW",Villarreal,es La Liga,21,1999,15.2,12,7,4,4,4,3,17,17.6,14,8,0,8,10,22,3,0,Matches
516,Darko Churlinov,mk MKD,"DF,MF",Stuttgart,de Bundesliga,20,2000,2.4,2,2,2,0,0,1,3,33.3,2,5,1,4,0,2,2,0,Matches
517,Víctor Chust,es ESP,DF,Real Madrid,es La Liga,20,2000,1.1,1,1,0,1,0,0,2,0.0,2,2,2,0,1,2,5,0,Matches
518,Sébastien Cibois,fr FRA,GK,Brest,fr Ligue 1,22,1998,3.0,0,0,0,0,0,0,0,,0,0,0,0,0,0,0,1,Matches
519,Cifu,es ESP,DF,Elche,es La Liga,29,1990,5.0,10,7,7,3,0,7,13,53.8,6,5,1,4,8,18,10,0,Matches
520,Alberto Cifuentes,es ESP,GK,Cádiz,es La Liga,41,1979,2.0,0,0,0,0,0,0,0,,0,0,0,0,0,0,0,0,Matches
521,Luca Cigarini,it ITA,MF,Crotone,it Serie A,34,1986,10.3,26,14,11,12,3,12,28,42.9,16,10,1,9,12,38,9,0,Matches
522,Jasper Cillessen,nl NED,GK,Valencia,es La Liga,31,1989,10.0,0,0,0,0,0,0,0,,0,0,0,0,0,0,0,0,Matches
523,Antonio Cioffi,it ITA,FW,Napoli,it Serie A,17,2002,0.1,0,0,0,0,0,0,0,,0,1,0,1,1,1,0,0,Matches
524,Tim Civeja,al ALB,MF,Augsburg,de Bundesliga,18,2002,0.4,0,0,0,0,0,0,1,0.0,1,0,0,0,3,3,0,0,Matches
525,Ciaran Clark,ie IRL,DF,Newcastle Utd,eng Premier League,30,1989,21.0,24,14,15,6,3,6,13,46.2,7,27,20,7,29,53,104,1,Matches
526,Alexis Claude-Maurice,fr FRA,"MF,FW",Nice,fr Ligue 1,22,1998,21.2,40,19,17,14,9,14,48,29.2,34,16,2,14,14,54,3,0,Matches
527,Jonathan Clauss,fr FRA,DF,Lens,fr Ligue 1,27,1992,28.0,43,20,12,20,11,17,38,44.7,21,24,1,23,45,88,46,0,Matches
528,Carlos Clerc,es ESP,DF,Levante,es La Liga,28,1992,30.9,56,29,33,16,7,22,39,56.4,17,26,4,22,37,93,55,1,Matches
529,Nathaniel Clyne,eng ENG,DF,Crystal Palace,eng Premier League,29,1991,12.7,17,10,8,8,1,9,16,56.3,7,7,2,5,18,35,25,1,Matches
530,Conor Coady,eng ENG,DF,Wolves,eng Premier League,27,1993,36.7,35,23,25,10,0,19,35,54.3,16,40,32,8,27,62,134,2,Matches
531,Marcus Coco,fr FRA,"MF,FW",Nantes,fr Ligue 1,24,1996,16.4,36,21,17,15,4,16,36,44.4,20,16,3,13,20,56,17,0,Matches
532,Coke,es ESP,DF,Levante,es La Liga,33,1987,9.3,24,10,14,7,3,14,27,51.9,13,13,1,12,14,38,27,0,Matches
533,Séamus Coleman,ie IRL,"DF,MF",Everton,eng Premier League,31,1988,17.9,39,26,21,14,4,21,30,70.0,9,22,6,16,13,52,37,2,Matches
534,Ebrima Colley,gm GAM,"MF,FW",Hellas Verona,it Serie A,20,2000,8.2,11,4,2,6,3,3,11,27.3,8,6,0,6,6,17,1,0,Matches
535,Omar Colley,gm GAM,DF,Sampdoria,it Serie A,27,1992,28.8,28,16,19,8,1,13,23,56.5,10,43,29,14,68,96,133,1,Matches
536,Simone Colombi,it ITA,GK,Parma,it Serie A,29,1991,2.0,0,0,0,0,0,0,0,,0,0,0,0,0,0,2,0,Matches
537,Lorenzo Colombo,it ITA,FW,Milan,it Serie A,18,2002,1.0,2,1,1,1,0,0,3,0.0,3,0,0,0,0,2,3,0,Matches
538,Racine Coly,sn SEN,MF,Nice,fr Ligue 1,24,1995,0.2,0,0,0,0,0,0,0,,0,0,0,0,0,0,0,0,Matches
539,Kingsley Coman,fr FRA,"FW,MF",Bayern Munich,de Bundesliga,24,1996,19.5,14,8,6,7,1,2,21,9.5,19,22,0,22,4,18,3,0,Matches
540,Daniel Congré,fr FRA,DF,Montpellier,fr Ligue 1,35,1985,36.6,59,35,45,12,2,36,70,51.4,34,50,33,17,69,128,144,3,Matches
541,Aaron Connolly,ie IRL,FW,Brighton,eng Premier League,20,2000,8.8,6,3,1,3,2,0,2,0.0,2,4,0,4,0,6,2,0,Matches
542,Andrea Consigli,it ITA,GK,Sassuolo,it Serie A,33,1987,37.0,2,2,2,0,0,2,2,100.0,0,0,0,0,0,2,14,4,Matches
543,Andrea Conti,it ITA,DF,Milan,it Serie A,26,1994,0.3,1,1,1,0,0,0,1,0.0,1,0,0,0,1,2,0,0,Matches
544,Andrea Conti,it ITA,DF,Parma,it Serie A,26,1994,9.0,21,10,16,4,1,13,26,50.0,13,13,4,9,16,37,23,0,Matches
545,Liam Cooper,sct SCO,DF,Leeds United,eng Premier League,28,1991,24.3,68,45,39,27,2,37,59,62.7,22,39,32,7,61,129,70,1,Matches
546,Francis Coquelin,fr FRA,MF,Villarreal,es La Liga,29,1991,8.2,19,14,4,12,3,8,19,42.1,11,8,2,6,21,40,11,1,Matches
547,Theo Corbeanu,ca CAN,FW,Wolves,eng Premier League,18,2002,0.1,2,1,0,2,0,1,1,100.0,0,0,0,0,1,3,0,0,Matches
548,Sébastien Corchia,fr FRA,DF,Nantes,fr Ligue 1,29,1990,23.0,55,30,29,17,9,33,60,55.0,27,28,10,18,38,93,40,1,Matches
549,Alex Cordaz,it ITA,GK,Crotone,it Serie A,37,1983,36.0,0,0,0,0,0,0,0,,0,0,0,0,1,1,7,2,Matches
550,Iñigo Córdoba,es ESP,"FW,MF",Athletic Club,es La Liga,23,1997,1.1,0,0,0,0,0,0,3,0.0,3,4,0,4,2,2,1,0,Matches
551,Iñigo Córdoba,es ESP,MF,Alavés,es La Liga,23,1997,2.4,6,4,1,3,2,2,10,20.0,8,7,0,7,3,9,2,0,Matches
552,Jhon Córdoba,co COL,FW,Hertha BSC,de Bundesliga,27,1993,17.1,9,4,1,5,3,2,4,50.0,2,13,2,11,6,15,4,0,Matches
553,Sergio Córdova,ve VEN,"FW,MF",Arminia,de Bundesliga,22,1997,12.1,16,8,0,10,6,2,15,13.3,13,14,3,11,9,25,9,0,Matches
554,Jack Cork,eng ENG,MF,Burnley,eng Premier League,31,1989,15.0,26,10,5,17,4,11,31,35.5,20,15,4,11,16,42,20,0,Matches
555,Andreas Cornelius,dk DEN,FW,Parma,it Serie A,27,1993,21.1,11,4,1,5,5,2,12,16.7,10,9,2,7,1,12,25,1,Matches
556,Maxwel Cornet,ci CIV,"DF,FW",Lyon,fr Ligue 1,23,1996,27.2,70,41,39,24,7,33,58,56.9,25,23,5,18,43,113,47,2,Matches
557,Ángel Correa,ar ARG,"FW,MF",Atlético Madrid,es La Liga,25,1995,26.6,38,21,10,23,5,15,45,33.3,30,18,1,17,22,60,16,0,Matches
558,Joaquín Correa,ar ARG,FW,Lazio,it Serie A,25,1994,21.5,21,12,6,11,4,7,25,28.0,18,14,0,14,7,28,12,0,Matches
559,Rober Correa,es ESP,DF,Eibar,es La Liga,27,1992,12.6,16,9,8,6,2,8,12,66.7,4,9,1,8,20,36,31,0,Matches
560,Félix Correia,pt POR,MF,Juventus,it Serie A,19,2001,0.1,0,0,0,0,0,0,0,,0,0,0,0,0,0,1,0,Matches
561,Thierry Correia,pt POR,DF,Valencia,es La Liga,21,1999,23.7,47,27,32,10,5,21,43,48.8,22,24,6,18,42,89,63,1,Matches
562,Danny da Costa,de GER,"DF,FW",Mainz 05,de Bundesliga,27,1993,13.4,22,16,6,9,7,13,27,48.1,14,17,2,15,17,39,27,0,Matches
563,Danny da Costa,de GER,DF,Eint Frankfurt,de Bundesliga,27,1993,1.2,0,0,0,0,0,0,1,0.0,1,3,1,2,0,0,4,0,Matches
564,David Pereira da Costa,pt POR,"MF,FW",Lens,fr Ligue 1,19,2001,1.8,4,4,1,2,1,2,3,66.7,1,2,0,2,0,4,4,0,Matches
565,Diego Costa,es ESP,FW,Atlético Madrid,es La Liga,31,1988,2.3,1,0,1,0,0,1,3,33.3,2,0,0,0,0,1,2,0,Matches
566,Douglas Costa,br BRA,"MF,FW",Juventus,it Serie A,29,1990,0.5,1,0,1,0,0,1,3,33.3,2,0,0,0,0,1,0,0,Matches
567,Douglas Costa,br BRA,"FW,MF",Bayern Munich,de Bundesliga,29,1990,3.6,2,1,1,1,0,1,3,33.3,2,7,0,7,2,4,1,0,Matches
568,Hélder Costa,ao ANG,"MF,FW",Leeds United,eng Premier League,26,1994,12.8,25,11,12,5,8,11,32,34.4,21,11,0,11,3,28,5,1,Matches
569,Jaume Costa,es ESP,"DF,MF",Villarreal,es La Liga,32,1988,3.9,10,6,4,6,0,7,9,77.8,2,7,1,6,6,16,8,0,Matches
570,Angelo da Costa Júnior,br BRA,GK,Bologna,it Serie A,36,1983,6.0,0,0,0,0,0,0,0,,0,0,0,0,0,0,2,3,Matches
571,Charles Costes,fr FRA,MF,Dijon,fr Ligue 1,17,2002,0.0,0,0,0,0,0,0,0,,0,0,0,0,0,0,0,0,Matches
572,Benoît Costil,fr FRA,GK,Bordeaux,fr Ligue 1,33,1987,38.0,1,1,1,0,0,1,3,33.3,2,1,0,1,1,2,17,0,Matches
573,Vladimír Coufal,cz CZE,DF,West Ham,eng Premier League,27,1992,33.9,73,36,50,15,8,52,89,58.4,37,41,7,34,41,114,102,1,Matches
574,Kalifa Coulibaly,ml MLI,FW,Nantes,fr Ligue 1,28,1991,10.9,3,1,0,1,2,2,8,25.0,6,3,1,2,2,5,12,0,Matches
575,Lassana Coulibaly,ml MLI,MF,Angers,fr Ligue 1,24,1996,18.7,78,41,33,34,11,39,75,52.0,36,29,4,25,33,111,17,0,Matches
576,Mamadou Coulibaly,sn SEN,MF,Udinese,it Serie A,21,1999,2.0,10,8,5,5,0,0,0,,0,2,0,2,1,11,0,0,Matches
577,Senou Coulibaly,ml MLI,DF,Dijon,fr Ligue 1,25,1994,21.5,33,21,23,10,0,12,24,50.0,12,18,12,6,30,63,89,0,Matches
578,Tanguy Coulibaly,fr FRA,"DF,FW",Stuttgart,de Bundesliga,19,2001,16.7,26,15,10,7,9,11,23,47.8,12,20,0,20,10,36,11,0,Matches
579,Thibaut Courtois,be BEL,GK,Real Madrid,es La Liga,28,1992,38.0,0,0,0,0,0,0,1,0.0,1,1,0,1,1,1,17,2,Matches
580,Philippe Coutinho,br BRA,"MF,FW",Barcelona,es La Liga,28,1992,7.3,8,6,2,5,1,3,9,33.3,6,7,0,7,2,10,1,0,Matches
581,Nicolas Cozza,fr FRA,DF,Montpellier,fr Ligue 1,21,1999,15.2,39,30,27,11,1,20,40,50.0,20,20,11,9,26,65,62,0,Matches
582,Alessio Cragno,it ITA,GK,Cagliari,it Serie A,26,1994,34.0,0,0,0,0,0,0,1,0.0,1,0,0,0,1,1,10,0,Matches
583,Gian Crespi,it ITA,GK,Crotone,it Serie A,19,2001,1.0,0,0,0,0,0,0,0,,0,0,0,0,0,0,0,0,Matches
584,Aaron Cresswell,eng ENG,DF,West Ham,eng Premier League,30,1989,35.2,32,13,15,15,2,18,32,56.3,14,29,14,15,32,64,79,2,Matches
585,Domenico Criscito,it ITA,DF,Genoa,it Serie A,33,1986,19.2,43,22,29,11,3,22,39,56.4,17,27,14,13,44,87,51,0,Matches
586,Bryan Cristante,it ITA,"DF,MF",Roma,it Serie A,25,1995,23.9,27,20,10,14,3,10,28,35.7,18,21,7,14,40,67,61,1,Matches
587,Giovanni Crociata,it ITA,DF,Crotone,it Serie A,22,1997,0.3,1,0,0,1,0,0,1,0.0,1,1,0,1,0,1,0,0,Matches
588,Juan Cruz Armada,es ESP,DF,Osasuna,es La Liga,28,1992,21.8,36,22,17,16,3,19,35,54.3,16,19,5,14,15,51,50,0,Matches
589,Juan Cuadrado,co COL,"DF,MF",Juventus,it Serie A,32,1988,24.2,43,25,22,15,6,29,60,48.3,31,16,2,14,43,86,22,2,Matches
590,Andrés Cubas,py PAR,MF,Nîmes,fr Ligue 1,24,1996,24.9,80,47,30,44,6,33,74,44.6,41,37,10,27,50,130,29,3,Matches
591,Sergio Cubero Ezcurra,es ESP,MF,Eibar,es La Liga,20,1999,0.0,0,0,0,0,0,0,0,,0,0,0,0,0,0,0,0,Matches
592,Cucho,co COL,"FW,MF",Getafe,es La Liga,21,1999,16.3,19,10,1,14,4,2,23,8.7,21,18,1,17,6,25,8,0,Matches
593,Marc Cucurella,es ESP,MF,Getafe,es La Liga,22,1998,36.0,64,51,19,40,5,25,66,37.9,41,45,4,41,40,104,27,0,Matches
594,Mickaël Cuisance,fr FRA,MF,Marseille,fr Ligue 1,20,1999,11.4,24,11,2,15,7,10,33,30.3,23,13,1,12,3,27,4,0,Matches
595,Mickaël Cuisance,fr FRA,FW,Bayern Munich,de Bundesliga,20,1999,0.2,0,0,0,0,0,0,0,,0,1,0,1,0,0,0,0,Matches
596,Matheus Cunha,br BRA,"FW,MF",Hertha BSC,de Bundesliga,21,1999,23.9,36,16,10,19,7,13,49,26.5,36,29,2,27,31,67,9,0,Matches
597,Giuseppe Cuomo,it ITA,DF,Crotone,it Serie A,22,1998,8.9,26,19,17,9,0,9,14,64.3,5,10,2,8,18,44,19,1,Matches
598,Patrick Cutrone,it ITA,FW,Wolves,eng Premier League,22,1998,0.3,0,0,0,0,0,0,0,,0,0,0,0,0,0,0,0,Matches
599,Patrick Cutrone,it ITA,FW,Fiorentina,it Serie A,22,1998,2.2,4,3,1,2,1,1,2,50.0,1,1,0,1,1,5,0,0,Matches
600,Patrick Cutrone,it ITA,FW,Valencia,es La Liga,22,1998,1.2,0,0,0,0,0,0,1,0.0,1,0,0,0,1,1,0,0,Matches
601,Wylan Cyprien,fr FRA,MF,Parma,it Serie A,25,1995,4.6,9,4,5,3,1,2,4,50.0,2,13,8,5,5,14,6,1,Matches
602,Rafael Czichos,de GER,DF,Köln,de Bundesliga,30,1990,25.1,48,24,33,13,2,23,42,54.8,19,25,9,16,53,101,109,0,Matches
603,Lennart-Marten Czyborra,de GER,DF,Genoa,it Serie A,21,1999,13.0,19,10,7,7,5,11,19,57.9,8,6,1,5,17,36,27,0,Matches
604,Danilo D'Ambrosio,it ITA,DF,Inter,it Serie A,31,1988,7.8,15,9,6,7,2,6,15,40.0,9,9,7,2,4,19,15,0,Matches
605,Damien Da Silva,fr FRA,DF,Rennes,fr Ligue 1,32,1988,29.6,22,13,13,8,1,12,18,66.7,6,17,13,4,44,66,99,1,Matches
606,Moanes Dabbur,il ISR,"FW,MF",Hoffenheim,de Bundesliga,28,1992,11.1,6,3,3,1,2,1,13,7.7,12,6,0,6,9,15,7,0,Matches
607,Bryan Dabo,bf BFA,MF,Benevento,it Serie A,28,1992,12.4,11,8,5,3,3,5,16,31.3,11,7,1,6,13,24,16,0,Matches
608,Colin Dagba,fr FRA,DF,Paris S-G,fr Ligue 1,21,1998,15.1,23,11,4,17,2,14,19,73.7,5,18,5,13,16,39,18,1,Matches
609,Finn Dahmen,de GER,GK,Mainz 05,de Bundesliga,22,1998,3.0,0,0,0,0,0,0,1,0.0,1,0,0,0,0,0,1,0,Matches
610,Mahmoud Dahoud,de GER,MF,Dortmund,de Bundesliga,24,1996,14.0,30,18,9,20,1,14,38,36.8,24,23,5,18,18,48,11,1,Matches
611,Leon Dajaku,de GER,FW,Union Berlin,de Bundesliga,19,2001,0.4,0,0,0,0,0,0,0,,0,0,0,0,0,0,0,0,Matches
612,Stuart Dallas,nir NIR,"MF,DF",Leeds United,eng Premier League,29,1991,37.9,74,45,46,22,6,30,88,34.1,58,41,3,38,44,118,52,1,Matches
613,Diogo Dalot,pt POR,DF,Milan,it Serie A,21,1999,12.1,32,17,23,6,3,17,34,50.0,17,18,5,13,25,57,42,0,Matches
614,Mikkel Damsgaard,dk DEN,"MF,FW",Sampdoria,it Serie A,20,2000,19.7,42,21,14,20,8,22,70,31.4,48,40,4,36,24,66,17,0,Matches
615,Flavius Daniliuc,at AUT,DF,Nice,fr Ligue 1,19,2001,16.4,23,15,15,5,3,10,21,47.6,11,17,6,11,14,37,32,0,Matches
616,Danilo,br BRA,"DF,MF",Juventus,it Serie A,29,1991,32.4,62,31,37,16,9,35,66,53.0,31,32,12,20,66,128,68,2,Matches
617,Scott Dann,eng ENG,DF,Crystal Palace,eng Premier League,33,1987,15.0,6,4,5,1,0,4,11,36.4,7,16,14,2,18,24,59,1,Matches
618,Tiago Dantas,pt POR,MF,Bayern Munich,de Bundesliga,19,2000,0.8,1,1,0,0,1,0,0,,0,0,0,0,0,1,0,0,Matches
619,Dante,br BRA,DF,Nice,fr Ligue 1,36,1983,8.6,10,5,6,4,0,3,7,42.9,4,6,4,2,10,20,20,0,Matches
620,Andrea Danzi,it ITA,DF,Hellas Verona,it Serie A,21,1999,1.2,0,0,0,0,0,0,1,0.0,1,0,0,0,3,3,1,0,Matches
621,Ebrima Darboe,gm GAM,MF,Roma,it Serie A,19,2001,3.6,5,2,3,1,1,3,10,30.0,7,3,0,3,8,13,0,1,Matches
622,Márton Dárdai,hu HUN,"DF,MF",Hertha BSC,de Bundesliga,18,2002,9.1,17,10,10,6,1,9,16,56.3,7,7,3,4,16,33,31,0,Matches
623,Vladimír Darida,cz CZE,MF,Hertha BSC,de Bundesliga,29,1990,21.1,34,19,11,19,4,9,31,29.0,22,34,2,32,27,61,18,0,Matches
624,Karl Darlow,eng ENG,GK,Newcastle Utd,eng Premier League,29,1990,25.0,0,0,0,0,0,0,0,,0,0,0,0,0,0,17,0,Matches
625,Matteo Darmian,it ITA,DF,Parma,it Serie A,30,1989,2.3,6,5,3,3,0,4,7,57.1,3,2,0,2,6,12,7,0,Matches
626,Matteo Darmian,it ITA,DF,Inter,it Serie A,30,1989,12.9,30,16,12,7,11,16,28,57.1,12,9,2,7,17,47,35,0,Matches
627,Jonathan David,ca CAN,FW,Lille,fr Ligue 1,20,2000,26.2,17,10,5,5,7,9,24,37.5,15,19,1,18,3,20,9,0,Matches
628,Alphonso Davies,ca CAN,DF,Bayern Munich,de Bundesliga,19,2000,19.6,39,27,16,17,6,28,40,70.0,12,21,1,20,28,67,33,1,Matches
629,Ben Davies,wls WAL,DF,Tottenham,eng Premier League,27,1993,15.0,27,17,10,11,6,13,30,43.3,17,10,5,5,18,45,49,2,Matches
630,Tom Davies,eng ENG,MF,Everton,eng Premier League,22,1998,15.8,31,18,17,12,2,16,39,41.0,23,15,9,6,34,65,21,2,Matches
631,Keinan Davis,eng ENG,"FW,MF",Aston Villa,eng Premier League,22,1998,3.1,2,1,1,0,1,0,1,0.0,1,1,0,1,0,2,2,0,Matches
632,Leif Davis,eng ENG,DF,Leeds United,eng Premier League,20,2000,0.4,0,0,0,0,0,0,3,0.0,3,1,0,1,1,1,0,0,Matches
633,Paweł Dawidowicz,pl POL,DF,Hellas Verona,it Serie A,25,1995,20.7,42,28,30,10,2,14,24,58.3,10,28,19,9,27,69,62,1,Matches
634,Craig Dawson,eng ENG,DF,West Ham,eng Premier League,30,1990,21.4,11,8,7,4,0,5,12,41.7,7,26,22,4,32,43,88,3,Matches
635,Kevin De Bruyne,be BEL,MF,Manchester City,eng Premier League,29,1991,22.2,34,21,6,18,10,13,48,27.1,35,26,1,25,9,43,10,0,Matches
636,Sebastien De Maio,fr FRA,DF,Udinese,it Serie A,33,1987,9.5,15,10,6,9,0,4,5,80.0,1,16,9,7,18,33,41,0,Matches
637,Rodrigo De Paul,ar ARG,MF,Udinese,it Serie A,26,1994,35.6,41,24,17,22,2,15,60,25.0,45,32,1,31,17,58,20,1,Matches
638,Mattia De Sciglio,it ITA,DF,Juventus,it Serie A,27,1992,0.3,0,0,0,0,0,0,0,,0,0,0,0,0,0,1,0,Matches
639,Mattia De Sciglio,it ITA,DF,Lyon,fr Ligue 1,27,1992,16.3,29,17,15,11,3,18,27,66.7,9,13,4,9,27,56,44,0,Matches
640,Lorenzo De Silvestri,it ITA,DF,Bologna,it Serie A,32,1988,23.8,34,24,18,13,3,16,37,43.2,21,37,10,27,30,64,62,3,Matches
641,Thibault De Smet,be BEL,DF,Reims,fr Ligue 1,22,1998,5.5,11,6,8,3,0,6,15,40.0,9,8,1,7,6,17,16,0,Matches
642,Lucas Deaux,fr FRA,"MF,DF",Nîmes,fr Ligue 1,31,1988,19.5,47,32,20,22,5,16,49,32.7,33,20,3,17,20,67,30,4,Matches
643,Mathieu Debuchy,fr FRA,DF,Saint-Étienne,fr Ligue 1,35,1985,23.4,58,33,37,17,4,40,62,64.5,22,27,9,18,45,103,61,0,Matches
644,Grégoire Defrel,mq MTQ,"MF,FW",Sassuolo,it Serie A,29,1991,14.8,13,8,5,5,3,5,13,38.5,8,9,0,9,7,20,5,0,Matches
645,Alessandro Deiola,it ITA,MF,Spezia,it Serie A,24,1995,4.0,6,3,2,3,1,5,13,38.5,8,3,1,2,3,9,1,0,Matches
646,Alessandro Deiola,it ITA,MF,Cagliari,it Serie A,24,1995,6.8,13,5,5,4,4,8,23,34.8,15,7,2,5,11,24,11,0,Matches
647,Romain Del Castillo,fr FRA,"MF,FW",Rennes,fr Ligue 1,24,1996,7.2,30,11,5,14,11,5,25,20.0,20,6,0,6,3,33,4,1,Matches
648,Lorenzo Del Pinto,it ITA,MF,Benevento,it Serie A,30,1990,0.1,0,0,0,0,0,0,2,0.0,2,0,0,0,0,0,0,0,Matches
649,Thomas Delaine,fr FRA,"DF,FW",Metz,fr Ligue 1,28,1992,19.8,32,18,19,11,2,20,35,57.1,15,22,5,17,24,56,30,1,Matches
650,Thomas Delaney,dk DEN,MF,Dortmund,de Bundesliga,28,1991,14.3,40,30,15,20,5,11,31,35.5,20,28,10,18,22,62,15,1,Matches
651,Liam Delap,eng ENG,FW,Manchester City,eng Premier League,17,2003,0.4,0,0,0,0,0,0,0,,0,0,0,0,0,0,0,0,Matches
652,Jonathan Delaplace,fr FRA,DF,Lorient,fr Ligue 1,34,1986,10.1,8,5,5,1,2,7,13,53.8,6,12,5,7,17,25,19,1,Matches
653,Sacha Delaye,fr FRA,MF,Montpellier,fr Ligue 1,18,2002,0.1,0,0,0,0,0,0,1,0.0,1,0,0,0,1,1,1,0,Matches
654,Cristian Dell'Orco,it ITA,DF,Spezia,it Serie A,26,1994,2.9,1,0,1,0,0,1,3,33.3,2,8,5,3,7,8,9,1,Matches
655,Andy Delort,dz ALG,FW,Montpellier,fr Ligue 1,28,1991,27.6,12,7,1,9,2,8,18,44.4,10,11,1,10,4,16,34,0,Matches
656,Fabian Delph,eng ENG,"MF,DF",Everton,eng Premier League,30,1989,3.0,5,2,3,2,0,1,3,33.3,2,2,0,2,4,9,8,1,Matches
657,Moussa Dembélé,fr FRA,FW,Atlético Madrid,es La Liga,24,1996,1.1,0,0,0,0,0,0,1,0.0,1,0,0,0,1,1,0,0,Matches
658,Moussa Dembélé,fr FRA,FW,Lyon,fr Ligue 1,24,1996,7.5,2,2,0,1,1,0,4,0.0,4,4,2,2,5,7,9,0,Matches
659,Ousmane Dembélé,fr FRA,FW,Barcelona,es La Liga,23,1997,19.7,14,9,4,9,1,6,17,35.3,11,10,0,10,9,23,3,1,Matches
660,Merih Demiral,tr TUR,DF,Juventus,it Serie A,22,1998,10.4,12,9,8,4,0,5,13,38.5,8,16,9,7,21,33,40,0,Matches
661,Kerem Demirbay,de GER,MF,Leverkusen,de Bundesliga,27,1993,19.4,46,31,15,26,5,19,38,50.0,19,21,4,17,8,54,6,1,Matches
662,Ermedin Demirović,ba BIH,FW,Freiburg,de Bundesliga,22,1998,16.6,15,9,4,6,5,2,16,12.5,14,29,5,24,0,15,27,0,Matches
663,Diego Demme,de GER,MF,Napoli,it Serie A,28,1991,17.7,56,32,26,22,8,23,63,36.5,40,14,1,13,11,67,15,1,Matches
664,Jason Denayer,be BEL,DF,Lyon,fr Ligue 1,25,1995,29.0,25,16,16,9,0,6,13,46.2,7,36,25,11,27,52,91,1,Matches
665,Leander Dendoncker,be BEL,"MF,DF",Wolves,eng Premier League,25,1995,27.8,54,29,29,22,3,31,60,51.7,29,38,15,23,27,81,52,2,Matches
666,Kévin Denkey,tg TOG,FW,Nîmes,fr Ligue 1,19,2000,5.8,4,2,0,3,1,0,3,0.0,3,2,0,2,1,5,2,0,Matches
667,Emmanuel Dennis,ng NGA,FW,Köln,de Bundesliga,22,1997,5.3,13,7,6,5,2,1,6,16.7,5,6,0,6,0,13,0,1,Matches
668,Stefano Denswil,sr SUR,DF,Bologna,it Serie A,27,1993,1.3,2,1,1,1,0,0,1,0.0,1,1,0,1,1,3,1,0,Matches
669,Fabio Depaoli,it ITA,DF,Benevento,it Serie A,23,1997,12.4,25,13,15,6,4,15,32,46.9,17,16,4,12,12,37,38,0,Matches
670,Fabio Depaoli,it ITA,MF,Sampdoria,it Serie A,23,1997,0.9,1,0,0,1,0,0,2,0.0,2,0,0,0,1,2,1,0,Matches
671,Fabio Depaoli,it ITA,DF,Atalanta,it Serie A,23,1997,2.1,3,2,0,1,2,1,2,50.0,1,4,0,4,3,6,2,0,Matches
672,Clément Depres,fr FRA,FW,Nîmes,fr Ligue 1,25,1994,0.2,0,0,0,0,0,0,0,,0,0,0,0,0,0,0,0,Matches
673,Mike van der Hoorn,nl NED,DF,Arminia,de Bundesliga,27,1992,15.1,8,4,3,5,0,1,3,33.3,2,12,8,4,27,35,73,0,Matches
674,Kastriot Dermaku,al ALB,"DF,MF",Parma,it Serie A,28,1992,1.1,1,1,1,0,0,0,0,,0,2,1,1,2,3,8,0,Matches
675,Kiril Despodov,bg BUL,FW,Cagliari,it Serie A,23,1996,0.1,1,1,0,1,0,1,1,100.0,0,0,0,0,0,1,0,0,Matches
676,Sergiño Dest,us USA,"DF,FW",Barcelona,es La Liga,19,2000,21.2,31,16,23,6,2,18,32,56.3,14,25,4,21,10,41,24,1,Matches
677,Mattia Destro,it ITA,FW,Genoa,it Serie A,29,1991,17.8,6,3,0,3,3,2,9,22.2,7,11,0,11,4,10,8,0,Matches
678,Gerard Deulofeu,es ESP,"FW,MF",Udinese,it Serie A,26,1994,6.6,2,2,1,1,0,2,12,16.7,10,2,0,2,3,5,0,0,Matches
679,Deyverson,br BRA,FW,Alavés,es La Liga,29,1991,9.7,6,4,3,1,2,2,13,15.4,11,9,0,9,9,15,13,0,Matches
680,Jacopo Dezi,it ITA,"FW,MF",Parma,it Serie A,28,1992,0.9,4,3,0,2,2,3,6,50.0,3,2,0,2,0,4,0,0,Matches
681,Samuel Di Carmine,it ITA,FW,Hellas Verona,it Serie A,31,1988,5.6,1,2,0,1,0,0,3,0.0,3,1,0,1,0,1,5,0,Matches
682,Samuel Di Carmine,it ITA,FW,Crotone,it Serie A,31,1988,5.3,2,2,1,0,1,1,3,33.3,2,2,0,2,0,2,5,0,Matches
683,Giovanni Di Lorenzo,it ITA,DF,Napoli,it Serie A,26,1993,36.0,79,50,54,21,4,43,75,57.3,32,37,13,24,35,114,64,1,Matches
684,Ángel Di María,ar ARG,"FW,MF",Paris S-G,fr Ligue 1,32,1988,20.6,26,17,6,8,12,11,45,24.4,34,14,1,13,6,32,7,0,Matches
685,Alessandro Di Pardo,it ITA,"FW,DF",Juventus,it Serie A,21,1999,0.2,0,0,0,0,0,0,0,,0,1,1,0,0,0,0,0,Matches
686,Giuseppe Di Serio,it ITA,"FW,MF",Benevento,it Serie A,19,2001,3.2,2,2,1,1,0,0,4,0.0,4,5,0,5,0,2,4,0,Matches
687,Boulaye Dia,sn SEN,"FW,MF",Reims,fr Ligue 1,23,1996,32.6,23,12,3,11,9,4,22,18.2,18,19,5,14,12,35,37,1,Matches
688,Abdoulay Diaby,ml MLI,DF,Getafe,es La Liga,29,1991,0.2,2,0,0,2,0,0,0,,0,2,0,2,0,2,0,0,Matches
689,Moussa Diaby,fr FRA,"FW,MF",Leverkusen,de Bundesliga,21,1999,26.5,10,6,4,5,1,6,20,30.0,14,11,0,11,12,22,5,0,Matches
690,Mbaye Diagne,sn SEN,FW,West Brom,eng Premier League,28,1991,13.2,4,3,3,0,1,1,4,25.0,3,2,1,1,1,5,16,0,Matches
691,Mouctar Diakhaby,gn GUI,DF,Valencia,es La Liga,23,1996,23.1,16,8,10,6,0,8,12,66.7,4,28,21,7,27,43,102,1,Matches
692,Abdou Diallo,sn SEN,DF,Paris S-G,fr Ligue 1,24,1996,16.6,16,11,9,5,2,8,13,61.5,5,15,8,7,25,41,36,0,Matches
693,Amad Diallo,ci CIV,FW,Manchester Utd,eng Premier League,18,2002,1.8,3,3,1,2,0,0,0,,0,2,1,1,0,3,1,0,Matches
694,Amad Diallo,ci CIV,MF,Atalanta,it Serie A,18,2002,0.2,0,0,0,0,0,0,0,,0,0,0,0,0,0,0,0,Matches
695,Habib Diallo,sn SEN,FW,Strasbourg,fr Ligue 1,25,1995,25.8,11,6,3,6,2,7,18,38.9,11,12,2,10,13,24,12,0,Matches
696,Habib Diallo,sn SEN,"FW,MF",Metz,fr Ligue 1,25,1995,1.6,1,1,0,1,0,1,1,100.0,0,0,0,0,0,1,5,0,Matches
697,Ibrahima Diallo,fr FRA,MF,Southampton,eng Premier League,21,1999,11.3,29,16,11,17,1,9,16,56.3,7,10,1,9,10,39,12,2,Matches
698,Ibrahima Diallo,fr FRA,MF,Brest,fr Ligue 1,21,1999,4.9,14,9,2,9,3,4,8,50.0,4,4,0,4,3,17,3,0,Matches
699,Amadou Diambo,gh GHA,FW,Benevento,it Serie A,19,2001,0.0,0,0,0,0,0,0,0,,0,0,0,0,0,0,0,0,Matches
700,Grady Diangana,cd COD,"MF,FW",West Brom,eng Premier League,22,1998,13.7,35,19,19,9,7,19,43,44.2,24,16,2,14,16,51,9,0,Matches
701,Stéphane Diarra,fr FRA,"MF,FW",Lorient,fr Ligue 1,21,1998,2.2,0,0,0,0,0,0,7,0.0,7,6,1,5,4,4,1,0,Matches
702,Rúben Dias,pt POR,DF,Manchester City,eng Premier League,23,1997,31.6,24,13,13,8,3,4,16,25.0,12,31,23,8,35,59,92,0,Matches
703,Krépin Diatta,sn SEN,"MF,DF",Monaco,fr Ligue 1,21,1999,4.3,4,3,1,1,2,1,3,33.3,2,5,1,4,4,8,1,0,Matches
704,Amadou Diawara,gn GUI,MF,Roma,it Serie A,23,1997,7.3,10,8,4,6,0,2,8,25.0,6,11,2,9,12,22,4,0,Matches
705,Brahim Díaz,ma MAR,"MF,FW",Milan,it Serie A,20,1999,13.6,18,10,7,7,4,10,23,43.5,13,10,0,10,2,20,2,0,Matches
706,Víctor Díaz,es ESP,DF,Granada,es La Liga,32,1988,9.2,21,10,13,6,2,10,19,52.6,9,14,8,6,16,37,39,0,Matches
707,Daniel Didavi,de GER,"MF,FW",Stuttgart,de Bundesliga,30,1990,10.8,16,6,2,9,5,7,12,58.3,5,10,0,10,3,19,8,0,Matches
708,Bamba Dieng,sn SEN,"FW,DF",Marseille,fr Ligue 1,20,2000,1.4,5,3,3,2,0,2,4,50.0,2,2,0,2,0,5,0,0,Matches
709,Eric Dier,eng ENG,DF,Tottenham,eng Premier League,26,1994,28.0,23,14,13,10,0,11,18,61.1,7,37,31,6,23,46,123,3,Matches
710,Daan Dierckx,be BEL,DF,Parma,it Serie A,17,2003,5.2,5,4,5,0,0,3,5,60.0,2,10,6,4,13,18,21,0,Matches
711,Lucas Digne,fr FRA,"DF,MF",Everton,eng Premier League,27,1993,29.8,63,38,40,16,7,29,54,53.7,25,42,4,38,31,94,87,0,Matches
712,Mitchell Dijks,nl NED,DF,Bologna,it Serie A,27,1993,16.5,21,14,15,5,1,12,21,57.1,9,17,2,15,17,38,35,0,Matches
713,Javairô Dilrosun,nl NED,"FW,MF",Hertha BSC,de Bundesliga,22,1998,5.9,5,3,2,2,1,1,6,16.7,5,5,0,5,4,9,3,0,Matches
714,Federico Dimarco,it ITA,DF,Hellas Verona,it Serie A,22,1997,29.0,32,19,23,7,2,13,28,46.4,15,18,9,9,47,79,50,1,Matches
715,Junior Dina Ebimbe,fr FRA,"FW,MF",Dijon,fr Ligue 1,19,2000,23.8,38,25,14,19,5,15,45,33.3,30,17,1,16,14,52,9,0,Matches
716,Tristan Dingomé,cm CMR,MF,Reims,fr Ligue 1,29,1991,0.2,0,0,0,0,0,0,1,0.0,1,0,0,0,0,0,0,0,Matches
717,Eren Dinkçi,de GER,"MF,FW",Werder Bremen,de Bundesliga,18,2001,1.2,1,1,1,0,0,0,1,0.0,1,4,0,4,2,3,1,0,Matches
718,Sinaly Diomande,ci CIV,DF,Lyon,fr Ligue 1,19,2001,12.6,10,7,8,1,1,5,14,35.7,9,19,15,4,33,43,53,1,Matches
719,Lois Diony,fr FRA,FW,Angers,fr Ligue 1,27,1992,19.4,15,10,3,9,3,4,18,22.2,14,6,3,3,5,20,16,0,Matches
720,Issa Diop,fr FRA,DF,West Ham,eng Premier League,23,1997,15.3,20,14,12,8,0,7,18,38.9,11,32,22,10,22,42,59,0,Matches
721,Papakouli Diop,sn SEN,MF,Eibar,es La Liga,34,1986,25.8,43,29,15,22,6,12,41,29.3,29,23,5,18,39,82,34,1,Matches
722,Sofiane Diop,fr FRA,"MF,FW",Monaco,fr Ligue 1,20,2000,22.5,49,34,17,25,7,18,53,34.0,35,25,1,24,31,80,15,0,Matches
723,Andy Diouf,fr FRA,FW,Rennes,fr Ligue 1,17,2003,0.1,0,0,0,0,0,0,0,,0,0,0,0,0,0,0,0,Matches
724,Yehvann Diouf,fr FRA,GK,Reims,fr Ligue 1,20,1999,1.5,0,0,0,0,0,0,0,,0,0,0,0,0,0,0,0,Matches
725,Assane Dioussé,sn SEN,DF,Saint-Étienne,fr Ligue 1,22,1997,0.0,0,0,0,0,0,0,0,,0,0,0,0,0,0,0,0,Matches
726,Jonas Dirkner,de GER,MF,Hertha BSC,de Bundesliga,18,2002,0.2,0,0,0,0,0,0,0,,0,0,0,0,0,0,0,0,Matches
727,Axel Disasi,fr FRA,DF,Monaco,fr Ligue 1,22,1998,22.3,29,20,17,12,0,20,35,57.1,15,18,11,7,26,55,66,1,Matches
728,Tiago Djaló,pt POR,DF,Lille,fr Ligue 1,20,2000,9.7,22,13,14,5,3,15,23,65.2,8,10,4,6,9,31,23,0,Matches
729,Djené,tg TOG,DF,Getafe,es La Liga,28,1991,32.7,61,39,31,26,4,26,34,76.5,8,24,11,13,42,103,96,0,Matches
730,Moussa Djenepo,ml MLI,MF,Southampton,eng Premier League,22,1998,13.8,52,27,27,17,8,28,63,44.4,35,24,2,22,10,62,14,0,Matches
731,Koffi Djidji,ci CIV,DF,Crotone,it Serie A,27,1992,16.9,39,28,30,8,1,10,20,50.0,10,35,20,15,28,67,73,0,Matches
732,Alexander Djiku,gh GHA,"DF,MF",Strasbourg,fr Ligue 1,25,1994,28.4,60,41,45,13,2,32,52,61.5,20,28,10,18,91,151,104,0,Matches
733,Berat Djimsiti,al ALB,DF,Atalanta,it Serie A,27,1993,29.2,41,29,27,12,2,17,34,50.0,17,34,20,14,62,103,89,1,Matches
734,Marko Dmitrović,rs SRB,GK,Eibar,es La Liga,28,1992,34.7,4,3,4,0,0,2,4,50.0,2,0,0,0,0,4,16,2,Matches
735,Ritsu Doan,jp JPN,"MF,FW",Arminia,de Bundesliga,22,1998,30.8,53,31,22,19,12,19,52,36.5,33,42,1,41,31,84,11,0,Matches
736,Mihai Dobre,ro ROU,FW,Dijon,fr Ligue 1,21,1998,5.9,12,5,6,2,4,7,14,50.0,7,5,0,5,10,22,3,0,Matches
737,Matt Doherty,ie IRL,DF,Tottenham,eng Premier League,28,1992,13.8,29,15,15,10,4,13,33,39.4,20,20,5,15,23,52,46,0,Matches
738,Jeremy Doku,be BEL,"MF,FW",Rennes,fr Ligue 1,18,2002,25.7,44,25,9,24,11,11,26,42.3,15,18,1,17,11,55,1,0,Matches
739,Kasper Dolberg,dk DEN,FW,Nice,fr Ligue 1,22,1997,21.4,6,2,1,3,2,2,11,18.2,9,11,2,9,6,12,19,1,Matches
740,Keagan Dolly,za RSA,MF,Montpellier,fr Ligue 1,27,1993,5.0,7,2,6,0,1,4,8,50.0,4,3,0,3,5,12,2,0,Matches
741,Jaume Doménech,es ESP,GK,Valencia,es La Liga,29,1990,28.0,1,1,1,0,0,1,2,50.0,1,1,0,1,0,1,16,2,Matches
742,Carlos Dominguez,es ESP,DF,Celta Vigo,es La Liga,19,2001,4.0,5,4,4,1,0,3,6,50.0,3,5,3,2,6,11,24,0,Matches
743,Nicolás Domínguez,ar ARG,MF,Bologna,it Serie A,22,1998,13.9,48,28,26,17,5,15,37,40.5,22,26,7,19,24,72,20,0,Matches
744,John Donald,es ESP,"DF,MF",Elche,es La Liga,19,2000,0.6,0,0,0,0,0,0,0,,0,0,0,0,0,0,1,0,Matches
745,Ji Dong-won,kr KOR,FW,Mainz 05,de Bundesliga,29,1991,0.7,1,1,1,0,0,0,0,,0,1,0,1,2,3,0,0,Matches
746,Anastasios Donis,gr GRE,MF,Reims,fr Ligue 1,23,1996,1.1,4,1,2,0,2,1,1,100.0,0,0,0,0,0,4,0,0,Matches
747,Gianluigi Donnarumma,it ITA,GK,Milan,it Serie A,21,1999,37.0,0,0,0,0,0,0,1,0.0,1,1,0,1,1,1,23,2,Matches
748,Bas Dost,nl NED,FW,Eint Frankfurt,de Bundesliga,31,1989,9.1,3,2,1,1,1,2,5,40.0,3,5,1,4,2,5,8,0,Matches
749,Abdoulaye Doucouré,ml MLI,MF,Everton,eng Premier League,27,1993,27.1,52,32,25,19,8,14,43,32.6,29,24,7,17,39,91,31,1,Matches
750,Cheick Doucouré,ml MLI,MF,Lens,fr Ligue 1,20,2000,29.2,87,47,40,42,5,32,65,49.2,33,20,4,16,52,139,26,1,Matches
751,Fodé Doucouré,ml MLI,DF,Reims,fr Ligue 1,19,2001,3.7,11,8,7,4,0,4,9,44.4,5,2,0,2,4,15,11,0,Matches
752,Mahamadou Doucouré,ml MLI,"FW,MF",Nîmes,fr Ligue 1,20,2000,0.5,1,1,1,0,0,1,1,100.0,0,0,0,0,0,1,0,0,Matches
753,Cheick Doukouré,ci CIV,"MF,FW",Levante,es La Liga,27,1992,1.1,5,4,2,1,2,3,4,75.0,1,2,0,2,3,8,0,0,Matches
754,Idrissa Doumbia,ci CIV,MF,Huesca,es La Liga,22,1998,8.7,15,8,6,7,2,5,13,38.5,8,6,3,3,7,22,9,0,Matches
755,Moussa Doumbia,ml MLI,"MF,FW",Reims,fr Ligue 1,25,1994,10.0,10,6,4,4,2,4,22,18.2,18,5,1,4,10,20,4,0,Matches
756,Souleyman Doumbia,ci CIV,DF,Angers,fr Ligue 1,23,1996,24.7,48,33,25,19,4,22,36,61.1,14,18,4,14,42,90,50,0,Matches
757,Aleksandar Dragović,at AUT,DF,Leverkusen,de Bundesliga,29,1991,12.6,11,7,5,5,1,9,13,69.2,4,17,5,12,13,24,33,0,Matches
758,Bartłomiej Drągowski,pl POL,GK,Fiorentina,it Serie A,22,1997,35.0,1,0,1,0,0,1,1,100.0,0,0,0,0,1,2,13,1,Matches
759,Denis Drăguș,ro ROU,"FW,MF",Crotone,it Serie A,21,1999,2.0,3,1,0,0,3,0,4,0.0,4,4,0,4,1,4,0,0,Matches
760,Radu Drăgușin,ro ROU,DF,Juventus,it Serie A,18,2002,0.0,0,0,0,0,0,0,0,,0,0,0,0,0,0,0,0,Matches
761,Mouhamadou Drammeh,fr FRA,MF,Reims,fr Ligue 1,21,1999,1.9,0,0,0,0,0,0,2,0.0,2,0,0,0,2,2,7,0,Matches
762,Julian Draxler,de GER,"MF,FW",Paris S-G,fr Ligue 1,26,1993,11.8,13,6,5,6,2,5,20,25.0,15,4,0,4,14,27,0,0,Matches
763,Dominick Drexler,de GER,"MF,FW",Köln,de Bundesliga,30,1990,13.7,36,26,15,18,3,12,30,40.0,18,5,1,4,14,50,15,0,Matches
764,Matthieu Dreyer,fr FRA,GK,Lorient,fr Ligue 1,31,1989,15.0,0,0,0,0,0,0,0,,0,0,0,0,0,0,4,2,Matches
765,Domingos Duarte,pt POR,DF,Granada,es La Liga,25,1995,26.3,32,20,18,12,2,14,21,66.7,7,29,20,9,29,61,86,0,Matches
766,Léo Duarte,br BRA,DF,Milan,it Serie A,24,1996,0.2,1,1,0,1,0,0,0,,0,0,0,0,1,2,0,0,Matches
767,Óscar Duarte,cr CRC,DF,Levante,es La Liga,31,1989,22.9,22,13,17,5,0,10,18,55.6,8,23,15,8,36,58,97,1,Matches
768,Rubén Duarte,es ESP,DF,Alavés,es La Liga,24,1995,28.3,55,30,28,21,6,23,52,44.2,29,44,6,38,66,121,72,0,Matches
769,Leo Dubois,fr FRA,DF,Lyon,fr Ligue 1,25,1994,32.3,38,26,19,16,3,18,36,50.0,18,27,9,18,31,69,69,2,Matches
770,Martin Dúbravka,sk SVK,GK,Newcastle Utd,eng Premier League,31,1989,13.0,0,0,0,0,0,0,0,,0,0,0,0,0,0,3,0,Matches
771,Ondrej Duda,sk SVK,"FW,MF",Köln,de Bundesliga,25,1994,28.2,36,14,13,18,5,8,39,20.5,31,28,2,26,19,55,20,0,Matches
772,Unai Dufur,es ESP,DF,Eibar,es La Liga,21,1999,0.7,2,2,2,0,0,2,4,50.0,2,0,0,0,1,3,0,0,Matches
773,Haris Duljević,ba BIH,"MF,FW",Nîmes,fr Ligue 1,26,1993,8.6,15,9,4,7,4,6,22,27.3,16,3,0,3,8,23,1,0,Matches
774,Paul Dummett,wls WAL,DF,Newcastle Utd,eng Premier League,28,1991,13.9,16,7,11,5,0,13,21,61.9,8,12,7,5,16,32,74,0,Matches
775,Alfred Duncan,gh GHA,MF,Fiorentina,it Serie A,27,1993,1.8,3,0,1,1,1,0,2,0.0,2,2,0,2,2,5,0,0,Matches
776,Alfred Duncan,gh GHA,MF,Cagliari,it Serie A,27,1993,11.9,18,10,8,9,1,4,21,19.0,17,8,0,8,16,34,8,1,Matches
777,Lewis Dunk,eng ENG,DF,Brighton,eng Premier League,28,1991,32.6,30,15,20,8,2,16,23,69.6,7,29,20,9,32,62,106,0,Matches
778,Jimmy Dunne,ie IRL,DF,Burnley,eng Premier League,22,1997,3.0,3,3,2,1,0,1,2,50.0,1,3,2,1,6,9,16,1,Matches
779,Erik Durm,de GER,DF,Eint Frankfurt,de Bundesliga,28,1992,16.4,17,13,7,9,1,8,21,38.1,13,19,5,14,29,46,26,0,Matches
780,Hugo Duro,es ESP,FW,Real Madrid,es La Liga,20,1999,0.6,0,0,0,0,0,0,0,,0,1,0,1,0,0,0,0,Matches
781,Jean-Kevin Duverne,ht HAI,DF,Brest,fr Ligue 1,23,1997,22.5,38,21,24,14,0,15,32,46.9,17,24,16,8,30,68,70,0,Matches
782,Paulo Dybala,ar ARG,FW,Juventus,it Serie A,26,1993,12.6,14,8,3,4,7,2,14,14.3,12,15,0,15,1,15,1,0,Matches
783,Edin Džeko,ba BIH,FW,Roma,it Serie A,34,1986,20.3,8,6,2,3,3,3,9,33.3,6,9,4,5,1,9,11,0,Matches
784,Steeve-Mike Ebongue,fr FRA,MF,Genoa,it Serie A,19,2001,0.6,2,1,1,0,1,0,3,0.0,3,1,0,1,0,2,0,0,Matches
785,Enzo Ebosse,cm CMR,DF,Angers,fr Ligue 1,21,1999,2.9,5,3,5,0,0,3,4,75.0,1,1,1,0,2,7,13,0,Matches
786,Bruno Ecuele Manga,ga GAB,DF,Dijon,fr Ligue 1,32,1988,38.0,52,38,46,6,0,29,40,72.5,11,50,33,17,57,109,165,3,Matches
787,Simone Edera,it ITA,"DF,MF",Torino,it Serie A,23,1997,0.6,3,1,2,1,0,3,4,75.0,1,0,0,0,1,4,1,0,Matches
788,Ederson,br BRA,GK,Manchester City,eng Premier League,26,1993,36.0,3,1,3,0,0,3,4,75.0,1,0,0,0,0,3,11,4,Matches
789,Kyle Edwards,eng ENG,"MF,FW",West Brom,eng Premier League,22,1998,1.3,3,2,1,1,1,0,0,,0,2,0,2,1,4,0,0,Matches
790,John Egan,ie IRL,DF,Sheffield Utd,eng Premier League,27,1992,29.2,41,21,29,12,0,22,39,56.4,17,43,31,12,41,82,131,0,Matches
791,Johannes Eggestein,de GER,"FW,MF",Werder Bremen,de Bundesliga,22,1998,0.4,0,0,0,0,0,0,1,0.0,1,0,0,0,1,1,2,0,Matches
792,Maximilian Eggestein,de GER,MF,Werder Bremen,de Bundesliga,23,1996,32.7,57,42,22,29,6,21,46,45.7,25,30,5,25,43,100,36,0,Matches
793,Lilian Egloff,de GER,MF,Stuttgart,de Bundesliga,17,2002,0.2,0,0,0,0,0,0,0,,0,0,0,0,0,0,0,0,Matches
794,Kingsley Ehizibue,nl NED,DF,Köln,de Bundesliga,25,1995,12.6,32,19,22,9,1,10,17,58.8,7,19,5,14,18,50,42,0,Matches
795,Albin Ekdal,se SWE,MF,Sampdoria,it Serie A,31,1989,25.5,56,29,21,32,3,23,65,35.4,42,31,12,19,49,105,35,0,Matches
796,Hugo Ekitike,fr FRA,"FW,MF",Reims,fr Ligue 1,18,2002,1.0,1,1,0,0,1,0,1,0.0,1,0,0,0,0,1,0,0,Matches
797,Anthony Elanga,se SWE,FW,Manchester Utd,eng Premier League,18,2002,1.7,4,2,3,1,0,4,5,80.0,1,1,1,0,1,5,1,0,Matches
798,Niclas Eliasson,se SWE,"MF,FW",Nîmes,fr Ligue 1,24,1995,20.0,28,14,9,12,7,11,24,45.8,13,20,1,19,23,51,16,0,Matches
799,Elif Elmas,mk MKD,"MF,FW",Napoli,it Serie A,20,1999,8.2,15,4,3,6,6,7,12,58.3,5,11,1,10,2,17,10,0,Matches
800,Ahmed Elmohamady,eg EGY,DF,Aston Villa,eng Premier League,32,1987,9.3,17,13,12,4,1,9,14,64.3,5,6,3,3,17,34,26,0,Matches
801,Mohamed Elneny,eg EGY,MF,Arsenal,eng Premier League,28,1992,17.2,14,6,7,7,0,7,28,25.0,21,11,4,7,24,38,20,2,Matches
802,Aritz Elustondo,es ESP,DF,Real Sociedad,es La Liga,26,1994,20.9,30,16,21,7,2,18,22,81.8,4,12,5,7,15,45,63,0,Matches
803,Nico Elvedi,ch SUI,DF,Gladbach,de Bundesliga,23,1996,28.2,49,35,36,12,1,25,37,67.6,12,38,22,16,65,114,123,0,Matches
804,Rodrigo Ely,br BRA,DF,Alavés,es La Liga,26,1993,5.2,5,2,3,2,0,3,4,75.0,1,2,1,1,7,12,23,1,Matches
805,Breel Embolo,ch SUI,"FW,MF",Gladbach,de Bundesliga,23,1997,16.0,15,10,1,13,1,0,6,0.0,6,16,1,15,8,23,8,0,Matches
806,Emerson,br BRA,DF,Betis,es La Liga,21,1999,33.2,91,52,62,25,4,43,78,55.1,35,33,6,27,61,152,102,2,Matches
807,Renaud Emond,be BEL,"FW,MF",Nantes,fr Ligue 1,28,1991,3.9,0,0,0,0,0,0,1,0.0,1,2,0,2,0,0,1,0,Matches
808,Alan Empereur,br BRA,DF,Hellas Verona,it Serie A,26,1994,2.4,0,0,0,0,0,0,0,,0,1,1,0,6,6,7,1,Matches
809,Youssef En-Nesyri,ma MAR,FW,Sevilla,es La Liga,23,1997,25.7,17,11,2,9,6,4,21,19.0,17,15,0,15,8,25,23,0,Matches
810,Keita Endo,jp JPN,"MF,FW",Union Berlin,de Bundesliga,22,1997,5.1,8,3,1,5,2,3,9,33.3,6,5,2,3,6,14,4,0,Matches
811,Wataru Endo,jp JPN,MF,Stuttgart,de Bundesliga,27,1993,32.8,65,44,25,34,6,29,71,40.8,42,53,14,39,51,116,59,0,Matches
812,Sergi Enrich,es ESP,FW,Eibar,es La Liga,30,1990,15.6,21,15,6,7,8,9,22,40.9,13,11,0,11,6,27,5,0,Matches
813,Christian Eriksen,dk DEN,MF,Inter,it Serie A,28,1992,15.4,12,6,6,4,2,7,20,35.0,13,16,1,15,9,21,13,1,Matches
814,Martin Erlic,hr CRO,DF,Spezia,it Serie A,22,1998,20.0,23,14,16,6,1,11,20,55.0,9,22,16,6,41,64,71,2,Matches
815,Patrick Erras,de GER,"FW,MF",Werder Bremen,de Bundesliga,25,1995,0.3,0,0,0,0,0,0,1,0.0,1,0,0,0,0,0,0,0,Matches
816,Gonzalo Escalante,ar ARG,MF,Lazio,it Serie A,27,1993,8.1,26,13,11,14,1,8,28,28.6,20,10,3,7,19,45,13,0,Matches
817,Aarón Escandell,es ESP,GK,Granada,es La Liga,24,1995,5.0,1,1,1,0,0,1,1,100.0,0,0,0,0,0,1,6,0,Matches
818,Dani Escriche,es ESP,"FW,MF",Huesca,es La Liga,22,1998,9.5,9,7,5,2,2,3,10,30.0,7,11,0,11,8,17,5,0,Matches
819,Sergio Escudero,es ESP,DF,Sevilla,es La Liga,30,1989,6.3,12,8,6,5,1,6,12,50.0,6,5,2,3,9,21,7,0,Matches
820,Alfonso Espino,uy URU,DF,Cádiz,es La Liga,28,1992,28.9,92,48,63,28,1,43,85,50.6,42,30,5,25,41,133,74,0,Matches
821,Vicente Esquerdo,es ESP,MF,Valencia,es La Liga,21,1999,2.6,7,4,5,2,0,4,6,66.7,2,4,2,2,8,15,1,0,Matches
822,Nahuel Estévez,ar ARG,MF,Spezia,it Serie A,24,1995,19.6,13,5,4,6,3,5,32,15.6,27,23,5,18,20,33,22,1,Matches
823,Pervis Estupiñán,ec ECU,DF,Villarreal,es La Liga,22,1998,13.0,37,17,23,12,2,14,23,60.9,9,10,2,8,35,72,14,2,Matches
824,Yoann Etienne,fr FRA,DF,Lorient,fr Ligue 1,23,1997,1.0,2,0,1,1,0,1,1,100.0,0,1,0,1,1,3,2,0,Matches
825,Xabier Etxeita,es ESP,DF,Getafe,es La Liga,32,1987,9.8,8,4,5,3,0,7,14,50.0,7,6,3,3,13,21,38,0,Matches
826,Jonny Evans,nir NIR,DF,Leicester City,eng Premier League,32,1988,27.5,25,12,22,2,1,14,20,70.0,6,8,3,5,46,71,98,1,Matches
827,Edu Expósito,es ESP,MF,Eibar,es La Liga,23,1996,27.3,51,30,16,31,4,20,66,30.3,46,25,4,21,22,73,17,0,Matches
828,Valentin Eysseric,fr FRA,"MF,FW",Fiorentina,it Serie A,28,1992,8.1,14,8,6,7,1,5,11,45.5,6,11,0,11,7,21,8,0,Matches
829,Eberechi Eze,eng ENG,MF,Crystal Palace,eng Premier League,22,1998,28.4,27,14,11,13,3,16,35,45.7,19,19,3,16,24,51,9,1,Matches
830,Jokin Ezkieta,es ESP,GK,Athletic Club,es La Liga,23,1996,1.0,0,0,0,0,0,0,0,,0,0,0,0,0,0,0,0,Matches
831,Łukasz Fabiański,pl POL,GK,West Ham,eng Premier League,35,1985,35.0,1,0,1,0,0,1,1,100.0,0,1,0,1,1,2,12,3,Matches
832,Fabinho,br BRA,"DF,MF",Liverpool,eng Premier League,26,1993,28.5,58,31,21,29,8,27,54,50.0,27,28,10,18,44,102,66,1,Matches
833,Fábio,br BRA,DF,Nantes,fr Ligue 1,30,1990,16.7,62,37,37,23,2,35,61,57.4,26,29,8,21,37,99,49,0,Matches
834,Cesc Fàbregas,es ESP,"MF,FW",Monaco,fr Ligue 1,33,1987,9.7,20,12,6,9,5,9,22,40.9,13,11,1,10,13,33,3,0,Matches
835,Bandiougou Fadiga,fr FRA,"FW,MF",Paris S-G,fr Ligue 1,19,2001,0.7,1,0,1,0,0,0,0,,0,0,0,0,0,1,0,0,Matches
836,Bandiougou Fadiga,fr FRA,"MF,FW",Brest,fr Ligue 1,19,2001,0.5,0,0,0,0,0,0,2,0.0,2,0,0,0,0,0,0,0,Matches
837,Wout Faes,be BEL,DF,Reims,fr Ligue 1,22,1998,32.2,35,22,26,9,0,20,39,51.3,19,40,31,9,68,103,144,1,Matches
838,Nicolò Fagioli,it ITA,MF,Juventus,it Serie A,19,2001,0.2,0,0,0,0,0,0,0,,0,0,0,0,0,0,1,0,Matches
839,Ralf Fährmann,de GER,GK,Schalke 04,de Bundesliga,31,1988,20.8,2,1,2,0,0,1,2,50.0,1,0,0,0,1,3,9,3,Matches
840,Romain Faivre,fr FRA,"MF,FW",Brest,fr Ligue 1,22,1998,32.1,54,27,26,23,5,21,54,38.9,33,30,0,30,30,84,18,0,Matches
841,Fali,es ESP,"DF,MF",Cádiz,es La Liga,26,1993,29.3,42,25,24,15,3,16,37,43.2,21,28,15,13,32,74,119,0,Matches
842,Iago Falque,es ESP,"MF,FW",Benevento,it Serie A,30,1990,4.0,4,2,2,2,0,1,6,16.7,5,4,1,3,0,4,1,0,Matches
843,Andri Fannar Baldursson,is ISL,MF,Bologna,it Serie A,18,2002,2.4,6,6,1,2,3,1,3,33.3,2,3,1,2,3,9,7,0,Matches
844,Paolo Faragò,it ITA,DF,Bologna,it Serie A,27,1993,0.3,1,1,1,0,0,1,2,50.0,1,1,0,1,0,1,0,0,Matches
845,Paolo Faragò,it ITA,DF,Cagliari,it Serie A,27,1993,4.1,13,9,10,3,0,9,20,45.0,11,3,2,1,6,19,15,0,Matches
846,Davide Faraoni,it ITA,DF,Hellas Verona,it Serie A,28,1991,32.1,62,33,36,19,7,28,51,54.9,23,48,17,31,49,111,83,1,Matches
847,Mohamed Fares,dz ALG,DF,Lazio,it Serie A,24,1996,12.7,20,15,9,7,4,11,19,57.9,8,14,1,13,16,36,21,0,Matches
848,Diego Farias,br BRA,FW,Spezia,it Serie A,30,1990,16.8,9,5,4,1,4,4,21,19.0,17,12,0,12,13,22,3,0,Matches
849,Wuilker Faríñez,ve VEN,GK,Lens,fr Ligue 1,22,1998,1.2,0,0,0,0,0,0,0,,0,0,0,0,0,0,1,0,Matches
850,Noah Fatar,fr FRA,"FW,MF",Angers,fr Ligue 1,18,2002,0.2,1,0,0,0,1,0,0,,0,0,0,0,0,1,0,0,Matches
851,Ansu Fati,es ESP,FW,Barcelona,es La Liga,17,2002,4.8,9,4,2,4,3,2,10,20.0,8,4,0,4,3,12,1,0,Matches
852,Julien Faussurier,fr FRA,DF,Brest,fr Ligue 1,33,1987,10.6,16,11,6,8,2,11,25,44.0,14,12,4,8,9,25,10,0,Matches
853,Andrea Favilli,it ITA,FW,Hellas Verona,it Serie A,23,1997,3.8,3,1,0,1,2,2,3,66.7,1,2,0,2,0,3,2,0,Matches
854,Federico Fazio,ar ARG,DF,Roma,it Serie A,33,1987,4.5,3,2,3,0,0,3,4,75.0,1,3,3,0,7,10,18,1,Matches
855,Nabil Fekir,fr FRA,"MF,FW",Betis,es La Liga,27,1993,29.1,45,23,9,22,14,7,43,16.3,36,31,2,29,8,53,2,0,Matches
856,Felipe,br BRA,DF,Atlético Madrid,es La Liga,31,1989,22.9,29,17,19,10,0,18,23,78.3,5,30,15,15,36,65,128,2,Matches
857,Luiz Felipe,it ITA,DF,Lazio,it Serie A,23,1997,10.1,32,20,19,11,2,16,24,66.7,8,20,9,11,21,53,29,1,Matches
858,João Félix,pt POR,"FW,MF",Atlético Madrid,es La Liga,20,1999,17.5,8,4,1,6,1,4,17,23.5,13,3,0,3,5,13,2,0,Matches
859,Ohis Felix Uduokhai,de GER,DF,Augsburg,de Bundesliga,22,1997,29.0,33,24,19,10,4,18,27,66.7,9,48,25,23,54,87,164,2,Matches
860,Zinedine Ferhat,dz ALG,"FW,MF",Nîmes,fr Ligue 1,27,1993,32.9,36,21,18,9,9,18,39,46.2,21,22,0,22,32,68,38,0,Matches
861,Bruno Fernandes,pt POR,MF,Manchester Utd,eng Premier League,25,1994,34.4,57,30,16,29,12,26,100,26.0,74,38,0,38,26,83,29,0,Matches
862,Edimilson Fernandes,ch SUI,"MF,FW",Mainz 05,de Bundesliga,24,1996,9.3,8,4,4,4,0,4,7,57.1,3,12,4,8,29,37,25,0,Matches
863,Aitor Fernández,es ESP,GK,Levante,es La Liga,29,1991,29.0,0,0,0,0,0,0,0,,0,0,0,0,2,2,17,1,Matches
864,Álex Fernández,es ESP,MF,Cádiz,es La Liga,27,1992,21.6,19,9,8,8,3,8,30,26.7,22,14,1,13,22,41,15,0,Matches
865,Álvaro Fernández,es ESP,GK,Huesca,es La Liga,22,1998,22.0,1,1,0,1,0,1,3,33.3,2,0,0,0,2,3,7,0,Matches
866,Andrés Fernández,es ESP,GK,Huesca,es La Liga,33,1986,16.0,0,0,0,0,0,0,0,,0,0,0,0,0,0,3,2,Matches
867,Augusto Fernández,ar ARG,MF,Cádiz,es La Liga,34,1986,4.1,11,3,5,6,0,2,13,15.4,11,5,1,4,9,20,5,0,Matches
868,Carlos Fernández,es ESP,FW,Sevilla,es La Liga,24,1996,1.6,1,0,1,0,0,0,2,0.0,2,3,1,2,1,2,0,0,Matches
869,Carlos Fernández,es ESP,"FW,MF",Real Sociedad,es La Liga,24,1996,4.3,3,2,0,2,1,1,8,12.5,7,6,1,5,0,3,6,0,Matches
870,Federico Fernández,ar ARG,DF,Newcastle Utd,eng Premier League,31,1989,23.1,29,22,23,5,1,17,21,81.0,4,41,31,10,17,46,147,0,Matches
871,Joaquín Fernández,es ESP,DF,Valladolid,es La Liga,24,1996,23.0,30,16,21,8,1,12,21,57.1,9,24,15,9,43,73,113,0,Matches
872,Fernandinho,br BRA,MF,Manchester City,eng Premier League,35,1985,13.2,31,17,8,14,9,20,43,46.5,23,11,2,9,23,54,17,0,Matches
873,Fernando,br BRA,MF,Sevilla,es La Liga,33,1987,28.3,54,28,24,25,5,23,43,53.5,20,25,11,14,41,95,70,0,Matches
874,Alex Ferrari,it ITA,DF,Sampdoria,it Serie A,26,1994,9.8,27,15,16,9,2,15,24,62.5,9,18,6,12,23,50,26,0,Matches
875,David Ferreiro,es ESP,"MF,FW",Huesca,es La Liga,32,1988,28.1,25,12,12,8,5,8,49,16.3,41,21,1,20,25,50,15,0,Matches
876,Salvador Ferrer,es ESP,DF,Spezia,it Serie A,22,1998,13.2,20,10,10,8,2,8,22,36.4,14,13,4,9,24,44,37,1,Matches
877,Facundo Ferreyra,ar ARG,FW,Celta Vigo,es La Liga,29,1991,3.3,4,3,1,2,1,0,2,0.0,2,5,0,5,2,6,2,0,Matches
878,Jordan Ferri,fr FRA,MF,Montpellier,fr Ligue 1,28,1992,28.6,58,40,34,22,2,31,103,30.1,72,30,5,25,8,66,18,1,Matches
879,Marco Festa,it ITA,GK,Crotone,it Serie A,28,1992,1.0,0,0,0,0,0,0,0,,0,0,0,0,0,0,0,0,Matches
880,Fidel,es ESP,"MF,DF",Elche,es La Liga,30,1989,26.6,46,30,28,15,3,25,64,39.1,39,22,2,20,16,62,14,0,Matches
881,Sam Field,eng ENG,MF,West Brom,eng Premier League,22,1998,0.7,5,5,3,2,0,0,0,,0,4,1,3,2,7,4,0,Matches
882,Alfreð Finnbogason,is ISL,FW,Augsburg,de Bundesliga,31,1989,6.0,2,1,0,1,1,0,1,0.0,1,7,1,6,1,3,4,0,Matches
883,Roberto Firmino,br BRA,FW,Liverpool,eng Premier League,28,1991,31.5,33,15,3,17,13,6,32,18.8,26,42,5,37,11,44,12,0,Matches
884,Junior Firpo,do DOM,"DF,MF",Barcelona,es La Liga,23,1996,3.2,1,1,1,0,0,0,1,0.0,1,5,3,2,4,5,7,0,Matches
885,John Fleck,sct SCO,MF,Sheffield Utd,eng Premier League,28,1991,28.6,51,33,28,18,5,26,83,31.3,57,26,4,22,28,79,12,1,Matches
886,Mark Flekken,nl NED,GK,Freiburg,de Bundesliga,27,1993,3.0,0,0,0,0,0,0,0,,0,0,0,0,0,0,1,0,Matches
887,Florian Flick,de GER,MF,Schalke 04,de Bundesliga,20,2000,4.0,10,7,4,6,0,7,16,43.8,9,4,3,1,7,17,5,1,Matches
888,Alexis Flips,fr FRA,"MF,FW",Reims,fr Ligue 1,20,2000,0.5,0,0,0,0,0,0,2,0.0,2,0,0,0,0,0,1,0,Matches
889,Alessandro Florenzi,it ITA,DF,Paris S-G,fr Ligue 1,29,1991,17.1,24,16,9,9,6,12,29,41.4,17,7,1,6,17,41,25,0,Matches
890,Kingsley Fobi,gh GHA,DF,Granada,es La Liga,21,1998,0.5,0,0,0,0,0,0,0,,0,0,0,0,1,1,1,0,Matches
891,Phil Foden,eng ENG,"FW,MF",Manchester City,eng Premier League,20,2000,18.0,22,11,12,8,2,9,23,39.1,14,9,0,9,11,33,11,0,Matches
892,Mamadou Fofana,ml MLI,"MF,DF",Metz,fr Ligue 1,22,1998,11.9,25,11,17,8,0,7,31,22.6,24,14,2,12,18,43,36,0,Matches
893,Seko Fofana,ci CIV,MF,Lens,fr Ligue 1,25,1995,25.7,16,8,3,10,3,4,26,15.4,22,16,5,11,34,50,23,1,Matches
894,Wesley Fofana,fr FRA,DF,Leicester City,eng Premier League,19,2000,25.1,51,37,27,22,2,31,46,67.4,15,28,16,12,61,112,94,0,Matches
895,Wesley Fofana,fr FRA,DF,Saint-Étienne,fr Ligue 1,19,2000,3.5,6,4,6,0,0,3,4,75.0,1,3,3,0,8,14,14,1,Matches
896,Youssouf Fofana,fr FRA,MF,Monaco,fr Ligue 1,21,1999,31.9,90,51,31,51,8,42,82,51.2,40,43,7,36,34,124,14,2,Matches
897,Thomas Foket,be BEL,DF,Reims,fr Ligue 1,25,1994,36.9,77,43,50,20,7,40,69,58.0,29,28,7,21,69,146,92,2,Matches
898,Ramón Folch,es ESP,MF,Elche,es La Liga,30,1989,0.0,0,0,0,0,0,0,0,,0,0,0,0,0,0,0,0,Matches
899,Lamine Fomba,fr FRA,MF,Nîmes,fr Ligue 1,22,1998,24.2,66,36,30,25,11,30,65,46.2,35,48,19,29,59,125,39,2,Matches
900,Thomas Fontaine,mg MAD,DF,Lorient,fr Ligue 1,29,1991,3.6,5,2,5,0,0,2,2,100.0,0,3,2,1,5,10,14,0,Matches
901,José Fontán,es ESP,DF,Celta Vigo,es La Liga,20,2000,7.2,12,9,8,4,0,5,11,45.5,6,4,3,1,13,25,27,0,Matches
902,José Fonte,pt POR,DF,Lille,fr Ligue 1,36,1983,35.4,40,29,28,10,2,27,33,81.8,6,36,23,13,36,76,137,1,Matches
903,Fernando Forestieri,it ITA,"FW,MF",Udinese,it Serie A,30,1990,6.1,9,7,4,4,1,3,7,42.9,4,7,0,7,2,11,0,0,Matches
904,Pablo Fornals,es ESP,"FW,MF",West Ham,eng Premier League,24,1996,28.6,44,26,14,24,6,11,73,15.1,62,43,1,42,36,80,9,0,Matches
905,Emil Forsberg,se SWE,"FW,MF",RB Leipzig,de Bundesliga,28,1991,17.1,11,6,1,6,4,5,27,18.5,22,10,1,9,11,22,4,0,Matches
906,Fraser Forster,eng ENG,GK,Southampton,eng Premier League,32,1988,8.0,1,0,1,0,0,1,2,50.0,1,0,0,0,0,1,9,0,Matches
907,Philipp Förster,de GER,MF,Stuttgart,de Bundesliga,25,1995,16.8,22,13,7,12,3,6,25,24.0,19,18,1,17,15,37,2,0,Matches
908,Steven Fortes,cv CPV,DF,Lens,fr Ligue 1,28,1992,15.9,33,20,20,10,3,16,22,72.7,6,25,10,15,27,60,52,0,Matches
909,Yassin Fortune,fr FRA,FW,Angers,fr Ligue 1,21,1999,0.2,0,0,0,0,0,0,0,,0,0,0,0,0,0,0,0,Matches
910,Timothy Fosu-Mensah,nl NED,DF,Manchester Utd,eng Premier League,22,1998,0.9,2,0,1,1,0,1,1,100.0,0,0,0,0,3,5,1,0,Matches
911,Timothy Fosu-Mensah,nl NED,DF,Leverkusen,de Bundesliga,22,1998,4.5,4,2,1,2,1,2,4,50.0,2,7,3,4,7,11,4,0,Matches
912,Daam Foulon,be BEL,DF,Benevento,it Serie A,21,1999,11.3,26,15,21,5,0,16,28,57.1,12,12,3,9,14,40,34,0,Matches
913,Dimitri Foulquier,fr FRA,DF,Granada,es La Liga,27,1993,29.6,35,21,20,12,3,15,26,57.7,11,24,7,17,26,61,60,0,Matches
914,Juan Foyth,ar ARG,"DF,MF",Villarreal,es La Liga,22,1998,13.0,40,22,22,14,4,12,29,41.4,17,21,6,15,19,59,24,1,Matches
915,Gianluca Frabotta,it ITA,"DF,MF",Juventus,it Serie A,21,1999,7.7,7,4,5,0,2,5,12,41.7,7,9,1,8,14,21,15,0,Matches
916,Raphael Framberger,de GER,DF,Augsburg,de Bundesliga,24,1995,17.1,42,23,26,11,5,19,25,76.0,6,24,2,22,36,78,62,1,Matches
917,Tyrese Francois,au AUS,DF,Fulham,eng Premier League,20,2000,0.2,0,0,0,0,0,0,0,,0,0,0,0,0,0,0,0,Matches
918,Ryan Fraser,sct SCO,"FW,MF",Newcastle Utd,eng Premier League,26,1994,10.3,4,1,3,1,0,2,5,40.0,3,1,0,1,6,10,7,0,Matches
919,Fred,br BRA,MF,Manchester Utd,eng Premier League,27,1993,26.6,81,39,39,38,4,29,89,32.6,60,49,9,40,45,126,26,1,Matches
920,Ryan Fredericks,eng ENG,"DF,FW",West Ham,eng Premier League,27,1992,6.3,9,5,5,4,0,3,7,42.9,4,6,2,4,11,20,20,0,Matches
921,Remo Freuler,ch SUI,MF,Atalanta,it Serie A,28,1992,30.1,63,39,17,38,8,32,76,42.1,44,52,4,48,39,102,27,2,Matches
922,Marco Friedl,at AUT,DF,Werder Bremen,de Bundesliga,22,1998,30.9,50,34,31,17,2,30,62,48.4,32,38,17,21,55,105,118,1,Matches
923,Marvin Friedrich,de GER,DF,Union Berlin,de Bundesliga,24,1995,34.0,47,29,35,11,1,18,32,56.3,14,38,18,20,52,99,109,0,Matches
924,Jeremie Frimpong,nl NED,"DF,FW",Leverkusen,de Bundesliga,19,2000,4.8,7,4,4,3,0,4,8,50.0,4,4,0,4,1,8,7,0,Matches
925,Jorge de Frutos,es ESP,MF,Levante,es La Liga,23,1997,24.3,48,24,21,21,6,11,41,26.8,30,25,2,23,16,64,18,0,Matches
926,Christian Fuchs,at AUT,DF,Leicester City,eng Premier League,34,1986,7.8,18,7,15,2,1,8,15,53.3,7,6,4,2,16,34,34,1,Matches
927,Angelo Fulgini,fr FRA,MF,Angers,fr Ligue 1,23,1996,30.3,22,13,4,12,6,12,34,35.3,22,17,0,17,15,37,9,0,Matches
928,Niclas Füllkrug,de GER,FW,Werder Bremen,de Bundesliga,27,1993,9.7,7,3,2,4,1,1,13,7.7,12,10,4,6,3,10,13,0,Matches
929,Ramiro Funes Mori,ar ARG,DF,Villarreal,es La Liga,29,1991,8.1,12,8,7,5,0,7,11,63.6,4,7,5,2,8,20,42,1,Matches
930,Darnell Furlong,eng ENG,DF,West Brom,eng Premier League,24,1995,32.6,45,27,27,12,6,21,44,47.7,23,39,16,23,49,94,90,0,Matches
931,Daniel Fuzato,br BRA,GK,Roma,it Serie A,23,1997,5.0,0,0,0,0,0,0,0,,0,1,0,1,0,0,1,1,Matches
932,Baptiste Gabard,fr FRA,MF,Saint-Étienne,fr Ligue 1,20,2000,1.5,4,3,1,3,0,1,5,20.0,4,4,0,4,1,5,0,0,Matches
933,Matteo Gabbia,it ITA,DF,Milan,it Serie A,20,1999,6.2,9,5,3,6,0,2,2,100.0,0,8,6,2,3,12,21,0,Matches
934,Manolo Gabbiadini,it ITA,FW,Sampdoria,it Serie A,28,1991,9.7,2,2,0,2,0,0,1,0.0,1,3,1,2,3,5,5,0,Matches
935,Mijat Gaćinović,rs SRB,"DF,MF",Hoffenheim,de Bundesliga,25,1995,9.1,18,10,6,11,1,9,24,37.5,15,13,0,13,18,36,15,0,Matches
936,Roberto Gagliardini,it ITA,MF,Inter,it Serie A,26,1994,13.7,30,17,17,8,5,5,28,17.9,23,15,3,12,19,49,16,0,Matches
937,Riccardo Gagliolo,se SWE,DF,Parma,it Serie A,30,1990,21.7,45,18,35,8,2,28,45,62.2,17,34,7,27,36,81,64,1,Matches
938,Adolfo Gaich,ar ARG,FW,Benevento,it Serie A,21,1999,8.5,9,4,1,7,1,1,13,7.7,12,4,0,4,2,11,4,0,Matches
939,Andrey Galabinov,bg BUL,FW,Spezia,it Serie A,31,1988,4.8,2,1,1,1,0,1,3,33.3,2,2,0,2,0,2,5,0,Matches
940,Javi Galán,es ESP,DF,Huesca,es La Liga,25,1994,34.1,88,54,47,35,6,46,72,63.9,26,30,4,26,39,127,61,0,Matches
941,Conor Gallagher,eng ENG,MF,West Brom,eng Premier League,20,2000,28.1,81,41,30,39,12,29,97,29.9,68,47,8,39,27,108,31,0,Matches
942,Enric Gallego,es ESP,FW,Osasuna,es La Liga,33,1986,9.0,6,3,2,2,2,2,14,14.3,12,5,1,4,1,7,9,0,Matches
943,Kévin Gameiro,fr FRA,FW,Valencia,es La Liga,33,1987,12.0,7,4,3,2,2,3,11,27.3,8,10,0,10,0,7,3,0,Matches
944,Idrissa Gana Gueye,sn SEN,MF,Paris S-G,fr Ligue 1,30,1989,17.6,63,35,20,34,9,26,50,52.0,24,26,7,19,20,83,9,3,Matches
945,Ignatius Ganago,cm CMR,FW,Lens,fr Ligue 1,21,1999,14.5,4,3,0,2,2,3,12,25.0,9,7,1,6,6,10,3,0,Matches
946,Aleix García,es ESP,MF,Eibar,es La Liga,23,1997,4.9,5,4,2,2,1,1,10,10.0,9,5,0,5,8,13,2,0,Matches
947,Borja García,es ESP,"MF,FW",Huesca,es La Liga,29,1990,12.4,13,7,4,6,3,6,12,50.0,6,12,0,12,10,23,4,1,Matches
948,Dani García,es ESP,MF,Athletic Club,es La Liga,30,1990,21.3,39,19,10,23,6,15,46,32.6,31,20,7,13,33,72,34,0,Matches
949,David García,es ESP,DF,Osasuna,es La Liga,26,1994,35.0,26,17,13,13,0,13,24,54.2,11,36,19,17,59,85,171,0,Matches
950,Eric García,es ESP,DF,Manchester City,eng Premier League,19,2001,4.3,8,7,5,3,0,5,7,71.4,2,4,1,3,4,12,10,0,Matches
951,Manu García,es ESP,MF,Alavés,es La Liga,34,1986,12.5,24,13,10,13,1,8,35,22.9,27,16,1,15,12,36,21,0,Matches
952,Raúl García,es ESP,"DF,MF",Valladolid,es La Liga,31,1989,5.6,10,8,5,5,0,6,20,30.0,14,5,1,4,9,19,10,0,Matches
953,Raúl García,es ESP,"FW,MF",Athletic Club,es La Liga,34,1986,19.4,34,19,9,19,6,7,22,31.8,15,30,1,29,15,49,20,0,Matches
954,Rubén García,es ESP,"MF,FW",Osasuna,es La Liga,27,1993,30.2,50,29,21,22,7,14,45,31.1,31,28,2,26,29,79,20,0,Matches
955,Sergi García,es ESP,MF,Alavés,es La Liga,21,1999,0.2,1,1,0,1,0,0,1,0.0,1,0,0,0,0,1,0,0,Matches
956,Unai García,es ESP,DF,Osasuna,es La Liga,28,1992,13.8,19,9,14,4,1,9,15,60.0,6,16,8,8,14,33,40,0,Matches
957,Mario Gaspar,es ESP,DF,Villarreal,es La Liga,29,1990,20.6,55,34,22,24,9,21,40,52.5,19,26,4,22,30,85,47,1,Matches
958,Manuel Gasparini,it ITA,GK,Udinese,it Serie A,18,2002,0.0,0,0,0,0,0,0,0,,0,0,0,0,0,0,0,0,Matches
959,Dwight Gayle,eng ENG,"FW,MF",Newcastle Utd,eng Premier League,29,1990,5.7,2,0,1,1,0,0,7,0.0,7,3,1,2,1,3,2,0,Matches
960,Paulo Gazzaniga,ar ARG,GK,Elche,es La Liga,28,1992,8.0,1,1,1,0,0,0,0,,0,0,0,0,1,2,4,0,Matches
961,Jean-Philippe Gbamin,ci CIV,MF,Everton,eng Premier League,24,1995,0.1,1,0,0,1,0,0,0,,0,1,0,1,0,1,1,0,Matches
962,Yann Gboho,fr FRA,"MF,FW",Rennes,fr Ligue 1,19,2001,3.4,6,3,3,1,2,3,8,37.5,5,1,0,1,1,7,3,1,Matches
963,David de Gea,es ESP,GK,Manchester Utd,eng Premier League,29,1990,25.5,0,0,0,0,0,0,0,,0,0,0,0,0,0,8,3,Matches
964,Christian Gebauer,at AUT,"MF,FW",Arminia,de Bundesliga,26,1993,7.6,9,4,2,5,2,4,11,36.4,7,4,1,3,6,15,14,0,Matches
965,Theodor Gebre Selassie,cz CZE,DF,Werder Bremen,de Bundesliga,33,1986,33.7,61,35,39,17,5,28,64,43.8,36,33,11,22,58,119,98,1,Matches
966,Emrehan Gedikli,de GER,FW,Leverkusen,de Bundesliga,17,2003,0.3,0,0,0,0,0,0,0,,0,0,0,0,0,0,0,0,Matches
967,Dennis Geiger,de GER,MF,Hoffenheim,de Bundesliga,22,1998,7.3,13,10,3,8,2,5,8,62.5,3,10,0,10,3,16,0,0,Matches
968,Christian Gentner,de GER,MF,Union Berlin,de Bundesliga,34,1985,11.5,17,8,9,5,3,5,18,27.8,13,13,1,12,17,34,16,0,Matches
969,Yannick Gerhardt,de GER,"MF,FW",Wolfsburg,de Bundesliga,26,1994,21.5,52,32,14,32,6,21,52,40.4,31,34,4,30,21,73,30,0,Matches
970,Valère Germain,fr FRA,"FW,MF",Marseille,fr Ligue 1,30,1990,9.5,8,6,2,4,2,3,11,27.3,8,7,2,5,11,19,22,0,Matches
971,Gervinho,ci CIV,FW,Parma,it Serie A,33,1987,22.5,5,1,2,2,1,1,14,7.1,13,11,1,10,10,15,3,0,Matches
972,Willem Geubbels,fr FRA,"MF,FW",Monaco,fr Ligue 1,18,2001,3.3,12,8,5,7,0,5,13,38.5,8,9,0,9,3,15,5,0,Matches
973,Hamadi Al Ghaddioui,ma MAR,FW,Stuttgart,de Bundesliga,29,1990,0.5,0,0,0,0,0,0,1,0.0,1,0,0,0,0,0,0,0,Matches
974,Anwar El Ghazi,nl NED,FW,Aston Villa,eng Premier League,25,1995,17.9,16,13,6,7,3,7,23,30.4,16,11,0,11,6,22,11,0,Matches
975,Paolo Ghiglione,it ITA,"DF,MF",Genoa,it Serie A,23,1997,15.1,27,15,17,8,2,13,28,46.4,15,14,2,12,13,40,25,0,Matches
976,Faouzi Ghoulam,dz ALG,"DF,FW",Napoli,it Serie A,29,1991,3.2,6,5,3,2,1,0,1,0.0,1,4,2,2,3,9,1,0,Matches
977,Kieran Gibbs,eng ENG,DF,West Brom,eng Premier League,30,1989,9.0,15,11,11,3,1,8,10,80.0,2,8,6,2,16,31,30,1,Matches
978,Morgan Gibbs-White,eng ENG,"MF,FW",Wolves,eng Premier League,20,2000,4.6,9,7,3,4,2,5,12,41.7,7,6,0,6,3,12,1,0,Matches
979,Niko Gießelmann,de GER,DF,Union Berlin,de Bundesliga,28,1991,4.8,12,9,7,4,1,5,8,62.5,3,9,3,6,8,20,13,1,Matches
980,Rafał Gikiewicz,pl POL,GK,Augsburg,de Bundesliga,32,1987,34.0,0,0,0,0,0,0,3,0.0,3,0,0,0,3,3,9,1,Matches
981,Bryan Gil,es ESP,FW,Sevilla,es La Liga,19,2001,0.1,1,1,0,1,0,0,0,,0,0,0,0,0,1,0,0,Matches
982,Bryan Gil,es ESP,"MF,FW",Eibar,es La Liga,19,2001,25.2,28,18,12,11,5,6,23,26.1,17,20,0,20,17,45,6,0,Matches
983,David Gil,es ESP,GK,Cádiz,es La Liga,26,1994,4.0,0,0,0,0,0,0,1,0.0,1,0,0,0,0,0,2,0,Matches
984,Billy Gilmour,sct SCO,MF,Chelsea,eng Premier League,19,2001,2.9,4,2,1,2,1,2,7,28.6,5,3,2,1,3,7,1,0,Matches
985,Álvaro Giménez,es ESP,FW,Cádiz,es La Liga,29,1991,4.5,4,2,2,2,0,0,3,0.0,3,2,0,2,2,6,3,0,Matches
986,Daniel Ginczek,de GER,"FW,MF",Wolfsburg,de Bundesliga,29,1991,2.4,2,2,1,1,0,2,8,25.0,6,2,0,2,1,3,2,0,Matches
987,Matthias Ginter,de GER,DF,Gladbach,de Bundesliga,26,1994,34.0,26,16,15,10,1,14,24,58.3,10,43,32,11,51,77,121,0,Matches
988,Andrei Girotto,br BRA,"DF,MF",Nantes,fr Ligue 1,28,1992,29.6,65,41,50,15,0,39,70,55.7,31,34,15,19,59,124,103,0,Matches
989,Olivier Giroud,fr FRA,FW,Chelsea,eng Premier League,33,1986,8.3,4,2,0,1,3,1,7,14.3,6,4,1,3,5,9,10,0,Matches
990,Robert Glatzel,de GER,FW,Mainz 05,de Bundesliga,26,1994,4.0,1,0,1,0,0,0,2,0.0,2,2,0,2,0,1,2,0,Matches
991,Kamil Glik,pl POL,DF,Benevento,it Serie A,32,1988,35.6,44,24,33,10,1,25,53,47.2,28,37,31,6,62,106,153,0,Matches
992,Serge Gnabry,de GER,"FW,MF",Bayern Munich,de Bundesliga,25,1995,18.3,39,19,7,19,13,12,32,37.5,20,17,0,17,26,65,3,0,Matches
993,Ben Godfrey,eng ENG,DF,Everton,eng Premier League,22,1998,29.8,55,33,37,15,3,27,41,65.9,14,56,37,19,33,88,120,0,Matches
994,Diego Godín,uy URU,DF,Cagliari,it Serie A,34,1986,27.9,60,32,51,9,0,24,39,61.5,15,41,24,17,56,116,117,0,Matches
995,Akaki Gogia,de GER,"FW,MF",Union Berlin,de Bundesliga,28,1992,1.6,1,0,0,1,0,0,2,0.0,2,0,0,0,1,2,0,0,Matches
996,Amer Gojak,ba BIH,"MF,FW",Torino,it Serie A,23,1997,5.3,1,0,1,0,0,1,7,14.3,6,5,0,5,3,4,1,0,Matches
997,Edoardo Goldaniga,it ITA,DF,Genoa,it Serie A,26,1993,20.6,28,18,21,7,0,14,23,60.9,9,17,7,10,38,66,62,1,Matches
998,Vladimir Golemić,si SVN,DF,Crotone,it Serie A,29,1991,26.0,33,16,17,13,3,14,19,73.7,5,38,26,12,40,73,97,2,Matches
999,Pierluigi Gollini,it ITA,GK,Atalanta,it Serie A,25,1995,24.0,1,0,1,0,0,1,2,50.0,1,1,0,1,1,2,11,0,Matches
1000,Aleksandr Golovin,ru RUS,"MF,FW",Monaco,fr Ligue 1,24,1996,11.9,28,16,6,18,4,8,39,20.5,31,21,0,21,11,39,3,0,Matches
1001,Tomislav Gomelt,hr CRO,MF,Crotone,it Serie A,25,1995,0.2,1,1,0,1,0,0,0,,0,0,0,0,1,2,0,0,Matches
1002,André Gomes,pt POR,MF,Everton,eng Premier League,27,1993,17.4,35,23,16,16,3,17,58,29.3,41,19,1,18,10,45,12,1,Matches
1003,Dani Gómez,es ESP,FW,Levante,es La Liga,22,1998,18.5,4,3,2,1,1,0,11,0.0,11,3,0,3,2,6,4,0,Matches
1004,Ibai Gómez,es ESP,MF,Athletic Club,es La Liga,30,1989,4.7,6,4,2,3,1,4,7,57.1,3,3,0,3,2,8,4,0,Matches
1005,Joe Gomez,eng ENG,DF,Liverpool,eng Premier League,23,1997,6.6,3,2,1,1,1,0,4,0.0,4,3,2,1,4,7,29,0,Matches
1006,Maxi Gómez,uy URU,FW,Valencia,es La Liga,23,1996,29.9,11,9,3,7,1,3,14,21.4,11,13,3,10,2,13,34,0,Matches
1007,Moi Gómez,es ESP,"MF,FW",Villarreal,es La Liga,26,1994,28.5,21,12,6,8,7,14,35,40.0,21,20,3,17,11,32,16,0,Matches
1008,Papu Gómez,ar ARG,"MF,FW",Atalanta,it Serie A,32,1988,7.4,3,2,2,1,0,2,8,25.0,6,8,1,7,1,4,1,0,Matches
1009,Papu Gómez,ar ARG,"MF,FW",Sevilla,es La Liga,32,1988,10.2,9,6,2,4,3,2,12,16.7,10,13,2,11,7,16,6,0,Matches
1010,Sergi Gómez,es ESP,DF,Sevilla,es La Liga,28,1992,8.0,4,3,2,2,0,1,1,100.0,0,5,4,1,6,10,34,0,Matches
1011,Sergio Gómez,es ESP,"MF,FW",Huesca,es La Liga,19,2000,8.8,29,10,17,9,3,11,22,50.0,11,15,0,15,14,43,9,0,Matches
1012,Alfred Gomis,sn SEN,GK,Dijon,fr Ligue 1,26,1993,5.0,1,0,1,0,0,1,2,50.0,1,0,0,0,1,2,7,0,Matches
1013,Alfred Gomis,sn SEN,GK,Rennes,fr Ligue 1,26,1993,22.0,1,1,1,0,0,1,1,100.0,0,0,0,0,3,4,10,1,Matches
1014,Maxime Gonalons,fr FRA,MF,Granada,es La Liga,31,1989,16.4,53,37,18,33,2,15,37,40.5,22,17,0,17,25,78,21,1,Matches
1015,Vagner Gonçalves,cv CPV,"FW,MF",Metz,fr Ligue 1,24,1996,10.7,16,9,5,5,6,2,15,13.3,13,6,0,6,4,20,1,1,Matches
1016,Álvaro González,es ESP,DF,Marseille,fr Ligue 1,30,1990,31.5,26,17,20,6,0,19,31,61.3,12,30,18,12,33,59,119,1,Matches
1017,Bruno González,es ESP,DF,Valladolid,es La Liga,30,1990,25.1,26,17,18,8,0,17,31,54.8,14,22,14,8,37,63,112,1,Matches
1018,Diego González,es ESP,DF,Elche,es La Liga,25,1995,14.2,11,7,7,3,1,5,11,45.5,6,16,9,7,20,31,49,1,Matches
1019,Nicolás González,ar ARG,"FW,MF",Stuttgart,de Bundesliga,22,1998,10.4,5,5,1,2,2,0,6,0.0,6,10,3,7,4,9,6,0,Matches
1020,Sergio González,es ESP,"MF,DF",Cádiz,es La Liga,23,1997,1.0,1,0,0,1,0,1,2,50.0,1,0,0,0,2,3,0,0,Matches
1021,Urko González,es ESP,MF,Real Sociedad,es La Liga,19,2001,0.5,0,0,0,0,0,0,1,0.0,1,1,1,0,0,0,1,0,Matches
1022,Anthony Gordon,eng ENG,"FW,MF",Everton,eng Premier League,19,2001,1.0,3,3,3,0,0,0,2,0.0,2,1,0,1,1,4,3,0,Matches
1023,Leon Goretzka,de GER,MF,Bayern Munich,de Bundesliga,25,1995,18.9,37,23,12,21,4,16,39,41.0,23,30,2,28,44,81,11,0,Matches
1024,Andoni Gorosabel,es ESP,DF,Real Sociedad,es La Liga,23,1996,26.5,76,43,45,20,11,27,64,42.2,37,25,4,21,23,99,42,0,Matches
1025,Robin Gosens,de GER,DF,Atalanta,it Serie A,26,1994,28.0,46,35,20,15,11,17,41,41.5,24,50,7,43,41,87,34,0,Matches
1026,Amine Gouiri,dz ALG,"FW,MF",Nice,fr Ligue 1,20,2000,30.5,31,18,7,16,8,10,41,24.4,31,22,6,16,17,48,23,0,Matches
1027,Lucas Gourna-Douath,fr FRA,MF,Saint-Étienne,fr Ligue 1,16,2003,14.7,32,22,18,11,3,15,28,53.6,13,10,0,10,24,56,18,0,Matches
1028,Jeffrey Gouweleeuw,nl NED,DF,Augsburg,de Bundesliga,29,1991,31.5,36,20,24,11,1,16,33,48.5,17,37,18,19,69,105,149,2,Matches
1029,Jonathan Gradit,fr FRA,DF,Lens,fr Ligue 1,27,1992,31.4,60,39,26,28,6,22,38,57.9,16,37,19,18,56,116,81,1,Matches
1030,Karlan Grant,eng ENG,"FW,MF",West Brom,eng Premier League,22,1997,12.5,5,3,3,2,0,2,4,50.0,2,7,0,7,5,10,17,0,Matches
1031,Alberto Grassi,it ITA,"MF,DF",Parma,it Serie A,25,1995,13.1,30,11,14,13,3,8,29,27.6,21,22,9,13,26,56,32,0,Matches
1032,Andrew Gravillon,gp GLP,DF,Lorient,fr Ligue 1,22,1998,25.2,26,17,17,9,0,13,28,46.4,15,44,31,13,59,85,118,4,Matches
1033,Demarai Gray,jm JAM,FW,Leicester City,eng Premier League,24,1996,0.2,1,1,1,0,0,0,0,,0,0,0,0,0,1,0,0,Matches
1034,Demarai Gray,jm JAM,FW,Leverkusen,de Bundesliga,24,1996,4.9,3,2,1,2,0,1,1,100.0,0,3,0,3,4,7,3,0,Matches
1035,Adrian Grbić,at AUT,FW,Lorient,fr Ligue 1,23,1996,10.7,6,4,2,2,2,1,7,14.3,6,6,0,6,5,11,7,0,Matches
1036,Jack Grealish,eng ENG,"FW,MF",Aston Villa,eng Premier League,24,1995,24.3,31,14,8,16,7,15,24,62.5,9,20,3,17,12,43,5,3,Matches
1037,Etienne Green,eng ENG,GK,Saint-Étienne,fr Ligue 1,20,2000,8.0,0,0,0,0,0,0,0,,0,0,0,0,0,0,3,0,Matches
1038,Mason Greenwood,eng ENG,FW,Manchester Utd,eng Premier League,18,2001,20.2,13,10,6,4,3,5,22,22.7,17,9,0,9,5,18,1,0,Matches
1039,Michael Gregoritsch,at AUT,"FW,MF",Augsburg,de Bundesliga,26,1994,9.3,13,10,6,7,0,3,10,30.0,7,2,0,2,3,16,17,0,Matches
1040,Clément Grenier,fr FRA,"MF,FW",Rennes,fr Ligue 1,29,1991,12.0,20,8,9,8,3,7,31,22.6,24,7,0,7,5,25,3,0,Matches
1041,Sebastian Griesbeck,de GER,MF,Union Berlin,de Bundesliga,29,1990,9.9,20,9,8,11,1,8,19,42.1,11,13,3,10,5,25,8,0,Matches
1042,Antoine Griezmann,fr FRA,"FW,MF",Barcelona,es La Liga,29,1991,28.9,37,22,10,18,9,12,40,30.0,28,20,1,19,12,49,11,0,Matches
1043,Vincenzo Grifo,it ITA,"MF,FW",Freiburg,de Bundesliga,27,1993,25.7,18,7,6,7,5,14,34,41.2,20,13,0,13,27,45,18,1,Matches
1044,Lennart Grill,de GER,GK,Leverkusen,de Bundesliga,21,1999,4.0,0,0,0,0,0,0,0,,0,0,0,0,0,0,2,0,Matches
1045,Florian Grillitsch,at AUT,"MF,DF",Hoffenheim,de Bundesliga,24,1995,20.9,37,21,21,13,3,19,52,36.5,33,38,7,31,51,88,47,1,Matches
1046,Christian Groß,de GER,"MF,DF",Werder Bremen,de Bundesliga,31,1989,16.3,44,28,17,25,2,15,37,40.5,22,12,2,10,24,68,37,0,Matches
1047,Pascal Groß,de GER,"MF,DF",Brighton,eng Premier League,29,1991,27.6,45,24,24,15,6,24,53,45.3,29,25,4,21,23,68,18,1,Matches
1048,Kamil Grosicki,pl POL,"MF,FW",West Brom,eng Premier League,32,1988,1.6,2,1,2,0,0,2,8,25.0,6,1,0,1,2,4,1,0,Matches
1049,Ilia Gruev,bg BUL,FW,Werder Bremen,de Bundesliga,20,2000,0.0,0,0,0,0,0,0,0,,0,0,0,0,0,0,0,0,Matches
1050,Carlos Gruezo,ec ECU,MF,Augsburg,de Bundesliga,25,1995,23.2,57,32,20,32,5,20,52,38.5,32,32,5,27,35,92,29,1,Matches
1051,Vicente Guaita,es ESP,GK,Crystal Palace,eng Premier League,33,1987,37.0,1,1,1,0,0,1,1,100.0,0,0,0,0,1,2,11,1,Matches
1052,Andrés Guardado,mx MEX,MF,Betis,es La Liga,33,1986,14.6,25,12,10,11,4,10,25,40.0,15,13,3,10,18,43,19,0,Matches
1053,Sergi Guardiola,es ESP,FW,Valladolid,es La Liga,29,1991,19.9,11,5,1,5,5,2,27,7.4,25,12,1,11,7,18,16,3,Matches
1054,Nemanja Gudelj,rs SRB,"MF,DF",Sevilla,es La Liga,28,1991,11.6,23,12,16,5,2,4,10,40.0,6,10,6,4,24,47,24,2,Matches
1055,Gonçalo Guedes,pt POR,"MF,FW",Valencia,es La Liga,23,1996,25.4,18,12,8,7,3,10,45,22.2,35,24,1,23,8,26,7,0,Matches
1056,Mattéo Guendouzi,fr FRA,MF,Hertha BSC,de Bundesliga,21,1999,20.2,24,13,10,12,2,9,25,36.0,16,15,4,11,21,45,24,1,Matches
1057,Raphaël Guerreiro,pt POR,DF,Dortmund,de Bundesliga,26,1993,24.6,30,13,14,8,8,16,31,51.6,15,21,4,17,28,58,31,1,Matches
1058,Evann Guessand,fr FRA,FW,Nice,fr Ligue 1,19,2001,0.3,0,0,0,0,0,0,1,0.0,1,1,1,0,1,1,1,0,Matches
1059,Kelyan Guessoum,fr FRA,DF,Nîmes,fr Ligue 1,21,1999,12.5,13,7,11,1,1,11,16,68.8,5,8,6,2,24,37,51,0,Matches
1060,Ander Guevara,es ESP,MF,Real Sociedad,es La Liga,23,1997,23.1,35,23,15,16,4,15,30,50.0,15,19,5,14,25,60,35,1,Matches
1061,Lamine Gueye,sn SEN,"FW,MF",Metz,fr Ligue 1,22,1998,16.2,18,9,4,11,3,7,24,29.2,17,7,2,5,21,39,5,0,Matches
1062,Pape Gueye,sn SEN,MF,Marseille,fr Ligue 1,21,1999,22.9,49,21,25,19,5,15,45,33.3,30,25,6,19,47,96,34,0,Matches
1063,John Guidetti,se SWE,FW,Alavés,es La Liga,28,1992,2.3,2,2,0,2,0,0,2,0.0,2,0,0,0,1,3,2,0,Matches
1064,Josuha Guilavogui,fr FRA,"MF,DF",Wolfsburg,de Bundesliga,29,1990,8.3,17,9,9,8,0,5,12,41.7,7,12,5,7,29,46,25,0,Matches
1065,Frederic Guilbert,fr FRA,DF,Strasbourg,fr Ligue 1,25,1994,12.4,37,19,23,11,3,21,34,61.8,13,14,1,13,33,70,32,0,Matches
1066,Hugo Guillamón,es ESP,DF,Valencia,es La Liga,20,2000,22.1,23,13,17,6,0,8,20,40.0,12,19,14,5,27,50,102,3,Matches
1067,Bruno Guimarães,br BRA,MF,Lyon,fr Ligue 1,22,1997,19.5,76,34,26,41,9,30,64,46.9,34,24,4,20,14,90,13,0,Matches
1068,Serhou Guirassy,gn GUI,FW,Rennes,fr Ligue 1,24,1996,19.6,4,1,1,3,0,1,3,33.3,2,10,1,9,5,9,17,0,Matches
1069,Péter Gulácsi,hu HUN,GK,RB Leipzig,de Bundesliga,30,1990,33.0,1,0,1,0,0,1,2,50.0,1,0,0,0,2,3,7,0,Matches
1070,Manuel Gulde,de GER,DF,Freiburg,de Bundesliga,29,1991,21.7,27,15,12,12,3,5,21,23.8,16,25,15,10,37,64,64,0,Matches
1071,Robert Gumny,pl POL,DF,Augsburg,de Bundesliga,22,1998,15.3,24,15,12,9,3,15,23,65.2,8,12,2,10,18,42,31,0,Matches
1072,İlkay Gündoğan,de GER,MF,Manchester City,eng Premier League,29,1990,22.5,25,15,8,12,5,10,39,25.6,29,13,4,9,20,45,9,0,Matches
1073,Christian Günter,de GER,"DF,MF",Freiburg,de Bundesliga,27,1993,34.0,34,19,18,13,3,15,43,34.9,28,38,9,29,29,63,40,0,Matches
1074,Koray Günter,de GER,DF,Hellas Verona,it Serie A,25,1994,19.6,20,10,10,9,1,4,9,44.4,5,27,21,6,70,90,87,0,Matches
1075,Jon Guridi,es ESP,MF,Real Sociedad,es La Liga,25,1995,9.2,19,9,10,6,3,8,22,36.4,14,8,1,7,10,29,9,0,Matches
1076,Malo Gusto,fr FRA,"DF,MF",Lyon,fr Ligue 1,17,2003,0.0,0,0,0,0,0,0,0,,0,0,0,0,0,0,0,0,Matches
1077,Raúl Guti,es ESP,MF,Elche,es La Liga,23,1996,31.8,48,28,21,22,5,16,52,30.8,36,25,3,22,49,97,25,0,Matches
1078,Marcos Mauro López Gutiérrez,ar ARG,DF,Cádiz,es La Liga,29,1991,20.3,23,15,15,8,0,15,24,62.5,9,18,12,6,22,45,78,0,Matches
1079,Miguel Gutiérrez,es ESP,DF,Real Madrid,es La Liga,19,2001,3.5,4,0,0,3,1,1,7,14.3,6,3,0,3,5,9,5,0,Matches
1080,Manu Gyabuaa,it ITA,MF,Atalanta,it Serie A,18,2001,0.0,0,0,0,0,0,0,0,,0,0,0,0,0,0,0,0,Matches
1081,Emmanuel Gyasi,gh GHA,FW,Spezia,it Serie A,26,1994,31.7,30,16,16,10,4,9,31,29.0,22,13,2,11,14,44,8,0,Matches
1082,Erling Haaland,no NOR,FW,Dortmund,de Bundesliga,20,2000,26.7,7,2,1,3,3,1,4,25.0,3,19,4,15,4,11,16,0,Matches
1083,Janik Haberer,de GER,"MF,FW",Freiburg,de Bundesliga,26,1994,5.4,7,4,4,3,0,3,15,20.0,12,4,1,3,7,14,9,0,Matches
1084,Alexander Hack,de GER,DF,Mainz 05,de Bundesliga,26,1993,15.2,32,21,23,8,1,18,31,58.1,13,26,17,9,41,73,91,2,Matches
1085,Antwoine Hackford,eng ENG,DF,Sheffield Utd,eng Premier League,16,2004,0.1,0,0,0,0,0,0,0,,0,0,0,0,0,0,0,0,Matches
1086,Munir El Haddadi,ma MAR,FW,Sevilla,es La Liga,24,1995,9.4,12,8,5,5,2,2,12,16.7,10,6,0,6,5,17,6,0,Matches
1087,André Hahn,de GER,"FW,MF",Augsburg,de Bundesliga,29,1990,22.6,31,17,14,13,4,9,44,20.5,35,35,3,32,14,45,24,0,Matches
1088,Amadou Haidara,ml MLI,"MF,FW",RB Leipzig,de Bundesliga,22,1998,21.2,50,28,20,21,9,11,36,30.6,25,33,1,32,30,80,24,0,Matches
1089,Massadio Haïdara,ml MLI,DF,Lens,fr Ligue 1,27,1992,23.7,48,32,21,21,6,23,37,62.2,14,29,6,23,35,83,60,0,Matches
1090,Achraf Hakimi,ma MAR,DF,Inter,it Serie A,21,1998,29.6,53,32,23,19,11,23,48,47.9,25,31,1,30,22,75,23,1,Matches
1091,Sébastien Haller,ci CIV,FW,West Ham,eng Premier League,26,1994,10.4,14,9,1,6,7,4,20,20.0,16,7,1,6,5,19,7,0,Matches
1092,Marcel Halstenberg,de GER,DF,RB Leipzig,de Bundesliga,28,1991,18.3,29,18,20,8,1,19,41,46.3,22,15,3,12,16,45,35,0,Matches
1093,Pierre-Yves Hamel,fr FRA,FW,Lorient,fr Ligue 1,26,1994,9.4,15,8,3,9,3,1,6,16.7,5,12,1,11,10,25,6,0,Matches
1094,Romain Hamouma,fr FRA,"FW,MF",Saint-Étienne,fr Ligue 1,33,1987,19.7,12,7,5,6,1,4,24,16.7,20,17,1,16,7,19,11,0,Matches
1095,Samir Handanović,si SVN,GK,Inter,it Serie A,36,1984,36.0,1,0,1,0,0,1,1,100.0,0,0,0,0,0,1,6,3,Matches
1096,Lukáš Haraslín,sk SVK,"FW,MF",Sassuolo,it Serie A,24,1996,3.7,8,4,2,5,1,2,5,40.0,3,1,0,1,0,8,2,0,Matches
1097,Amine Harit,ma MAR,"MF,FW",Schalke 04,de Bundesliga,23,1997,23.3,22,13,8,11,3,10,23,43.5,13,9,1,8,17,39,7,1,Matches
1098,Rekeem Harper,eng ENG,MF,West Brom,eng Premier League,20,2000,0.4,0,0,0,0,0,0,0,,0,2,0,2,1,1,0,0,Matches
1099,Jack Harrison,eng ENG,"MF,FW",Leeds United,eng Premier League,23,1996,31.6,63,38,20,30,13,26,59,44.1,33,30,2,28,15,78,21,0,Matches
1100,Marcel Hartel,de GER,MF,Arminia,de Bundesliga,24,1996,18.7,35,19,15,18,2,20,40,50.0,20,17,4,13,26,61,16,1,Matches
1101,Makoto Hasebe,jp JPN,"DF,MF",Eint Frankfurt,de Bundesliga,36,1984,25.4,43,29,21,20,2,25,51,49.0,26,31,12,19,31,74,68,2,Matches
1102,Hans Hateboer,nl NED,DF,Atalanta,it Serie A,26,1994,19.6,28,17,12,14,2,13,23,56.5,10,8,1,7,17,45,9,0,Matches
1103,Kortney Hause,eng ENG,DF,Aston Villa,eng Premier League,25,1995,7.0,4,2,3,1,0,0,3,0.0,3,4,2,2,8,12,53,0,Matches
1104,Kai Havertz,de GER,"MF,FW",Chelsea,eng Premier League,21,1999,16.9,18,9,6,10,2,6,27,22.2,21,25,0,25,4,22,22,1,Matches
1105,Isaac Hayden,eng ENG,"MF,DF",Newcastle Utd,eng Premier League,25,1995,21.6,52,29,23,22,7,14,35,40.0,21,32,9,23,43,95,47,0,Matches
1106,Eden Hazard,be BEL,"FW,MF",Real Madrid,es La Liga,29,1991,5.9,3,2,1,2,0,0,3,0.0,3,3,0,3,3,6,0,0,Matches
1107,Thorgan Hazard,be BEL,"MF,FW",Dortmund,de Bundesliga,27,1993,7.3,8,2,6,1,1,3,13,23.1,10,4,0,4,10,18,1,0,Matches
1108,Jonas Hector,de GER,"MF,FW",Köln,de Bundesliga,30,1990,14.3,34,22,8,21,5,15,35,42.9,20,24,5,19,19,53,20,1,Matches
1109,Michael Hector,jm JAM,DF,Fulham,eng Premier League,28,1992,2.9,3,2,1,2,0,1,6,16.7,5,4,2,2,0,3,6,0,Matches
1110,Hwang Hee-chan,kr KOR,"FW,MF",RB Leipzig,de Bundesliga,24,1996,5.1,3,2,1,0,2,1,7,14.3,6,4,0,4,1,4,1,0,Matches
1111,Ahmed Hegazi,eg EGY,DF,West Brom,eng Premier League,29,1991,1.0,0,0,0,0,0,0,0,,0,2,0,2,1,1,7,0,Matches
1112,Dominique Heintz,de GER,DF,Freiburg,de Bundesliga,26,1993,15.2,22,11,19,3,0,10,19,52.6,9,10,8,2,35,57,49,0,Matches
1113,Dean Henderson,eng ENG,GK,Manchester Utd,eng Premier League,23,1997,12.5,1,1,1,0,0,1,2,50.0,1,0,0,0,0,1,3,2,Matches
1114,Jordan Henderson,eng ENG,"MF,DF",Liverpool,eng Premier League,30,1990,18.9,24,15,12,9,3,10,26,38.5,16,12,1,11,34,58,30,0,Matches
1115,Jeff Hendrick,ie IRL,MF,Newcastle Utd,eng Premier League,28,1992,15.8,8,3,5,3,0,1,13,7.7,12,14,9,5,19,27,18,0,Matches
1116,Benjamin Henrichs,de GER,"DF,MF",RB Leipzig,de Bundesliga,23,1997,6.0,12,7,4,5,3,2,9,22.2,7,9,1,8,8,20,8,0,Matches
1117,Dalbert Henrique,br BRA,DF,Rennes,fr Ligue 1,26,1993,4.1,7,6,4,2,1,6,8,75.0,2,8,2,6,5,12,8,0,Matches
1118,Eduardo Henrique,br BRA,MF,Crotone,it Serie A,25,1995,10.3,5,2,1,4,0,3,12,25.0,9,6,1,5,7,12,7,1,Matches
1119,Luis Henrique,br BRA,"FW,DF",Marseille,fr Ligue 1,18,2001,7.5,5,4,3,1,1,4,9,44.4,5,5,1,4,7,12,4,0,Matches
1120,Christophe Hérelle,mq MTQ,DF,Brest,fr Ligue 1,27,1992,15.3,19,13,12,6,1,10,12,83.3,2,13,9,4,31,50,41,2,Matches
1121,Jérôme Hergault,fr FRA,"DF,MF",Lorient,fr Ligue 1,34,1986,18.1,38,23,22,10,6,17,31,54.8,14,16,2,14,22,60,34,0,Matches
1122,Mario Hermoso,es ESP,DF,Atlético Madrid,es La Liga,25,1995,28.6,55,31,40,11,4,37,61,60.7,24,23,10,13,36,91,73,0,Matches
1123,Aridane Hernández,es ESP,DF,Osasuna,es La Liga,31,1989,22.5,20,11,13,6,1,7,12,58.3,5,22,19,3,34,54,127,1,Matches
1124,Lucas Hernández,fr FRA,DF,Bayern Munich,de Bundesliga,24,1996,17.7,41,31,16,17,8,17,31,54.8,14,24,6,18,19,60,38,0,Matches
1125,Pablo Hernández,es ESP,MF,Leeds United,eng Premier League,35,1985,4.7,5,3,2,1,2,5,16,31.3,11,2,0,2,0,5,0,1,Matches
1126,Theo Hernández,fr FRA,DF,Milan,it Serie A,22,1997,32.6,48,29,22,21,5,19,38,50.0,19,29,6,23,34,82,64,5,Matches
1127,Hernani,br BRA,MF,Parma,it Serie A,26,1994,24.3,51,25,21,27,3,29,66,43.9,37,35,4,31,31,82,40,1,Matches
1128,Ander Herrera,es ESP,MF,Paris S-G,fr Ligue 1,30,1989,20.6,53,35,17,26,10,30,77,39.0,47,31,5,26,31,84,22,1,Matches
1129,Héctor Herrera,mx MEX,MF,Atlético Madrid,es La Liga,30,1990,7.6,12,7,5,6,1,7,13,53.8,6,7,2,5,14,26,8,0,Matches
1130,Sergio Herrera,es ESP,GK,Osasuna,es La Liga,27,1993,32.9,0,0,0,0,0,0,2,0.0,2,0,0,0,3,3,29,3,Matches
1131,Yangel Herrera,ve VEN,MF,Granada,es La Liga,22,1998,25.7,59,26,19,32,8,11,41,26.8,30,53,17,36,26,85,32,1,Matches
1132,Patrick Herrmann,de GER,"FW,MF",Gladbach,de Bundesliga,29,1991,9.7,9,6,4,3,2,2,14,14.3,12,16,0,16,10,19,8,0,Matches
1133,Pablo Hervías,es ESP,"DF,MF",Valladolid,es La Liga,27,1993,13.4,19,12,7,9,3,9,26,34.6,17,6,0,6,11,30,8,0,Matches
1134,Përparim Hetemaj,fi FIN,MF,Benevento,it Serie A,33,1986,24.6,44,27,21,18,5,26,61,42.6,35,41,5,36,22,66,24,1,Matches
1135,Son Heung-min,kr KOR,FW,Tottenham,eng Premier League,28,1992,34.6,32,18,11,14,7,18,72,25.0,54,28,3,25,14,46,8,0,Matches
1136,Aaron Hickey,sct SCO,DF,Bologna,it Serie A,18,2002,8.4,12,8,10,2,0,7,17,41.2,10,6,1,5,15,27,15,1,Matches
1137,Vitorino Hilton,br BRA,DF,Montpellier,fr Ligue 1,42,1977,23.5,15,10,10,4,1,3,14,21.4,11,34,26,8,38,53,104,3,Matches
1138,Martin Hinteregger,at AUT,DF,Eint Frankfurt,de Bundesliga,27,1992,28.1,77,49,53,22,2,37,63,58.7,26,31,12,19,44,121,92,0,Matches
1139,Marwin Hitz,ch SUI,GK,Dortmund,de Bundesliga,32,1987,15.5,1,1,1,0,0,1,1,100.0,0,0,0,0,0,1,7,1,Matches
1140,Wesley Hoedt,nl NED,DF,Lazio,it Serie A,26,1994,10.6,22,16,18,4,0,10,17,58.8,7,9,5,4,17,39,48,1,Matches
1141,Ki-Jana Hoever,nl NED,"DF,MF",Wolves,eng Premier League,18,2002,6.4,14,6,11,2,1,10,22,45.5,12,2,0,2,9,23,23,0,Matches
1142,Nicolas Höfler,de GER,MF,Freiburg,de Bundesliga,30,1990,30.3,54,28,16,31,7,23,59,39.0,36,34,10,24,66,120,41,2,Matches
1143,Jonas Hofmann,de GER,"FW,MF",Gladbach,de Bundesliga,28,1992,20.2,26,20,12,12,2,10,53,18.9,43,27,2,25,27,53,9,0,Matches
1144,Marco Höger,de GER,"DF,MF",Köln,de Bundesliga,30,1989,0.6,1,0,0,1,0,1,2,50.0,1,2,0,2,2,3,1,0,Matches
1145,Rob Holding,eng ENG,DF,Arsenal,eng Premier League,24,1995,28.4,43,20,28,13,2,17,35,48.6,18,37,27,10,24,67,120,0,Matches
1146,Lucas Höler,de GER,"FW,MF",Freiburg,de Bundesliga,26,1994,23.2,36,24,13,19,4,12,32,37.5,20,19,2,17,16,52,14,0,Matches
1147,Mason Holgate,eng ENG,DF,Everton,eng Premier League,23,1996,25.4,56,36,31,18,7,20,50,40.0,30,37,13,24,35,91,90,3,Matches
1148,Jordan Holsgrove,sct SCO,MF,Celta Vigo,es La Liga,20,1999,1.6,6,4,4,1,1,5,8,62.5,3,2,0,2,2,8,1,0,Matches
1149,Franck Honorat,fr FRA,"MF,FW",Brest,fr Ligue 1,23,1996,27.3,28,13,12,10,6,14,37,37.8,23,15,3,12,11,39,24,0,Matches
1150,Matthew Hoppe,us USA,FW,Schalke 04,de Bundesliga,19,2001,14.5,6,6,1,3,2,2,12,16.7,10,8,2,6,4,10,15,0,Matches
1151,Jannes Horn,de GER,DF,Köln,de Bundesliga,23,1997,19.6,35,19,23,11,1,23,31,74.2,8,19,2,17,10,45,45,0,Matches
1152,Timo Horn,de GER,GK,Köln,de Bundesliga,27,1993,33.4,1,0,1,0,0,1,4,25.0,3,1,0,1,0,1,11,2,Matches
1153,Fraser Hornby,sct SCO,"FW,MF",Reims,fr Ligue 1,20,1999,0.4,0,0,0,0,0,0,0,,0,0,0,0,1,1,0,0,Matches
1154,Conor Hourihane,ie IRL,MF,Aston Villa,eng Premier League,29,1991,2.5,0,0,0,0,0,0,2,0.0,2,3,0,3,0,0,2,0,Matches
1155,Lukáš Hrádecký,fi FIN,GK,Leverkusen,de Bundesliga,30,1989,28.5,0,0,0,0,0,0,1,0.0,1,0,0,0,1,1,11,3,Matches
1156,Ajdin Hrustic,au AUS,"MF,DF",Eint Frankfurt,de Bundesliga,24,1996,3.0,6,5,2,3,1,3,10,30.0,7,2,0,2,4,10,3,0,Matches
1157,Florian Hübner,de GER,DF,Union Berlin,de Bundesliga,29,1991,5.8,10,5,7,3,0,7,15,46.7,8,7,3,4,13,23,21,0,Matches
1158,Callum Hudson-Odoi,eng ENG,"FW,DF",Chelsea,eng Premier League,19,2000,11.8,23,15,11,7,5,8,21,38.1,13,15,1,14,6,29,6,0,Matches
1159,Niall Huggins,wls WAL,DF,Leeds United,eng Premier League,19,2000,0.4,0,0,0,0,0,0,1,0.0,1,0,0,0,0,0,1,0,Matches
1160,Mats Hummels,de GER,DF,Dortmund,de Bundesliga,31,1988,31.3,58,40,34,18,6,26,42,61.9,16,31,22,9,73,131,122,2,Matches
1161,Adrien Hunou,fr FRA,"FW,MF",Rennes,fr Ligue 1,26,1994,6.5,6,3,2,2,2,2,8,25.0,6,7,0,7,1,7,2,0,Matches
1162,Klaas-Jan Huntelaar,nl NED,FW,Schalke 04,de Bundesliga,36,1983,6.5,4,2,0,2,2,0,2,0.0,2,3,1,2,2,6,3,0,Matches
1163,Elseid Hysaj,al ALB,DF,Napoli,it Serie A,26,1994,19.6,29,17,16,11,2,17,33,51.5,16,18,4,14,30,59,52,0,Matches
1164,Pierre Højbjerg,dk DEN,MF,Tottenham,eng Premier League,24,1995,38.0,98,51,45,42,11,54,129,41.9,75,51,9,42,48,146,66,0,Matches
1165,Simone Iacoponi,it ITA,DF,Parma,it Serie A,33,1987,13.3,22,12,16,5,1,13,26,50.0,13,9,4,5,11,33,42,1,Matches
1166,Iago,br BRA,DF,Augsburg,de Bundesliga,23,1997,17.3,37,27,21,13,3,17,29,58.6,12,17,5,12,22,59,55,0,Matches
1167,Roger Ibanez,br BRA,DF,Roma,it Serie A,21,1998,26.6,59,37,28,25,6,25,45,55.6,20,38,17,21,68,127,78,3,Matches
1168,Vedad Ibišević,ba BIH,FW,Schalke 04,de Bundesliga,35,1984,1.7,0,0,0,0,0,0,0,,0,1,0,1,1,1,1,0,Matches
1169,Vicente Iborra,es ESP,MF,Villarreal,es La Liga,32,1988,10.3,18,8,8,7,3,8,24,33.3,16,14,7,7,14,32,25,1,Matches
1170,Didier Ibrahim Ndong,ga GAB,MF,Dijon,fr Ligue 1,26,1994,29.0,53,32,22,30,1,25,70,35.7,45,35,7,28,37,90,40,0,Matches
1171,Zlatan Ibrahimović,se SWE,FW,Milan,it Serie A,38,1981,16.6,5,4,0,4,1,3,6,50.0,3,5,3,2,6,11,27,1,Matches
1172,Mauro Icardi,ar ARG,FW,Paris S-G,fr Ligue 1,27,1993,12.0,6,2,1,2,3,4,13,30.8,9,3,1,2,3,9,7,0,Matches
1173,Oussama Idrissi,ma MAR,"FW,MF",Sevilla,es La Liga,24,1996,0.3,1,1,0,1,0,1,2,50.0,1,2,0,2,1,2,0,0,Matches
1174,Blendi Idrizi,xk KVX,MF,Schalke 04,de Bundesliga,22,1998,2.6,8,4,1,6,1,1,1,100.0,0,6,2,4,3,11,1,0,Matches
1175,Odion Ighalo,ng NGA,FW,Manchester Utd,eng Premier League,31,1989,0.1,0,0,0,0,0,0,1,0.0,1,0,0,0,0,0,0,0,Matches
1176,Iglesias,es ESP,"DF,MF",Getafe,es La Liga,22,1998,6.7,27,15,14,10,3,11,19,57.9,8,11,1,10,17,44,19,0,Matches
1177,Borja Iglesias,es ESP,FW,Betis,es La Liga,27,1993,15.7,1,1,0,0,1,1,8,12.5,7,7,2,5,3,4,9,0,Matches
1178,Igor,br BRA,DF,Fiorentina,it Serie A,22,1998,13.0,15,9,9,6,0,7,12,58.3,5,17,9,8,23,38,34,0,Matches
1179,Kelechi Iheanacho,ng NGA,FW,Leicester City,eng Premier League,23,1996,16.2,12,5,2,4,6,4,17,23.5,13,14,0,14,2,14,1,1,Matches
1180,Jonathan Ikone,fr FRA,"MF,FW",Lille,fr Ligue 1,22,1998,24.2,18,12,3,8,7,9,22,40.9,13,16,1,15,7,25,9,0,Matches
1181,Yun Il-lok,kr KOR,"MF,FW",Montpellier,fr Ligue 1,28,1992,3.5,0,0,0,0,0,0,4,0.0,4,0,0,0,5,5,1,0,Matches
1182,Ivan Ilić,rs SRB,MF,Hellas Verona,it Serie A,19,2001,20.4,26,14,11,11,4,7,21,33.3,14,17,5,12,27,53,26,0,Matches
1183,Josip Iličić,si SVN,"MF,FW",Atalanta,it Serie A,32,1988,17.0,9,4,1,5,3,5,21,23.8,16,12,0,12,2,11,0,1,Matches
1184,Asier Illarramendi,es ESP,MF,Real Sociedad,es La Liga,30,1990,3.7,5,2,1,4,0,1,5,20.0,4,2,0,2,5,10,7,0,Matches
1185,Stefan Ilsanker,at AUT,"MF,DF",Eint Frankfurt,de Bundesliga,31,1989,17.5,33,20,17,15,1,21,42,50.0,21,30,8,22,30,63,51,2,Matches
1186,Ciro Immobile,it ITA,FW,Lazio,it Serie A,30,1990,31.7,14,13,4,6,4,7,22,31.8,15,13,1,12,6,20,9,0,Matches
1187,Riccardo Improta,it ITA,"DF,MF",Benevento,it Serie A,26,1993,25.9,39,23,25,8,6,21,45,46.7,24,23,4,19,28,67,47,0,Matches
1188,Roberto Inglese,it ITA,FW,Parma,it Serie A,28,1991,6.4,5,2,1,2,2,2,11,18.2,9,10,0,10,0,5,3,0,Matches
1189,Danny Ings,eng ENG,FW,Southampton,eng Premier League,28,1992,24.1,22,13,3,16,3,12,28,42.9,16,39,2,37,3,25,27,1,Matches
1190,Marcus Ingvartsen,dk DEN,"MF,FW",Union Berlin,de Bundesliga,24,1996,21.8,17,11,5,6,6,8,26,30.8,18,22,0,22,18,35,10,0,Matches
1191,Lorenzo Insigne,it ITA,FW,Napoli,it Serie A,29,1991,31.8,26,18,8,12,6,13,72,18.1,59,30,1,29,37,63,6,1,Matches
1192,Roberto Insigne,it ITA,"MF,FW",Benevento,it Serie A,26,1994,17.8,16,10,8,3,5,7,27,25.9,20,10,0,10,7,23,9,0,Matches
1193,Pablo Insua,es ESP,DF,Huesca,es La Liga,26,1993,17.6,37,18,26,9,2,14,31,45.2,17,14,8,6,24,61,68,0,Matches
1194,Takashi Inui,jp JPN,"MF,FW",Eibar,es La Liga,32,1988,20.2,13,8,6,3,4,3,12,25.0,9,19,0,19,12,25,7,0,Matches
1195,Artur Ioniță,md MDA,MF,Benevento,it Serie A,29,1990,31.5,47,22,11,31,5,17,63,27.0,46,38,14,24,19,66,28,0,Matches
1196,Alexander Isak,se SWE,FW,Real Sociedad,es La Liga,20,1999,26.0,9,5,0,3,6,3,8,37.5,5,17,1,16,3,12,7,0,Matches
1197,Isco,es ESP,MF,Real Madrid,es La Liga,28,1992,10.1,13,9,5,5,3,2,14,14.3,12,7,1,6,2,15,2,0,Matches
1198,Ardian Ismajli,al ALB,DF,Spezia,it Serie A,23,1996,14.4,19,9,10,8,1,8,13,61.5,5,10,7,3,23,42,52,1,Matches
1199,Abass Issah,gh GHA,"DF,FW",Mainz 05,de Bundesliga,21,1998,0.2,0,0,0,0,0,0,0,,0,0,0,0,0,0,0,0,Matches
1200,Branislav Ivanović,rs SRB,DF,West Brom,eng Premier League,36,1984,8.5,14,5,11,3,0,7,13,53.8,6,11,5,6,8,22,25,0,Matches
1201,Alex Iwobi,ng NGA,"FW,MF",Everton,eng Premier League,24,1996,17.1,27,10,10,14,3,13,25,52.0,12,20,1,19,16,43,14,0,Matches
1202,Jairo Izquierdo,es ESP,"MF,DF",Cádiz,es La Liga,26,1993,14.2,21,13,13,8,0,12,31,38.7,19,7,1,6,14,35,12,0,Matches
1203,José Izquierdo,co COL,DF,Brighton,eng Premier League,28,1992,0.1,0,0,0,0,0,0,0,,0,0,0,0,0,0,0,0,Matches
1204,Armando Izzo,it ITA,DF,Torino,it Serie A,28,1992,22.3,30,16,13,13,4,13,33,39.4,20,22,9,13,53,83,62,0,Matches
1205,Phil Jagielka,eng ENG,DF,Sheffield Utd,eng Premier League,37,1982,5.8,5,4,4,0,1,2,7,28.6,5,11,5,6,10,15,26,2,Matches
1206,Alireza Jahanbakhsh,ir IRN,"FW,MF",Brighton,eng Premier League,26,1993,5.9,9,7,3,5,1,2,12,16.7,10,8,0,8,8,17,1,0,Matches
1207,Mato Jajalo,ba BIH,MF,Udinese,it Serie A,32,1988,0.4,1,1,1,0,0,1,1,100.0,0,1,0,1,2,3,0,0,Matches
1208,Ismail Jakobs,sn SEN,"MF,FW",Köln,de Bundesliga,20,1999,19.2,25,10,17,4,4,11,21,52.4,10,18,1,17,16,41,36,0,Matches
1209,Daniel James,wls WAL,FW,Manchester Utd,eng Premier League,22,1997,10.1,15,9,4,7,4,3,18,16.7,15,10,1,9,0,15,6,0,Matches
1210,Reece James,eng ENG,DF,Chelsea,eng Premier League,20,1999,26.4,55,35,24,22,9,21,44,47.7,23,36,7,29,17,72,52,0,Matches
1211,Alexandre Jankewitz,ch SUI,MF,Southampton,eng Premier League,18,2001,0.0,2,1,2,0,0,1,1,100.0,0,0,0,0,0,2,0,0,Matches
1212,Saidy Janko,gm GAM,DF,Valladolid,es La Liga,24,1995,13.6,19,10,12,5,2,8,14,57.1,6,9,1,8,18,37,47,0,Matches
1213,Jakub Jankto,cz CZE,MF,Sampdoria,it Serie A,24,1996,26.8,28,17,14,7,7,11,35,31.4,24,16,1,15,24,52,34,0,Matches
1214,Tony Jantschke,de GER,DF,Gladbach,de Bundesliga,30,1990,3.0,2,2,1,1,0,1,3,33.3,2,6,4,2,4,6,7,0,Matches
1215,Adnan Januzaj,be BEL,"FW,MF",Real Sociedad,es La Liga,25,1995,11.3,9,8,0,6,3,3,8,37.5,5,7,2,5,3,12,4,0,Matches
1216,Rune Jarstein,no NOR,GK,Hertha BSC,de Bundesliga,35,1984,8.0,0,0,0,0,0,0,0,,0,0,0,0,0,0,7,1,Matches
1217,Jason,es ESP,"MF,DF",Valencia,es La Liga,26,1994,4.9,9,3,5,2,2,4,16,25.0,12,6,1,5,10,19,4,0,Matches
1218,Luis Javier Suárez,co COL,"FW,MF",Granada,es La Liga,22,1997,18.5,19,11,5,7,7,6,17,35.3,11,10,1,9,8,27,11,0,Matches
1219,Corentin Jean,fr FRA,"FW,MF",Lens,fr Ligue 1,25,1995,6.4,4,3,1,1,2,0,5,0.0,5,4,0,4,2,6,2,0,Matches
1220,Daniel Jebbison,eng ENG,FW,Sheffield Utd,eng Premier League,16,2003,3.2,6,2,1,3,2,3,7,42.9,4,6,1,5,1,7,0,0,Matches
1221,Tin Jedvaj,hr CRO,DF,Leverkusen,de Bundesliga,24,1995,1.7,5,2,2,3,0,1,3,33.3,2,2,1,1,2,7,9,0,Matches
1222,Fredrik Jensen,fi FIN,"FW,MF",Augsburg,de Bundesliga,22,1997,4.2,3,2,1,2,0,3,6,50.0,3,4,1,3,2,5,6,0,Matches
1223,Jesé,es ESP,FW,Paris S-G,fr Ligue 1,27,1993,0.3,0,0,0,0,0,0,1,0.0,1,0,0,0,0,0,0,0,Matches
1224,Gabriel Jesus,br BRA,FW,Manchester City,eng Premier League,23,1997,22.9,17,6,5,5,7,11,28,39.3,17,16,0,16,15,32,5,0,Matches
1225,Juan Jesus,br BRA,DF,Roma,it Serie A,29,1991,1.7,3,1,2,1,0,2,4,50.0,2,1,0,1,2,5,5,0,Matches
1226,Raúl Jiménez,mx MEX,FW,Wolves,eng Premier League,29,1991,9.1,3,2,1,2,0,0,7,0.0,7,2,0,2,8,11,12,0,Matches
1227,Joaquín,es ESP,"FW,MF",Betis,es La Liga,39,1981,14.3,9,3,1,5,3,4,12,33.3,8,8,0,8,17,26,11,0,Matches
1228,John Joe,ie IRL,"MF,FW",Getafe,es La Liga,16,2003,0.7,2,0,0,2,0,0,0,,0,0,0,0,0,2,0,0,Matches
1229,Joelinton,br BRA,"FW,MF",Newcastle Utd,eng Premier League,23,1996,22.0,33,21,7,21,5,14,37,37.8,23,30,2,28,9,42,24,0,Matches
1230,Marco John,de GER,DF,Hoffenheim,de Bundesliga,18,2002,11.1,21,15,9,5,7,10,22,45.5,12,18,1,17,16,37,21,0,Matches
1231,Ben Johnson,eng ENG,"DF,FW",West Ham,eng Premier League,20,2000,5.8,11,5,5,3,3,7,9,77.8,2,5,1,4,11,22,9,0,Matches
1232,Sam Johnstone,eng ENG,GK,West Brom,eng Premier League,27,1993,37.0,0,0,0,0,0,0,0,,0,0,0,0,2,2,15,2,Matches
1233,Curtis Jones,eng ENG,MF,Liverpool,eng Premier League,19,2001,13.1,16,6,6,7,3,12,25,48.0,13,13,0,13,19,35,11,1,Matches
1234,Frenkie de Jong,nl NED,"MF,DF",Barcelona,es La Liga,23,1997,35.0,44,27,21,19,4,15,35,42.9,20,20,4,16,38,82,29,2,Matches
1235,Luuk de Jong,nl NED,FW,Sevilla,es La Liga,29,1990,14.1,9,5,3,2,4,1,7,14.3,6,11,3,8,5,14,15,0,Matches
1236,Jony,es ESP,"MF,FW",Osasuna,es La Liga,29,1991,9.7,7,3,1,2,4,5,20,25.0,15,5,0,5,14,21,3,0,Matches
1237,Joan Jordán,es ESP,MF,Sevilla,es La Liga,26,1994,26.7,52,28,17,29,6,17,76,22.4,59,22,3,19,27,79,25,0,Matches
1238,Jorginho,it ITA,MF,Chelsea,eng Premier League,28,1991,22.3,57,30,22,31,4,31,76,40.8,45,33,5,28,40,97,21,3,Matches
1239,Josan,es ESP,"MF,DF",Elche,es La Liga,30,1989,21.4,34,18,23,11,0,13,39,33.3,26,24,1,23,21,55,26,1,Matches
1240,Willian José,br BRA,FW,Wolves,eng Premier League,28,1991,12.3,2,1,1,1,0,1,4,25.0,3,6,1,5,1,3,12,0,Matches
1241,Willian José,br BRA,FW,Real Sociedad,es La Liga,28,1991,7.7,3,1,0,3,0,1,3,33.3,2,3,1,2,0,3,8,0,Matches
1242,Joselu,es ESP,FW,Alavés,es La Liga,30,1990,33.6,27,14,6,15,6,8,28,28.6,20,26,3,23,15,42,58,1,Matches
1243,Josema,es ESP,DF,Elche,es La Liga,24,1996,21.8,43,28,33,10,0,10,18,55.6,8,17,7,10,37,80,92,0,Matches
1244,Jota,pt POR,"MF,FW",Valladolid,es La Liga,21,1999,7.4,7,3,1,4,2,5,10,50.0,5,4,0,4,6,13,5,1,Matches
1245,Jota,es ESP,MF,Alavés,es La Liga,29,1991,15.5,19,14,6,7,6,3,29,10.3,26,12,0,12,9,28,9,0,Matches
1246,Diogo Jota,pt POR,FW,Liverpool,eng Premier League,23,1996,12.4,12,6,4,7,1,2,29,6.9,27,9,0,9,5,17,3,0,Matches
1247,Stevan Jovetić,me MNE,"FW,MF",Monaco,fr Ligue 1,30,1989,8.9,8,4,2,3,3,3,13,23.1,10,1,0,1,3,11,3,0,Matches
1248,Luka Jović,rs SRB,FW,Real Madrid,es La Liga,22,1997,1.7,0,0,0,0,0,0,0,,0,0,0,0,0,0,0,0,Matches
1249,Luka Jović,rs SRB,FW,Eint Frankfurt,de Bundesliga,22,1997,9.9,2,0,0,2,0,0,4,0.0,4,3,0,3,1,3,7,0,Matches
1250,Juanmi,es ESP,"FW,MF",Betis,es La Liga,27,1993,6.7,13,9,3,5,5,4,18,22.2,14,4,0,4,2,15,4,0,Matches
1251,Hamed Junior Traorè,ci CIV,"MF,FW",Sassuolo,it Serie A,20,2000,19.9,29,17,10,10,9,14,35,40.0,21,27,3,24,18,47,9,0,Matches
1252,Vinicius Júnior,br BRA,FW,Real Madrid,es La Liga,20,2000,21.9,32,22,14,10,8,11,43,25.6,32,28,0,28,7,39,4,0,Matches
1253,James Justin,eng ENG,DF,Leicester City,eng Premier League,22,1998,23.0,61,37,38,18,5,20,41,48.8,21,36,10,26,30,91,58,1,Matches
1254,Musa Juwara,gm GAM,"MF,DF",Bologna,it Serie A,18,2001,0.5,2,2,2,0,0,1,3,33.3,2,1,0,1,0,2,0,0,Matches
1255,Jens Jønsson,dk DEN,MF,Cádiz,es La Liga,27,1993,29.1,55,29,25,25,5,22,52,42.3,30,39,7,32,51,106,45,0,Matches
1256,Ozan Kabak,tr TUR,DF,Liverpool,eng Premier League,20,2000,8.9,19,10,11,4,4,6,9,66.7,3,2,2,0,12,31,28,1,Matches
1257,Ozan Kabak,tr TUR,DF,Schalke 04,de Bundesliga,20,2000,13.8,17,9,11,5,1,6,13,46.2,7,20,11,9,13,30,57,0,Matches
1258,Abdoul Kader Bamba,fr FRA,"FW,MF",Nantes,fr Ligue 1,26,1994,10.2,18,3,7,8,3,11,18,61.1,7,10,0,10,7,25,4,1,Matches
1259,Pavel Kadeřábek,cz CZE,"DF,FW",Hoffenheim,de Bundesliga,28,1992,17.6,15,12,7,6,2,6,15,40.0,9,12,3,9,18,33,31,0,Matches
1260,Tino Kadewere,zw ZIM,FW,Lyon,fr Ligue 1,24,1996,22.3,35,22,12,16,7,17,49,34.7,32,16,3,13,21,56,31,0,Matches
1261,Damian Kądzior,pl POL,"FW,MF",Eibar,es La Liga,28,1992,2.2,1,0,0,1,0,1,5,20.0,4,1,0,1,0,1,0,0,Matches
1262,Florian Kainz,at AUT,"MF,FW",Köln,de Bundesliga,27,1992,5.0,4,2,0,4,0,2,8,25.0,6,7,0,7,3,7,3,0,Matches
1263,Gaël Kakuta,cd COD,"MF,FW",Lens,fr Ligue 1,29,1991,26.6,38,23,10,18,10,8,44,18.2,36,24,3,21,17,55,4,0,Matches
1264,Sasa Kalajdzic,at AUT,FW,Stuttgart,de Bundesliga,23,1997,23.7,16,12,4,5,7,2,17,11.8,15,10,1,9,9,25,21,0,Matches
1265,Arnaud Kalimuendo,fr FRA,FW,Paris S-G,fr Ligue 1,18,2002,0.8,0,0,0,0,0,0,0,,0,0,0,0,0,0,0,0,Matches
1266,Arnaud Kalimuendo,fr FRA,"FW,MF",Lens,fr Ligue 1,18,2002,13.5,8,2,2,2,4,1,7,14.3,6,11,0,11,2,10,2,0,Matches
1267,Nikola Kalinić,hr CRO,FW,Hellas Verona,it Serie A,32,1988,11.8,5,1,2,2,1,0,3,0.0,3,6,0,6,1,6,7,0,Matches
1268,Yayah Kallon,sl SLE,FW,Genoa,it Serie A,19,2001,0.5,0,0,0,0,0,0,0,,0,0,0,0,0,0,0,0,Matches
1269,Samuel Kalu,ng NGA,"FW,MF",Bordeaux,fr Ligue 1,22,1997,10.7,21,12,11,8,2,4,13,30.8,9,14,0,14,9,30,2,0,Matches
1270,Pierre Kalulu,fr FRA,DF,Milan,it Serie A,20,2000,8.1,18,14,11,6,1,10,14,71.4,4,9,3,6,19,37,20,0,Matches
1271,Daichi Kamada,jp JPN,MF,Eint Frankfurt,de Bundesliga,23,1996,26.2,48,28,21,16,11,16,49,32.7,33,18,1,17,14,62,22,0,Matches
1272,Aboubakar Kamara,mr MTN,"FW,MF",Fulham,eng Premier League,25,1995,3.5,2,2,1,1,0,0,5,0.0,5,6,0,6,1,3,0,0,Matches
1273,Aboubakar Kamara,mr MTN,"FW,MF",Dijon,fr Ligue 1,25,1995,6.2,3,1,0,2,1,1,7,14.3,6,1,0,1,0,3,2,0,Matches
1274,Bingourou Kamara,sn SEN,GK,Strasbourg,fr Ligue 1,23,1996,8.0,1,1,1,0,0,1,3,33.3,2,0,0,0,1,2,2,1,Matches
1275,Boubacar Kamara,fr FRA,MF,Marseille,fr Ligue 1,20,1999,32.2,88,51,31,49,8,40,74,54.1,34,36,13,23,34,122,51,0,Matches
1276,Hassane Kamara,ci CIV,"DF,FW",Nice,fr Ligue 1,26,1994,32.9,65,39,40,16,9,27,49,55.1,22,39,12,27,55,120,61,1,Matches
1277,Marcin Kamiński,pl POL,DF,Stuttgart,de Bundesliga,28,1992,2.4,1,1,0,0,1,0,0,,0,2,1,1,1,2,10,0,Matches
1278,Kevin Kampl,si SVN,MF,RB Leipzig,de Bundesliga,29,1990,21.5,38,26,9,24,5,18,35,51.4,17,20,2,18,29,67,14,0,Matches
1279,Harry Kane,eng ENG,FW,Tottenham,eng Premier League,27,1993,34.2,22,12,1,17,4,8,26,30.8,18,28,11,17,11,33,40,0,Matches
1280,Lee Kang-in,kr KOR,"FW,MF",Valencia,es La Liga,19,2001,14.0,15,11,8,4,3,3,31,9.7,28,12,0,12,2,17,0,0,Matches
1281,Wilfried Kanga,ci CIV,FW,Angers,fr Ligue 1,22,1998,1.5,0,0,0,0,0,0,1,0.0,1,1,0,1,0,0,2,0,Matches
1282,N'Golo Kanté,fr FRA,MF,Chelsea,eng Premier League,29,1991,23.8,79,42,39,35,5,27,56,48.2,29,42,4,38,59,138,34,0,Matches
1283,Jimmy Kaparos,de GER,MF,Schalke 04,de Bundesliga,18,2001,0.2,0,0,0,0,0,0,1,0.0,1,0,0,0,0,0,0,0,Matches
1284,Yann Karamoh,fr FRA,"FW,MF",Parma,it Serie A,22,1998,14.4,27,17,8,12,7,11,31,35.5,20,6,0,6,4,31,11,0,Matches
1285,Isaac Karamoko,fr FRA,DF,Sassuolo,it Serie A,18,2002,0.0,1,0,0,0,1,1,1,100.0,0,0,0,0,0,1,0,0,Matches
1286,Atakan Karazor,de GER,"DF,MF",Stuttgart,de Bundesliga,23,1996,11.5,20,12,12,7,1,13,22,59.1,9,18,8,10,21,41,50,2,Matches
1287,Augustus Kargbo,sl SLE,FW,Crotone,it Serie A,20,1999,0.4,0,0,0,0,0,0,0,,0,0,0,0,0,0,0,0,Matches
1288,Loris Karius,de GER,GK,Union Berlin,de Bundesliga,27,1993,3.2,0,0,0,0,0,0,0,,0,0,0,0,0,0,2,0,Matches
1289,Rick Karsdorp,nl NED,DF,Roma,it Serie A,25,1995,28.3,36,23,19,12,5,21,48,43.8,27,18,1,17,30,66,32,0,Matches
1290,Silas Katompa,cd COD,"DF,FW",Stuttgart,de Bundesliga,21,1998,21.3,48,29,19,19,10,21,44,47.7,23,29,1,28,22,70,11,2,Matches
1291,Noah Katterbach,de GER,"DF,MF",Köln,de Bundesliga,19,2001,12.3,18,11,11,6,1,13,21,61.9,8,7,3,4,23,41,22,0,Matches
1292,Eiji Kawashima,jp JPN,GK,Strasbourg,fr Ligue 1,37,1983,24.0,1,0,1,0,0,1,1,100.0,0,0,0,0,0,1,4,2,Matches
1293,Moise Kean,it ITA,"FW,MF",Everton,eng Premier League,20,2000,0.2,0,0,0,0,0,0,0,,0,0,0,0,0,0,0,0,Matches
1294,Moise Kean,it ITA,FW,Paris S-G,fr Ligue 1,20,2000,18.9,11,8,2,6,3,3,12,25.0,9,7,1,6,8,19,10,0,Matches
1295,Michael Keane,eng ENG,DF,Everton,eng Premier League,27,1993,33.2,28,15,20,8,0,14,31,45.2,17,46,33,13,51,79,161,0,Matches
1296,Neeskens Kebano,cd COD,"FW,MF",Fulham,eng Premier League,28,1992,1.3,0,0,0,0,0,0,1,0.0,1,3,0,3,0,0,0,0,Matches
1297,Thilo Kehrer,de GER,DF,Paris S-G,fr Ligue 1,23,1996,18.0,31,26,17,11,3,10,26,38.5,16,16,4,12,15,46,37,1,Matches
1298,Habib Keita,ml MLI,MF,Lyon,fr Ligue 1,18,2002,0.1,0,0,0,0,0,0,0,,0,0,0,0,0,0,0,0,Matches
1299,Naby Keïta,gn GUI,MF,Liverpool,eng Premier League,25,1995,5.8,11,5,1,8,2,7,17,41.2,10,10,0,10,9,20,6,0,Matches
1300,Yannik Keitel,de GER,MF,Freiburg,de Bundesliga,20,2000,5.5,12,8,7,4,1,7,9,77.8,2,9,3,6,10,22,8,0,Matches
1301,Caoimhín Kelleher,ie IRL,GK,Liverpool,eng Premier League,21,1998,2.0,0,0,0,0,0,0,0,,0,0,0,0,0,0,2,0,Matches
1302,Stephane Keller,cm CMR,DF,Alavés,es La Liga,18,2001,0.2,1,0,1,0,0,1,1,100.0,0,0,0,0,0,1,0,0,Matches
1303,Martin Kelly,eng ENG,DF,Crystal Palace,eng Premier League,30,1990,0.0,1,0,1,0,0,1,1,100.0,0,0,0,0,0,1,0,0,Matches
1304,Marc-Oliver Kempf,de GER,DF,Stuttgart,de Bundesliga,25,1995,30.3,49,26,28,18,3,29,49,59.2,20,40,25,15,68,117,103,1,Matches
1305,Kenedy,br BRA,"FW,MF",Granada,es La Liga,24,1996,16.3,22,12,10,7,5,5,25,20.0,20,21,4,17,26,48,15,1,Matches
1306,Jonjoe Kenny,eng ENG,DF,Everton,eng Premier League,23,1997,0.9,2,1,1,0,1,2,2,100.0,0,0,0,0,1,3,3,0,Matches
1307,Franck Kessié,ci CIV,MF,Milan,it Serie A,23,1996,35.8,53,30,28,19,6,20,38,52.6,18,47,15,32,46,99,51,0,Matches
1308,Reda Khadra,de GER,MF,Brighton,eng Premier League,19,2001,0.1,0,0,0,0,0,0,0,,0,0,0,0,0,0,0,0,Matches
1309,Omar Khailoti,it ITA,DF,Bologna,it Serie A,18,2001,0.3,0,0,0,0,0,0,0,,0,2,0,2,1,1,0,0,Matches
1310,Saîf-Eddine Khaoui,tn TUN,"FW,DF",Marseille,fr Ligue 1,25,1995,6.7,19,11,7,6,6,7,16,43.8,9,8,0,8,12,31,1,0,Matches
1311,Wahbi Khazri,tn TUN,FW,Saint-Étienne,fr Ligue 1,29,1991,13.1,24,15,12,7,5,12,24,50.0,12,10,1,9,4,28,11,0,Matches
1312,Rani Khedira,de GER,MF,Augsburg,de Bundesliga,26,1994,20.2,29,10,13,15,1,10,20,50.0,10,14,5,9,31,60,47,0,Matches
1313,Sami Khedira,de GER,MF,Hertha BSC,de Bundesliga,33,1987,4.4,11,6,3,7,1,6,12,50.0,6,4,0,4,9,20,7,0,Matches
1314,Kiké,es ESP,FW,Eibar,es La Liga,30,1989,34.3,24,18,5,7,12,6,22,27.3,16,24,1,23,7,31,29,0,Matches
1315,Luca Kilian,de GER,DF,Mainz 05,de Bundesliga,20,1999,4.2,14,7,10,4,0,9,17,52.9,8,3,1,2,13,27,12,0,Matches
1316,Max Kilman,eng ENG,DF,Wolves,eng Premier League,23,1997,14.6,21,14,13,4,4,8,14,57.1,6,17,8,9,19,40,46,0,Matches
1317,Joshua Kimmich,de GER,MF,Bayern Munich,de Bundesliga,25,1995,24.4,40,28,16,19,5,10,53,18.9,43,25,5,20,36,76,19,0,Matches
1318,Presnel Kimpembe,fr FRA,DF,Paris S-G,fr Ligue 1,24,1995,25.6,46,28,23,19,4,24,34,70.6,10,19,11,8,30,76,61,4,Matches
1319,Joshua King,no NOR,"MF,FW",Everton,eng Premier League,28,1992,1.6,4,1,2,1,1,0,0,,0,3,0,3,1,5,1,0,Matches
1320,Simon Kjær,dk DEN,DF,Milan,it Serie A,31,1989,26.6,45,26,23,20,2,18,30,60.0,12,42,26,16,42,87,125,0,Matches
1321,Davy Klaassen,nl NED,MF,Werder Bremen,de Bundesliga,27,1993,2.5,3,1,0,1,2,0,5,0.0,5,5,1,4,3,6,4,0,Matches
1322,Felix Klaus,de GER,"DF,MF",Wolfsburg,de Bundesliga,27,1992,1.5,7,4,3,4,0,4,5,80.0,1,4,0,4,2,9,4,0,Matches
1323,Klauss,br BRA,"MF,FW",Hoffenheim,de Bundesliga,23,1997,0.6,1,0,0,0,1,0,1,0.0,1,0,0,0,0,1,0,0,Matches
1324,Ragnar Klavan,ee EST,DF,Cagliari,it Serie A,34,1985,8.6,15,9,9,5,1,7,11,63.6,4,9,4,5,8,23,34,0,Matches
1325,Philipp Klement,de GER,"MF,FW",Stuttgart,de Bundesliga,27,1992,4.7,7,3,6,0,1,3,7,42.9,4,9,2,7,6,13,7,0,Matches
1326,Mateusz Klich,pl POL,MF,Leeds United,eng Premier League,30,1990,26.6,38,20,14,20,4,14,61,23.0,47,13,4,9,11,49,16,0,Matches
1327,Mateo Klimowicz,de GER,"MF,FW",Stuttgart,de Bundesliga,20,2000,13.3,20,15,6,10,4,5,18,27.8,13,5,1,4,2,22,2,0,Matches
1328,Fabian Klos,de GER,FW,Arminia,de Bundesliga,32,1987,30.1,24,13,9,11,4,7,26,26.9,19,20,6,14,4,28,29,0,Matches
1329,Lukas Klostermann,de GER,DF,RB Leipzig,de Bundesliga,24,1996,16.1,23,19,8,12,3,11,18,61.1,7,16,6,10,18,41,44,1,Matches
1330,Justin Kluivert,nl NED,MF,Roma,it Serie A,21,1999,0.2,0,0,0,0,0,0,0,,0,0,0,0,0,0,0,0,Matches
1331,Justin Kluivert,nl NED,"FW,MF",RB Leipzig,de Bundesliga,21,1999,9.0,2,1,1,1,0,0,2,0.0,2,4,0,4,5,7,3,0,Matches
1332,Lukas Klünter,de GER,DF,Hertha BSC,de Bundesliga,24,1996,11.0,10,5,6,4,0,5,10,50.0,5,3,1,2,11,21,29,1,Matches
1333,Ansgar Knauff,de GER,"MF,FW",Dortmund,de Bundesliga,18,2002,0.8,0,0,0,0,0,0,1,0.0,1,3,1,2,0,0,0,0,Matches
1334,Robin Knoche,de GER,DF,Union Berlin,de Bundesliga,28,1992,33.8,44,29,30,12,2,23,39,59.0,16,43,27,16,49,93,118,2,Matches
1335,Gregor Kobel,ch SUI,GK,Stuttgart,de Bundesliga,22,1997,33.0,2,2,2,0,0,2,2,100.0,0,0,0,0,2,4,8,1,Matches
1336,Robin Koch,de GER,"DF,MF",Leeds United,eng Premier League,24,1996,12.6,27,16,17,10,0,10,19,52.6,9,18,12,6,27,54,34,2,Matches
1337,Giorgi Kochorashvili,ge GEO,MF,Levante,es La Liga,21,1999,0.3,1,0,1,0,0,0,0,,0,0,0,0,0,1,0,0,Matches
1338,Kenan Kodro,ba BIH,"FW,MF",Valladolid,es La Liga,26,1993,5.1,0,0,0,0,0,0,2,0.0,2,2,1,1,2,2,6,0,Matches
1339,Kenan Kodro,ba BIH,"FW,MF",Athletic Club,es La Liga,26,1993,0.5,0,0,0,0,0,0,1,0.0,1,0,0,0,0,0,0,0,Matches
1340,Dominik Kohr,de GER,MF,Mainz 05,de Bundesliga,26,1994,14.1,47,31,14,26,7,20,39,51.3,19,18,5,13,27,74,15,0,Matches
1341,Dominik Kohr,de GER,"MF,DF",Eint Frankfurt,de Bundesliga,26,1994,2.9,11,7,0,7,4,4,9,44.4,5,5,1,4,9,20,9,0,Matches
1342,Koba Koindredi,fr FRA,MF,Valencia,es La Liga,18,2001,0.2,1,1,1,0,0,0,1,0.0,1,0,0,0,0,1,0,0,Matches
1343,Koke,es ESP,MF,Atlético Madrid,es La Liga,28,1992,33.6,64,42,22,31,11,28,98,28.6,70,35,6,29,36,100,40,0,Matches
1344,Aleksandr Kokorin,ru RUS,"FW,MF",Fiorentina,it Serie A,29,1991,1.0,1,0,0,1,0,0,1,0.0,1,1,0,1,0,1,0,0,Matches
1345,Aleksandar Kolarov,rs SRB,DF,Inter,it Serie A,34,1985,4.3,4,4,0,4,0,1,2,50.0,1,2,0,2,7,11,8,0,Matches
1346,Sead Kolašinac,ba BIH,DF,Arsenal,eng Premier League,27,1993,1.0,0,0,0,0,0,0,0,,0,0,0,0,1,1,0,0,Matches
1347,Sead Kolašinac,ba BIH,"DF,MF",Schalke 04,de Bundesliga,27,1993,15.8,20,17,10,7,3,8,18,44.4,10,17,5,12,20,40,17,0,Matches
1348,Randal Kolo Muani,fr FRA,FW,Nantes,fr Ligue 1,21,1998,33.7,22,14,1,13,8,7,27,25.9,20,15,2,13,8,30,26,0,Matches
1349,Timothée Kolodziejczak,fr FRA,DF,Saint-Étienne,fr Ligue 1,28,1991,22.6,28,15,23,5,0,19,27,70.4,8,24,15,9,36,64,80,1,Matches
1350,Ghislain Konan,ci CIV,DF,Reims,fr Ligue 1,24,1995,29.0,57,32,35,17,5,32,56,57.1,24,25,11,14,30,87,67,0,Matches
1351,Ibrahima Konaté,fr FRA,DF,RB Leipzig,de Bundesliga,21,1999,7.7,6,4,2,3,1,2,8,25.0,6,6,3,3,8,14,24,0,Matches
1352,Moussa Konaté,sn SEN,FW,Dijon,fr Ligue 1,27,1993,13.3,5,3,1,2,2,2,11,18.2,9,4,1,3,5,10,8,0,Matches
1353,Geoffrey Kondogbia,cf CTA,MF,Valencia,es La Liga,27,1993,4.9,16,9,9,4,3,7,19,36.8,12,6,1,5,8,24,8,0,Matches
1354,Geoffrey Kondogbia,cf CTA,MF,Atlético Madrid,es La Liga,27,1993,6.8,30,20,12,16,2,11,20,55.0,9,11,5,6,11,41,8,1,Matches
1355,Lamine Koné,ci CIV,DF,Strasbourg,fr Ligue 1,31,1989,11.6,9,6,5,4,0,5,8,62.5,3,4,3,1,15,24,36,0,Matches
1356,Moussa Koné,sn SEN,FW,Nîmes,fr Ligue 1,23,1996,19.5,13,6,1,8,4,2,9,22.2,7,7,1,6,2,15,7,0,Matches
1357,Youssouf Koné,ml MLI,"DF,MF",Elche,es La Liga,25,1995,0.8,2,0,1,0,1,0,1,0.0,1,0,0,0,0,2,0,0,Matches
1358,Terence Kongolo,nl NED,DF,Fulham,eng Premier League,26,1994,1.0,3,2,1,2,0,1,1,100.0,0,0,0,0,2,5,3,0,Matches
1359,Ezri Konsa,eng ENG,DF,Aston Villa,eng Premier League,22,1997,35.5,25,13,18,6,1,9,13,69.2,4,53,47,6,29,54,162,1,Matches
1360,Laurent Koscielny,fr FRA,DF,Bordeaux,fr Ligue 1,34,1985,24.6,29,17,18,11,0,16,24,66.7,8,44,34,10,54,83,115,1,Matches
1361,Filip Kostić,rs SRB,DF,Eint Frankfurt,de Bundesliga,27,1992,28.2,54,31,22,23,9,22,54,40.7,32,43,6,37,26,80,28,2,Matches
1362,Márk Kosznovszky,hu HUN,MF,Parma,it Serie A,18,2002,1.0,2,2,1,1,0,1,4,25.0,3,2,0,2,1,3,1,0,Matches
1363,Christian Kouamé,ci CIV,FW,Fiorentina,it Serie A,22,1997,11.1,9,4,2,4,3,4,12,33.3,8,9,1,8,5,14,4,0,Matches
1364,Kalidou Koulibaly,sn SEN,DF,Napoli,it Serie A,29,1991,24.5,36,24,25,7,4,19,32,59.4,13,46,26,20,29,65,64,2,Matches
1365,Jules Koundé,fr FRA,DF,Sevilla,es La Liga,21,1998,33.1,27,15,14,11,2,10,24,41.7,14,24,16,8,40,67,104,0,Matches
1366,Boubakar Kouyaté,ml MLI,DF,Metz,fr Ligue 1,23,1997,21.8,60,35,45,15,0,32,58,55.2,26,44,27,17,60,120,132,1,Matches
1367,Cheikhou Kouyaté,sn SEN,DF,Crystal Palace,eng Premier League,30,1989,34.7,58,37,44,12,2,25,43,58.1,18,42,26,16,32,90,125,2,Matches
1368,Mateo Kovačić,hr CRO,MF,Chelsea,eng Premier League,26,1994,20.2,46,28,19,24,3,17,32,53.1,15,18,1,17,15,61,11,2,Matches
1369,Viktor Kovalenko,ua UKR,FW,Atalanta,it Serie A,24,1996,0.0,0,0,0,0,0,0,0,,0,0,0,0,0,0,1,0,Matches
1370,Emil Krafth,se SWE,DF,Newcastle Utd,eng Premier League,25,1994,14.3,19,8,9,9,1,12,25,48.0,13,15,9,6,15,34,52,2,Matches
1371,Andrej Kramarić,hr CRO,"FW,MF",Hoffenheim,de Bundesliga,29,1991,26.4,7,4,4,0,3,3,8,37.5,5,8,1,7,7,14,5,1,Matches
1372,Christoph Kramer,de GER,MF,Gladbach,de Bundesliga,29,1991,22.6,55,37,22,28,5,28,58,48.3,30,32,11,21,34,89,39,0,Matches
1373,Jean-Philippe Krasso,ci CIV,FW,Saint-Étienne,fr Ligue 1,23,1997,2.5,5,3,1,4,0,2,4,50.0,2,5,0,5,1,6,3,0,Matches
1374,Toni Kroos,de GER,MF,Real Madrid,es La Liga,30,1990,23.5,42,22,15,15,12,11,44,25.0,33,26,6,20,15,57,10,3,Matches
1375,Filip Krovinović,hr CRO,MF,West Brom,eng Premier League,24,1995,6.1,13,10,6,5,2,6,18,33.3,12,2,0,2,4,17,2,0,Matches
1376,Rade Krunić,ba BIH,"MF,FW",Milan,it Serie A,26,1993,8.0,15,12,6,6,3,7,17,41.2,10,12,2,10,10,25,9,0,Matches
1377,Max Kruse,de GER,"FW,MF",Union Berlin,de Bundesliga,32,1988,18.1,7,3,1,5,1,2,9,22.2,7,11,0,11,3,10,3,0,Matches
1378,Lukas Kübler,de GER,"DF,MF",Freiburg,de Bundesliga,27,1992,9.8,15,8,9,5,1,9,14,64.3,5,9,3,6,21,36,31,0,Matches
1379,Takefusa Kubo,jp JPN,"MF,FW",Villarreal,es La Liga,19,2001,3.3,1,1,0,0,1,1,5,20.0,4,2,0,2,1,2,2,0,Matches
1380,Takefusa Kubo,jp JPN,"MF,FW",Getafe,es La Liga,19,2001,8.9,7,4,2,3,2,1,14,7.1,13,14,0,14,14,21,4,0,Matches
1381,Juraj Kucka,sk SVK,"MF,FW",Parma,it Serie A,33,1987,25.9,67,36,21,37,9,26,74,35.1,48,25,3,22,28,95,25,0,Matches
1382,Kuki,es ESP,MF,Valladolid,es La Liga,22,1998,0.3,1,1,0,0,1,0,1,0.0,1,0,0,0,0,1,0,0,Matches
1383,Dejan Kulusevski,se SWE,"MF,FW",Juventus,it Serie A,20,2000,21.4,33,19,12,10,11,14,43,32.6,29,22,0,22,9,42,2,1,Matches
1384,Marash Kumbulla,al ALB,DF,Roma,it Serie A,20,2000,15.1,16,11,8,7,1,5,17,29.4,12,12,5,7,24,40,38,1,Matches
1385,Pierre Kunde,cm CMR,MF,Mainz 05,de Bundesliga,25,1995,5.7,8,4,1,5,2,2,9,22.2,7,6,0,6,10,18,9,0,Matches
1386,Fabian Kunze,de GER,MF,Arminia,de Bundesliga,22,1998,14.1,38,26,19,15,4,19,42,45.2,23,19,3,16,18,56,22,1,Matches
1387,Jasmin Kurtić,si SVN,MF,Parma,it Serie A,31,1989,30.4,46,28,22,21,3,21,70,30.0,49,22,2,20,33,79,57,1,Matches
1388,Layvin Kurzawa,fr FRA,DF,Paris S-G,fr Ligue 1,27,1992,14.2,26,19,10,10,6,9,28,32.1,19,20,5,15,28,54,26,1,Matches
1389,Dereck Kutesa,ch SUI,"MF,FW",Reims,fr Ligue 1,22,1997,7.6,15,7,7,3,5,5,14,35.7,9,7,1,6,7,22,3,0,Matches
1390,Ahmed Kutucu,tr TUR,"FW,MF",Schalke 04,de Bundesliga,20,2000,1.2,1,0,0,0,1,1,2,50.0,1,1,0,1,0,1,0,0,Matches
1391,Enock Kwateng,fr FRA,DF,Bordeaux,fr Ligue 1,23,1997,11.5,21,12,15,4,2,14,27,51.9,13,15,3,12,26,47,27,0,Matches
1392,Giorgos Kyriakopoulos,gr GRE,DF,Sassuolo,it Serie A,24,1996,16.2,35,18,17,12,6,8,28,28.6,20,16,5,11,15,50,42,0,Matches
1393,Antonino La Gumina,it ITA,FW,Sampdoria,it Serie A,24,1996,3.8,3,2,0,1,2,0,3,0.0,3,5,1,4,3,6,5,0,Matches
1394,Gaëtan Laborde,fr FRA,"FW,MF",Montpellier,fr Ligue 1,26,1994,36.2,43,22,21,17,5,16,60,26.7,44,29,3,26,16,59,25,1,Matches
1395,Alexandre Lacazette,fr FRA,FW,Arsenal,eng Premier League,29,1991,21.4,18,10,4,11,3,4,22,18.2,18,20,1,19,12,30,13,0,Matches
1396,Tom Lacoux,fr FRA,MF,Bordeaux,fr Ligue 1,18,2002,5.8,22,14,10,11,1,9,21,42.9,12,12,3,9,12,34,7,0,Matches
1397,Maxence Lacroix,fr FRA,DF,Wolfsburg,de Bundesliga,20,2000,28.8,49,29,37,12,0,24,45,53.3,21,51,21,30,65,114,140,1,Matches
1398,Alban Lafont,fr FRA,GK,Nantes,fr Ligue 1,21,1999,38.0,1,0,1,0,0,1,1,100.0,0,1,0,1,0,1,14,0,Matches
1399,Víctor Laguardia,es ESP,DF,Alavés,es La Liga,30,1989,29.2,20,12,13,6,1,14,31,45.2,17,25,13,12,37,57,104,0,Matches
1400,Konrad Laimer,at AUT,"DF,MF",RB Leipzig,de Bundesliga,23,1997,0.9,2,0,0,1,1,0,4,0.0,4,2,0,2,1,3,0,0,Matches
1401,Stefan Lainer,at AUT,DF,Gladbach,de Bundesliga,27,1992,30.8,62,37,30,22,10,27,60,45.0,33,34,5,29,35,97,85,1,Matches
1402,Diego Lainez,mx MEX,"FW,MF",Betis,es La Liga,20,2000,9.6,9,4,3,5,1,6,16,37.5,10,15,0,15,11,20,6,0,Matches
1403,Kenny Lala,mg MAD,DF,Strasbourg,fr Ligue 1,28,1991,20.4,22,13,13,8,1,11,22,50.0,11,12,6,6,23,45,33,1,Matches
1404,Adam Lallana,eng ENG,"MF,FW",Brighton,eng Premier League,32,1988,17.7,28,13,11,13,4,8,39,20.5,31,18,3,15,15,43,13,0,Matches
1405,Érik Lamela,ar ARG,"FW,MF",Tottenham,eng Premier League,28,1992,8.0,17,9,1,11,5,8,21,38.1,13,11,1,10,6,23,2,0,Matches
1406,Sam Lammers,nl NED,"FW,MF",Atalanta,it Serie A,23,1997,3.2,2,0,0,2,0,0,6,0.0,6,0,0,0,0,2,3,0,Matches
1407,Tariq Lamptey,gh GHA,"DF,MF",Brighton,eng Premier League,19,2000,9.8,17,9,7,6,4,6,13,46.2,7,8,1,7,19,36,12,1,Matches
1408,Loïck Landre,fr FRA,DF,Nîmes,fr Ligue 1,28,1992,18.1,14,7,9,5,0,13,28,46.4,15,22,19,3,31,45,52,0,Matches
1409,Michael Langer,at AUT,GK,Schalke 04,de Bundesliga,35,1985,2.7,0,0,0,0,0,0,0,,0,0,0,0,0,0,3,0,Matches
1410,Manuel Lanzini,ar ARG,"MF,FW",West Ham,eng Premier League,27,1993,6.3,9,2,3,4,2,3,10,30.0,7,9,0,9,7,16,5,0,Matches
1411,Gianluca Lapadula,pe PER,FW,Benevento,it Serie A,30,1990,28.5,22,12,3,13,6,6,25,24.0,19,18,3,15,5,27,16,0,Matches
1412,Aymeric Laporte,es ESP,DF,Manchester City,eng Premier League,26,1994,14.9,13,6,10,3,0,7,11,63.6,4,12,7,5,11,24,28,0,Matches
1413,Julien Laporte,fr FRA,DF,Lorient,fr Ligue 1,26,1993,29.5,65,39,48,16,1,42,74,56.8,32,34,23,11,65,130,125,0,Matches
1414,Danilo Larangeira,br BRA,DF,Bologna,it Serie A,36,1984,34.8,33,24,23,10,0,8,29,27.6,21,58,36,22,51,84,127,2,Matches
1415,Gautier Larsonneur,fr FRA,GK,Brest,fr Ligue 1,23,1997,35.0,1,1,1,0,0,1,1,100.0,0,2,0,2,0,1,16,3,Matches
1416,Kevin Lasagna,it ITA,FW,Udinese,it Serie A,27,1992,12.3,6,1,2,3,1,3,14,21.4,11,11,0,11,6,12,7,0,Matches
1417,Kevin Lasagna,it ITA,FW,Hellas Verona,it Serie A,27,1992,14.1,7,3,0,5,2,1,5,20.0,4,12,1,11,1,8,11,0,Matches
1418,Jamaal Lascelles,eng ENG,DF,Newcastle Utd,eng Premier League,26,1993,18.1,14,7,5,9,0,3,6,50.0,3,27,17,10,12,26,86,0,Matches
1419,Paul Lasne,fr FRA,MF,Brest,fr Ligue 1,31,1989,18.7,46,26,25,19,2,17,40,42.5,23,25,5,20,47,93,17,2,Matches
1420,Toni Lato,es ESP,DF,Valencia,es La Liga,22,1997,8.1,13,6,7,3,3,6,13,46.2,7,12,1,11,10,23,21,0,Matches
1421,Danny Latza,de GER,MF,Mainz 05,de Bundesliga,30,1989,20.0,43,26,12,19,12,23,70,32.9,47,39,3,36,27,70,23,0,Matches
1422,Armand Lauriente,fr FRA,"MF,FW",Lorient,fr Ligue 1,21,1998,18.0,30,10,10,19,1,7,26,26.9,19,21,0,21,15,45,4,0,Matches
1423,Vincent Laurini,fr FRA,DF,Parma,it Serie A,31,1989,9.7,16,11,8,6,2,7,9,77.8,2,8,4,4,17,33,22,1,Matches
1424,Lauti,uy URU,MF,Celta Vigo,es La Liga,19,2001,0.2,0,0,0,0,0,0,0,,0,0,0,0,0,0,1,0,Matches
1425,Wesley Lautoa,nc NCL,"MF,DF",Dijon,fr Ligue 1,32,1987,17.9,36,20,20,13,3,11,37,29.7,26,17,8,9,29,65,33,1,Matches
1426,Valentino Lazaro,at AUT,"DF,FW",Gladbach,de Bundesliga,24,1996,13.8,17,11,7,5,5,12,19,63.2,7,18,1,17,15,32,20,0,Matches
1427,Darko Lazović,rs SRB,"DF,MF",Hellas Verona,it Serie A,29,1990,27.8,29,17,8,17,4,20,42,47.6,22,17,7,10,20,49,29,0,Matches
1428,Manuel Lazzari,it ITA,DF,Lazio,it Serie A,26,1993,29.0,24,14,15,4,5,14,39,35.9,25,22,3,19,18,42,28,0,Matches
1429,Jérémy Le Douaron,fr FRA,"FW,MF",Brest,fr Ligue 1,22,1998,9.1,15,10,9,4,2,7,21,33.3,14,14,1,13,8,23,11,0,Matches
1430,Enzo Le Fée,fr FRA,MF,Lorient,fr Ligue 1,20,2000,20.2,51,28,23,23,5,27,73,37.0,46,30,6,24,25,76,10,0,Matches
1431,Vincent Le Goff,fr FRA,DF,Lorient,fr Ligue 1,30,1989,25.6,42,29,16,24,2,18,49,36.7,31,27,5,22,44,86,44,0,Matches
1432,Maxime Le Marchand,fr FRA,DF,Fulham,eng Premier League,30,1989,1.4,2,2,2,0,0,2,2,100.0,0,0,0,0,0,2,3,0,Matches
1433,Robin Le Normand,es ESP,DF,Real Sociedad,es La Liga,23,1996,30.5,34,20,25,8,1,9,19,47.4,10,35,24,11,36,70,87,1,Matches
1434,Damien Le Tallec,fr FRA,"MF,DF",Montpellier,fr Ligue 1,30,1990,13.6,16,10,10,4,2,10,30,33.3,20,15,8,7,25,41,21,2,Matches
1435,James Lea Siliki,cm CMR,MF,Rennes,fr Ligue 1,24,1996,2.8,5,2,1,3,1,2,2,100.0,0,3,0,3,1,6,1,1,Matches
1436,Rafael Leão,pt POR,FW,Milan,it Serie A,21,1999,21.4,13,6,4,7,2,6,15,40.0,9,17,0,17,4,17,14,1,Matches
1437,Jean-Louis Leca,fr FRA,GK,Lens,fr Ligue 1,34,1985,36.8,3,2,3,0,0,3,5,60.0,2,0,0,0,1,4,14,4,Matches
1438,Mathew Leckie,au AUS,"FW,DF",Hertha BSC,de Bundesliga,29,1991,5.6,12,3,5,5,2,4,11,36.4,7,8,0,8,13,25,9,0,Matches
1439,Benjamin Lecomte,fr FRA,GK,Monaco,fr Ligue 1,29,1991,28.0,0,0,0,0,0,0,2,0.0,2,1,0,1,2,2,20,1,Matches
1440,Jeremías Ledesma,ar ARG,GK,Cádiz,es La Liga,27,1993,32.0,1,0,1,0,0,1,1,100.0,0,1,0,1,0,1,22,6,Matches
1441,Pierre Lees-Melou,fr FRA,MF,Nice,fr Ligue 1,27,1993,22.9,67,39,33,31,3,25,83,30.1,58,50,14,36,29,96,31,1,Matches
1442,Lucas Leiva,br BRA,MF,Lazio,it Serie A,33,1987,23.7,68,32,38,28,2,30,86,34.9,56,21,0,21,57,125,21,0,Matches
1443,Florian Lejeune,fr FRA,DF,Alavés,es La Liga,29,1991,33.5,43,32,36,7,0,21,35,60.0,14,38,24,14,51,94,149,1,Matches
1444,Iñigo Lekue,es ESP,DF,Athletic Club,es La Liga,27,1993,7.2,9,7,6,3,0,3,8,37.5,5,8,1,7,4,13,24,0,Matches
1445,Thomas Lemar,fr FRA,MF,Atlético Madrid,es La Liga,24,1995,15.2,30,17,9,17,4,11,24,45.8,13,22,1,21,11,41,10,0,Matches
1446,Mario Lemina,ga GAB,MF,Fulham,eng Premier League,26,1993,18.9,62,35,25,30,7,23,44,52.3,21,26,5,21,30,92,21,0,Matches
1447,Fabien Lemoine,fr FRA,MF,Lorient,fr Ligue 1,33,1987,21.5,74,45,39,33,2,36,89,40.4,53,25,1,24,27,101,35,0,Matches
1448,Clément Lenglet,fr FRA,DF,Barcelona,es La Liga,25,1995,27.5,36,21,23,10,3,19,28,67.9,9,26,12,14,33,69,71,1,Matches
1449,Bernd Leno,de GER,GK,Arsenal,eng Premier League,28,1992,34.8,1,0,1,0,0,1,1,100.0,0,1,0,1,0,1,11,2,Matches
1450,Christopher Lenz,de GER,"DF,FW",Union Berlin,de Bundesliga,25,1994,25.0,74,41,39,30,5,35,71,49.3,36,34,5,29,35,109,50,0,Matches
1451,Pedro León,es ESP,"MF,FW",Eibar,es La Liga,33,1986,10.4,9,8,3,3,3,3,17,17.6,14,11,0,11,7,16,2,0,Matches
1452,Sergio León,es ESP,FW,Levante,es La Liga,31,1989,8.3,6,2,0,4,2,2,8,25.0,6,4,0,4,3,9,2,0,Matches
1453,Lukas Lerager,dk DEN,MF,Genoa,it Serie A,27,1993,12.9,24,13,14,9,1,11,30,36.7,19,13,3,10,14,38,25,1,Matches
1454,Mehdi Léris,dz ALG,"DF,MF",Sampdoria,it Serie A,22,1998,4.3,11,5,6,4,1,6,16,37.5,10,12,2,10,12,23,15,0,Matches
1455,Khanya Leshabela,za RSA,MF,Leicester City,eng Premier League,20,1999,0.1,0,0,0,0,0,0,0,,0,0,0,0,0,0,0,0,Matches
1456,Karlo Letica,hr CRO,GK,Sampdoria,it Serie A,23,1997,1.0,0,0,0,0,0,0,0,,0,0,0,0,0,0,2,0,Matches
1457,Gaetano Letizia,it ITA,DF,Benevento,it Serie A,30,1990,17.4,36,25,19,13,4,17,36,47.2,19,15,3,12,20,56,42,1,Matches
1458,Robert Lewandowski,pl POL,FW,Bayern Munich,de Bundesliga,31,1988,27.3,15,9,0,7,8,2,13,15.4,11,9,1,8,3,18,11,0,Matches
1459,Jamal Lewis,nir NIR,DF,Newcastle Utd,eng Premier League,22,1998,20.4,37,20,23,13,1,16,38,42.1,22,21,7,14,11,48,44,1,Matches
1460,Aaron Leya Iseka,be BEL,FW,Metz,fr Ligue 1,22,1997,11.2,6,4,2,3,1,0,4,0.0,4,4,2,2,0,6,6,0,Matches
1461,Yanis Lhery,fr FRA,MF,Saint-Étienne,fr Ligue 1,17,2003,0.3,0,0,0,0,0,0,0,,0,0,0,0,0,0,0,0,Matches
1462,Dimitri Liénard,fr FRA,MF,Strasbourg,fr Ligue 1,32,1988,20.3,39,27,17,19,3,24,55,43.6,31,23,1,22,18,57,10,0,Matches
1463,Philipp Lienhart,at AUT,DF,Freiburg,de Bundesliga,24,1996,33.3,21,13,12,7,2,9,20,45.0,11,30,21,9,42,63,100,0,Matches
1464,Matthijs de Ligt,nl NED,DF,Juventus,it Serie A,20,1999,24.7,37,19,20,16,1,18,28,64.3,10,42,21,21,31,68,64,0,Matches
1465,Isaac Lihadji,fr FRA,"MF,FW",Lille,fr Ligue 1,18,2002,2.2,11,4,2,6,3,4,5,80.0,1,5,1,4,1,12,0,1,Matches
1466,Dimitris Limnios,gr GRE,"MF,FW",Köln,de Bundesliga,22,1998,4.2,9,6,3,5,1,5,6,83.3,1,5,0,5,2,11,1,0,Matches
1467,Victor Lindelöf,se SWE,DF,Manchester Utd,eng Premier League,26,1994,28.7,22,10,12,10,0,12,24,50.0,12,22,14,8,30,52,95,1,Matches
1468,Karol Linetty,pl POL,MF,Torino,it Serie A,25,1995,20.4,38,28,13,19,6,16,45,35.6,29,19,5,14,15,53,7,0,Matches
1469,Jesse Lingard,eng ENG,"MF,FW",West Ham,eng Premier League,27,1992,15.8,12,6,4,8,0,5,14,35.7,9,7,1,6,4,16,0,0,Matches
1470,Pol Lirola,es ESP,"DF,FW",Fiorentina,it Serie A,22,1997,5.5,13,8,8,2,3,6,12,50.0,6,6,3,3,6,19,9,0,Matches
1471,Pol Lirola,es ESP,"DF,FW",Marseille,fr Ligue 1,22,1997,17.3,28,16,11,15,2,16,28,57.1,12,18,5,13,25,53,26,0,Matches
1472,Jake Livermore,eng ENG,MF,West Brom,eng Premier League,30,1989,13.8,33,18,14,16,3,14,31,45.2,17,21,6,15,16,49,26,0,Matches
1473,Diego Llorente,es ESP,DF,Leeds United,eng Premier League,26,1993,13.4,34,21,21,13,0,19,32,59.4,13,18,13,5,20,54,40,2,Matches
1474,Diego Llorente,es ESP,DF,Real Sociedad,es La Liga,26,1993,1.0,1,0,1,0,0,1,2,50.0,1,1,1,0,2,3,5,0,Matches
1475,Fernando Llorente,es ESP,FW,Udinese,it Serie A,35,1985,7.9,4,1,2,2,0,2,5,40.0,3,3,0,3,2,6,17,0,Matches
1476,Fernando Llorente,es ESP,"FW,MF",Napoli,it Serie A,35,1985,0.6,0,0,0,0,0,0,0,,0,0,0,0,0,0,0,0,Matches
1477,Marcos Llorente,es ESP,"MF,FW",Atlético Madrid,es La Liga,25,1995,32.8,71,42,21,40,10,26,62,41.9,36,40,3,37,29,100,28,0,Matches
1478,Hugo Lloris,fr FRA,GK,Tottenham,eng Premier League,33,1986,38.0,0,0,0,0,0,0,1,0.0,1,0,0,0,0,0,10,1,Matches
1479,Giovani Lo Celso,ar ARG,MF,Tottenham,eng Premier League,24,1996,10.5,28,22,12,11,5,10,29,34.5,19,12,1,11,7,35,5,0,Matches
1480,Stanislav Lobotka,sk SVK,MF,Napoli,it Serie A,25,1994,1.7,1,1,0,1,0,0,1,0.0,1,1,1,0,0,1,1,1,Matches
1481,Manuel Locatelli,it ITA,MF,Sassuolo,it Serie A,22,1998,32.0,81,47,43,28,10,29,56,51.8,27,35,15,20,51,132,65,1,Matches
1482,Renan Lodi,br BRA,"DF,FW",Atlético Madrid,es La Liga,22,1998,12.5,30,17,13,12,5,17,26,65.4,9,15,0,15,16,46,18,0,Matches
1483,Ruben Loftus-Cheek,eng ENG,FW,Chelsea,eng Premier League,24,1996,0.7,0,0,0,0,0,0,0,,0,0,0,0,0,0,0,0,Matches
1484,Ruben Loftus-Cheek,eng ENG,"MF,FW",Fulham,eng Premier League,24,1996,21.2,25,14,7,15,3,7,23,30.4,16,20,2,18,7,32,18,0,Matches
1485,Niklas Lomb,de GER,GK,Leverkusen,de Bundesliga,27,1993,1.5,0,0,0,0,0,0,0,,0,0,0,0,0,0,0,2,Matches
1486,Kevin Long,ie IRL,DF,Burnley,eng Premier League,29,1990,7.1,11,6,9,2,0,7,9,77.8,2,11,7,4,6,17,24,0,Matches
1487,Shane Long,ie IRL,FW,Southampton,eng Premier League,33,1987,2.3,2,1,0,0,2,2,3,66.7,1,0,0,0,3,5,1,0,Matches
1488,Matthew Longstaff,eng ENG,MF,Newcastle Utd,eng Premier League,20,2000,4.2,3,2,2,1,0,2,8,25.0,6,7,0,7,7,10,2,0,Matches
1489,Sean Longstaff,eng ENG,MF,Newcastle Utd,eng Premier League,22,1997,15.7,31,14,13,15,3,18,42,42.9,24,26,5,21,19,50,14,2,Matches
1490,Ademola Lookman,ng NGA,"FW,MF",Fulham,eng Premier League,22,1997,30.5,35,11,18,9,8,13,44,29.5,31,31,1,30,20,55,9,0,Matches
1491,Anthony Lopes,pt POR,GK,Lyon,fr Ligue 1,29,1990,38.0,1,1,1,0,0,1,2,50.0,1,1,0,1,1,2,20,1,Matches
1492,Rony Lopes,pt POR,"FW,MF",Nice,fr Ligue 1,24,1995,19.8,20,14,4,13,3,6,27,22.2,21,14,3,11,8,28,6,0,Matches
1493,Adrián López,es ESP,"FW,MF",Osasuna,es La Liga,32,1988,5.3,3,3,0,1,2,1,5,20.0,4,3,0,3,0,3,3,0,Matches
1494,Javi López,es ESP,"DF,MF",Alavés,es La Liga,18,2002,2.8,5,5,3,2,0,2,3,66.7,1,2,0,2,3,8,3,1,Matches
1495,Maxime Lopez,fr FRA,MF,Sassuolo,it Serie A,22,1997,20.7,24,13,15,6,3,14,41,34.1,27,9,0,9,16,40,10,1,Matches
1496,Maxime Lopez,fr FRA,"FW,MF",Marseille,fr Ligue 1,22,1997,1.5,1,1,1,0,0,0,2,0.0,2,0,0,0,2,3,2,0,Matches
1497,Pedro López Muñoz,es ESP,DF,Huesca,es La Liga,36,1983,11.9,23,15,10,8,5,15,22,68.2,7,10,4,6,16,39,23,1,Matches
1498,Pau López,es ESP,GK,Roma,it Serie A,25,1994,20.2,2,0,2,0,0,2,2,100.0,0,1,0,1,0,2,7,4,Matches
1499,Roberto López,es ESP,"MF,FW",Real Sociedad,es La Liga,20,2000,5.6,5,1,1,2,2,2,5,40.0,3,2,0,2,4,9,6,0,Matches
1500,Unai López,es ESP,MF,Athletic Club,es La Liga,24,1995,15.8,27,17,13,13,1,10,29,34.5,19,20,5,15,18,45,9,1,Matches
1501,Dion Lopy,sn SEN,MF,Reims,fr Ligue 1,18,2002,2.8,1,1,0,1,0,0,0,,0,0,0,0,2,3,1,0,Matches
1502,Jordan Lotomba,ch SUI,"DF,MF",Nice,fr Ligue 1,21,1998,23.6,35,25,19,11,5,20,34,58.8,14,19,7,12,33,68,52,1,Matches
1503,Adrien Louveau,fr FRA,MF,Lens,fr Ligue 1,20,2000,0.1,0,0,0,0,0,0,0,,0,0,0,0,0,0,1,0,Matches
1504,Imran Louza,ma MAR,MF,Nantes,fr Ligue 1,21,1999,26.4,55,28,25,26,4,21,69,30.4,48,20,4,16,33,88,15,2,Matches
1505,Matteo Lovato,it ITA,DF,Hellas Verona,it Serie A,20,2000,15.4,21,12,14,5,2,10,21,47.6,11,20,10,10,37,58,48,1,Matches
1506,Max Lowe,eng ENG,DF,Sheffield Utd,eng Premier League,23,1997,6.1,26,11,18,6,2,9,21,42.9,12,12,4,8,5,31,11,0,Matches
1507,Eduard Löwen,de GER,"MF,DF",Hertha BSC,de Bundesliga,23,1997,0.9,5,1,3,1,1,2,5,40.0,3,1,0,1,1,6,1,0,Matches
1508,Matthew Lowton,eng ENG,DF,Burnley,eng Premier League,31,1989,34.0,54,32,31,22,1,32,73,43.8,41,36,13,23,56,110,91,1,Matches
1509,Anthony Lozano,hn HON,FW,Cádiz,es La Liga,27,1993,16.9,12,4,1,5,6,2,13,15.4,11,3,1,2,3,15,8,0,Matches
1510,Hirving Lozano,mx MEX,FW,Napoli,it Serie A,25,1995,21.8,29,18,10,13,6,10,36,27.8,26,37,1,36,18,47,14,0,Matches
1511,Jan Luca Schuler,de GER,FW,Schalke 04,de Bundesliga,21,1999,0.4,2,2,1,1,0,0,1,0.0,1,1,0,1,0,2,0,0,Matches
1512,Jean Lucas,br BRA,MF,Lyon,fr Ligue 1,22,1998,1.9,3,2,2,1,0,1,4,25.0,3,3,1,2,2,5,1,0,Matches
1513,Jean Lucas,br BRA,"MF,FW",Brest,fr Ligue 1,22,1998,11.2,19,13,10,9,0,8,29,27.6,21,7,0,7,8,27,10,1,Matches
1514,Anderson Lucoqui,ao ANG,DF,Arminia,de Bundesliga,23,1997,17.8,40,25,23,17,0,20,40,50.0,20,30,7,23,27,67,53,0,Matches
1515,Jeison Lucumí,co COL,MF,Elche,es La Liga,25,1995,0.5,1,1,0,1,0,0,0,,0,1,0,1,0,1,0,0,Matches
1516,Kilian Ludewig,de GER,"DF,FW",Schalke 04,de Bundesliga,20,2000,5.8,16,6,10,5,1,8,25,32.0,17,7,0,7,3,19,14,0,Matches
1517,Florentino Luís,pt POR,MF,Monaco,fr Ligue 1,20,1999,2.7,7,2,4,2,1,6,10,60.0,4,1,0,1,6,13,2,1,Matches
1518,José Luis Gayà,es ESP,DF,Valencia,es La Liga,25,1995,31.6,59,33,40,13,6,33,68,48.5,35,22,3,19,38,97,62,1,Matches
1519,José Luis Morales,es ESP,"MF,FW",Levante,es La Liga,33,1987,27.1,18,10,7,9,2,8,36,22.2,28,17,0,17,11,29,11,0,Matches
1520,José Luis Palomino,ar ARG,DF,Atalanta,it Serie A,30,1990,27.0,67,33,41,19,7,24,48,50.0,24,30,16,14,79,146,60,2,Matches
1521,Luisinho,pt POR,DF,Huesca,es La Liga,35,1985,2.0,3,3,2,1,0,1,3,33.3,2,3,0,3,4,7,7,0,Matches
1522,Luismi,es ESP,"MF,DF",Elche,es La Liga,28,1992,1.9,4,2,1,3,0,1,2,50.0,1,2,0,2,4,8,0,0,Matches
1523,David Luiz,br BRA,DF,Arsenal,eng Premier League,33,1987,15.5,12,9,5,7,0,4,4,100.0,0,16,9,7,16,28,50,2,Matches
1524,Douglas Luiz,br BRA,MF,Aston Villa,eng Premier League,22,1998,30.9,49,18,22,26,1,20,58,34.5,38,52,17,35,43,92,44,2,Matches
1525,Romelu Lukaku,be BEL,FW,Inter,it Serie A,27,1993,32.0,11,1,1,6,4,6,14,42.9,8,11,1,10,3,14,34,0,Matches
1526,Dodi Lukebakio,be BEL,"FW,MF",Hertha BSC,de Bundesliga,22,1997,20.6,21,14,13,5,3,9,20,45.0,11,14,1,13,12,33,8,0,Matches
1527,Saša Lukić,rs SRB,MF,Torino,it Serie A,23,1996,23.4,32,13,11,18,3,15,50,30.0,35,23,5,18,17,49,17,0,Matches
1528,Senad Lulić,ba BIH,DF,Lazio,it Serie A,34,1986,8.0,14,7,6,5,3,7,15,46.7,8,10,1,9,4,18,13,0,Matches
1529,John Lundstram,eng ENG,MF,Sheffield Utd,eng Premier League,26,1994,22.6,25,16,12,11,2,13,47,27.7,34,26,8,18,14,39,29,1,Matches
1530,Sebastiano Luperto,it ITA,DF,Crotone,it Serie A,23,1996,20.9,38,20,28,8,2,16,27,59.3,11,17,7,10,27,65,74,1,Matches
1531,Andreas Luthe,de GER,GK,Union Berlin,de Bundesliga,33,1987,30.8,1,1,1,0,0,1,3,33.3,2,1,0,1,0,1,8,3,Matches
1532,Lyanco,br BRA,DF,Torino,it Serie A,23,1997,21.8,21,14,13,6,2,8,14,57.1,6,36,26,10,46,67,76,0,Matches
1533,Charalambos Lykogiannis,gr GRE,DF,Cagliari,it Serie A,26,1993,26.9,34,21,22,9,3,22,38,57.9,16,34,13,21,32,66,94,0,Matches
1534,Yann M'Vila,fr FRA,MF,Saint-Étienne,fr Ligue 1,30,1990,0.2,0,0,0,0,0,0,2,0.0,2,0,0,0,1,1,0,0,Matches
1535,Alexis Mac Allister,ar ARG,"MF,FW",Brighton,eng Premier League,21,1998,12.4,26,12,6,16,4,11,38,28.9,27,25,4,21,9,35,4,0,Matches
1536,Darwin Machís,ve VEN,"FW,MF",Granada,es La Liga,27,1993,22.5,30,17,12,10,8,6,19,31.6,13,21,2,19,22,52,13,0,Matches
1537,Tim Maciejewski,de GER,FW,Union Berlin,de Bundesliga,19,2001,0.1,0,0,0,0,0,0,0,,0,0,0,0,0,0,0,0,Matches
1538,Luca Mack,de GER,MF,Stuttgart,de Bundesliga,20,2000,0.1,0,0,0,0,0,0,0,,0,0,0,0,0,0,1,0,Matches
1539,Yvann Macon,fr FRA,DF,Saint-Étienne,fr Ligue 1,21,1998,6.0,30,20,20,8,2,7,19,36.8,12,6,2,4,9,39,13,0,Matches
1540,James Maddison,eng ENG,MF,Leicester City,eng Premier League,23,1996,23.3,32,16,5,16,11,14,41,34.1,27,14,1,13,9,41,5,0,Matches
1541,Mikail Maden,no NOR,FW,Schalke 04,de Bundesliga,18,2002,0.1,0,0,0,0,0,0,0,,0,0,0,0,0,0,0,0,Matches
1542,Pablo Maffeo,es ESP,DF,Huesca,es La Liga,23,1997,21.8,26,17,21,4,1,12,26,46.2,14,18,6,12,35,61,27,0,Matches
1543,Gabriel Magalhães,br BRA,DF,Arsenal,eng Premier League,22,1997,22.2,25,15,19,5,1,13,19,68.4,6,27,19,8,26,51,74,2,Matches
1544,Lisandro Magallán,ar ARG,DF,Crotone,it Serie A,26,1993,24.2,54,31,28,24,2,17,42,40.5,25,29,15,14,44,98,78,1,Matches
1545,Christian Maggio,it ITA,DF,Benevento,it Serie A,38,1982,3.3,9,4,2,7,0,3,9,33.3,6,4,1,3,2,11,6,0,Matches
1546,Giulio Maggiore,it ITA,MF,Spezia,it Serie A,22,1998,24.6,61,36,26,28,7,21,53,39.6,32,33,6,27,19,80,25,1,Matches
1547,Francesco Magnanelli,it ITA,MF,Sassuolo,it Serie A,35,1984,4.9,7,5,2,5,0,3,10,30.0,7,6,2,4,13,20,10,0,Matches
1548,Giangiacomo Magnani,it ITA,DF,Hellas Verona,it Serie A,24,1995,16.8,26,15,14,9,3,9,16,56.3,7,25,16,9,44,70,105,1,Matches
1549,Hugo Magnetti,fr FRA,MF,Brest,fr Ligue 1,22,1998,6.7,24,12,10,13,1,20,40,50.0,20,6,1,5,14,38,8,0,Matches
1550,Harry Maguire,eng ENG,DF,Manchester Utd,eng Premier League,27,1993,33.9,29,17,19,10,0,18,29,62.1,11,28,23,5,60,89,122,4,Matches
1551,Abdallahi Mahmoud,mr MTN,MF,Alavés,es La Liga,20,2000,0.7,2,2,1,1,0,0,1,0.0,1,0,0,0,1,3,0,0,Matches
1552,Hicham Mahou,fr FRA,FW,Nice,fr Ligue 1,21,1999,0.4,1,1,1,0,0,1,2,50.0,1,2,0,2,1,2,0,0,Matches
1553,Riyad Mahrez,dz ALG,FW,Manchester City,eng Premier League,29,1991,21.7,20,5,2,10,8,6,30,20.0,24,19,0,19,8,28,4,0,Matches
1554,Arne Maier,de GER,MF,Arminia,de Bundesliga,21,1999,11.5,13,9,5,7,1,4,11,36.4,7,10,3,7,8,21,11,1,Matches
1555,Arne Maier,de GER,MF,Hertha BSC,de Bundesliga,21,1999,0.3,1,1,0,1,0,0,1,0.0,1,0,0,0,0,1,0,0,Matches
1556,Habib Maïga,ci CIV,MF,Metz,fr Ligue 1,24,1996,29.9,81,52,36,40,5,42,85,49.4,43,37,6,31,49,130,36,0,Matches
1557,Mike Maignan,fr FRA,GK,Lille,fr Ligue 1,25,1995,38.0,0,0,0,0,0,0,0,,0,0,0,0,0,0,7,2,Matches
1558,Ainsley Maitland-Niles,eng ENG,"MF,DF",Arsenal,eng Premier League,22,1997,5.4,11,7,6,5,0,8,12,66.7,4,12,2,10,14,25,7,1,Matches
1559,Ainsley Maitland-Niles,eng ENG,MF,West Brom,eng Premier League,22,1997,13.7,22,10,7,8,7,9,28,32.1,19,12,1,11,17,39,24,0,Matches
1560,Josh Maja,ng NGA,FW,Fulham,eng Premier League,21,1998,9.0,7,4,0,3,4,4,10,40.0,6,3,1,2,4,11,1,0,Matches
1561,Josh Maja,ng NGA,FW,Bordeaux,fr Ligue 1,21,1998,8.9,8,2,3,3,2,3,14,21.4,11,3,0,3,6,14,9,0,Matches
1562,Radosław Majecki,pl POL,GK,Monaco,fr Ligue 1,20,1999,1.0,0,0,0,0,0,0,0,,0,0,0,0,0,0,1,0,Matches
1563,Abdul Majeed Waris,gh GHA,"FW,MF",Strasbourg,fr Ligue 1,28,1991,6.1,1,1,1,0,0,1,6,16.7,5,0,0,0,2,3,2,0,Matches
1564,Marco Majouga,cf CTA,"FW,MF",Nîmes,fr Ligue 1,19,2001,1.4,1,1,1,0,0,1,3,33.3,2,0,0,0,0,1,0,0,Matches
1565,Jean-Victor Makengo,fr FRA,MF,Udinese,it Serie A,22,1998,5.8,8,7,5,3,0,3,13,23.1,10,7,1,6,5,13,7,0,Matches
1566,Nemanja Maksimović,rs SRB,MF,Getafe,es La Liga,25,1995,30.3,50,28,22,24,4,19,46,41.3,27,40,9,31,57,107,46,1,Matches
1567,Nikola Maksimović,rs SRB,DF,Napoli,it Serie A,28,1991,13.4,18,9,11,6,1,9,18,50.0,9,15,6,9,21,39,49,3,Matches
1568,Filip Malbašić,rs SRB,"FW,MF",Cádiz,es La Liga,27,1992,9.6,12,7,4,5,3,6,18,33.3,12,10,0,10,4,16,2,0,Matches
1569,Kévin Malcuit,ma MAR,DF,Fiorentina,it Serie A,29,1991,2.3,5,3,2,2,1,0,1,0.0,1,5,0,5,3,8,6,0,Matches
1570,Kévin Malcuit,ma MAR,"FW,MF",Napoli,it Serie A,29,1991,0.4,2,1,2,0,0,0,1,0.0,1,0,0,0,2,4,2,0,Matches
1571,Daniel Maldini,it ITA,"FW,DF",Milan,it Serie A,18,2001,0.3,1,0,0,1,0,0,2,0.0,2,0,0,0,0,1,0,0,Matches
1572,Ruslan Malinovskyi,ua UKR,"MF,FW",Atalanta,it Serie A,27,1993,20.8,19,8,2,13,4,8,23,34.8,15,16,1,15,2,21,4,0,Matches
1573,Yunus Mallı,tr TUR,MF,Wolfsburg,de Bundesliga,28,1992,0.6,1,0,0,1,0,1,1,100.0,0,0,0,0,0,1,0,0,Matches
1574,Hugo Mallo,es ESP,DF,Celta Vigo,es La Liga,29,1991,28.9,58,40,34,23,1,24,52,46.2,28,42,11,31,37,95,77,0,Matches
1575,Mickael Malsa,mq MTQ,MF,Levante,es La Liga,24,1995,26.0,55,26,28,24,3,23,51,45.1,28,38,9,29,43,98,36,2,Matches
1576,Dennis Man,ro ROU,"FW,MF",Parma,it Serie A,21,1998,7.8,12,6,6,4,2,6,21,28.6,15,5,0,5,2,14,6,0,Matches
1577,Hianga Mananga Mbock,fr FRA,"MF,FW",Brest,fr Ligue 1,20,1999,5.1,4,3,2,2,0,2,9,22.2,7,2,0,2,3,7,6,0,Matches
1578,Vincent Manceau,fr FRA,DF,Angers,fr Ligue 1,31,1989,25.7,42,27,23,17,2,30,63,47.6,33,23,2,21,35,77,61,0,Matches
1579,Gianluca Mancini,it ITA,DF,Roma,it Serie A,24,1996,31.7,50,29,29,19,2,18,31,58.1,13,38,18,20,72,122,77,3,Matches
1580,Steve Mandanda,fr FRA,GK,Marseille,fr Ligue 1,35,1985,37.0,0,0,0,0,0,0,1,0.0,1,0,0,0,2,2,8,6,Matches
1581,Reinildo Mandava,mz MOZ,DF,Lille,fr Ligue 1,26,1994,24.2,79,43,39,32,8,35,58,60.3,23,26,3,23,45,124,53,0,Matches
1582,Aïssa Mandi,dz ALG,DF,Betis,es La Liga,28,1991,26.6,30,17,20,10,0,10,16,62.5,6,21,13,8,39,69,90,0,Matches
1583,Rolando Mandragora,it ITA,MF,Udinese,it Serie A,23,1997,4.4,8,5,3,4,1,3,10,30.0,7,10,3,7,6,14,5,0,Matches
1584,Rolando Mandragora,it ITA,MF,Torino,it Serie A,23,1997,16.9,19,4,4,9,6,7,30,23.3,23,19,6,13,20,39,19,0,Matches
1585,Mario Mandžukić,hr CRO,FW,Milan,it Serie A,34,1986,2.4,7,6,2,4,1,2,3,66.7,1,0,0,0,2,9,3,0,Matches
1586,Sadio Mané,sn SEN,FW,Liverpool,eng Premier League,28,1992,31.2,48,30,6,22,20,12,33,36.4,21,30,0,30,15,63,11,0,Matches
1587,Niccolò Manfredini,it ITA,GK,Benevento,it Serie A,32,1988,1.0,0,0,0,0,0,0,0,,0,0,0,0,0,0,2,1,Matches
1588,Eliaquim Mangala,fr FRA,DF,Valencia,es La Liga,29,1991,3.6,0,0,0,0,0,0,1,0.0,1,8,6,2,6,6,12,0,Matches
1589,Orel Mangala,be BEL,MF,Stuttgart,de Bundesliga,22,1998,23.4,27,15,13,11,3,17,28,60.7,11,27,10,17,26,53,30,0,Matches
1590,Thomas Mangani,fr FRA,MF,Angers,fr Ligue 1,33,1987,29.9,54,37,25,26,3,30,90,33.3,60,31,8,23,38,92,39,0,Matches
1591,Vito Mannone,it ITA,GK,Monaco,fr Ligue 1,32,1988,9.0,0,0,0,0,0,0,0,,0,0,0,0,0,0,3,1,Matches
1592,Kostas Manolas,gr GRE,DF,Napoli,it Serie A,29,1991,25.5,31,18,24,7,0,17,24,70.8,7,22,13,9,23,54,82,2,Matches
1593,Javier Manquillo,es ESP,DF,Newcastle Utd,eng Premier League,26,1994,9.2,24,14,8,14,2,11,17,64.7,6,8,1,7,9,33,15,1,Matches
1594,Juan Manuel Ramos,uy URU,DF,Spezia,it Serie A,23,1996,3.3,5,0,3,0,2,4,7,57.1,3,1,0,1,2,7,6,0,Matches
1595,Myziane Maolida,km COM,"FW,MF",Nice,fr Ligue 1,21,1999,12.0,13,8,4,4,5,4,11,36.4,7,6,1,5,6,19,4,0,Matches
1596,Faitout Maouassa,fr FRA,DF,Rennes,fr Ligue 1,22,1998,13.0,20,11,10,8,2,11,19,57.9,8,9,1,8,17,37,36,0,Matches
1597,Sekou Mara,fr FRA,"FW,MF",Bordeaux,fr Ligue 1,18,2002,2.5,5,3,1,3,1,2,10,20.0,8,0,0,0,1,6,1,0,Matches
1598,Fernando Marçal,br BRA,"DF,MF",Wolves,eng Premier League,31,1989,6.9,13,5,6,7,0,6,11,54.5,5,11,2,9,12,25,25,0,Matches
1599,Fernando Marçal,br BRA,DF,Lyon,fr Ligue 1,31,1989,0.9,1,0,0,1,0,0,0,,0,0,0,0,2,3,0,0,Matches
1600,Marcelo,br BRA,"DF,MF",Real Madrid,es La Liga,32,1988,11.7,25,21,11,6,8,11,24,45.8,13,13,1,12,10,35,15,0,Matches
1601,Marcelo,br BRA,DF,Lyon,fr Ligue 1,33,1987,32.3,44,29,30,12,2,26,37,70.3,11,35,25,10,49,93,122,2,Matches
1602,Solly March,eng ENG,"DF,MF",Brighton,eng Premier League,26,1994,18.6,49,23,24,15,10,18,34,52.9,16,30,5,25,22,71,30,0,Matches
1603,Federico Marchetti,it ITA,GK,Genoa,it Serie A,37,1983,3.7,1,0,1,0,0,1,1,100.0,0,0,0,0,0,1,2,1,Matches
1604,Riccardo Marchizza,it ITA,DF,Spezia,it Serie A,22,1998,17.3,20,11,12,5,3,12,21,57.1,9,13,4,9,11,31,27,0,Matches
1605,Gian Marco Ferrari,it ITA,DF,Sassuolo,it Serie A,28,1992,33.5,32,20,15,14,3,10,23,43.5,13,46,37,9,50,82,100,1,Matches
1606,Iván Marcone,ar ARG,MF,Elche,es La Liga,30,1990,29.4,64,41,42,17,5,35,84,41.7,49,27,8,19,36,100,33,3,Matches
1607,Óscar de Marcos,es ESP,"DF,MF",Athletic Club,es La Liga,31,1989,16.9,28,17,12,10,6,10,25,40.0,15,12,1,11,12,40,38,0,Matches
1608,Dario Maresic,at AUT,DF,Reims,fr Ligue 1,20,1999,5.7,12,7,8,4,0,8,14,57.1,6,7,2,5,10,22,17,1,Matches
1609,José Mari,es ESP,MF,Cádiz,es La Liga,32,1987,16.1,32,17,13,18,1,14,31,45.2,17,16,7,9,27,59,33,1,Matches
1610,Pablo Marí,es ESP,DF,Arsenal,eng Premier League,26,1993,10.0,15,9,12,3,0,5,10,50.0,5,8,7,1,9,24,30,2,Matches
1611,José María Giménez,uy URU,DF,Atlético Madrid,es La Liga,25,1995,19.6,20,7,14,5,1,12,17,70.6,5,17,11,6,21,41,65,0,Matches
1612,Mariano,do DOM,FW,Real Madrid,es La Liga,26,1993,5.7,4,2,2,1,1,0,9,0.0,9,3,1,2,0,4,3,0,Matches
1613,Jordan Marié,fr FRA,MF,Dijon,fr Ligue 1,28,1991,15.9,34,17,9,23,2,23,56,41.1,33,14,5,9,23,57,12,2,Matches
1614,Adrián Marín,es ESP,"DF,MF",Alavés,es La Liga,23,1997,1.0,1,1,0,1,0,0,2,0.0,2,1,0,1,2,3,2,0,Matches
1615,Adrián Marín,es ESP,"DF,MF",Granada,es La Liga,23,1997,3.0,5,2,1,3,1,2,3,66.7,1,5,2,3,4,9,9,0,Matches
1616,Răzvan Marin,ro ROU,MF,Cagliari,it Serie A,24,1996,32.9,54,33,26,22,6,27,53,50.9,26,29,10,19,29,83,15,0,Matches
1617,Guillermo Maripán,cl CHI,DF,Monaco,fr Ligue 1,26,1994,23.2,26,11,17,9,0,15,27,55.6,12,18,11,7,27,53,66,1,Matches
1618,Marlon,br BRA,DF,Sassuolo,it Serie A,24,1995,19.4,19,13,13,6,0,13,18,72.2,5,23,17,6,27,46,44,2,Matches
1619,Omar Marmoush,eg EGY,FW,Wolfsburg,de Bundesliga,21,1999,0.0,0,0,0,0,0,0,0,,0,0,0,0,0,0,0,0,Matches
1620,Marquinhos,br BRA,DF,Paris S-G,fr Ligue 1,26,1994,23.6,27,21,14,10,3,15,26,57.7,11,21,9,12,27,54,75,2,Matches
1621,Luca Marrone,it ITA,DF,Crotone,it Serie A,30,1990,17.6,25,18,16,9,0,13,21,61.9,8,22,11,11,26,51,56,1,Matches
1622,Roger Martí,es ESP,FW,Levante,es La Liga,29,1991,24.4,11,7,5,4,2,6,23,26.1,17,10,3,7,4,15,6,0,Matches
1623,Anthony Martial,fr FRA,FW,Manchester Utd,eng Premier League,24,1995,16.4,2,1,1,1,0,0,10,0.0,10,17,3,14,1,3,8,0,Matches
1624,Aarón Martín,es ESP,DF,Celta Vigo,es La Liga,23,1997,17.1,34,20,15,16,3,10,33,30.3,23,15,4,11,13,47,37,0,Matches
1625,Aarón Martín,es ESP,"DF,FW",Mainz 05,de Bundesliga,23,1997,2.9,3,2,2,1,0,2,4,50.0,2,1,0,1,2,5,2,0,Matches
1626,Álex Martín,es ESP,DF,Cádiz,es La Liga,22,1998,1.1,2,0,1,1,0,2,4,50.0,2,1,1,0,0,2,6,0,Matches
1627,Jonas Martin,fr FRA,MF,Rennes,fr Ligue 1,30,1990,5.4,11,9,5,4,2,5,14,35.7,9,11,2,9,13,24,2,1,Matches
1628,Gabriel Martinelli,br BRA,FW,Arsenal,eng Premier League,19,2001,6.5,7,1,2,3,2,4,10,40.0,6,6,0,6,8,15,4,0,Matches
1629,Emiliano Martínez,ar ARG,GK,Aston Villa,eng Premier League,27,1992,38.0,3,3,3,0,0,3,4,75.0,1,0,0,0,2,5,10,2,Matches
1630,Iñigo Martínez,es ESP,DF,Athletic Club,es La Liga,29,1991,28.0,22,15,16,6,0,9,27,33.3,18,17,7,10,28,50,96,0,Matches
1631,Javi Martínez,es ESP,"MF,FW",Osasuna,es La Liga,20,1999,5.1,9,4,1,6,2,5,12,41.7,7,9,0,9,5,14,4,0,Matches
1632,Javi Martínez,es ESP,"DF,MF",Bayern Munich,de Bundesliga,31,1988,5.2,10,5,4,4,2,7,9,77.8,2,8,4,4,13,23,19,0,Matches
1633,Josep Martinez,es ESP,GK,RB Leipzig,de Bundesliga,22,1998,1.0,0,0,0,0,0,0,0,,0,0,0,0,0,0,0,0,Matches
1634,Lautaro Martínez,ar ARG,FW,Inter,it Serie A,22,1997,28.5,25,12,5,11,9,7,24,29.2,17,31,1,30,27,52,16,0,Matches
1635,Pablo Martinez,fr FRA,DF,Nîmes,fr Ligue 1,31,1989,6.0,10,7,7,3,0,7,7,100.0,0,6,4,2,11,21,28,0,Matches
1636,Lucas Martínez Quarta,ar ARG,DF,Fiorentina,it Serie A,24,1996,16.5,32,20,17,11,4,18,41,43.9,23,27,9,18,39,71,48,0,Matches
1637,Gelson Martins,pt POR,"MF,FW",Monaco,fr Ligue 1,25,1995,17.2,41,26,12,16,13,15,37,40.5,22,20,0,20,13,54,8,0,Matches
1638,Adam Marušić,me MNE,DF,Lazio,it Serie A,27,1992,33.0,38,22,22,15,1,20,40,50.0,20,38,6,32,40,78,54,0,Matches
1639,Sylvain Marveaux,fr FRA,"MF,FW",Lorient,fr Ligue 1,34,1986,2.2,6,3,1,4,1,3,3,100.0,0,2,0,2,1,7,2,0,Matches
1640,Marvin,es ESP,"DF,MF",Real Madrid,es La Liga,20,2000,1.5,3,2,0,3,0,1,2,50.0,1,1,0,1,2,5,3,0,Matches
1641,Omar Mascarell,gq EQG,MF,Schalke 04,de Bundesliga,27,1993,19.6,41,24,15,19,7,21,54,38.9,33,40,14,26,37,78,32,1,Matches
1642,Andrea Masiello,it ITA,DF,Genoa,it Serie A,34,1986,28.5,38,22,29,6,3,23,48,47.9,25,32,13,19,53,91,107,3,Matches
1643,Jordi Masip,es ESP,GK,Valladolid,es La Liga,31,1989,25.0,0,0,0,0,0,0,2,0.0,2,2,0,2,2,2,8,1,Matches
1644,Roberto Massimo,de GER,"DF,FW",Stuttgart,de Bundesliga,19,2000,8.4,21,11,13,5,3,11,24,45.8,13,5,1,4,11,32,13,0,Matches
1645,Giuseppe Mastinu,it ITA,FW,Spezia,it Serie A,28,1991,0.4,1,1,0,0,1,1,1,100.0,0,1,0,1,0,1,0,0,Matches
1646,Arthur Masuaku,cd COD,"DF,MF",West Ham,eng Premier League,26,1993,11.2,20,12,14,6,0,11,34,32.4,23,12,0,12,8,28,28,2,Matches
1647,Jaime Mata,es ESP,FW,Getafe,es La Liga,31,1988,22.6,12,7,1,3,8,3,18,16.7,15,13,2,11,6,18,16,0,Matches
1648,Juan Mata,es ESP,"FW,MF",Manchester Utd,eng Premier League,32,1988,5.7,1,0,1,0,0,0,7,0.0,7,3,0,3,3,4,3,0,Matches
1649,Pape Matar Sarr,sn SEN,MF,Metz,fr Ligue 1,17,2002,17.7,45,29,19,21,5,20,38,52.6,18,24,4,20,27,72,16,0,Matches
1650,Eliot Matazo,be BEL,MF,Monaco,fr Ligue 1,18,2002,3.5,11,5,6,5,0,3,7,42.9,4,1,0,1,1,12,2,0,Matches
1651,Jean-Philippe Mateta,fr FRA,FW,Crystal Palace,eng Premier League,23,1997,2.5,1,1,0,1,0,1,3,33.3,2,1,0,1,0,1,2,0,Matches
1652,Jean-Philippe Mateta,fr FRA,FW,Mainz 05,de Bundesliga,23,1997,11.1,6,3,1,3,2,0,3,0.0,3,3,1,2,4,10,6,0,Matches
1653,Nemanja Matić,rs SRB,MF,Manchester Utd,eng Premier League,31,1988,12.3,25,11,13,12,0,13,31,41.9,18,19,5,14,22,47,10,3,Matches
1654,Joël Matip,cm CMR,DF,Liverpool,eng Premier League,28,1991,7.7,14,9,7,7,0,7,8,87.5,1,6,0,6,7,21,22,0,Matches
1655,Rabbi Matondo,wls WAL,"FW,MF",Schalke 04,de Bundesliga,19,2000,2.4,3,2,0,3,0,2,3,66.7,1,1,0,1,1,4,1,0,Matches
1656,Ryder Matos,br BRA,MF,Udinese,it Serie A,27,1993,0.1,0,0,0,0,0,0,0,,0,0,0,0,0,0,0,0,Matches
1657,Henning Matriciani,de GER,DF,Schalke 04,de Bundesliga,20,2000,0.3,1,1,1,0,0,1,1,100.0,0,1,0,1,0,1,1,0,Matches
1658,Chrislain Matsima,fr FRA,"DF,FW",Monaco,fr Ligue 1,18,2002,3.9,5,4,3,2,0,4,7,57.1,3,3,0,3,4,9,12,0,Matches
1659,Federico Mattiello,it ITA,DF,Spezia,it Serie A,25,1995,0.4,0,0,0,0,0,0,0,,0,0,0,0,0,0,0,0,Matches
1660,Neal Maupay,fr FRA,"FW,MF",Brighton,eng Premier League,23,1996,27.9,20,8,9,7,4,4,24,16.7,20,20,0,20,13,33,6,0,Matches
1661,Tony Mauricio,fr FRA,MF,Lens,fr Ligue 1,26,1994,5.6,19,12,7,8,4,11,17,64.7,6,8,1,7,3,22,4,0,Matches
1662,Stephy Mavididi,eng ENG,"FW,MF",Montpellier,fr Ligue 1,22,1998,22.6,18,5,7,10,1,8,23,34.8,15,12,0,12,14,32,6,0,Matches
1663,Konstantinos Mavropanos,gr GRE,DF,Stuttgart,de Bundesliga,22,1997,16.3,42,29,29,12,1,27,46,58.7,19,25,10,15,59,101,66,1,Matches
1664,Eric Maxim Choupo-Moting,cm CMR,"FW,MF",Bayern Munich,de Bundesliga,31,1989,9.1,8,2,0,5,3,1,4,25.0,3,6,0,6,2,10,7,0,Matches
1665,Borja Mayoral,es ESP,FW,Roma,it Serie A,23,1997,17.2,3,2,0,0,3,1,10,10.0,9,5,0,5,0,3,5,2,Matches
1666,Borja Mayoral,es ESP,FW,Real Madrid,es La Liga,23,1997,0.3,0,0,0,0,0,0,1,0.0,1,0,0,0,0,0,0,0,Matches
1667,Youssef Maziz,fr FRA,"MF,FW",Metz,fr Ligue 1,22,1998,2.9,2,0,1,1,0,1,5,20.0,4,1,0,1,6,8,1,0,Matches
1668,Antonio Mazzotta,it ITA,DF,Crotone,it Serie A,30,1989,0.6,1,1,0,1,0,0,0,,0,0,0,0,0,1,1,0,Matches
1669,Kevin Mbabu,ch SUI,DF,Wolfsburg,de Bundesliga,25,1995,18.2,51,33,27,17,7,24,35,68.6,11,28,7,21,22,73,59,1,Matches
1670,Kylian Mbappé,fr FRA,FW,Paris S-G,fr Ligue 1,21,1998,26.4,4,2,0,1,3,2,9,22.2,7,7,1,6,3,7,4,1,Matches
1671,Ibrahima Mbaye,sn SEN,DF,Bologna,it Serie A,25,1994,4.8,6,5,5,1,0,3,5,60.0,2,5,3,2,1,7,10,0,Matches
1672,Jean-Manuel Mbom,de GER,"MF,DF",Werder Bremen,de Bundesliga,20,2000,12.9,19,13,14,3,2,8,27,29.6,19,17,6,11,13,32,27,0,Matches
1673,Nathanael Mbuku,fr FRA,"MF,FW",Reims,fr Ligue 1,18,2002,24.6,33,19,9,13,11,8,28,28.6,20,17,0,17,14,47,10,0,Matches
1674,James McArthur,sct SCO,MF,Crystal Palace,eng Premier League,32,1987,16.3,57,32,25,27,5,15,39,38.5,24,28,3,25,23,80,31,0,Matches
1675,Oliver McBurnie,sct SCO,FW,Sheffield Utd,eng Premier League,24,1996,14.7,15,7,7,7,1,5,17,29.4,12,10,3,7,6,21,30,0,Matches
1676,Alex McCarthy,eng ENG,GK,Southampton,eng Premier League,30,1989,30.0,1,0,1,0,0,1,4,25.0,3,0,0,0,0,1,11,1,Matches
1677,James McCarthy,ie IRL,MF,Crystal Palace,eng Premier League,29,1990,9.1,16,12,9,7,0,8,21,38.1,13,15,7,8,8,24,12,0,Matches
1678,John McGinn,sct SCO,MF,Aston Villa,eng Premier League,25,1994,37.0,61,37,23,31,7,27,84,32.1,57,38,6,32,43,104,23,2,Matches
1679,David McGoldrick,ie IRL,"FW,MF",Sheffield Utd,eng Premier League,32,1987,26.6,33,21,8,15,10,13,31,41.9,18,19,3,16,2,35,25,0,Matches
1680,Weston McKennie,us USA,MF,Juventus,it Serie A,21,1998,18.9,34,19,9,20,5,12,33,36.4,21,21,3,18,28,62,26,0,Matches
1681,Dwight McNeil,eng ENG,MF,Burnley,eng Premier League,20,1999,34.1,47,24,24,18,5,18,56,32.1,38,44,6,38,32,79,32,1,Matches
1682,Scott McTominay,sct SCO,MF,Manchester Utd,eng Premier League,23,1996,23.7,51,24,23,25,3,23,36,63.9,13,35,10,25,29,80,46,0,Matches
1683,Gary Medel,cl CHI,"DF,MF",Bologna,it Serie A,32,1987,5.7,12,9,6,5,1,4,10,40.0,6,8,6,2,7,19,10,0,Matches
1684,Facundo Medina,ar ARG,DF,Lens,fr Ligue 1,21,1999,22.3,39,22,22,15,2,24,38,63.2,14,25,9,16,39,78,51,3,Matches
1685,Nathan de Medina,be BEL,DF,Arminia,de Bundesliga,22,1997,7.1,16,10,9,6,1,3,10,30.0,7,12,2,10,11,27,22,0,Matches
1686,Ben Mee,eng ENG,DF,Burnley,eng Premier League,30,1989,29.9,32,15,16,14,2,14,29,48.3,15,54,45,9,43,75,148,2,Matches
1687,Joshua Mees,de GER,FW,Union Berlin,de Bundesliga,24,1996,0.1,0,0,0,0,0,0,0,,0,0,0,0,0,0,0,0,Matches
1688,Admir Mehmedi,ch SUI,"MF,FW",Wolfsburg,de Bundesliga,29,1991,9.1,17,9,6,7,4,6,16,37.5,10,7,0,7,5,22,1,0,Matches
1689,Soualiho Meïté,fr FRA,MF,Torino,it Serie A,26,1994,10.2,11,7,6,4,1,5,16,31.3,11,18,1,17,10,21,9,1,Matches
1690,Soualiho Meïté,fr FRA,MF,Milan,it Serie A,26,1994,6.5,18,10,10,6,2,8,17,47.1,9,9,2,7,8,26,16,0,Matches
1691,Hannibal Mejbri,tn TUN,MF,Manchester Utd,eng Premier League,17,2003,0.1,0,0,0,0,0,0,0,,0,0,0,0,0,0,0,0,Matches
1692,Farid El Melali,dz ALG,"FW,MF",Angers,fr Ligue 1,23,1997,4.6,9,5,5,4,0,2,13,15.4,11,12,0,12,6,15,2,0,Matches
1693,Filippo Melegoni,it ITA,"MF,DF",Genoa,it Serie A,21,1999,4.3,7,6,2,5,0,3,6,50.0,3,5,0,5,5,12,8,0,Matches
1694,Gonzalo Melero,es ESP,"MF,FW",Levante,es La Liga,26,1994,20.6,24,15,11,6,7,10,39,25.6,29,14,5,9,18,42,22,1,Matches
1695,Birger Meling,no NOR,DF,Nîmes,fr Ligue 1,25,1994,25.9,49,31,27,15,7,33,50,66.0,17,43,9,34,36,85,70,0,Matches
1696,Arthur Melo,br BRA,MF,Juventus,it Serie A,23,1996,12.9,17,9,7,10,0,12,31,38.7,19,6,1,5,18,35,9,1,Matches
1697,Memphis,nl NED,FW,Lyon,fr Ligue 1,26,1994,32.5,4,3,0,3,1,1,20,5.0,19,11,1,10,5,9,3,0,Matches
1698,Houboulang Mendes,gw GNB,DF,Lorient,fr Ligue 1,22,1998,14.4,28,19,19,5,4,16,28,57.1,12,14,2,12,14,42,35,0,Matches
1699,Pedro Mendes,pt POR,DF,Montpellier,fr Ligue 1,29,1990,18.1,21,19,16,5,0,14,21,66.7,7,23,13,10,34,55,58,0,Matches
1700,Thiago Mendes,br BRA,MF,Lyon,fr Ligue 1,28,1992,24.9,37,22,13,20,4,18,38,47.4,20,33,7,26,39,76,21,2,Matches
1701,Brais Méndez,es ESP,"MF,FW",Celta Vigo,es La Liga,23,1997,29.7,59,31,23,27,9,16,65,24.6,49,27,2,25,32,91,34,0,Matches
1702,Édgar Méndez,es ESP,"MF,FW",Alavés,es La Liga,30,1990,23.2,39,29,18,13,8,15,48,31.3,33,20,3,17,19,58,14,0,Matches
1703,Eñaut Mendía,es ESP,FW,Eibar,es La Liga,21,1999,0.7,2,1,2,0,0,1,2,50.0,1,1,1,0,0,2,0,0,Matches
1704,Batista Mendy,fr FRA,MF,Nantes,fr Ligue 1,20,2000,0.8,1,1,0,1,0,0,1,0.0,1,3,1,2,1,2,1,0,Matches
1705,Benjamin Mendy,fr FRA,DF,Manchester City,eng Premier League,26,1994,10.6,13,9,1,8,4,5,21,23.8,16,12,5,7,5,18,14,1,Matches
1706,Edouard Mendy,sn SEN,GK,Chelsea,eng Premier League,28,1992,30.5,0,0,0,0,0,0,1,0.0,1,0,0,0,1,1,9,3,Matches
1707,Edouard Mendy,sn SEN,GK,Rennes,fr Ligue 1,28,1992,1.0,0,0,0,0,0,0,0,,0,0,0,0,0,0,0,0,Matches
1708,Ferland Mendy,fr FRA,DF,Real Madrid,es La Liga,25,1995,24.5,26,16,17,6,3,12,24,50.0,12,16,4,12,26,52,32,1,Matches
1709,Nampalys Mendy,sn SEN,MF,Leicester City,eng Premier League,28,1992,16.2,26,17,18,6,2,7,20,35.0,13,12,1,11,14,40,8,0,Matches
1710,Hamza Mendyl,ma MAR,"FW,DF",Schalke 04,de Bundesliga,22,1997,1.1,2,2,2,0,0,0,2,0.0,2,2,0,2,0,2,2,0,Matches
1711,Levent Mercan,de GER,FW,Schalke 04,de Bundesliga,19,2000,0.1,0,0,0,0,0,0,0,,0,0,0,0,0,0,0,0,Matches
1712,Jorge Meré,es ESP,DF,Köln,de Bundesliga,23,1997,14.4,13,6,9,3,1,6,13,46.2,7,14,11,3,15,28,63,0,Matches
1713,Alex Meret,it ITA,GK,Napoli,it Serie A,23,1997,22.0,0,0,0,0,0,0,1,0.0,1,0,0,0,0,0,5,0,Matches
1714,Mikel Merino,es ESP,MF,Real Sociedad,es La Liga,24,1996,23.9,61,36,14,36,11,18,45,40.0,27,36,8,28,32,93,26,0,Matches
1715,Martín Merquelanz,es ESP,"MF,FW",Real Sociedad,es La Liga,25,1995,6.1,9,3,3,2,4,2,7,28.6,5,7,1,6,3,12,4,0,Matches
1716,Yıldırım Mert Çetin,tr TUR,DF,Hellas Verona,it Serie A,23,1997,4.6,8,4,3,5,0,2,6,33.3,4,7,5,2,14,22,11,1,Matches
1717,Dries Mertens,be BEL,"FW,MF",Napoli,it Serie A,33,1987,16.2,16,14,4,7,5,5,25,20.0,20,7,1,6,9,25,3,1,Matches
1718,Roque Mesa,es ESP,MF,Valladolid,es La Liga,31,1989,19.6,46,29,18,24,4,20,47,42.6,27,11,2,9,14,60,23,1,Matches
1719,Illan Meslier,fr FRA,GK,Leeds United,eng Premier League,20,2000,35.0,0,0,0,0,0,0,1,0.0,1,0,0,0,0,0,17,8,Matches
1720,Lionel Messi,ar ARG,"FW,MF",Barcelona,es La Liga,33,1987,33.6,18,10,3,9,6,6,17,35.3,11,12,0,12,6,24,0,2,Matches
1721,Junior Messias,br BRA,"MF,FW",Crotone,it Serie A,29,1991,35.7,60,35,26,24,10,22,70,31.4,48,32,12,20,35,95,40,0,Matches
1722,Thomas Meunier,be BEL,DF,Dortmund,de Bundesliga,28,1991,16.4,30,21,19,6,5,20,29,69.0,9,16,6,10,18,48,29,2,Matches
1723,Mexer,mz MOZ,DF,Bordeaux,fr Ligue 1,31,1988,7.9,9,6,8,0,1,5,10,50.0,5,8,5,3,17,26,22,0,Matches
1724,Max Meyer,de GER,MF,Köln,de Bundesliga,24,1995,3.9,7,4,3,3,1,4,8,50.0,4,4,1,3,3,10,1,0,Matches
1725,Omenuke Mfulu,cd COD,MF,Elche,es La Liga,26,1994,8.8,18,12,10,8,0,5,15,33.3,10,7,1,6,11,29,18,0,Matches
1726,Míchel,es ESP,MF,Valladolid,es La Liga,32,1988,10.5,18,11,10,3,5,5,22,22.7,17,10,1,9,9,27,12,1,Matches
1727,Jonas Michelbrink,de GER,MF,Hertha BSC,de Bundesliga,19,2001,0.4,0,0,0,0,0,0,0,,0,0,0,0,0,0,0,0,Matches
1728,Clément Michelin,fr FRA,DF,Lens,fr Ligue 1,23,1997,12.8,25,19,13,9,3,9,16,56.3,7,13,4,9,25,50,32,0,Matches
1729,Edouard Michut,fr FRA,MF,Paris S-G,fr Ligue 1,17,2003,0.0,0,0,0,0,0,0,0,,0,0,0,0,0,0,0,0,Matches
1730,Petar Mićin,rs SRB,MF,Udinese,it Serie A,21,1998,0.2,0,0,0,0,0,0,0,,0,0,0,0,0,0,0,0,Matches
1731,Florian Miguel,fr FRA,DF,Nîmes,fr Ligue 1,23,1996,17.1,14,13,12,2,0,9,17,52.9,8,21,13,8,45,59,66,1,Matches
1732,Valentin Mihaila,ro ROU,"FW,MF",Parma,it Serie A,20,2000,7.8,2,1,1,1,0,0,10,0.0,10,8,1,7,5,7,8,0,Matches
1733,Nikola Milenković,rs SRB,DF,Fiorentina,it Serie A,22,1997,33.7,49,29,33,14,2,21,33,63.6,12,42,33,9,44,93,122,1,Matches
1734,Arkadiusz Milik,pl POL,FW,Marseille,fr Ligue 1,26,1994,13.6,14,9,0,7,7,2,12,16.7,10,5,1,4,2,16,9,0,Matches
1735,Sergej Milinković-Savić,rs SRB,MF,Lazio,it Serie A,25,1995,30.5,59,40,20,30,9,27,84,32.1,57,52,12,40,33,92,47,0,Matches
1736,Vanja Milinković-Savić,rs SRB,GK,Torino,it Serie A,23,1997,5.0,1,1,1,0,0,1,1,100.0,0,0,0,0,0,1,1,3,Matches
1737,Éder Militão,br BRA,DF,Real Madrid,es La Liga,22,1998,12.6,20,8,13,6,1,8,14,57.1,6,19,6,13,19,39,42,0,Matches
1738,Luka Milivojević,rs SRB,MF,Crystal Palace,eng Premier League,29,1991,26.2,65,34,25,31,9,42,77,54.5,35,29,6,23,35,100,47,2,Matches
1739,Luis Milla,es ESP,MF,Granada,es La Liga,25,1994,13.9,22,11,11,10,1,6,28,21.4,22,10,0,10,24,46,16,1,Matches
1740,Pere Milla,es ESP,"FW,MF",Elche,es La Liga,27,1992,22.0,24,17,12,10,2,8,37,21.6,29,17,5,12,13,37,17,1,Matches
1741,Álex Millán,es ESP,FW,Villarreal,es La Liga,20,1999,0.0,0,0,0,0,0,0,0,,0,0,0,0,0,0,0,0,Matches
1742,Vincenzo Millico,it ITA,"FW,MF",Torino,it Serie A,19,2000,0.2,0,0,0,0,0,0,0,,0,0,0,0,0,0,0,0,Matches
1743,Enzo Millot,fr FRA,MF,Monaco,fr Ligue 1,18,2002,0.5,2,0,0,1,1,1,1,100.0,0,0,0,0,2,4,0,0,Matches
1744,James Milner,eng ENG,"MF,DF",Liverpool,eng Premier League,34,1986,11.9,26,19,9,14,3,11,33,33.3,22,30,3,27,14,40,16,1,Matches
1745,Santi Mina,es ESP,FW,Celta Vigo,es La Liga,24,1995,26.8,31,13,9,12,10,6,37,16.2,31,15,3,12,6,37,17,0,Matches
1746,Yerry Mina,co COL,DF,Everton,eng Premier League,25,1994,21.5,21,14,17,4,0,8,12,66.7,4,30,23,7,24,45,110,1,Matches
1747,Takumi Minamino,jp JPN,MF,Southampton,eng Premier League,25,1995,7.9,7,3,2,5,0,2,19,10.5,17,13,1,12,4,11,9,0,Matches
1748,Takumi Minamino,jp JPN,"MF,FW",Liverpool,eng Premier League,25,1995,3.3,4,3,1,2,1,0,12,0.0,12,1,0,1,2,6,3,0,Matches
1749,Tyrone Mings,eng ENG,DF,Aston Villa,eng Premier League,27,1993,35.5,32,16,23,7,2,16,24,66.7,8,59,40,19,41,73,172,3,Matches
1750,Óscar Mingueza,es ESP,DF,Barcelona,es La Liga,21,1999,21.1,52,33,28,17,7,30,53,56.6,23,19,6,13,20,72,48,2,Matches
1751,Rafa Mir,es ESP,FW,Huesca,es La Liga,23,1997,32.0,15,9,4,4,7,7,22,31.8,15,14,2,12,15,30,25,0,Matches
1752,Jorge Miramón,es ESP,DF,Levante,es La Liga,31,1989,19.2,32,22,26,6,0,21,35,60.0,14,22,2,20,27,59,54,0,Matches
1753,Aleksei Miranchuk,ru RUS,"MF,FW",Atalanta,it Serie A,24,1995,7.5,24,13,8,9,7,6,9,66.7,3,1,0,1,3,27,1,0,Matches
1754,Juan Miranda,es ESP,DF,Betis,es La Liga,20,2000,18.4,27,11,16,9,2,16,32,50.0,16,18,2,16,29,56,58,1,Matches
1755,Antonio Mirante,it ITA,GK,Roma,it Serie A,37,1983,12.8,0,0,0,0,0,0,1,0.0,1,1,0,1,0,0,7,2,Matches
1756,Tyrick Mitchell,eng ENG,DF,Crystal Palace,eng Premier League,20,1999,19.0,64,35,48,9,7,23,40,57.5,17,29,10,19,21,85,62,1,Matches
1757,Aleksandar Mitrović,rs SRB,FW,Fulham,eng Premier League,25,1994,15.6,7,4,0,3,4,2,8,25.0,6,12,3,9,3,10,8,0,Matches
1758,Stefan Mitrović,rs SRB,DF,Strasbourg,fr Ligue 1,30,1990,30.9,36,27,29,7,0,24,37,64.9,13,23,13,10,31,67,108,5,Matches
1759,Maximilian Mittelstädt,de GER,"DF,FW",Hertha BSC,de Bundesliga,23,1997,20.0,66,39,42,21,3,35,72,48.6,37,34,5,29,55,121,61,1,Matches
1760,Henrikh Mkhitaryan,am ARM,"MF,FW",Roma,it Serie A,31,1989,30.5,58,24,13,27,18,13,62,21.0,49,34,0,34,39,97,10,0,Matches
1761,Jakub Moder,pl POL,"DF,MF",Brighton,eng Premier League,21,1999,7.2,15,7,5,7,3,7,20,35.0,13,12,1,11,3,18,9,0,Matches
1762,Anthony Modeste,fr FRA,"FW,MF",Saint-Étienne,fr Ligue 1,32,1988,3.3,2,1,0,2,0,1,4,25.0,3,3,1,2,0,2,3,0,Matches
1763,Anthony Modeste,fr FRA,FW,Köln,de Bundesliga,32,1988,2.5,2,0,0,2,0,0,1,0.0,1,0,0,0,0,2,2,0,Matches
1764,Luka Modrić,hr CRO,MF,Real Madrid,es La Liga,34,1985,30.4,37,23,18,16,3,13,36,36.1,23,14,2,12,48,85,14,1,Matches
1765,Terem Moffi,ng NGA,FW,Lorient,fr Ligue 1,21,1999,23.0,13,8,0,8,5,4,19,21.1,15,5,2,3,4,17,8,0,Matches
1766,Kevin Möhwald,de GER,MF,Werder Bremen,de Bundesliga,27,1993,17.3,15,9,9,5,1,4,18,22.2,14,10,3,7,32,47,19,2,Matches
1767,Niklas Moisander,fi FIN,DF,Werder Bremen,de Bundesliga,34,1985,13.6,14,11,11,3,0,8,14,57.1,6,15,8,7,22,36,61,0,Matches
1768,Dion Moise Sahi,ci CIV,"FW,MF",Strasbourg,fr Ligue 1,18,2001,1.0,1,0,0,1,0,1,1,100.0,0,1,0,1,0,1,0,0,Matches
1769,Johan Mojica,co COL,DF,Atalanta,it Serie A,27,1992,3.3,4,4,3,1,0,2,3,66.7,1,3,0,3,7,11,6,0,Matches
1770,Johan Mojica,co COL,DF,Elche,es La Liga,27,1992,13.4,21,10,15,5,1,8,18,44.4,10,15,4,11,15,36,27,0,Matches
1771,Guillem Molina,es ESP,DF,Valencia,es La Liga,20,2000,1.7,1,0,1,0,0,0,5,0.0,5,1,1,0,4,5,5,0,Matches
1772,Jorge Molina,es ESP,FW,Granada,es La Liga,38,1982,17.9,11,4,3,5,3,8,22,36.4,14,5,1,4,3,14,19,0,Matches
1773,Nahuel Molina,ar ARG,DF,Udinese,it Serie A,22,1998,20.3,27,18,13,10,4,16,42,38.1,26,26,4,22,21,48,49,1,Matches
1774,Salvatore Molina,it ITA,"MF,DF",Crotone,it Serie A,28,1992,25.7,39,22,18,14,7,29,45,64.4,16,30,8,22,17,56,41,0,Matches
1775,Victor Mollejo,es ESP,"MF,DF",Getafe,es La Liga,19,2001,0.8,2,1,1,0,1,0,1,0.0,1,0,0,0,0,2,0,0,Matches
1776,Florent Mollet,fr FRA,MF,Montpellier,fr Ligue 1,28,1991,26.2,20,15,7,11,2,12,47,25.5,35,18,4,14,32,52,9,1,Matches
1777,Jayson Molumby,ie IRL,MF,Brighton,eng Premier League,20,1999,0.0,0,0,0,0,0,0,0,,0,0,0,0,0,0,0,0,Matches
1778,Alkhaly Momo Cissé,gn GUI,"FW,DF",Stuttgart,de Bundesliga,17,2002,0.4,1,1,1,0,0,0,0,,0,1,0,1,0,1,0,0,Matches
1779,Jon Moncayola,es ESP,MF,Osasuna,es La Liga,22,1998,29.6,61,36,27,23,11,24,67,35.8,43,27,9,18,23,84,38,0,Matches
1780,Gabriele Moncini,it ITA,"FW,MF",Benevento,it Serie A,24,1996,4.0,2,1,2,0,0,0,1,0.0,1,2,0,2,2,4,4,0,Matches
1781,Thomas Monconduit,fr FRA,MF,Lorient,fr Ligue 1,29,1991,12.8,28,15,9,16,3,15,41,36.6,26,10,3,7,13,41,21,1,Matches
1782,Kévin Monnet-Paquet,fr FRA,"MF,FW",Saint-Étienne,fr Ligue 1,31,1988,6.3,11,7,7,2,2,5,10,50.0,5,5,0,5,6,17,7,0,Matches
1783,Nacho Monreal,es ESP,DF,Real Sociedad,es La Liga,34,1986,23.1,31,19,17,11,3,7,20,35.0,13,14,3,11,31,62,43,0,Matches
1784,Cristóbal Montiel,es ESP,"MF,FW",Fiorentina,it Serie A,20,2000,0.0,0,0,0,0,0,0,1,0.0,1,0,0,0,0,0,0,0,Matches
1785,Lorenzo Montipò,it ITA,GK,Benevento,it Serie A,24,1996,37.0,0,0,0,0,0,0,0,,0,1,0,1,0,0,16,3,Matches
1786,Ángel Montoro,es ESP,MF,Granada,es La Liga,32,1988,15.1,15,9,7,7,1,4,16,25.0,12,13,3,10,22,37,21,0,Matches
1787,Martín Montoya,es ESP,DF,Betis,es La Liga,29,1991,2.7,6,3,2,2,2,1,3,33.3,2,1,1,0,2,8,6,0,Matches
1788,Emre Mor,tr TUR,"FW,MF",Celta Vigo,es La Liga,23,1997,5.6,8,4,1,3,4,0,3,0.0,3,5,0,5,5,13,0,0,Matches
1789,Luca Mora,it ITA,MF,Spezia,it Serie A,32,1988,1.3,3,1,1,2,0,2,4,50.0,2,2,1,1,0,3,2,0,Matches
1790,Wesley Moraes,br BRA,FW,Aston Villa,eng Premier League,23,1996,0.2,0,0,0,0,0,0,1,0.0,1,0,0,0,0,0,0,0,Matches
1791,Álvaro Morata,es ESP,FW,Juventus,it Serie A,27,1992,22.4,17,12,2,10,5,4,28,14.3,24,22,2,20,5,22,21,0,Matches
1792,Jan Morávek,cz CZE,MF,Augsburg,de Bundesliga,30,1989,3.0,5,3,4,1,0,1,8,12.5,7,3,0,3,7,12,2,0,Matches
1793,Jon Morcillo,es ESP,"MF,FW",Athletic Club,es La Liga,21,1998,15.1,16,9,3,6,7,7,30,23.3,23,9,0,9,15,31,11,0,Matches
1794,Jérémy Morel,mg MAD,DF,Lorient,fr Ligue 1,36,1984,27.7,31,19,21,10,0,20,39,51.3,19,26,11,15,44,75,81,1,Matches
1795,Alberto Moreno,es ESP,DF,Villarreal,es La Liga,28,1992,2.1,7,4,7,0,0,2,5,40.0,3,2,1,1,3,10,2,0,Matches
1796,Álex Moreno,es ESP,DF,Betis,es La Liga,27,1993,19.8,42,26,25,12,5,20,43,46.5,23,18,4,14,35,77,48,0,Matches
1797,Gerard Moreno,es ESP,FW,Villarreal,es La Liga,28,1992,29.7,24,15,8,10,6,7,34,20.6,27,17,4,13,15,39,26,0,Matches
1798,Tete Morente,es ESP,"MF,FW",Elche,es La Liga,23,1996,22.4,31,17,17,9,5,9,39,23.1,30,20,0,20,13,44,28,0,Matches
1799,Mateu Morey,es ESP,DF,Dortmund,de Bundesliga,20,2000,9.2,13,7,4,7,2,9,12,75.0,3,6,1,5,18,31,7,1,Matches
1800,Wes Morgan,jm JAM,DF,Leicester City,eng Premier League,36,1984,0.2,0,0,0,0,0,0,0,,0,0,0,0,0,0,1,0,Matches
1801,Ilaix Moriba,gn GUI,MF,Barcelona,es La Liga,17,2003,6.0,14,6,5,7,2,5,10,50.0,5,16,1,15,5,19,4,1,Matches
1802,Raúl Moro,es ESP,FW,Lazio,it Serie A,17,2002,0.1,0,0,0,0,0,0,1,0.0,1,0,0,0,0,0,0,0,Matches
1803,Loren Morón,es ESP,FW,Betis,es La Liga,26,1993,11.0,11,7,2,6,3,1,16,6.3,15,11,0,11,3,14,14,0,Matches
1804,Pedro Mosquera,es ESP,MF,Huesca,es La Liga,32,1988,22.8,38,18,19,18,1,13,53,24.5,40,23,6,17,31,69,38,1,Matches
1805,Aimen Moueffek,fr FRA,"DF,MF",Saint-Étienne,fr Ligue 1,19,2001,8.3,25,15,16,6,3,13,32,40.6,19,17,2,15,9,34,18,0,Matches
1806,Youssoufa Moukoko,de GER,"FW,MF",Dortmund,de Bundesliga,15,2004,4.7,3,2,1,1,1,0,0,,0,3,0,3,0,3,2,0,Matches
1807,Harold Moukoudi,cm CMR,DF,Saint-Étienne,fr Ligue 1,22,1997,25.3,46,27,37,8,1,28,38,73.7,10,24,10,14,42,88,78,1,Matches
1808,Jessy Moulin,fr FRA,GK,Saint-Étienne,fr Ligue 1,34,1986,29.0,2,1,2,0,0,2,3,66.7,1,0,0,0,2,4,9,2,Matches
1809,Steve Mounié,bj BEN,FW,Brest,fr Ligue 1,25,1994,29.8,15,11,3,11,1,3,28,10.7,25,18,3,15,12,27,40,0,Matches
1810,Mason Mount,eng ENG,MF,Chelsea,eng Premier League,21,1999,32.1,75,35,22,38,15,25,69,36.2,44,40,2,38,31,106,14,0,Matches
1811,Lucas Moura,br BRA,"FW,MF",Tottenham,eng Premier League,27,1992,15.7,32,16,12,16,4,8,29,27.6,21,12,0,12,18,50,10,0,Matches
1812,Lys Mousset,fr FRA,"FW,MF",Sheffield Utd,eng Premier League,24,1996,3.3,1,0,0,0,1,0,2,0.0,2,1,0,1,0,1,1,1,Matches
1813,João Moutinho,pt POR,MF,Wolves,eng Premier League,33,1986,28.1,75,40,34,35,6,35,91,38.5,56,18,3,15,47,122,28,0,Matches
1814,Samuel Moutoussamy,cd COD,FW,Nantes,fr Ligue 1,23,1996,0.9,0,0,0,0,0,0,1,0.0,1,1,0,1,0,0,0,0,Matches
1815,Loris Mouyokolo,fr FRA,DF,Lorient,fr Ligue 1,19,2001,0.2,1,1,1,0,0,1,1,100.0,0,1,1,0,0,1,1,0,Matches
1816,Javi Moyano,es ESP,DF,Valladolid,es La Liga,34,1986,1.1,0,0,0,0,0,0,0,,0,2,0,2,0,0,2,0,Matches
1817,Nordi Mukiele,fr FRA,DF,RB Leipzig,de Bundesliga,22,1997,18.6,44,30,14,28,2,21,37,56.8,16,33,1,32,23,67,33,2,Matches
1818,Mert Müldür,tr TUR,DF,Sassuolo,it Serie A,21,1999,18.6,43,20,26,9,8,27,53,50.9,26,17,1,16,36,79,41,0,Matches
1819,Florian Müller,de GER,GK,Freiburg,de Bundesliga,22,1997,31.0,0,0,0,0,0,0,3,0.0,3,1,0,1,2,2,10,1,Matches
1820,Sebastian Müller,de GER,"MF,DF",Arminia,de Bundesliga,19,2001,0.0,0,0,0,0,0,0,0,,0,0,0,0,0,0,0,0,Matches
1821,Thomas Müller,de GER,MF,Bayern Munich,de Bundesliga,30,1989,29.7,49,22,11,23,15,24,73,32.9,49,43,3,40,21,70,18,1,Matches
1822,Joel Mumbongo,se SWE,FW,Burnley,eng Premier League,21,1999,0.4,0,0,0,0,0,0,0,,0,1,0,1,0,0,0,0,Matches
1823,Marshall Munetsi,zw ZIM,"MF,DF",Reims,fr Ligue 1,24,1996,21.4,35,19,19,14,2,21,41,51.2,20,33,25,8,57,92,85,3,Matches
1824,Iker Muniain,es ESP,"MF,FW",Athletic Club,es La Liga,27,1992,21.6,20,7,4,10,6,6,24,25.0,18,15,0,15,11,31,4,0,Matches
1825,Aihen Muñoz,es ESP,DF,Real Sociedad,es La Liga,22,1997,13.4,23,16,15,5,3,11,19,57.9,8,12,2,10,10,33,31,0,Matches
1826,Joaquín Muñoz,es ESP,FW,Huesca,es La Liga,21,1999,0.5,0,0,0,0,0,0,2,0.0,2,0,0,0,1,1,0,0,Matches
1827,Luis Muriel,co COL,FW,Atalanta,it Serie A,29,1991,16.0,20,9,4,8,8,9,26,34.6,17,17,0,17,7,27,4,0,Matches
1828,Jeison Murillo,co COL,DF,Celta Vigo,es La Liga,28,1992,30.0,45,21,35,9,1,24,44,54.5,20,29,17,12,36,81,100,2,Matches
1829,Vedat Muriqi,xk KVX,FW,Lazio,it Serie A,26,1994,9.2,3,1,0,2,1,0,8,0.0,8,9,2,7,3,6,20,0,Matches
1830,Jacob Murphy,eng ENG,"DF,MF",Newcastle Utd,eng Premier League,25,1995,18.1,39,24,25,12,2,24,49,49.0,25,27,3,24,14,53,29,0,Matches
1831,Nicola Murru,it ITA,DF,Torino,it Serie A,25,1994,6.3,9,6,1,5,3,3,5,60.0,2,11,1,10,12,21,24,0,Matches
1832,Petar Musa,hr CRO,FW,Union Berlin,de Bundesliga,22,1998,7.9,12,8,3,6,3,4,8,50.0,4,10,0,10,4,16,5,0,Matches
1833,Mateo Musacchio,ar ARG,DF,Lazio,it Serie A,29,1990,2.5,1,1,1,0,0,0,0,,0,5,2,3,2,3,5,0,Matches
1834,Mateo Musacchio,ar ARG,DF,Milan,it Serie A,29,1990,0.4,2,1,2,0,0,2,3,66.7,1,1,0,1,3,5,0,0,Matches
1835,Yunus Musah,us USA,MF,Valencia,es La Liga,17,2002,17.0,21,18,12,3,6,8,24,33.3,16,20,0,20,15,36,12,1,Matches
1836,Jamal Musiala,de GER,"FW,MF",Bayern Munich,de Bundesliga,17,2003,9.8,20,12,5,7,8,7,22,31.8,15,17,2,15,14,34,3,0,Matches
1837,Juan Musso,ar ARG,GK,Udinese,it Serie A,26,1994,35.0,1,1,1,0,0,1,1,100.0,0,0,0,0,1,2,8,1,Matches
1838,Shkodran Mustafi,de GER,DF,Arsenal,eng Premier League,28,1992,0.5,1,1,1,0,0,1,1,100.0,0,1,0,1,0,1,3,0,Matches
1839,Shkodran Mustafi,de GER,DF,Schalke 04,de Bundesliga,28,1992,11.5,16,5,15,1,0,3,12,25.0,9,20,15,5,32,48,76,1,Matches
1840,Yoshinori Mutō,jp JPN,"FW,MF",Eibar,es La Liga,28,1992,12.5,12,7,1,4,7,3,8,37.5,5,5,0,5,3,15,2,0,Matches
1841,Phillipp Mwene,at AUT,"DF,MF",Mainz 05,de Bundesliga,26,1994,18.6,36,23,21,11,4,19,38,50.0,19,26,3,23,24,60,33,0,Matches
1842,Joakim Mæhle,dk DEN,DF,Atalanta,it Serie A,23,1997,13.5,18,10,7,5,6,8,19,42.1,11,17,2,15,11,29,5,0,Matches
1843,Obite N'Dicka,ci CIV,DF,Eint Frankfurt,de Bundesliga,20,1999,22.7,31,23,16,15,0,16,28,57.1,12,27,6,21,47,78,85,0,Matches
1844,Kévin N'Doram,fr FRA,MF,Metz,fr Ligue 1,24,1996,3.4,3,2,0,3,0,1,3,33.3,2,0,0,0,6,9,2,0,Matches
1845,Stanley N'Soki,fr FRA,DF,Nice,fr Ligue 1,21,1999,13.8,27,19,15,9,3,13,22,59.1,9,17,4,13,26,53,38,2,Matches
1846,Nacho,es ESP,DF,Valladolid,es La Liga,31,1989,20.1,43,21,29,10,4,24,52,46.2,28,21,1,20,29,72,47,0,Matches
1847,Nacho,es ESP,DF,Real Madrid,es La Liga,30,1990,22.2,27,14,13,11,3,12,35,34.3,23,19,9,10,40,67,58,0,Matches
1848,Yuto Nagatomo,jp JPN,DF,Marseille,fr Ligue 1,33,1986,17.7,23,16,12,8,3,9,18,50.0,9,14,3,11,29,52,43,0,Matches
1849,Kenny Nagera,fr FRA,FW,Paris S-G,fr Ligue 1,18,2002,0.0,0,0,0,0,0,0,0,,0,0,0,0,0,0,0,0,Matches
1850,Radja Nainggolan,be BEL,MF,Cagliari,it Serie A,32,1988,20.5,41,26,22,14,5,19,34,55.9,15,18,0,18,15,56,15,1,Matches
1851,Radja Nainggolan,be BEL,MF,Inter,it Serie A,32,1988,0.5,0,0,0,0,0,0,0,,0,0,0,0,1,1,0,0,Matches
1852,Marvelous Nakamba,zw ZIM,MF,Aston Villa,eng Premier League,26,1994,8.3,22,14,10,11,1,7,12,58.3,5,16,5,11,17,39,9,1,Matches
1853,Nahitan Nández,uy URU,"MF,DF",Cagliari,it Serie A,24,1995,30.4,56,28,23,23,10,25,68,36.8,43,26,4,22,23,79,49,0,Matches
1854,Nano,es ESP,FW,Cádiz,es La Liga,25,1995,0.1,0,0,0,0,0,0,0,,0,0,0,0,0,0,0,0,Matches
1855,Paul Nardi,fr FRA,GK,Lorient,fr Ligue 1,26,1994,23.0,0,0,0,0,0,0,1,0.0,1,1,0,1,0,0,15,2,Matches
1856,Matija Nastasić,rs SRB,DF,Schalke 04,de Bundesliga,27,1993,13.6,11,7,9,2,0,9,16,56.3,7,22,18,4,26,37,51,1,Matches
1857,Roberto Navarro,es ESP,MF,Real Sociedad,es La Liga,18,2002,0.4,1,1,1,0,0,0,2,0.0,2,0,0,0,1,2,0,0,Matches
1858,Ximo Navarro,es ESP,DF,Alavés,es La Liga,30,1990,26.4,54,30,36,17,1,14,30,46.7,16,14,4,10,47,101,75,3,Matches
1859,Jesús Navas,es ESP,DF,Sevilla,es La Liga,34,1985,31.4,27,21,15,11,1,15,22,68.2,7,10,3,7,37,64,62,1,Matches
1860,Keylor Navas,cr CRC,GK,Paris S-G,fr Ligue 1,33,1986,28.0,0,0,0,0,0,0,0,,0,0,0,0,0,0,10,0,Matches
1861,Raúl Navas,es ESP,DF,Osasuna,es La Liga,32,1988,1.9,6,3,5,1,0,4,6,66.7,2,0,0,0,3,9,13,0,Matches
1862,Papa Ndiaga Yade,mr MTN,"FW,MF",Metz,fr Ligue 1,20,2000,11.1,15,8,9,2,4,7,20,35.0,13,9,0,9,4,19,6,0,Matches
1863,Iliman Ndiaye,sn SEN,MF,Sheffield Utd,eng Premier League,20,2000,0.1,1,1,0,1,0,1,1,100.0,0,0,0,0,0,1,0,0,Matches
1864,Wilfred Ndidi,ng NGA,"MF,DF",Leicester City,eng Premier League,23,1996,24.2,96,63,45,44,7,26,66,39.4,40,38,11,27,61,157,55,0,Matches
1865,Bridge Ndilu,fr FRA,"FW,MF",Nantes,fr Ligue 1,20,2000,0.5,0,0,0,0,0,0,2,0.0,2,2,0,2,0,0,0,0,Matches
1866,Tanguy Ndombele,fr FRA,MF,Tottenham,eng Premier League,23,1996,23.2,41,20,11,21,9,18,44,40.9,26,28,4,24,19,60,15,0,Matches
1867,Dan Ndoye,ch SUI,"FW,MF",Nice,fr Ligue 1,19,2000,6.1,7,6,3,4,0,1,8,12.5,7,4,0,4,7,14,4,0,Matches
1868,Paul Nebel,de GER,"MF,FW",Mainz 05,de Bundesliga,17,2002,0.6,1,1,0,1,0,0,1,0.0,1,0,0,0,2,3,0,0,Matches
1869,Álvaro Negredo,es ESP,FW,Cádiz,es La Liga,34,1985,24.4,11,5,3,4,4,5,11,45.5,6,7,2,5,3,14,19,0,Matches
1870,Reiss Nelson,eng ENG,"FW,MF",Arsenal,eng Premier League,20,1999,0.8,1,0,0,0,1,0,0,,0,0,0,0,1,2,1,0,Matches
1871,Ilija Nestorovski,mk MKD,"FW,MF",Udinese,it Serie A,30,1990,7.8,6,4,2,3,1,2,13,15.4,11,5,0,5,1,7,7,0,Matches
1872,Neto,br BRA,GK,Barcelona,es La Liga,31,1989,7.0,0,0,0,0,0,0,1,0.0,1,0,0,0,0,0,3,1,Matches
1873,Pedro Neto,pt POR,"FW,MF",Wolves,eng Premier League,20,2000,28.3,16,9,4,6,6,6,28,21.4,22,18,2,16,31,47,8,0,Matches
1874,Luca Netz,de GER,"DF,FW",Hertha BSC,de Bundesliga,17,2003,3.4,14,8,12,2,0,6,17,35.3,11,3,0,3,6,20,8,0,Matches
1875,Manuel Neuer,de GER,GK,Bayern Munich,de Bundesliga,34,1986,33.0,0,0,0,0,0,0,1,0.0,1,0,0,0,2,2,12,3,Matches
1876,Florian Neuhaus,de GER,MF,Gladbach,de Bundesliga,23,1997,29.1,48,28,19,26,3,19,63,30.2,44,35,7,28,50,98,20,1,Matches
1877,Carlos Neva,es ESP,DF,Granada,es La Liga,24,1996,20.0,12,6,6,6,0,6,11,54.5,5,16,4,12,27,39,58,0,Matches
1878,Rúben Neves,pt POR,MF,Wolves,eng Premier League,23,1997,29.7,86,46,42,38,6,36,88,40.9,52,55,11,44,65,151,46,2,Matches
1879,Neymar,br BRA,"MF,FW",Paris S-G,fr Ligue 1,28,1992,15.7,14,11,1,6,7,8,37,21.6,29,8,0,8,9,23,0,0,Matches
1880,Yvan Neyou,cm CMR,MF,Saint-Étienne,fr Ligue 1,23,1997,27.1,58,31,24,33,1,25,60,41.7,35,34,5,29,31,89,13,1,Matches
1881,Jessic Ngankam,de GER,FW,Hertha BSC,de Bundesliga,20,2000,3.3,5,2,1,2,2,1,3,33.3,2,6,1,5,0,5,1,0,Matches
1882,Muzinga Ngonda,cd COD,DF,Dijon,fr Ligue 1,25,1994,25.6,59,40,37,21,1,30,50,60.0,20,28,3,25,72,131,58,0,Matches
1883,Ahmad Ngouyamsa,cm CMR,DF,Dijon,fr Ligue 1,19,2000,1.7,6,4,5,1,0,4,8,50.0,4,2,1,1,2,8,8,0,Matches
1884,Opa Nguette,sn SEN,"FW,MF",Metz,fr Ligue 1,26,1994,12.6,15,8,2,8,5,3,10,30.0,7,14,2,12,1,16,1,0,Matches
1885,Moussa Niakhate,sn SEN,DF,Mainz 05,de Bundesliga,24,1996,31.8,42,22,28,13,1,14,29,48.3,15,31,15,16,49,91,79,0,Matches
1886,Ibrahima Niane,sn SEN,FW,Metz,fr Ligue 1,21,1999,7.4,1,1,0,0,1,1,2,50.0,1,3,0,3,0,1,8,0,Matches
1887,M'Baye Niang,sn SEN,FW,Rennes,fr Ligue 1,25,1994,4.7,3,2,2,1,0,0,0,,0,2,0,2,1,4,2,0,Matches
1888,Mamor Niang,sn SEN,"MF,FW",Getafe,es La Liga,18,2002,0.2,1,1,0,1,0,0,0,,0,1,0,1,0,1,0,0,Matches
1889,Tanguy Nianzou,fr FRA,"DF,FW",Bayern Munich,de Bundesliga,18,2002,1.3,3,1,3,0,0,1,1,100.0,0,0,0,0,3,6,1,0,Matches
1890,Florian Niederlechner,de GER,FW,Augsburg,de Bundesliga,29,1990,19.3,7,5,1,4,2,0,10,0.0,10,8,3,5,10,17,18,0,Matches
1891,Nieto,es ESP,"FW,DF",Cádiz,es La Liga,22,1998,0.2,1,1,0,1,0,0,0,,0,0,0,0,0,1,1,0,Matches
1892,Saúl Ñíguez,es ESP,"MF,DF",Atlético Madrid,es La Liga,25,1994,22.6,57,34,27,23,7,30,59,50.8,29,35,2,33,19,76,43,0,Matches
1893,Joakim Nilsson,se SWE,DF,Arminia,de Bundesliga,26,1994,24.0,36,24,23,12,1,14,23,60.9,9,29,22,7,39,75,111,0,Matches
1894,Casimir Ninga,td CHA,FW,Angers,fr Ligue 1,27,1993,0.3,0,0,0,0,0,0,0,,0,0,0,0,0,0,1,0,Matches
1895,Nino,es ESP,"FW,MF",Elche,es La Liga,40,1980,3.2,0,0,0,0,0,0,1,0.0,1,1,0,1,0,0,0,0,Matches
1896,Fernando Niño,es ESP,FW,Villarreal,es La Liga,19,2000,6.6,8,3,0,4,4,2,9,22.2,7,1,0,1,2,10,2,0,Matches
1897,Eddie Nketiah,eng ENG,FW,Arsenal,eng Premier League,21,1999,4.7,3,1,0,2,1,0,2,0.0,2,6,0,6,0,3,5,0,Matches
1898,Nicolas Nkoulou,cm CMR,DF,Torino,it Serie A,30,1990,15.1,14,9,11,3,0,7,12,58.3,5,28,14,14,33,47,71,1,Matches
1899,Niels Nkounkou,fr FRA,"DF,FW",Everton,eng Premier League,19,2000,0.9,4,3,1,2,1,3,8,37.5,5,4,0,4,0,4,4,0,Matches
1900,Christopher Nkunku,fr FRA,"FW,MF",RB Leipzig,de Bundesliga,22,1997,21.0,16,11,3,7,6,8,18,44.4,10,27,1,26,9,25,14,0,Matches
1901,Dan Nlundulu,eng ENG,"FW,MF",Southampton,eng Premier League,21,1999,1.2,0,0,0,0,0,0,1,0.0,1,2,0,2,0,0,2,0,Matches
1902,Mark Noble,eng ENG,MF,West Ham,eng Premier League,33,1987,7.9,8,4,2,5,1,4,14,28.6,10,7,3,4,13,21,3,0,Matches
1903,Nolito,es ESP,"MF,FW",Celta Vigo,es La Liga,33,1986,28.9,70,36,30,30,10,32,92,34.8,60,46,2,44,22,92,19,0,Matches
1904,Arnaud Nordin,fr FRA,"MF,FW",Saint-Étienne,fr Ligue 1,22,1998,19.7,14,8,5,5,4,6,21,28.6,15,13,2,11,9,23,10,0,Matches
1905,Håvard Nordtveit,no NOR,DF,Hoffenheim,de Bundesliga,30,1990,7.8,6,2,5,1,0,6,8,75.0,2,4,2,2,13,19,42,0,Matches
1906,Will Norris,eng ENG,GK,Burnley,eng Premier League,26,1993,2.0,0,0,0,0,0,0,0,,0,0,0,0,0,0,0,0,Matches
1907,Oliver Norwood,nir NIR,MF,Sheffield Utd,eng Premier League,29,1991,24.7,49,22,16,28,5,21,72,29.2,51,29,12,17,36,85,51,1,Matches
1908,Olivier Ntcham,cm CMR,MF,Marseille,fr Ligue 1,24,1996,1.3,1,0,0,1,0,1,3,33.3,2,3,1,2,2,3,3,0,Matches
1909,Alexander Nübel,de GER,GK,Bayern Munich,de Bundesliga,23,1996,1.0,0,0,0,0,0,0,0,,0,0,0,0,0,0,1,0,Matches
1910,Kasim Nuhu,gh GHA,DF,Hoffenheim,de Bundesliga,25,1995,11.0,13,7,9,4,0,6,10,60.0,4,8,3,5,15,28,38,0,Matches
1911,Unai Núñez,es ESP,DF,Athletic Club,es La Liga,23,1997,23.4,23,12,16,7,0,10,15,66.7,5,19,14,5,32,55,110,0,Matches
1912,Bram Nuytinck,nl NED,DF,Udinese,it Serie A,30,1990,18.2,21,15,10,9,2,13,20,65.0,7,30,17,13,25,46,77,0,Matches
1913,Kelechi Nwakali,ng NGA,"MF,FW",Huesca,es La Liga,22,1998,1.6,4,3,1,2,1,0,4,0.0,4,1,0,1,1,5,1,0,Matches
1914,Simeon Nwankwo,ng NGA,FW,Crotone,it Serie A,28,1992,32.7,9,2,2,6,1,3,22,13.6,19,21,5,16,6,15,51,0,Matches
1915,Gerzino Nyamsi,fr FRA,DF,Rennes,fr Ligue 1,23,1997,9.7,12,10,2,8,2,4,6,66.7,2,8,5,3,10,22,32,1,Matches
1916,Allan Nyom,cm CMR,"MF,DF",Getafe,es La Liga,32,1988,25.8,38,23,14,19,5,15,30,50.0,15,16,2,14,22,60,42,0,Matches
1917,M'Bala Nzola,ao ANG,FW,Spezia,it Serie A,23,1996,21.1,12,5,2,6,4,4,7,57.1,3,15,1,14,3,15,20,0,Matches
1918,Steven Nzonzi,fr FRA,MF,Rennes,fr Ligue 1,31,1988,32.3,34,16,15,16,3,12,31,38.7,19,24,10,14,16,50,26,0,Matches
1919,Jack O'Connell,eng ENG,DF,Sheffield Utd,eng Premier League,26,1994,2.0,3,1,1,1,1,0,1,0.0,1,4,3,1,2,5,7,0,Matches
1920,Dara O'Shea,ie IRL,DF,West Brom,eng Premier League,21,1999,23.4,45,25,30,13,2,21,45,46.7,24,32,17,15,45,90,108,0,Matches
1921,Michael Obafemi,ie IRL,FW,Southampton,eng Premier League,20,2000,0.7,1,0,0,1,0,0,1,0.0,1,1,0,1,0,1,0,0,Matches
1922,Pedro Obiang,gq EQG,MF,Sassuolo,it Serie A,28,1992,16.3,35,22,17,15,3,12,35,34.3,23,26,7,19,22,57,27,0,Matches
1923,Jan Oblak,si SVN,GK,Atlético Madrid,es La Liga,27,1993,38.0,0,0,0,0,0,0,0,,0,0,0,0,0,0,6,2,Matches
1924,Lucas Ocampos,ar ARG,FW,Sevilla,es La Liga,26,1994,29.2,36,24,12,16,8,13,37,35.1,24,33,1,32,19,55,30,1,Matches
1925,Bastian Oczipka,de GER,"DF,FW",Schalke 04,de Bundesliga,31,1989,21.4,33,20,22,10,1,7,21,33.3,14,22,4,18,24,57,41,0,Matches
1926,Brian Oddei,it ITA,"FW,MF",Sassuolo,it Serie A,17,2002,0.5,2,1,1,1,0,2,3,66.7,1,1,0,1,0,2,1,0,Matches
1927,Denis Odoi,gh GHA,DF,Fulham,eng Premier League,32,1988,3.0,3,3,2,1,0,1,4,25.0,3,3,1,2,5,8,5,0,Matches
1928,Álvaro Odriozola,es ESP,DF,Real Madrid,es La Liga,24,1995,9.2,14,7,5,8,1,3,5,60.0,2,6,3,3,6,20,12,1,Matches
1929,Angelo Ogbonna,it ITA,DF,West Ham,eng Premier League,32,1988,27.7,26,13,20,5,1,9,17,52.9,8,25,11,14,30,56,119,0,Matches
1930,Stefano Okaka,it ITA,FW,Udinese,it Serie A,30,1989,16.5,10,7,2,5,3,2,10,20.0,8,7,1,6,2,12,19,0,Matches
1931,Shinji Okazaki,jp JPN,"FW,MF",Huesca,es La Liga,34,1986,12.5,7,5,5,0,2,0,5,0.0,5,5,0,5,4,11,6,0,Matches
1932,Masaya Okugawa,jp JPN,MF,Arminia,de Bundesliga,24,1996,10.2,17,8,5,11,1,6,14,42.9,8,17,2,15,8,25,5,0,Matches
1933,Lucas Olaza,uy URU,DF,Valladolid,es La Liga,26,1994,14.0,20,9,11,7,2,9,17,52.9,8,15,7,8,15,35,38,0,Matches
1934,Lucas Olaza,uy URU,DF,Celta Vigo,es La Liga,26,1994,17.9,25,16,12,12,1,10,18,55.6,8,15,1,14,24,49,34,0,Matches
1935,Christian Oliva,uy URU,MF,Cagliari,it Serie A,24,1996,4.3,10,4,6,3,1,6,17,35.3,11,11,1,10,8,18,7,0,Matches
1936,Christian Oliva,uy URU,MF,Valencia,es La Liga,24,1996,2.2,2,0,1,1,0,1,6,16.7,5,1,0,1,6,8,0,0,Matches
1937,Kiko Olivas,es ESP,DF,Valladolid,es La Liga,31,1988,2.0,3,2,2,1,0,3,5,60.0,2,2,2,0,7,10,3,0,Matches
1938,Paulo Oliveira,pt POR,DF,Eibar,es La Liga,28,1992,29.3,42,21,32,8,2,19,36,52.8,17,39,14,25,59,101,112,0,Matches
1939,Mathías Olivera,uy URU,DF,Getafe,es La Liga,22,1997,29.0,61,33,31,21,9,32,56,57.1,24,33,3,30,31,92,55,0,Matches
1940,Maximiliano Olivera,uy URU,DF,Fiorentina,it Serie A,28,1992,1.0,2,0,1,1,0,1,1,100.0,0,3,1,2,0,2,8,0,Matches
1941,Dani Olmo,es ESP,MF,RB Leipzig,de Bundesliga,22,1998,24.4,23,14,6,13,4,4,23,17.4,19,15,0,15,13,36,21,0,Matches
1942,Robin Olsen,se SWE,GK,Everton,eng Premier League,30,1990,7.0,0,0,0,0,0,0,0,,0,0,0,0,0,0,4,1,Matches
1943,Jonas Omlin,ch SUI,GK,Montpellier,fr Ligue 1,26,1994,29.7,1,1,1,0,0,1,4,25.0,3,0,0,0,0,1,9,1,Matches
1944,Jérôme Onguéné,cm CMR,DF,Genoa,it Serie A,22,1997,2.0,2,1,2,0,0,2,7,28.6,5,2,0,2,2,4,8,0,Matches
1945,Karim Onisiwo,at AUT,"FW,MF",Mainz 05,de Bundesliga,28,1992,20.5,31,20,7,15,9,14,23,60.9,9,20,1,19,5,36,12,0,Matches
1946,Josh Onomah,eng ENG,MF,Fulham,eng Premier League,23,1997,4.2,11,8,1,6,4,0,5,0.0,5,4,2,2,2,13,1,0,Matches
1947,Javier Ontiveros,es ESP,"FW,MF",Huesca,es La Liga,22,1997,10.2,21,14,10,10,1,9,26,34.6,17,12,0,12,9,30,6,0,Matches
1948,Henry Onyekuru,ng NGA,FW,Monaco,fr Ligue 1,23,1997,1.6,1,0,1,0,0,1,4,25.0,3,1,0,1,0,1,0,0,Matches
1949,Willi Orban,hu HUN,DF,RB Leipzig,de Bundesliga,27,1992,26.3,40,26,19,15,6,23,37,62.2,14,29,20,9,40,80,74,0,Matches
1950,Fabián Orellana,cl CHI,"MF,FW",Valladolid,es La Liga,34,1986,23.8,33,19,12,14,7,12,55,21.8,43,18,0,18,15,48,9,0,Matches
1951,Divock Origi,be BEL,FW,Liverpool,eng Premier League,25,1995,2.1,3,2,0,2,1,1,3,33.3,2,5,1,4,1,4,2,0,Matches
1952,Riccardo Orsolini,it ITA,"FW,MF",Bologna,it Serie A,23,1997,19.5,37,18,13,12,12,16,39,41.0,23,22,3,19,10,47,22,0,Matches
1953,Stefan Ortega,de GER,GK,Arminia,de Bundesliga,27,1992,34.0,2,1,2,0,0,2,6,33.3,4,0,0,0,0,2,12,3,Matches
1954,Yuya Osako,jp JPN,"MF,FW",Werder Bremen,de Bundesliga,30,1990,8.5,12,8,2,5,5,2,9,22.2,7,6,1,5,5,17,7,0,Matches
1955,Ben Osborn,eng ENG,"MF,DF",Sheffield Utd,eng Premier League,25,1994,17.8,33,18,15,10,8,13,40,32.5,27,20,3,17,12,45,17,0,Matches
1956,Victor Osimhen,ng NGA,FW,Napoli,it Serie A,21,1998,17.5,22,15,2,6,14,3,15,20.0,12,6,0,6,7,29,10,0,Matches
1957,Yordan Osorio,ve VEN,DF,Parma,it Serie A,26,1994,20.1,22,14,13,9,0,9,24,37.5,15,30,18,12,53,75,77,1,Matches
1958,David Ospina,co COL,GK,Napoli,it Serie A,31,1988,16.0,0,0,0,0,0,0,0,,0,0,0,0,0,0,4,0,Matches
1959,Owen Otasowie,us USA,"MF,FW",Wolves,eng Premier League,19,2001,2.1,5,5,3,2,0,1,2,50.0,1,1,1,0,3,8,4,0,Matches
1960,Otávio,br BRA,MF,Bordeaux,fr Ligue 1,26,1994,17.3,54,31,33,19,2,26,55,47.3,29,20,5,15,26,80,36,0,Matches
1961,Paulo Otávio,br BRA,DF,Wolfsburg,de Bundesliga,25,1994,19.3,60,40,32,22,6,34,62,54.8,28,51,7,44,42,102,59,0,Matches
1962,Remi Oudin,fr FRA,"FW,MF",Bordeaux,fr Ligue 1,23,1996,26.9,34,16,22,7,5,15,36,41.7,21,22,2,20,51,85,40,1,Matches
1963,Alexandre Oukidja,dz ALG,GK,Metz,fr Ligue 1,32,1988,34.0,0,0,0,0,0,0,1,0.0,1,1,0,1,0,0,17,3,Matches
1964,Zinédine Ould Khaled,fr FRA,MF,Angers,fr Ligue 1,20,2000,0.4,0,0,0,0,0,0,0,,0,0,0,0,1,1,0,0,Matches
1965,Adam Ounas,dz ALG,"FW,MF",Crotone,it Serie A,23,1996,13.3,9,4,4,4,1,0,7,0.0,7,12,1,11,3,12,4,0,Matches
1966,Adam Ounas,dz ALG,"MF,FW",Cagliari,it Serie A,23,1996,3.4,3,2,3,0,0,0,11,0.0,11,5,0,5,3,6,0,0,Matches
1967,Thomas Ouwejan,nl NED,DF,Udinese,it Serie A,23,1996,4.6,4,1,0,3,1,2,9,22.2,7,4,0,4,5,9,6,0,Matches
1968,Reece Oxford,eng ENG,DF,Augsburg,de Bundesliga,21,1998,15.1,26,18,15,11,0,10,17,58.8,7,28,22,6,29,55,89,0,Matches
1969,Alex Oxlade-Chamberlain,eng ENG,"MF,FW",Liverpool,eng Premier League,26,1993,2.8,4,0,0,3,1,0,2,0.0,2,1,0,1,2,6,0,0,Matches
1970,Mikel Oyarzabal,es ESP,"FW,MF",Real Sociedad,es La Liga,23,1997,26.8,30,17,14,12,4,10,31,32.3,21,30,5,25,15,45,17,0,Matches
1971,Ambroise Oyongo,cm CMR,DF,Montpellier,fr Ligue 1,29,1991,6.2,13,6,10,3,0,9,15,60.0,6,3,2,1,8,21,26,1,Matches
1972,Salih Özcan,tr TUR,MF,Köln,de Bundesliga,22,1998,15.2,21,13,11,10,0,12,33,36.4,21,11,2,9,20,41,14,1,Matches
1973,Levin Öztunalı,de GER,"DF,FW",Mainz 05,de Bundesliga,24,1996,8.4,24,18,14,8,2,8,17,47.1,9,15,0,15,15,39,16,0,Matches
1974,Pablo,br BRA,DF,Bordeaux,fr Ligue 1,29,1991,12.0,17,11,13,4,0,8,14,57.1,6,17,12,5,25,42,46,1,Matches
1975,Fernando Pacheco,es ESP,GK,Alavés,es La Liga,28,1992,37.2,2,0,2,0,0,2,4,50.0,2,0,0,0,2,4,19,0,Matches
1976,Jon Pacheco,es ESP,DF,Real Sociedad,es La Liga,19,2001,0.4,0,0,0,0,0,0,0,,0,0,0,0,1,1,0,0,Matches
1977,Gonçalo Paciência,pt POR,FW,Schalke 04,de Bundesliga,25,1994,8.3,8,3,4,1,3,4,16,25.0,12,4,1,3,1,9,3,0,Matches
1978,Daniele Padelli,it ITA,GK,Inter,it Serie A,34,1985,0.5,0,0,0,0,0,0,0,,0,0,0,0,0,0,0,0,Matches
1979,Mattia Pagliuca,it ITA,MF,Bologna,it Serie A,18,2002,0.1,0,0,0,0,0,0,0,,0,0,0,0,1,1,0,0,Matches
1980,Vincent Pajot,fr FRA,MF,Metz,fr Ligue 1,29,1990,10.2,35,20,19,11,5,10,18,55.6,8,9,2,7,42,77,11,0,Matches
1981,Rodrigo Palacio,ar ARG,FW,Bologna,it Serie A,38,1982,27.8,13,6,2,3,8,1,15,6.7,14,18,0,18,7,20,29,0,Matches
1982,Exequiel Palacios,ar ARG,MF,Leverkusen,de Bundesliga,21,1998,6.4,31,17,12,16,3,17,30,56.7,13,13,0,13,12,43,7,0,Matches
1983,Helibelton Palacios,co COL,DF,Elche,es La Liga,27,1993,8.3,20,10,16,3,1,8,13,61.5,5,9,1,8,5,25,21,0,Matches
1984,Ante Palaversa,hr CRO,MF,Getafe,es La Liga,20,2000,0.1,0,0,0,0,0,0,1,0.0,1,0,0,0,0,0,0,0,Matches
1985,Alberto Paleari,it ITA,GK,Genoa,it Serie A,27,1992,2.3,0,0,0,0,0,0,0,,0,0,0,0,0,0,1,0,Matches
1986,Nicolas Pallois,fr FRA,DF,Nantes,fr Ligue 1,32,1987,30.8,58,36,42,14,2,38,72,52.8,34,44,20,24,37,95,155,1,Matches
1987,Emerson Palmieri,it ITA,DF,Chelsea,eng Premier League,25,1994,1.0,3,3,2,0,1,1,3,33.3,2,0,0,0,1,4,6,0,Matches
1988,Antonio Palumbo,it ITA,MF,Sampdoria,it Serie A,23,1996,0.1,0,0,0,0,0,0,1,0.0,1,0,0,0,0,0,0,0,Matches
1989,Martin Palumbo,no NOR,MF,Udinese,it Serie A,18,2002,0.7,0,0,0,0,0,0,0,,0,5,0,5,1,1,0,0,Matches
1990,Goran Pandev,mk MKD,"FW,MF",Genoa,it Serie A,37,1983,15.6,9,5,1,6,2,4,10,40.0,6,6,0,6,2,11,7,1,Matches
1991,Ivor Pandur,hr CRO,GK,Hellas Verona,it Serie A,20,2000,3.7,0,0,0,0,0,0,0,,0,0,0,0,0,0,0,0,Matches
1992,Jonathan Panzo,eng ENG,DF,Dijon,fr Ligue 1,19,2000,20.0,17,12,13,4,0,8,11,72.7,3,27,13,14,59,76,91,2,Matches
1993,Matondo-Merveille Papela,de GER,DF,Mainz 05,de Bundesliga,19,2001,0.0,0,0,0,0,0,0,1,0.0,1,0,0,0,0,0,0,0,Matches
1994,Lucas Paquetá,br BRA,MF,Lyon,fr Ligue 1,22,1997,25.3,70,36,30,28,12,23,66,34.8,43,28,3,25,20,90,16,1,Matches
1995,Gaëtan Paquiez,fr FRA,DF,Nîmes,fr Ligue 1,26,1994,11.6,21,12,12,7,2,12,29,41.4,17,10,3,7,16,37,28,0,Matches
1996,Rubén Pardo,es ESP,MF,Bordeaux,fr Ligue 1,27,1992,0.3,0,0,0,0,0,0,0,,0,0,0,0,1,1,0,0,Matches
1997,Leandro Paredes,ar ARG,MF,Paris S-G,fr Ligue 1,26,1994,14.5,30,18,12,15,3,19,39,48.7,20,17,5,12,17,47,13,1,Matches
1998,Daniel Parejo,es ESP,MF,Villarreal,es La Liga,31,1989,34.6,65,40,32,23,10,33,81,40.7,48,35,8,27,45,110,21,3,Matches
1999,Vittorio Parigini,it ITA,"MF,DF",Genoa,it Serie A,24,1996,0.6,5,2,4,0,1,0,1,0.0,1,0,0,0,0,5,0,0,Matches
2000,Marco Parolo,it ITA,"DF,MF",Lazio,it Serie A,35,1985,7.3,21,8,8,11,2,8,20,40.0,12,20,6,14,14,35,31,0,Matches
2001,Thomas Partey,gh GHA,MF,Arsenal,eng Premier League,27,1993,17.0,44,21,16,24,4,24,56,42.9,32,17,5,12,23,67,18,0,Matches
2002,Thomas Partey,gh GHA,MF,Atlético Madrid,es La Liga,27,1993,2.2,7,4,4,3,0,5,8,62.5,3,4,1,3,2,9,1,0,Matches
2003,Mario Pašalić,hr CRO,MF,Atalanta,it Serie A,25,1995,12.5,26,15,5,17,4,12,19,63.2,7,12,1,11,8,34,6,0,Matches
2004,Felix Passlack,de GER,DF,Dortmund,de Bundesliga,22,1998,4.0,9,6,4,2,3,4,8,50.0,4,11,1,10,3,12,2,0,Matches
2005,Christian Pastina,it ITA,DF,Benevento,it Serie A,19,2001,1.3,0,0,0,0,0,0,1,0.0,1,1,0,1,1,1,8,0,Matches
2006,Javier Pastore,ar ARG,"MF,FW",Roma,it Serie A,31,1989,0.9,2,2,2,0,0,2,2,100.0,0,0,0,0,0,2,0,0,Matches
2007,Patric,es ESP,DF,Lazio,it Serie A,27,1993,17.7,30,16,15,11,4,13,24,54.2,11,13,3,10,18,48,51,1,Matches
2008,Rui Patrício,pt POR,GK,Wolves,eng Premier League,32,1988,37.0,0,0,0,0,0,0,1,0.0,1,0,0,0,1,1,3,3,Matches
2009,Paulinho,br BRA,FW,Leverkusen,de Bundesliga,20,2000,0.7,0,0,0,0,0,0,0,,0,0,0,0,0,0,0,0,Matches
2010,Gabriel Paulista,br BRA,DF,Valencia,es La Liga,29,1990,30.2,17,11,9,5,3,6,17,35.3,11,32,27,5,59,76,132,3,Matches
2011,Benjamin Pavard,fr FRA,DF,Bayern Munich,de Bundesliga,24,1996,21.6,44,27,20,16,8,23,40,57.5,17,29,5,24,48,92,31,1,Matches
2012,Jiří Pavlenka,cz CZE,GK,Werder Bremen,de Bundesliga,28,1992,34.0,2,0,2,0,0,2,2,100.0,0,0,0,0,1,3,17,4,Matches
2013,Vasileios Pavlidis,gr GRE,FW,Schalke 04,de Bundesliga,17,2002,0.0,0,0,0,0,0,0,0,,0,0,0,0,0,0,0,0,Matches
2014,Mateo Pavlović,ba BIH,DF,Angers,fr Ligue 1,30,1990,12.3,11,6,8,3,0,8,23,34.8,15,13,11,2,21,32,40,0,Matches
2015,Strahinja Pavlović,rs SRB,DF,Monaco,fr Ligue 1,19,2001,0.0,0,0,0,0,0,0,0,,0,0,0,0,0,0,0,0,Matches
2016,Leonardo Pavoletti,it ITA,FW,Cagliari,it Serie A,31,1988,17.6,7,3,2,5,0,1,20,5.0,19,4,2,2,4,11,32,0,Matches
2017,Dimitri Payet,fr FRA,"FW,MF",Marseille,fr Ligue 1,33,1987,26.9,27,17,4,16,7,17,40,42.5,23,19,2,17,8,35,10,0,Matches
2018,Nehuén Paz,ar ARG,DF,Bologna,it Serie A,27,1993,4.0,9,4,4,5,0,6,7,85.7,1,4,2,2,11,20,16,0,Matches
2019,Bailey Peacock-Farrell,nir NIR,GK,Burnley,eng Premier League,23,1996,4.0,0,0,0,0,0,0,0,,0,0,0,0,0,0,0,0,Matches
2020,Mads Pedersen,dk DEN,DF,Augsburg,de Bundesliga,23,1996,9.9,25,16,20,3,2,10,22,45.5,12,13,3,10,15,40,32,0,Matches
2021,Alfonso Pedraza,es ESP,DF,Villarreal,es La Liga,24,1996,23.3,35,19,16,11,8,11,31,35.5,20,21,5,16,34,69,47,1,Matches
2022,Pedri,es ESP,MF,Barcelona,es La Liga,17,2002,26.8,44,27,16,16,12,17,71,23.9,54,46,1,45,33,77,7,0,Matches
2023,Pedro,es ESP,"MF,FW",Roma,it Serie A,33,1987,17.7,22,14,6,11,5,7,35,20.0,28,10,0,10,9,31,2,1,Matches
2024,João Pedro,it ITA,"FW,MF",Cagliari,it Serie A,28,1992,36.1,13,6,2,6,5,2,27,7.4,25,32,6,26,13,26,28,0,Matches
2025,Gianluca Pegolo,it ITA,GK,Sassuolo,it Serie A,39,1981,1.0,0,0,0,0,0,0,0,,0,0,0,0,0,0,1,0,Matches
2026,Peter Pekarík,sk SVK,DF,Hertha BSC,de Bundesliga,33,1986,18.8,24,18,17,7,0,17,31,54.8,14,19,8,11,27,51,41,0,Matches
2027,Yohann Pelé,fr FRA,GK,Marseille,fr Ligue 1,37,1982,1.0,0,0,0,0,0,0,0,,0,0,0,0,0,0,0,0,Matches
2028,Graziano Pellè,it ITA,FW,Parma,it Serie A,35,1985,6.8,2,2,0,1,1,1,8,12.5,7,3,0,3,2,4,8,0,Matches
2029,Pietro Pellegri,it ITA,"FW,MF",Monaco,fr Ligue 1,19,2001,2.6,2,1,0,2,0,0,0,,0,1,0,1,0,2,0,0,Matches
2030,Lorenzo Pellegrini,it ITA,MF,Roma,it Serie A,24,1996,28.9,40,24,13,20,7,21,60,35.0,39,37,2,35,42,82,23,1,Matches
2031,Luca Pellegrini,it ITA,"DF,MF",Genoa,it Serie A,21,1999,7.1,9,6,6,2,1,4,10,40.0,6,11,2,9,8,17,13,1,Matches
2032,Facundo Pellistri,uy URU,"MF,FW",Alavés,es La Liga,18,2001,6.0,8,5,2,4,2,3,13,23.1,10,0,0,0,4,12,3,0,Matches
2033,Andy Pelmard,fr FRA,DF,Nice,fr Ligue 1,20,2000,13.4,18,12,12,5,1,9,12,75.0,3,11,3,8,20,38,35,0,Matches
2034,Lee Peltier,eng ENG,DF,West Brom,eng Premier League,33,1986,2.5,9,4,8,1,0,4,4,100.0,0,1,1,0,1,10,11,0,Matches
2035,Federico Peluso,it ITA,DF,Sassuolo,it Serie A,36,1984,2.3,1,1,1,0,0,1,2,50.0,1,2,2,0,3,4,12,0,Matches
2036,Timothee Pembele,fr FRA,DF,Paris S-G,fr Ligue 1,17,2002,4.3,8,7,4,4,0,5,14,35.7,9,4,0,4,5,13,8,1,Matches
2037,Rubén Peña,es ESP,DF,Villarreal,es La Liga,29,1991,12.4,25,14,8,15,2,19,33,57.6,14,20,1,19,13,38,19,0,Matches
2038,Philipp Pentke,de GER,GK,Hoffenheim,de Bundesliga,35,1985,3.0,0,0,0,0,0,0,0,,0,0,0,0,0,0,0,0,Matches
2039,Nicolas Pépé,ci CIV,FW,Arsenal,eng Premier League,25,1995,18.0,20,15,8,6,6,8,23,34.8,15,16,1,15,12,32,19,0,Matches
2040,Alberto Perea,es ESP,MF,Cádiz,es La Liga,29,1990,17.2,28,17,12,10,6,9,35,25.7,26,26,1,25,21,49,9,0,Matches
2041,Andreas Pereira,br BRA,"FW,MF",Lazio,it Serie A,24,1996,6.0,5,0,1,3,1,2,12,16.7,10,6,0,6,1,6,4,0,Matches
2042,Danilo Pereira,pt POR,"MF,DF",Paris S-G,fr Ligue 1,28,1991,15.9,21,11,6,11,4,6,14,42.9,8,14,6,8,29,50,33,4,Matches
2043,Mathias Pereira Lage,pt POR,"FW,MF",Angers,fr Ligue 1,23,1996,16.3,29,17,12,15,2,10,40,25.0,30,21,4,17,15,44,16,0,Matches
2044,Matheus Pereira,pt POR,"MF,FW",West Brom,eng Premier League,24,1996,28.6,26,15,14,10,2,12,54,22.2,42,18,0,18,29,55,16,0,Matches
2045,Pedro Pereira,pt POR,DF,Crotone,it Serie A,22,1998,28.3,50,32,29,17,4,21,40,52.5,19,33,11,22,19,69,61,0,Matches
2046,Ricardo Pereira,pt POR,"DF,FW",Leicester City,eng Premier League,26,1993,10.7,31,22,16,8,7,14,35,40.0,21,24,1,23,15,46,23,0,Matches
2047,Gastón Pereiro,uy URU,"MF,DF",Cagliari,it Serie A,25,1995,3.0,3,1,2,1,0,1,2,50.0,1,2,0,2,1,4,2,1,Matches
2048,Bruno Peres,br BRA,DF,Roma,it Serie A,30,1990,15.9,21,11,11,7,3,13,24,54.2,11,18,4,14,27,48,11,0,Matches
2049,Roberto Pereyra,ar ARG,"MF,FW",Udinese,it Serie A,29,1991,32.5,18,11,7,8,3,7,23,30.4,16,24,5,19,27,45,24,0,Matches
2050,Ayoze Pérez,es ESP,"MF,FW",Leicester City,eng Premier League,27,1993,14.8,32,15,6,20,6,13,48,27.1,35,28,0,28,10,42,7,0,Matches
2051,Carles Pérez,es ESP,"MF,FW",Roma,it Serie A,22,1998,8.6,9,4,3,6,0,6,31,19.4,25,9,0,9,6,15,1,0,Matches
2052,Iñigo Pérez,es ESP,"MF,DF",Osasuna,es La Liga,32,1988,15.0,20,10,9,6,5,10,16,62.5,6,12,0,12,15,35,8,1,Matches
2053,Juan Pérez,es ESP,GK,Osasuna,es La Liga,24,1996,3.0,0,0,0,0,0,0,0,,0,0,0,0,0,0,1,0,Matches
2054,Kike Pérez,es ESP,MF,Valladolid,es La Liga,23,1997,12.9,26,19,8,14,4,7,33,21.2,26,10,1,9,17,43,18,0,Matches
2055,Lucas Pérez,es ESP,FW,Alavés,es La Liga,31,1988,19.5,6,2,3,3,0,2,10,20.0,8,6,1,5,2,8,5,0,Matches
2056,Luis Pérez,es ESP,DF,Valladolid,es La Liga,25,1995,14.4,33,17,16,17,0,18,30,60.0,12,26,8,18,14,47,54,1,Matches
2057,Manuel Perez,fr FRA,"MF,FW",Lens,fr Ligue 1,29,1991,1.4,1,0,1,0,0,0,8,0.0,8,2,0,2,2,3,2,0,Matches
2058,Nehuén Pérez,ar ARG,DF,Granada,es La Liga,20,2000,8.2,6,3,6,0,0,4,6,66.7,2,5,4,1,12,18,33,0,Matches
2059,Mattia Perin,it ITA,GK,Genoa,it Serie A,27,1992,32.0,0,0,0,0,0,0,0,,0,0,0,0,1,1,6,0,Matches
2060,Ivan Perišić,hr CRO,"DF,FW",Inter,it Serie A,31,1989,19.9,22,13,11,6,5,12,33,36.4,21,33,4,29,19,41,36,1,Matches
2061,Romain Perraud,fr FRA,DF,Brest,fr Ligue 1,22,1997,34.9,60,34,42,16,2,24,45,53.3,21,36,3,33,45,105,76,0,Matches
2062,Lucas Perrin,fr FRA,DF,Marseille,fr Ligue 1,21,1998,3.4,7,4,4,3,0,5,12,41.7,7,5,4,1,8,15,16,0,Matches
2063,Pavao Pervan,at AUT,GK,Wolfsburg,de Bundesliga,32,1987,2.0,0,0,0,0,0,0,0,,0,0,0,0,0,0,1,0,Matches
2064,Matteo Pessina,it ITA,MF,Atalanta,it Serie A,23,1997,18.3,14,7,4,6,4,7,24,29.2,17,17,2,15,17,31,7,1,Matches
2065,Andrea Petagna,it ITA,FW,Napoli,it Serie A,25,1995,10.7,2,0,0,2,0,2,7,28.6,5,4,0,4,1,3,7,0,Matches
2066,Nils Petersen,de GER,FW,Freiburg,de Bundesliga,31,1988,14.5,11,7,2,6,3,3,21,14.3,18,25,1,24,9,20,28,0,Matches
2067,Lukas Petkov,bg BUL,MF,Augsburg,de Bundesliga,19,2000,0.0,0,0,0,0,0,0,0,,0,0,0,0,0,0,0,0,Matches
2068,Jacopo Petriccione,it ITA,MF,Crotone,it Serie A,25,1995,10.6,14,8,6,7,1,9,24,37.5,15,11,2,9,8,22,11,0,Matches
2069,Jens Petter Hauge,no NOR,FW,Milan,it Serie A,20,1999,5.9,7,4,3,3,1,6,10,60.0,4,4,0,4,1,8,3,0,Matches
2070,Germán Pezzella,ar ARG,DF,Fiorentina,it Serie A,29,1991,30.5,34,20,22,12,0,18,32,56.3,14,26,14,12,36,70,109,1,Matches
2071,Giuseppe Pezzella,it ITA,DF,Parma,it Serie A,22,1997,20.3,34,19,23,9,2,22,41,53.7,19,22,9,13,12,46,52,3,Matches
2072,Maximilian Philipp,de GER,MF,Wolfsburg,de Bundesliga,26,1994,12.3,15,6,3,6,6,5,21,23.8,16,17,0,17,6,21,3,0,Matches
2073,Rayan Philippe,fr FRA,FW,Dijon,fr Ligue 1,19,2000,1.0,3,1,1,1,1,2,2,100.0,0,0,0,0,0,3,0,0,Matches
2074,Romain Philippoteaux,fr FRA,"FW,MF",Nîmes,fr Ligue 1,32,1988,2.4,1,1,1,0,0,1,5,20.0,4,2,0,2,2,3,1,0,Matches
2075,Romain Philippoteaux,fr FRA,"MF,FW",Brest,fr Ligue 1,32,1988,6.5,11,6,6,3,2,6,9,66.7,3,4,0,4,10,21,2,0,Matches
2076,Kalvin Phillips,eng ENG,MF,Leeds United,eng Premier League,24,1995,27.0,74,38,38,29,7,26,62,41.9,36,49,14,35,45,119,53,3,Matches
2077,Matt Phillips,sct SCO,MF,West Brom,eng Premier League,29,1991,20.3,15,8,4,11,0,7,23,30.4,16,32,4,28,10,25,32,1,Matches
2078,Nathaniel Phillips,eng ENG,DF,Liverpool,eng Premier League,23,1997,16.2,22,14,15,7,0,11,24,45.8,13,17,14,3,20,42,81,0,Matches
2079,Jaden Philogene Bidace,eng ENG,FW,Aston Villa,eng Premier League,18,2002,0.0,0,0,0,0,0,0,0,,0,0,0,0,0,0,0,0,Matches
2080,Krzysztof Piątek,pl POL,FW,Hertha BSC,de Bundesliga,25,1995,18.1,9,4,1,7,1,3,22,13.6,19,11,0,11,6,15,14,0,Matches
2081,Pablo Piatti,ar ARG,"MF,FW",Elche,es La Liga,31,1989,4.0,8,6,3,3,2,3,12,25.0,9,5,0,5,2,10,1,0,Matches
2082,Cristiano Piccini,it ITA,DF,Atalanta,it Serie A,27,1992,0.7,1,1,1,0,0,0,1,0.0,1,1,0,1,0,1,0,0,Matches
2083,Cristiano Piccini,it ITA,DF,Valencia,es La Liga,27,1992,0.7,1,1,1,0,0,1,2,50.0,1,0,0,0,0,1,3,0,Matches
2084,Roberto Piccoli,it ITA,FW,Spezia,it Serie A,19,2001,7.8,7,3,0,4,3,2,4,50.0,2,4,0,4,2,9,5,0,Matches
2085,Jordan Pickford,eng ENG,GK,Everton,eng Premier League,26,1994,30.5,0,0,0,0,0,0,2,0.0,2,2,0,2,3,3,16,4,Matches
2086,Jérémy Pied,fr FRA,DF,Lille,fr Ligue 1,31,1989,3.5,7,0,3,3,1,4,9,44.4,5,3,1,2,6,13,8,0,Matches
2087,Amos Pieper,de GER,DF,Arminia,de Bundesliga,22,1998,29.8,58,32,39,17,2,20,33,60.6,13,48,35,13,66,124,160,3,Matches
2088,Ronaël Pierre-Gabriel,fr FRA,DF,Brest,fr Ligue 1,22,1998,25.6,60,40,42,16,2,35,52,67.3,17,17,7,10,30,90,57,0,Matches
2089,Erik Pieters,nl NED,"DF,MF",Burnley,eng Premier League,31,1988,14.1,30,21,18,9,3,19,39,48.7,20,30,9,21,12,42,34,0,Matches
2090,Tomás Pina Isla,es ESP,MF,Alavés,es La Liga,32,1987,28.6,39,18,18,16,5,16,42,38.1,26,28,8,20,37,76,42,0,Matches
2091,Andrea Pinamonti,it ITA,FW,Inter,it Serie A,21,1999,1.9,0,0,0,0,0,0,0,,0,1,0,1,1,1,2,0,Matches
2092,Yeremi Pino,es ESP,"FW,MF",Villarreal,es La Liga,17,2002,8.9,19,11,10,7,2,8,28,28.6,20,20,1,19,9,28,8,0,Matches
2093,Carlo Pinsoglio,it ITA,GK,Juventus,it Serie A,30,1990,0.3,0,0,0,0,0,0,0,,0,0,0,0,0,0,0,0,Matches
2094,Gerard Piqué,es ESP,DF,Barcelona,es La Liga,33,1987,16.5,16,11,11,5,0,9,12,75.0,3,9,4,5,26,42,46,0,Matches
2095,Fabio Pisacane,it ITA,DF,Cagliari,it Serie A,34,1986,2.5,3,2,2,1,0,3,7,42.9,4,8,5,3,1,4,9,1,Matches
2096,Łukasz Piszczek,pl POL,DF,Dortmund,de Bundesliga,35,1985,5.1,10,7,6,4,0,5,12,41.7,7,5,1,4,5,15,12,0,Matches
2097,Marko Pjaca,hr CRO,"FW,MF",Genoa,it Serie A,25,1995,15.8,13,6,6,3,4,4,16,25.0,12,7,2,5,7,20,12,0,Matches
2098,Miralem Pjanić,ba BIH,MF,Barcelona,es La Liga,30,1990,7.0,13,8,7,4,2,7,13,53.8,6,5,1,4,11,24,5,0,Matches
2099,Óscar Plano,es ESP,"MF,FW",Valladolid,es La Liga,29,1991,28.0,42,24,24,12,6,14,46,30.4,32,35,6,29,34,76,43,0,Matches
2100,Marvin Plattenhardt,de GER,DF,Hertha BSC,de Bundesliga,28,1992,11.9,15,10,6,7,2,5,9,55.6,4,9,1,8,1,16,19,1,Matches
2101,Alassane Pléa,fr FRA,FW,Gladbach,de Bundesliga,27,1993,20.0,19,9,4,10,5,5,20,25.0,15,1,0,1,5,24,7,0,Matches
2102,Dani Plomer,es ESP,FW,Granada,es La Liga,21,1998,0.5,0,0,0,0,0,0,1,0.0,1,0,0,0,0,0,1,0,Matches
2103,Tommaso Pobega,it ITA,MF,Spezia,it Serie A,21,1999,13.7,24,13,7,13,4,11,31,35.5,20,10,2,8,9,33,22,0,Matches
2104,Daniel Podence,pt POR,"MF,FW",Wolves,eng Premier League,24,1995,18.5,12,6,5,5,2,2,19,10.5,17,5,1,4,13,25,2,0,Matches
2105,Paul Pogba,fr FRA,"MF,FW",Manchester Utd,eng Premier League,27,1993,21.1,36,26,15,16,5,11,33,33.3,22,24,2,22,26,62,37,0,Matches
2106,Joel Pohjanpalo,fi FIN,FW,Union Berlin,de Bundesliga,25,1994,9.5,5,1,0,3,2,1,6,16.7,5,1,0,1,1,6,12,0,Matches
2107,Joel Pohjanpalo,fi FIN,MF,Leverkusen,de Bundesliga,25,1994,0.1,0,0,0,0,0,0,0,,0,0,0,0,0,0,0,0,Matches
2108,Andrea Poli,it ITA,MF,Bologna,it Serie A,30,1989,4.3,9,7,4,2,3,6,12,50.0,6,7,1,6,7,16,7,0,Matches
2109,Matteo Politano,it ITA,"FW,MF",Napoli,it Serie A,26,1993,21.2,24,16,13,9,2,11,47,23.4,36,14,1,13,14,38,18,0,Matches
2110,Jorge Pombo,es ESP,"FW,MF",Cádiz,es La Liga,26,1994,5.8,7,3,3,2,2,1,8,12.5,7,2,0,2,2,9,3,0,Matches
2111,Marin Pongračić,hr CRO,DF,Wolfsburg,de Bundesliga,22,1997,6.4,13,9,9,3,1,6,8,75.0,2,12,5,7,11,24,27,0,Matches
2112,Pere Pons,es ESP,MF,Alavés,es La Liga,27,1993,13.2,20,10,8,8,4,5,16,31.3,11,15,2,13,7,27,10,0,Matches
2113,Nick Pope,eng ENG,GK,Burnley,eng Premier League,28,1992,32.0,1,1,1,0,0,0,1,0.0,1,0,0,0,2,3,29,2,Matches
2114,Manolo Portanova,it ITA,"MF,FW",Genoa,it Serie A,20,2000,0.7,3,3,1,1,1,0,2,0.0,2,3,1,2,1,4,2,0,Matches
2115,Manolo Portanova,it ITA,MF,Juventus,it Serie A,20,2000,0.8,2,0,2,0,0,0,2,0.0,2,4,1,3,0,2,1,0,Matches
2116,Francisco Portillo,es ESP,"MF,FW",Getafe,es La Liga,30,1990,4.6,5,3,1,4,0,2,14,14.3,12,3,0,3,5,10,1,0,Matches
2117,Portu,es ESP,"FW,MF",Real Sociedad,es La Liga,28,1992,24.3,18,8,4,10,4,7,36,19.4,29,24,2,22,8,26,5,0,Matches
2118,Stefan Posch,at AUT,DF,Hoffenheim,de Bundesliga,23,1997,23.5,52,24,29,17,6,27,47,57.4,20,27,8,19,37,89,73,1,Matches
2119,Sergio Postigo,es ESP,DF,Levante,es La Liga,31,1988,18.0,16,12,12,3,1,7,18,38.9,11,21,10,11,33,49,84,1,Matches
2120,Yussuf Poulsen,dk DEN,FW,RB Leipzig,de Bundesliga,26,1994,15.0,10,6,1,6,3,1,17,5.9,16,16,0,16,6,16,13,0,Matches
2121,Maxime Poundjé,fr FRA,DF,Bordeaux,fr Ligue 1,27,1992,5.5,10,7,9,1,0,2,6,33.3,4,7,3,4,11,21,5,0,Matches
2122,Darío Poveda,es ESP,FW,Getafe,es La Liga,23,1997,0.1,0,0,0,0,0,0,0,,0,1,0,1,0,0,0,0,Matches
2123,Alejandro Pozo Pozo,es ESP,"DF,MF",Eibar,es La Liga,21,1999,24.3,38,22,17,15,6,17,38,44.7,21,35,2,33,27,65,40,1,Matches
2124,Dennis Praet,be BEL,MF,Leicester City,eng Premier League,26,1994,8.0,14,7,4,7,3,6,15,40.0,9,12,2,10,7,21,3,0,Matches
2125,Sanjin Prcić,ba BIH,MF,Strasbourg,fr Ligue 1,26,1993,3.9,3,2,0,3,0,2,5,40.0,3,4,3,1,4,7,2,1,Matches
2126,Nicolas de Préville,fr FRA,"FW,MF",Bordeaux,fr Ligue 1,29,1991,17.9,19,14,7,6,6,9,42,21.4,33,15,0,15,13,32,7,0,Matches
2127,Manuel Prietl,at AUT,MF,Arminia,de Bundesliga,28,1991,28.0,65,44,33,28,4,12,73,16.4,61,34,7,27,45,110,24,0,Matches
2128,Grischa Prömel,de GER,MF,Union Berlin,de Bundesliga,25,1995,20.2,39,23,14,23,2,18,34,52.9,16,20,2,18,24,63,22,0,Matches
2129,Davy Pröpper,nl NED,MF,Brighton,eng Premier League,28,1991,2.4,6,5,0,6,0,2,5,40.0,3,3,0,3,1,7,0,0,Matches
2130,Ivan Provedel,it ITA,GK,Spezia,it Serie A,26,1994,29.0,2,0,2,0,0,2,6,33.3,4,0,0,0,2,4,20,1,Matches
2131,Antonio Puertas,es ESP,"FW,MF",Granada,es La Liga,28,1992,24.1,27,13,9,12,6,10,32,31.3,22,24,5,19,12,39,25,0,Matches
2132,Riqui Puig,es ESP,"MF,FW",Barcelona,es La Liga,20,1999,3.2,5,3,1,3,1,4,8,50.0,4,0,0,0,1,6,0,0,Matches
2133,Erick Pulgar,cl CHI,MF,Fiorentina,it Serie A,26,1994,22.2,41,18,17,23,1,22,49,44.9,27,24,10,14,41,82,45,1,Matches
2134,Jorge Pulido,es ESP,DF,Huesca,es La Liga,29,1991,32.1,39,24,31,8,0,17,29,58.6,12,32,18,14,52,91,98,0,Matches
2135,Christian Pulisic,us USA,"FW,MF",Chelsea,eng Premier League,21,1998,19.3,19,11,8,10,1,8,21,38.1,13,25,2,23,12,31,9,0,Matches
2136,Ignacio Pussetto,ar ARG,FW,Udinese,it Serie A,24,1995,8.4,16,8,5,6,5,6,17,35.3,11,14,0,14,13,29,6,0,Matches
2137,Fabio Quagliarella,it ITA,FW,Sampdoria,it Serie A,37,1983,24.5,12,8,4,4,4,2,19,10.5,17,14,1,13,7,19,10,0,Matches
2138,Robin Quaison,se SWE,"FW,MF",Mainz 05,de Bundesliga,26,1993,16.4,14,6,3,6,5,7,14,50.0,7,10,0,10,13,27,10,0,Matches
2139,Domingos Quina,pt POR,MF,Granada,es La Liga,20,1999,3.8,5,5,1,3,1,3,6,50.0,3,8,0,8,2,7,0,0,Matches
2140,Quini,es ESP,DF,Granada,es La Liga,30,1989,13.2,33,22,23,7,3,19,36,52.8,17,15,6,9,15,48,39,0,Matches
2141,Quique,es ESP,"FW,MF",Eibar,es La Liga,30,1990,1.9,0,0,0,0,0,0,1,0.0,1,2,0,2,0,0,0,0,Matches
2142,Dani Raba,es ESP,"MF,FW",Villarreal,es La Liga,24,1995,1.7,2,1,0,1,1,2,8,25.0,6,1,0,1,0,2,0,0,Matches
2143,Simone Rabbi,it ITA,"FW,DF",Bologna,it Serie A,18,2001,0.4,0,0,0,0,0,0,1,0.0,1,0,0,0,0,0,0,0,Matches
2144,Adrien Rabiot,fr FRA,MF,Juventus,it Serie A,25,1995,25.7,72,42,24,41,7,28,60,46.7,32,32,11,21,43,115,29,1,Matches
2145,Uroš Račić,rs SRB,MF,Valencia,es La Liga,22,1998,24.3,38,22,16,16,6,16,54,29.6,38,33,11,22,26,64,54,0,Matches
2146,Anthony Racioppi,ch SUI,GK,Dijon,fr Ligue 1,21,1998,21.0,0,0,0,0,0,0,2,0.0,2,0,0,0,2,2,12,4,Matches
2147,Nemanja Radoja,rs SRB,MF,Levante,es La Liga,27,1993,12.5,23,15,12,10,1,5,19,26.3,14,9,3,6,19,42,12,1,Matches
2148,Nemanja Radonjić,rs SRB,FW,Marseille,fr Ligue 1,24,1996,4.4,6,5,1,2,3,2,12,16.7,10,8,0,8,3,9,1,0,Matches
2149,Nemanja Radonjić,rs SRB,"FW,MF",Hertha BSC,de Bundesliga,24,1996,6.8,5,3,2,2,1,1,5,20.0,4,1,0,1,2,7,1,0,Matches
2150,Aleksandar Radovanović,rs SRB,DF,Lens,fr Ligue 1,26,1993,1.0,1,1,0,1,0,0,0,,0,2,1,1,0,1,2,0,Matches
2151,Ivan Radovanović,rs SRB,"DF,MF",Genoa,it Serie A,31,1988,24.8,18,15,13,5,0,12,31,38.7,19,39,21,18,37,55,114,2,Matches
2152,Ionuț Radu,ro ROU,GK,Inter,it Serie A,23,1997,1.5,0,0,0,0,0,0,0,,0,0,0,0,0,0,1,0,Matches
2153,Ștefan Radu,ro ROU,DF,Lazio,it Serie A,33,1986,27.3,43,24,20,19,4,25,40,62.5,15,27,14,13,45,88,73,1,Matches
2154,Rafael,br BRA,GK,Spezia,it Serie A,38,1982,2.3,0,0,0,0,0,0,0,,0,0,0,0,0,0,0,0,Matches
2155,Rafinha,br BRA,"MF,FW",Paris S-G,fr Ligue 1,27,1993,15.1,54,26,18,28,8,28,49,57.1,21,18,3,15,13,67,6,0,Matches
2156,Antonio Raimondo,it ITA,FW,Bologna,it Serie A,16,2004,0.0,0,0,0,0,0,0,0,,0,0,0,0,0,0,0,0,Matches
2157,Predrag Rajković,rs SRB,GK,Reims,fr Ligue 1,24,1995,36.5,2,1,2,0,0,2,5,40.0,3,1,0,1,2,4,17,3,Matches
2158,Ivan Rakitić,hr CRO,MF,Sevilla,es La Liga,32,1988,24.8,32,18,18,10,4,12,41,29.3,29,19,4,15,26,58,29,1,Matches
2159,Jonás Ramalho,es ESP,DF,Osasuna,es La Liga,27,1993,3.4,5,4,4,0,1,1,3,33.3,2,3,0,3,2,7,7,0,Matches
2160,Benito Raman,be BEL,"FW,MF",Schalke 04,de Bundesliga,25,1994,13.8,19,13,11,6,2,6,29,20.7,23,11,0,11,5,24,5,0,Matches
2161,Gastón Ramírez,uy URU,"FW,MF",Sampdoria,it Serie A,29,1990,10.8,31,15,10,17,4,8,27,29.6,19,19,3,16,4,35,13,0,Matches
2162,Sandro Ramírez,es ESP,FW,Huesca,es La Liga,25,1995,14.3,13,9,3,8,2,4,11,36.4,7,11,1,10,10,23,2,0,Matches
2163,Sergio Ramos,es ESP,DF,Real Madrid,es La Liga,34,1986,14.2,15,12,8,6,1,6,10,60.0,4,9,5,4,19,34,39,1,Matches
2164,Aaron Ramsdale,eng ENG,GK,Sheffield Utd,eng Premier League,22,1998,38.0,1,1,1,0,0,1,1,100.0,0,0,0,0,2,3,22,6,Matches
2165,Aaron Ramsey,wls WAL,MF,Juventus,it Serie A,29,1990,12.1,22,14,8,13,1,8,25,32.0,17,13,2,11,7,29,8,2,Matches
2166,Jacob Ramsey,eng ENG,MF,Aston Villa,eng Premier League,19,2001,7.0,10,5,3,4,3,2,12,16.7,10,13,6,7,4,14,5,0,Matches
2167,Kayne Ramsey,eng ENG,DF,Southampton,eng Premier League,19,2000,1.0,5,2,4,1,0,3,3,100.0,0,0,0,0,0,5,3,0,Matches
2168,Darren Randolph,ie IRL,GK,West Ham,eng Premier League,33,1987,3.0,0,0,0,0,0,0,0,,0,0,0,0,0,0,1,0,Matches
2169,Andrea Ranocchia,it ITA,DF,Inter,it Serie A,32,1988,7.8,13,10,6,6,1,7,8,87.5,1,5,3,2,12,25,19,0,Matches
2170,Raphinha,br BRA,"MF,FW",Leeds United,eng Premier League,23,1996,26.2,34,17,13,16,5,12,58,20.7,46,31,1,30,29,63,27,0,Matches
2171,Raphinha,br BRA,"FW,MF",Rennes,fr Ligue 1,23,1996,4.5,5,2,1,3,1,1,4,25.0,3,5,0,5,3,8,4,0,Matches
2172,Marcus Rashford,eng ENG,FW,Manchester Utd,eng Premier League,22,1997,32.4,18,9,2,8,8,7,27,25.9,20,22,2,20,8,26,10,0,Matches
2173,Milot Rashica,xk KVX,"FW,MF",Werder Bremen,de Bundesliga,24,1996,16.2,24,12,11,11,2,12,23,52.2,11,7,0,7,4,28,6,0,Matches
2174,Giacomo Raspadori,it ITA,"FW,MF",Sassuolo,it Serie A,20,2000,13.7,5,3,1,1,3,0,4,0.0,4,13,5,8,2,7,9,0,Matches
2175,Federico Ravaglia,it ITA,GK,Bologna,it Serie A,20,1999,4.0,0,0,0,0,0,0,1,0.0,1,0,0,0,0,0,2,0,Matches
2176,Tim Ream,us USA,DF,Fulham,eng Premier League,32,1987,7.0,12,5,9,3,0,8,11,72.7,3,8,5,3,6,18,26,1,Matches
2177,Ante Rebić,hr CRO,FW,Milan,it Serie A,26,1993,19.7,26,9,4,8,14,8,37,21.6,29,21,1,20,7,33,17,0,Matches
2178,Arkadiusz Reca,pl POL,DF,Crotone,it Serie A,25,1995,25.7,34,16,15,11,8,10,45,22.2,35,30,3,27,50,84,64,0,Matches
2179,Recio,es ESP,MF,Eibar,es La Liga,29,1991,8.2,17,5,4,8,5,8,18,44.4,10,6,0,6,4,21,1,0,Matches
2180,Daishawn Redan,nl NED,"FW,MF",Hertha BSC,de Bundesliga,19,2001,1.1,0,0,0,0,0,0,0,,0,1,0,1,0,0,0,0,Matches
2181,Nathan Redmond,eng ENG,"MF,FW",Southampton,eng Premier League,26,1994,19.3,30,17,14,12,4,8,24,33.3,16,24,2,22,11,41,9,0,Matches
2182,Harrison Reed,eng ENG,MF,Fulham,eng Premier League,25,1995,25.0,63,38,28,28,7,29,73,39.7,44,34,11,23,50,113,31,1,Matches
2183,Vasco Regini,it ITA,DF,Sampdoria,it Serie A,29,1990,1.0,2,2,2,0,0,2,2,100.0,0,1,1,0,1,3,5,0,Matches
2184,Sergio Reguilón,es ESP,DF,Tottenham,eng Premier League,23,1996,24.9,47,25,30,13,4,23,48,47.9,25,39,7,32,32,79,50,1,Matches
2185,Bobby Reid,jm JAM,"MF,FW",Fulham,eng Premier League,27,1993,26.4,31,15,17,10,4,18,39,46.2,21,19,5,14,21,52,39,0,Matches
2186,Pepe Reina,es ESP,GK,Lazio,it Serie A,37,1982,29.0,0,0,0,0,0,0,1,0.0,1,0,0,0,1,1,6,0,Matches
2187,Jeff Reine-Adélaïde,fr FRA,"MF,FW",Nice,fr Ligue 1,22,1998,11.8,7,4,1,4,2,2,9,22.2,7,10,1,9,4,11,6,0,Matches
2188,Jeff Reine-Adélaïde,fr FRA,FW,Lyon,fr Ligue 1,22,1998,0.3,0,0,0,0,0,0,0,,0,0,0,0,0,0,0,0,Matches
2189,Reinier,br BRA,"MF,FW",Dortmund,de Bundesliga,18,2002,2.9,9,4,6,1,2,2,4,50.0,2,4,1,3,2,11,0,0,Matches
2190,Francisco Reis Ferreira,pt POR,DF,Valencia,es La Liga,23,1997,2.0,1,1,1,0,0,0,3,0.0,3,0,0,0,0,1,6,0,Matches
2191,Rocco Reitz,de GER,MF,Gladbach,de Bundesliga,18,2002,0.7,3,2,0,3,0,2,2,100.0,0,3,1,2,1,4,1,0,Matches
2192,Karim Rekik,nl NED,DF,Sevilla,es La Liga,25,1994,7.3,7,5,2,5,0,1,4,25.0,3,8,3,5,6,13,17,0,Matches
2193,Álex Remiro,es ESP,GK,Real Sociedad,es La Liga,25,1995,38.0,0,0,0,0,0,0,1,0.0,1,0,0,0,3,3,14,0,Matches
2194,Panagiotis Retsos,gr GRE,DF,Saint-Étienne,fr Ligue 1,21,1998,3.0,5,3,5,0,0,3,7,42.9,4,1,1,0,3,8,12,0,Matches
2195,Marco Reus,de GER,"MF,FW",Dortmund,de Bundesliga,31,1989,25.3,33,16,9,16,8,9,33,27.3,24,22,2,20,14,47,13,0,Matches
2196,Elvis Rexhbeçaj,de GER,"MF,FW",Köln,de Bundesliga,22,1997,20.4,53,32,17,27,9,19,53,35.8,34,32,7,25,26,79,18,0,Matches
2197,Oriol Rey,es ESP,MF,Valladolid,es La Liga,22,1998,0.2,0,0,0,0,0,0,0,,0,0,0,0,1,1,0,0,Matches
2198,Gio Reyna,us USA,"MF,FW",Dortmund,de Bundesliga,17,2002,22.0,24,13,9,8,7,9,25,36.0,16,14,1,13,10,34,11,0,Matches
2199,Baptiste Reynet,fr FRA,GK,Nîmes,fr Ligue 1,29,1990,38.0,2,1,2,0,0,2,4,50.0,2,1,0,1,1,3,9,2,Matches
2200,Bryan Reynolds,us USA,DF,Roma,it Serie A,19,2001,3.1,4,2,1,1,2,1,5,20.0,4,4,0,4,6,10,4,0,Matches
2201,Franck Ribéry,fr FRA,FW,Fiorentina,it Serie A,37,1983,23.9,24,11,4,9,11,5,29,17.2,24,11,2,9,3,27,1,0,Matches
2202,Federico Ricci,it ITA,FW,Sassuolo,it Serie A,26,1994,0.0,0,0,0,0,0,0,0,,0,0,0,0,0,0,0,0,Matches
2203,Giacomo Ricci,it ITA,DF,Parma,it Serie A,23,1996,0.7,3,1,1,2,0,0,0,,0,2,2,0,1,4,4,0,Matches
2204,Matteo Ricci,it ITA,MF,Spezia,it Serie A,26,1994,24.8,40,23,14,24,2,27,52,51.9,25,24,4,20,34,74,13,0,Matches
2205,Declan Rice,eng ENG,MF,West Ham,eng Premier League,21,1999,32.0,59,35,33,25,1,21,51,41.2,30,39,11,28,59,118,41,0,Matches
2206,Chris Richards,us USA,DF,Hoffenheim,de Bundesliga,20,2000,10.5,19,8,12,6,1,10,16,62.5,6,13,4,9,21,40,40,1,Matches
2207,Chris Richards,us USA,DF,Bayern Munich,de Bundesliga,20,2000,1.0,0,0,0,0,0,0,0,,0,0,0,0,1,1,1,0,Matches
2208,Lewis Richardson,eng ENG,"FW,MF",Burnley,eng Premier League,17,2003,0.0,0,0,0,0,0,0,0,,0,0,0,0,0,0,0,0,Matches
2209,Richarlison,br BRA,FW,Everton,eng Premier League,23,1997,31.8,50,32,21,22,7,16,51,31.4,35,28,3,25,14,64,36,1,Matches
2210,Marco Richter,de GER,"FW,MF",Augsburg,de Bundesliga,22,1997,15.7,17,9,3,12,2,7,23,30.4,16,10,0,10,6,23,9,0,Matches
2211,Mikel Rico,es ESP,MF,Huesca,es La Liga,35,1984,24.3,24,12,14,8,2,11,34,32.4,23,20,3,17,23,47,22,0,Matches
2212,Sergio Rico,es ESP,GK,Paris S-G,fr Ligue 1,26,1993,9.0,0,0,0,0,0,0,0,,0,0,0,0,0,0,1,0,Matches
2213,Jaïro Riedewald,nl NED,MF,Crystal Palace,eng Premier League,23,1996,20.2,34,15,13,17,4,16,36,44.4,20,39,7,32,29,63,25,0,Matches
2214,Emiliano Rigoni,ar ARG,MF,Elche,es La Liga,27,1993,12.7,12,7,3,8,1,3,15,20.0,12,16,1,15,6,18,9,0,Matches
2215,Tomás Rincón,ve VEN,MF,Torino,it Serie A,32,1988,31.6,68,38,27,33,8,36,71,50.7,35,32,7,25,31,99,44,0,Matches
2216,Luis Rioja,es ESP,"MF,FW",Alavés,es La Liga,26,1993,23.2,21,14,11,7,3,7,39,17.9,32,23,1,22,20,41,30,0,Matches
2217,Renaud Ripart,fr FRA,"MF,FW",Nîmes,fr Ligue 1,27,1993,33.9,52,30,25,19,8,26,84,31.0,58,58,12,46,36,88,53,0,Matches
2218,Andrea Rispoli,it ITA,DF,Crotone,it Serie A,31,1988,7.2,6,3,2,3,1,2,7,28.6,5,12,3,9,5,11,15,1,Matches
2219,Mihailo Ristić,rs SRB,DF,Montpellier,fr Ligue 1,24,1995,24.8,45,22,25,13,7,28,44,63.6,16,30,9,21,26,71,57,0,Matches
2220,Matt Ritchie,sct SCO,"DF,MF",Newcastle Utd,eng Premier League,30,1989,15.0,10,3,5,3,2,3,17,17.6,14,17,2,15,12,22,47,0,Matches
2221,Maxence Rivera,fr FRA,"MF,FW",Saint-Étienne,fr Ligue 1,18,2002,2.7,12,10,6,4,2,4,10,40.0,6,5,0,5,1,13,0,0,Matches
2222,Emmanuel Rivière,fr FRA,FW,Crotone,it Serie A,30,1990,7.1,2,1,2,0,0,0,3,0.0,3,5,1,4,1,3,0,0,Matches
2223,Rober,es ESP,"DF,MF",Levante,es La Liga,25,1995,15.8,14,7,8,3,3,8,18,44.4,10,24,16,8,35,49,52,1,Matches
2224,Roberto,es ESP,GK,Valladolid,es La Liga,34,1986,13.0,0,0,0,0,0,0,1,0.0,1,0,0,0,0,0,7,0,Matches
2225,Sergi Roberto,es ESP,"DF,FW",Barcelona,es La Liga,28,1992,10.5,9,6,5,2,2,7,13,53.8,6,12,6,6,10,19,20,0,Matches
2226,Tyler Roberts,wls WAL,"MF,FW",Leeds United,eng Premier League,21,1999,14.9,15,13,1,11,3,5,22,22.7,17,17,2,15,9,24,12,0,Matches
2227,Andrew Robertson,sct SCO,DF,Liverpool,eng Premier League,26,1994,37.6,46,34,23,18,5,28,57,49.1,29,39,9,30,21,67,79,1,Matches
2228,Antonee Robinson,us USA,DF,Fulham,eng Premier League,22,1997,24.0,45,28,24,16,5,27,44,61.4,17,21,4,17,37,82,68,0,Matches
2229,Callum Robinson,ie IRL,"FW,MF",West Brom,eng Premier League,25,1995,17.3,7,5,5,1,1,3,19,15.8,16,9,0,9,7,14,8,0,Matches
2230,Jack Robinson,eng ENG,DF,Sheffield Utd,eng Premier League,26,1993,9.7,14,6,8,5,1,6,11,54.5,5,10,4,6,9,23,42,0,Matches
2231,Joel Robles,es ESP,GK,Betis,es La Liga,30,1990,18.0,0,0,0,0,0,0,1,0.0,1,1,0,1,0,0,11,2,Matches
2232,Hal Robson-Kanu,wls WAL,FW,West Brom,eng Premier League,31,1989,6.2,2,1,1,0,1,0,1,0.0,1,2,0,2,2,4,7,0,Matches
2233,Marc Roca,es ESP,MF,Bayern Munich,de Bundesliga,23,1996,2.0,2,2,0,0,2,0,4,0.0,4,4,1,3,2,4,1,0,Matches
2234,Christopher Rocchia,fr FRA,"DF,FW",Marseille,fr Ligue 1,22,1998,0.2,1,0,1,0,0,0,2,0.0,2,0,0,0,0,1,1,0,Matches
2235,Rubén Rochina,es ESP,MF,Levante,es La Liga,29,1991,15.6,38,28,12,23,3,12,35,34.3,23,22,2,20,22,60,7,0,Matches
2236,Marek Rodák,sk SVK,GK,Fulham,eng Premier League,23,1996,2.0,0,0,0,0,0,0,0,,0,0,0,0,0,0,0,0,Matches
2237,Sebastian Rode,de GER,MF,Eint Frankfurt,de Bundesliga,29,1990,18.1,44,25,21,16,7,14,46,30.4,32,30,3,27,47,91,18,0,Matches
2238,Joe Rodon,wls WAL,DF,Tottenham,eng Premier League,22,1997,8.1,14,9,11,2,1,3,4,75.0,1,10,8,2,21,35,36,2,Matches
2239,Rodri,es ESP,MF,Manchester City,eng Premier League,24,1996,30.5,72,40,24,40,8,33,66,50.0,33,23,9,14,36,108,54,3,Matches
2240,Rodri,es ESP,"FW,MF",Betis,es La Liga,20,2000,6.0,3,3,1,2,0,1,6,16.7,5,7,0,7,2,5,0,0,Matches
2241,Rodrigo,es ESP,"MF,FW",Leeds United,eng Premier League,29,1991,14.3,14,7,8,3,3,4,22,18.2,18,7,0,7,5,19,16,0,Matches
2242,Kévin Rodrigues,pt POR,"DF,MF",Eibar,es La Liga,26,1994,12.2,16,8,8,5,3,7,23,30.4,16,10,1,9,20,36,15,1,Matches
2243,Ángel Rodríguez,es ESP,"FW,MF",Getafe,es La Liga,33,1987,15.3,7,4,1,4,2,1,16,6.3,15,7,0,7,2,9,8,0,Matches
2244,Óscar Rodríguez Arnaiz,es ESP,"MF,FW",Sevilla,es La Liga,22,1998,5.7,15,9,3,8,4,6,13,46.2,7,2,0,2,10,25,1,0,Matches
2245,Guido Rodríguez,ar ARG,MF,Betis,es La Liga,26,1994,31.8,98,56,52,40,6,40,85,47.1,45,52,14,38,68,166,58,2,Matches
2246,James Rodríguez,co COL,"FW,MF",Everton,eng Premier League,29,1991,19.6,28,17,8,15,5,11,46,23.9,35,17,0,17,15,43,3,0,Matches
2247,Jay Rodriguez,eng ENG,FW,Burnley,eng Premier League,31,1989,14.1,25,16,5,15,5,13,28,46.4,15,25,4,21,2,27,7,0,Matches
2248,Miguel Rodríguez,es ESP,"FW,DF",Celta Vigo,es La Liga,17,2003,0.3,1,1,0,1,0,0,0,,0,0,0,0,0,1,0,0,Matches
2249,Ricardo Rodríguez,ch SUI,DF,Torino,it Serie A,27,1992,13.8,21,14,11,8,2,13,22,59.1,9,16,5,11,20,41,43,0,Matches
2250,Víctor Rodríguez,es ESP,MF,Elche,es La Liga,31,1989,4.7,4,3,3,1,0,0,9,0.0,9,5,1,4,5,9,4,0,Matches
2251,Rodrygo,br BRA,FW,Real Madrid,es La Liga,19,2001,10.9,15,6,10,4,1,2,17,11.8,15,15,0,15,7,22,4,0,Matches
2252,Marko Rog,hr CRO,MF,Cagliari,it Serie A,25,1995,12.9,40,24,15,22,3,16,37,43.2,21,17,6,11,19,59,15,0,Matches
2253,Rogério,br BRA,DF,Sassuolo,it Serie A,22,1998,20.9,26,13,19,5,2,19,27,70.4,8,26,5,21,31,57,53,0,Matches
2254,Luis Rojas,cl CHI,"MF,FW",Crotone,it Serie A,18,2002,1.2,1,0,0,1,0,1,2,50.0,1,2,0,2,1,2,0,0,Matches
2255,Alessio Romagnoli,it ITA,DF,Milan,it Serie A,25,1995,21.2,17,7,8,7,2,8,19,42.1,11,29,22,7,24,41,80,0,Matches
2256,Cristian Romero,ar ARG,DF,Atalanta,it Serie A,22,1998,28.3,63,32,41,19,3,27,49,55.1,22,31,13,18,96,159,71,2,Matches
2257,Oriol Romeu,es ESP,MF,Southampton,eng Premier League,28,1991,19.6,69,35,25,39,5,26,68,38.2,42,28,7,21,30,99,18,0,Matches
2258,Cristiano Ronaldo,pt POR,FW,Juventus,it Serie A,35,1985,31.1,6,3,1,3,2,3,15,20.0,12,11,3,8,5,11,15,1,Matches
2259,Facundo Roncaglia,ar ARG,DF,Osasuna,es La Liga,33,1987,13.7,25,14,14,11,0,11,20,55.0,9,11,6,5,25,50,26,0,Matches
2260,Valentin Rongier,fr FRA,MF,Marseille,fr Ligue 1,25,1994,21.0,93,59,31,55,7,43,85,50.6,42,32,2,30,28,121,21,1,Matches
2261,Marten de Roon,nl NED,MF,Atalanta,it Serie A,29,1991,33.6,80,48,30,36,14,36,84,42.9,48,44,9,35,69,149,40,0,Matches
2262,Jérôme Roussillon,fr FRA,DF,Wolfsburg,de Bundesliga,27,1993,13.7,24,12,14,8,2,11,20,55.0,9,10,1,9,19,43,28,0,Matches
2263,Nolan Roux,fr FRA,FW,Nîmes,fr Ligue 1,32,1988,7.2,7,3,1,4,2,3,8,37.5,5,6,0,6,5,12,4,0,Matches
2264,Nicolò Rovella,it ITA,MF,Genoa,it Serie A,18,2001,13.2,29,16,15,11,3,9,32,28.1,23,11,0,11,20,49,19,1,Matches
2265,Amir Rrahmani,xk KVX,DF,Napoli,it Serie A,26,1994,12.2,13,8,7,6,0,6,9,66.7,3,17,14,3,8,21,39,1,Matches
2266,Rubén,es ESP,GK,Osasuna,es La Liga,36,1984,2.1,0,0,0,0,0,0,0,,0,0,0,0,0,0,1,0,Matches
2267,Waldo Rubio,es ESP,"FW,MF",Valladolid,es La Liga,24,1995,4.2,6,4,2,2,2,1,14,7.1,13,6,0,6,3,9,3,0,Matches
2268,John Ruddy,eng ENG,GK,Wolves,eng Premier League,33,1986,1.0,0,0,0,0,0,0,0,,0,0,0,0,0,0,0,0,Matches
2269,Antonio Rüdiger,de GER,DF,Chelsea,eng Premier League,27,1993,19.0,31,23,16,14,1,12,15,80.0,3,17,10,7,18,49,51,0,Matches
2270,Sebastian Rudy,de GER,"MF,FW",Hoffenheim,de Bundesliga,30,1990,18.6,35,26,15,15,5,16,45,35.6,29,24,4,20,13,48,21,1,Matches
2271,Sebastian Rudy,de GER,DF,Schalke 04,de Bundesliga,30,1990,2.0,4,2,2,0,2,4,7,57.1,3,6,4,2,1,5,4,0,Matches
2272,Kevin Rüegg,ch SUI,"DF,MF",Hellas Verona,it Serie A,21,1998,2.3,0,0,0,0,0,0,0,,0,3,0,3,2,2,3,0,Matches
2273,Daniele Rugani,it ITA,DF,Cagliari,it Serie A,26,1994,11.1,24,11,10,12,2,10,20,50.0,10,15,10,5,15,39,46,0,Matches
2274,Daniele Rugani,it ITA,DF,Rennes,fr Ligue 1,26,1994,1.0,0,0,0,0,0,0,1,0.0,1,1,1,0,1,1,1,0,Matches
2275,Matteo Ruggeri,it ITA,DF,Atalanta,it Serie A,18,2002,2.3,3,0,1,2,0,2,3,66.7,1,2,0,2,4,7,2,0,Matches
2276,Mário Rui,pt POR,DF,Napoli,it Serie A,29,1991,18.5,24,13,17,6,1,17,33,51.5,16,17,4,13,28,52,29,1,Matches
2277,Aitor Ruibal,es ESP,"FW,MF",Betis,es La Liga,24,1996,17.7,32,18,14,14,4,10,35,28.6,25,26,0,26,11,43,8,0,Matches
2278,Isma Ruiz,es ESP,MF,Granada,es La Liga,19,2001,0.7,1,0,0,1,0,0,1,0.0,1,0,0,0,0,1,3,0,Matches
2279,Kays Ruiz,ma MAR,"FW,MF",Paris S-G,fr Ligue 1,17,2002,2.1,1,1,0,1,0,0,4,0.0,4,1,0,1,3,4,2,0,Matches
2280,Fabián Ruiz Peña,es ESP,MF,Napoli,it Serie A,24,1996,28.5,58,31,26,21,11,25,70,35.7,45,33,3,30,36,94,32,1,Matches
2281,Víctor Ruiz,es ESP,DF,Betis,es La Liga,31,1989,24.0,11,7,7,4,0,4,13,30.8,9,17,13,4,44,55,85,0,Matches
2282,Gerónimo Rulli,ar ARG,GK,Villarreal,es La Liga,28,1992,2.0,0,0,0,0,0,0,0,,0,0,0,0,0,0,0,1,Matches
2283,Georginio Rutter,fr FRA,"FW,MF",Rennes,fr Ligue 1,18,2002,0.5,2,2,0,1,1,1,3,33.3,2,2,0,2,0,2,0,0,Matches
2284,Georginio Rutter,fr FRA,FW,Hoffenheim,de Bundesliga,18,2002,2.7,4,4,2,2,0,1,2,50.0,1,2,0,2,0,4,2,0,Matches
2285,Mathew Ryan,au AUS,GK,Arsenal,eng Premier League,28,1992,3.0,0,0,0,0,0,0,0,,0,0,0,0,0,0,1,0,Matches
2286,Mathew Ryan,au AUS,GK,Brighton,eng Premier League,28,1992,11.0,1,0,1,0,0,0,0,,0,0,0,0,0,1,4,0,Matches
2287,Julian Ryerson,no NOR,"DF,MF",Union Berlin,de Bundesliga,22,1997,11.9,22,15,4,14,4,12,15,80.0,3,13,0,13,11,33,17,0,Matches
2288,Frederik Rønnow,dk DEN,GK,Schalke 04,de Bundesliga,27,1992,10.5,0,0,0,0,0,0,0,,0,0,0,0,1,1,9,1,Matches
2289,João Victor Santos Sá,br BRA,FW,Wolfsburg,de Bundesliga,26,1994,5.2,9,6,2,6,1,6,11,54.5,5,11,0,11,8,17,2,0,Matches
2290,Roli Pereira de Sa,fr FRA,"FW,MF",Nantes,fr Ligue 1,23,1996,0.6,4,3,1,3,0,3,4,75.0,1,2,0,2,0,4,0,0,Matches
2291,Idriss Saadi,dz ALG,"MF,FW",Strasbourg,fr Ligue 1,28,1992,1.4,0,0,0,0,0,0,2,0.0,2,0,0,0,0,0,0,0,Matches
2292,Youssouf Sabaly,sn SEN,DF,Bordeaux,fr Ligue 1,27,1993,32.3,47,33,24,17,6,27,45,60.0,18,31,8,23,49,96,57,2,Matches
2293,Mathys Saban,fr FRA,FW,Saint-Étienne,fr Ligue 1,18,2002,0.1,0,0,0,0,0,0,0,,0,0,0,0,0,0,0,0,Matches
2294,Marcel Sabitzer,at AUT,MF,RB Leipzig,de Bundesliga,26,1994,22.5,29,21,12,16,1,12,37,32.4,25,7,2,5,35,64,27,0,Matches
2295,Alexis Saelemaekers,be BEL,FW,Milan,it Serie A,21,1999,22.4,43,26,20,18,5,19,60,31.7,41,29,1,28,25,68,6,0,Matches
2296,Modibo Sagnan,ml MLI,DF,Real Sociedad,es La Liga,21,1999,6.9,12,7,6,6,0,4,6,66.7,2,7,2,5,6,18,25,1,Matches
2297,Allan Saint-Maximin,fr FRA,"FW,MF",Newcastle Utd,eng Premier League,23,1997,17.3,16,9,6,9,1,4,9,44.4,5,10,0,10,4,20,2,0,Matches
2298,Borja Sainz,es ESP,"MF,FW",Alavés,es La Liga,19,2001,5.0,7,3,3,2,2,4,16,25.0,12,4,0,4,6,13,1,0,Matches
2299,Romain Saïss,ma MAR,DF,Wolves,eng Premier League,30,1990,26.7,35,24,23,12,0,19,33,57.6,14,28,13,15,52,87,115,1,Matches
2300,Bukayo Saka,eng ENG,"FW,MF",Arsenal,eng Premier League,18,2001,28.4,25,16,10,13,2,11,40,27.5,29,21,2,19,25,50,24,0,Matches
2301,Hiroki Sakai,jp JPN,DF,Marseille,fr Ligue 1,30,1990,26.5,81,48,34,35,12,39,51,76.5,12,21,5,16,54,135,65,0,Matches
2302,Moïse Sakava,cm CMR,MF,Reims,fr Ligue 1,19,2000,0.1,0,0,0,0,0,0,0,,0,0,0,0,0,0,0,0,Matches
2303,Mamadou Sakho,fr FRA,DF,Crystal Palace,eng Premier League,30,1990,3.1,3,2,1,2,0,3,3,100.0,0,3,2,1,3,6,11,0,Matches
2304,Jacopo Sala,it ITA,DF,Spezia,it Serie A,28,1991,4.2,17,9,14,1,2,8,22,36.4,14,5,2,3,5,22,6,0,Matches
2305,Mohamed Salah,eg EGY,FW,Liverpool,eng Premier League,28,1992,34.2,18,9,4,4,10,7,16,43.8,9,10,0,10,1,19,10,1,Matches
2306,Eddie Salcedo,it ITA,"MF,FW",Hellas Verona,it Serie A,18,2001,8.4,6,2,3,2,1,3,3,100.0,0,6,0,6,6,12,6,0,Matches
2307,William Saliba,fr FRA,DF,Nice,fr Ligue 1,19,2001,20.0,15,9,8,5,2,5,6,83.3,1,17,16,1,26,41,80,2,Matches
2308,Romain Salin,fr FRA,GK,Rennes,fr Ligue 1,36,1984,15.0,0,0,0,0,0,0,1,0.0,1,0,0,0,1,1,6,3,Matches
2309,Mohammed Salisu,gh GHA,DF,Southampton,eng Premier League,21,1999,9.4,38,21,20,16,2,25,34,73.5,9,22,5,17,17,55,30,0,Matches
2310,Roland Sallai,hu HUN,"MF,FW",Freiburg,de Bundesliga,23,1997,18.5,18,14,7,9,2,5,13,38.5,8,11,1,10,11,29,8,0,Matches
2311,Salvi,es ESP,"MF,FW",Cádiz,es La Liga,29,1991,21.5,18,10,14,3,1,8,26,30.8,18,14,1,13,20,38,24,0,Matches
2312,Lazar Samardzic,rs SRB,MF,RB Leipzig,de Bundesliga,18,2002,2.2,10,7,4,6,0,5,13,38.5,8,6,0,6,2,12,1,0,Matches
2313,Diadie Samassékou,ml MLI,MF,Hoffenheim,de Bundesliga,24,1996,28.5,71,41,22,42,7,33,90,36.7,57,41,12,29,78,149,50,0,Matches
2314,Mama Samba Baldé,gw GNB,FW,Dijon,fr Ligue 1,24,1995,24.0,23,9,4,13,6,9,22,40.9,13,16,1,15,4,27,26,0,Matches
2315,Junior Sambia,fr FRA,"DF,MF",Montpellier,fr Ligue 1,23,1996,27.2,41,29,20,14,7,26,38,68.4,12,27,14,13,39,80,46,0,Matches
2316,Frédéric Sammaritano,fr FRA,"FW,MF",Dijon,fr Ligue 1,34,1986,12.6,15,10,9,5,1,9,26,34.6,17,6,0,6,9,24,3,0,Matches
2317,Fede San Emeterio,es ESP,MF,Valladolid,es La Liga,23,1997,16.2,25,14,15,7,3,11,31,35.5,20,23,8,15,28,53,33,0,Matches
2318,Antonio Sanabria,py PAR,FW,Torino,it Serie A,24,1996,10.9,8,3,0,4,4,2,9,22.2,7,5,0,5,5,13,8,0,Matches
2319,Antonio Sanabria,py PAR,FW,Betis,es La Liga,24,1996,10.4,5,5,0,4,1,0,2,0.0,2,8,1,7,3,8,9,0,Matches
2320,Oihan Sancet,es ESP,"FW,MF",Athletic Club,es La Liga,20,2000,11.5,8,2,3,4,1,2,7,28.6,5,4,0,4,5,13,7,0,Matches
2321,Renato Sanches,pt POR,MF,Lille,fr Ligue 1,22,1997,14.1,13,7,4,8,1,5,25,20.0,20,13,2,11,13,26,8,0,Matches
2322,Ricard Sánchez ,es ESP,DF,Atlético Madrid,es La Liga,20,2000,0.3,1,1,0,0,1,0,0,,0,1,0,1,0,1,1,0,Matches
2323,Alexis Sánchez,cl CHI,FW,Inter,it Serie A,31,1988,12.7,14,8,4,4,6,5,18,27.8,13,11,0,11,7,21,1,1,Matches
2324,Davinson Sánchez,co COL,DF,Tottenham,eng Premier League,24,1996,16.5,40,20,31,9,0,21,32,65.6,11,18,13,5,14,54,85,2,Matches
2325,Germán Sánchez,es ESP,DF,Granada,es La Liga,33,1986,29.3,24,11,13,9,2,11,23,47.8,12,28,26,2,38,62,130,1,Matches
2326,Javi Sánchez,es ESP,DF,Valladolid,es La Liga,23,1997,10.2,15,10,10,4,1,9,10,90.0,1,15,7,8,15,30,37,0,Matches
2327,Manu Sánchez,es ESP,DF,Osasuna,es La Liga,19,2000,10.8,27,15,10,10,7,11,25,44.0,14,8,0,8,8,35,14,0,Matches
2328,Manu Sánchez,es ESP,DF,Atlético Madrid,es La Liga,19,2000,0.5,0,0,0,0,0,0,1,0.0,1,1,0,1,0,0,1,0,Matches
2329,Juan Sánchez Miño,ar ARG,"DF,MF",Elche,es La Liga,30,1990,5.5,8,5,5,3,0,6,14,42.9,8,4,0,4,4,12,7,0,Matches
2330,Pepe Sánchez,es ESP,DF,Granada,es La Liga,20,2000,2.8,4,2,2,2,0,3,4,75.0,1,5,2,3,4,8,9,0,Matches
2331,Robert Sánchez,es ESP,GK,Brighton,eng Premier League,22,1997,27.0,1,0,1,0,0,1,1,100.0,0,1,0,1,1,2,11,2,Matches
2332,Jadon Sancho,eng ENG,"FW,MF",Dortmund,de Bundesliga,20,2000,22.9,18,11,4,10,4,7,16,43.8,9,20,1,19,16,34,9,0,Matches
2333,Alex Sandro,br BRA,DF,Juventus,it Serie A,29,1991,20.6,37,23,19,13,5,13,25,52.0,12,20,4,16,31,68,57,0,Matches
2334,Leroy Sané,de GER,"FW,MF",Bayern Munich,de Bundesliga,24,1996,20.1,18,10,2,10,6,13,30,43.3,17,23,1,22,9,27,8,1,Matches
2335,Salif Sané,sn SEN,DF,Schalke 04,de Bundesliga,29,1990,11.9,17,9,9,7,1,13,23,56.5,10,25,13,12,25,42,66,0,Matches
2336,Oier Sanjurjo,es ESP,MF,Osasuna,es La Liga,34,1986,23.2,39,16,8,27,4,17,60,28.3,43,24,6,18,29,68,41,0,Matches
2337,Mohamed Sankoh,nl NED,MF,Stuttgart,de Bundesliga,16,2003,0.2,0,0,0,0,0,0,0,,0,1,0,1,0,0,0,0,Matches
2338,Siriki Sanogo,ci CIV,MF,Benevento,it Serie A,18,2001,0.1,0,0,0,0,0,0,0,,0,0,0,0,0,0,0,0,Matches
2339,Morgan Sanson,fr FRA,MF,Aston Villa,eng Premier League,25,1994,3.3,7,4,4,2,1,1,4,25.0,3,5,0,5,4,11,1,0,Matches
2340,Morgan Sanson,fr FRA,MF,Marseille,fr Ligue 1,25,1994,9.2,21,12,6,12,3,9,28,32.1,19,12,0,12,9,30,5,0,Matches
2341,Nicola Sansone,it ITA,"FW,MF",Bologna,it Serie A,28,1991,13.0,22,11,7,12,3,10,31,32.3,21,15,0,15,9,31,7,0,Matches
2342,Baptiste Santamaria,fr FRA,MF,Angers,fr Ligue 1,25,1995,3.0,9,6,3,5,1,2,7,28.6,5,4,0,4,7,16,8,0,Matches
2343,Baptiste Santamaria,fr FRA,MF,Freiburg,de Bundesliga,25,1995,24.5,51,38,19,24,8,20,54,37.0,34,36,7,29,52,103,34,1,Matches
2344,Federico Santander,py PAR,FW,Bologna,it Serie A,29,1991,0.4,0,0,0,0,0,0,0,,0,0,0,0,0,0,0,0,Matches
2345,Davide Santon,it ITA,DF,Roma,it Serie A,29,1991,6.5,4,3,2,2,0,3,7,42.9,4,10,1,9,4,8,12,0,Matches
2346,Samir Santos,br BRA,DF,Udinese,it Serie A,25,1994,24.6,40,23,26,12,2,13,29,44.8,16,33,17,16,58,98,60,1,Matches
2347,Riccardo Saponara,it ITA,MF,Fiorentina,it Serie A,28,1991,0.6,2,1,0,2,0,1,3,33.3,2,0,0,0,1,3,0,0,Matches
2348,Riccardo Saponara,it ITA,"FW,MF",Spezia,it Serie A,28,1991,4.3,4,1,1,0,3,1,3,33.3,2,1,0,1,1,5,4,0,Matches
2349,Ivan Šaponjić,rs SRB,FW,Cádiz,es La Liga,22,1997,4.3,1,0,0,1,0,0,2,0.0,2,2,0,2,1,2,4,0,Matches
2350,Pablo Sarabia,es ESP,"FW,MF",Paris S-G,fr Ligue 1,28,1992,14.7,15,11,6,6,3,10,38,26.3,28,9,1,8,5,20,8,0,Matches
2351,Josh Sargent,us USA,"FW,MF",Werder Bremen,de Bundesliga,20,2000,27.8,32,19,13,13,6,13,27,48.1,14,39,4,35,17,49,36,0,Matches
2352,Bouna Sarr,sn SEN,DF,Marseille,fr Ligue 1,28,1992,0.8,1,1,0,0,1,1,1,100.0,0,1,1,0,1,2,1,0,Matches
2353,Bouna Sarr,sn SEN,DF,Bayern Munich,de Bundesliga,28,1992,5.0,9,8,4,3,2,3,6,50.0,3,7,0,7,10,19,7,1,Matches
2354,Sidy Sarr,sn SEN,MF,Nîmes,fr Ligue 1,24,1996,5.1,10,6,4,6,0,2,5,40.0,3,1,1,0,7,17,4,0,Matches
2355,Marco Sau,it ITA,"MF,FW",Benevento,it Serie A,32,1987,8.7,6,2,0,6,0,1,16,6.3,15,7,0,7,5,11,3,0,Matches
2356,Téji Savanier,fr FRA,MF,Montpellier,fr Ligue 1,28,1991,24.1,49,33,16,25,8,22,73,30.1,51,28,6,22,38,87,15,0,Matches
2357,Stefan Savić,me MNE,DF,Atlético Madrid,es La Liga,29,1991,32.8,40,25,32,7,1,21,34,61.8,13,33,19,14,42,82,110,0,Matches
2358,Romaine Sawyers,kn SKN,MF,West Brom,eng Premier League,28,1991,16.5,30,18,16,12,2,14,43,32.6,29,20,4,16,18,48,12,3,Matches
2359,Gianluca Scamacca,it ITA,FW,Genoa,it Serie A,21,1999,15.0,19,10,6,7,6,7,19,36.8,12,21,4,17,9,28,12,0,Matches
2360,Dane Scarlett,eng ENG,FW,Tottenham,eng Premier League,16,2004,0.0,0,0,0,0,0,0,0,,0,0,0,0,0,0,0,0,Matches
2361,Fabian Schär,ch SUI,DF,Newcastle Utd,eng Premier League,28,1991,13.8,13,4,8,5,0,7,19,36.8,12,19,12,7,27,40,52,1,Matches
2362,Aurélien Scheidler,fr FRA,FW,Dijon,fr Ligue 1,22,1998,3.8,2,0,0,2,0,0,2,0.0,2,0,0,0,1,3,5,0,Matches
2363,Nicolás Schiappacasse,uy URU,MF,Sassuolo,it Serie A,21,1999,0.2,0,0,0,0,0,0,0,,0,0,0,0,0,0,0,0,Matches
2364,Pasquale Schiattarella,it ITA,MF,Benevento,it Serie A,33,1987,25.0,37,22,25,12,0,19,47,40.4,28,19,5,14,32,69,29,2,Matches
2365,Patrik Schick,cz CZE,FW,Leverkusen,de Bundesliga,24,1996,20.7,7,2,0,5,2,1,4,25.0,3,5,2,3,3,10,20,0,Matches
2366,Sven Schipplock,de GER,"FW,MF",Arminia,de Bundesliga,31,1988,8.3,15,8,7,6,2,6,27,22.2,21,13,2,11,6,21,8,0,Matches
2367,Xaver Schlager,at AUT,MF,Wolfsburg,de Bundesliga,22,1997,29.2,66,40,20,38,8,22,68,32.4,46,50,6,44,54,120,38,0,Matches
2368,Keven Schlotterbeck,de GER,DF,Freiburg,de Bundesliga,23,1997,18.4,31,10,16,15,0,10,23,43.5,13,26,18,8,36,67,89,2,Matches
2369,Nico Schlotterbeck,de GER,DF,Union Berlin,de Bundesliga,20,1999,14.3,34,19,14,19,1,18,28,64.3,10,13,6,7,31,65,29,1,Matches
2370,Jeffrey Schlupp,gh GHA,MF,Crystal Palace,eng Premier League,27,1992,15.9,29,16,14,12,3,6,23,26.1,17,24,8,16,22,51,16,0,Matches
2371,Kasper Schmeichel,dk DEN,GK,Leicester City,eng Premier League,33,1986,38.0,0,0,0,0,0,0,0,,0,0,0,0,0,0,10,0,Matches
2372,Jonathan Schmid,fr FRA,"MF,DF",Freiburg,de Bundesliga,30,1990,26.6,37,19,17,13,7,16,30,53.3,14,26,10,16,28,65,38,0,Matches
2373,Romano Schmid,at AUT,"MF,FW",Werder Bremen,de Bundesliga,20,2000,13.1,22,16,8,10,4,8,35,22.9,27,21,0,21,8,30,6,0,Matches
2374,Benno Schmitz,de GER,DF,Köln,de Bundesliga,25,1994,4.6,14,7,6,7,1,7,13,53.8,6,8,2,6,6,20,7,0,Matches
2375,Morgan Schneiderlin,fr FRA,MF,Nice,fr Ligue 1,30,1989,24.4,51,31,21,24,6,20,54,37.0,34,21,11,10,53,104,46,0,Matches
2376,Alessandro Schöpf,at AUT,"FW,MF",Schalke 04,de Bundesliga,26,1994,10.5,11,9,3,7,1,1,6,16.7,5,15,1,14,6,17,6,0,Matches
2377,Jerdy Schouten,nl NED,MF,Bologna,it Serie A,23,1997,27.9,50,25,23,25,2,16,37,43.2,21,36,13,23,79,129,37,6,Matches
2378,Nico Schulz,de GER,DF,Dortmund,de Bundesliga,27,1993,6.8,9,6,4,3,2,2,11,18.2,9,12,4,8,6,15,10,0,Matches
2379,Alexander Schwolow,de GER,GK,Hertha BSC,de Bundesliga,28,1992,26.0,0,0,0,0,0,0,0,,0,1,0,1,0,0,6,0,Matches
2380,Christopher Scott,de GER,"MF,FW",Bayern Munich,de Bundesliga,18,2002,0.4,2,1,0,1,1,2,2,100.0,0,0,0,0,0,2,1,0,Matches
2381,Matteo Scozzarella,it ITA,MF,Parma,it Serie A,32,1988,1.7,4,0,3,1,0,2,3,66.7,1,3,1,2,6,10,0,0,Matches
2382,Simone Scuffet,it ITA,GK,Udinese,it Serie A,24,1996,1.0,0,0,0,0,0,0,0,,0,0,0,0,0,0,0,0,Matches
2383,Jacopo Segre,it ITA,MF,Torino,it Serie A,23,1997,2.1,5,2,2,1,2,2,5,40.0,3,0,0,0,0,5,1,0,Matches
2384,Davie Selke,de GER,FW,Werder Bremen,de Bundesliga,25,1995,9.0,3,2,1,1,1,0,6,0.0,6,3,2,1,1,4,7,0,Matches
2385,Malik Sellouki,fr FRA,"FW,MF",Nice,fr Ligue 1,20,2000,0.7,0,0,0,0,0,0,1,0.0,1,2,0,2,2,2,0,0,Matches
2386,Matz Sels,be BEL,GK,Strasbourg,fr Ligue 1,28,1992,6.0,0,0,0,0,0,0,0,,0,0,0,0,0,0,4,0,Matches
2387,Nélson Semedo,pt POR,"DF,MF",Wolves,eng Premier League,26,1993,33.1,85,48,53,23,9,42,72,58.3,30,30,10,20,41,126,78,2,Matches
2388,Léo Sena,br BRA,MF,Spezia,it Serie A,24,1995,9.8,22,12,7,10,5,12,26,46.2,14,19,4,15,11,33,5,0,Matches
2389,Stefano Sensi,it ITA,MF,Inter,it Serie A,24,1995,6.7,9,6,3,5,1,4,11,36.4,7,6,1,5,7,16,1,0,Matches
2390,Jaime Seoane,es ESP,MF,Huesca,es La Liga,23,1997,22.9,50,30,20,23,7,24,65,36.9,41,27,6,21,17,67,14,0,Matches
2391,Luigi Sepe,it ITA,GK,Parma,it Serie A,29,1991,36.0,0,0,0,0,0,0,2,0.0,2,0,0,0,2,2,13,2,Matches
2392,Suat Serdar,de GER,MF,Schalke 04,de Bundesliga,23,1997,21.7,55,35,18,33,4,17,52,32.7,35,29,4,25,23,78,21,0,Matches
2393,Jean Seri,ci CIV,MF,Bordeaux,fr Ligue 1,29,1991,7.9,17,9,3,12,2,4,15,26.7,11,8,2,6,12,29,7,0,Matches
2394,Femi Seriki,eng ENG,MF,Sheffield Utd,eng Premier League,18,2002,0.0,0,0,0,0,0,0,0,,0,0,0,0,0,0,0,0,Matches
2395,Ryan Sessegnon,eng ENG,"DF,FW",Hoffenheim,de Bundesliga,20,2000,17.5,47,25,26,13,8,15,34,44.1,19,26,3,23,30,77,46,0,Matches
2396,Nils Seufert,de GER,"MF,FW",Arminia,de Bundesliga,23,1997,3.8,12,9,2,5,5,2,8,25.0,6,3,1,2,5,17,6,0,Matches
2397,Edgar Sevikyan,am ARM,MF,Levante,es La Liga,18,2001,0.1,0,0,0,0,0,0,0,,0,0,0,0,0,0,0,0,Matches
2398,Stephan El Shaarawy,it ITA,"MF,FW",Roma,it Serie A,27,1992,6.4,4,3,0,3,1,2,9,22.2,7,3,1,2,3,7,2,0,Matches
2399,Jamie Shackleton,eng ENG,"MF,DF",Leeds United,eng Premier League,20,1999,5.1,10,6,6,4,0,4,11,36.4,7,3,1,2,9,19,3,0,Matches
2400,Xherdan Shaqiri,ch SUI,"MF,FW",Liverpool,eng Premier League,28,1991,6.2,7,4,3,1,3,2,7,28.6,5,4,0,4,2,9,0,0,Matches
2401,Billy Sharp,eng ENG,FW,Sheffield Utd,eng Premier League,34,1986,8.2,5,1,0,3,2,2,9,22.2,7,2,0,2,0,5,2,0,Matches
2402,Luke Shaw,eng ENG,DF,Manchester Utd,eng Premier League,25,1995,29.5,44,28,21,16,7,21,36,58.3,15,34,9,25,20,64,44,2,Matches
2403,Jonjo Shelvey,eng ENG,MF,Newcastle Utd,eng Premier League,28,1992,29.1,39,14,18,19,2,10,37,27.0,27,26,14,12,36,75,42,0,Matches
2404,Eldor Shomurodov,uz UZB,FW,Genoa,it Serie A,25,1995,18.6,28,14,7,13,8,9,37,24.3,28,17,2,15,6,34,11,0,Matches
2405,Shola Shoretire,eng ENG,FW,Manchester Utd,eng Premier League,16,2004,0.1,0,0,0,0,0,0,0,,0,0,0,0,0,0,0,0,Matches
2406,Mahame Siby,ml MLI,MF,Strasbourg,fr Ligue 1,24,1996,0.2,0,0,0,0,0,0,1,0.0,1,0,0,0,0,0,1,0,Matches
2407,Abdoulaye Sidibé,fr FRA,MF,Saint-Étienne,fr Ligue 1,18,2002,0.1,1,1,1,0,0,1,2,50.0,1,0,0,0,0,1,0,0,Matches
2408,Djibril Sidibé,fr FRA,DF,Monaco,fr Ligue 1,28,1992,22.0,58,34,26,29,3,37,52,71.2,15,20,5,15,50,108,37,2,Matches
2409,Sidnei,br BRA,DF,Betis,es La Liga,30,1989,7.7,9,3,6,3,0,4,9,44.4,5,6,4,2,16,25,28,0,Matches
2410,Kaj Sierhuis,nl NED,"FW,MF",Reims,fr Ligue 1,22,1998,7.2,7,2,1,2,4,2,9,22.2,7,2,1,1,2,9,5,0,Matches
2411,Tim Siersleben,de GER,DF,Wolfsburg,de Bundesliga,20,2000,0.4,2,2,2,0,0,1,1,100.0,0,1,0,1,0,2,0,0,Matches
2412,Gylfi Sigurðsson,is ISL,"MF,FW",Everton,eng Premier League,30,1989,25.0,30,20,9,14,7,13,44,29.5,31,31,2,29,34,64,21,1,Matches
2413,Luca Siligardi,it ITA,"MF,FW",Crotone,it Serie A,32,1988,0.5,4,2,0,3,1,1,5,20.0,4,0,0,0,0,4,0,0,Matches
2414,Luca Siligardi,it ITA,"FW,MF",Parma,it Serie A,32,1988,0.4,0,0,0,0,0,0,2,0.0,2,0,0,0,0,0,0,0,Matches
2415,Adrien Silva,pt POR,MF,Sampdoria,it Serie A,31,1989,17.8,49,22,21,22,6,18,54,33.3,36,34,1,33,30,79,10,1,Matches
2416,André Silva,pt POR,FW,Eint Frankfurt,de Bundesliga,24,1995,30.7,11,2,0,7,4,6,13,46.2,7,11,1,10,3,14,15,0,Matches
2417,Bernardo Silva,pt POR,"MF,FW",Manchester City,eng Premier League,25,1994,22.9,26,14,7,12,7,11,52,21.2,41,17,1,16,17,43,8,0,Matches
2418,Caio Henrique Oliveira Silva,br BRA,DF,Monaco,fr Ligue 1,23,1997,26.3,50,34,25,20,5,31,51,60.8,20,20,3,17,16,66,37,0,Matches
2419,David Silva,es ESP,MF,Real Sociedad,es La Liga,34,1986,15.5,19,12,2,14,3,8,21,38.1,13,14,1,13,13,32,8,2,Matches
2420,Fábio Silva,pt POR,FW,Wolves,eng Premier League,18,2002,15.2,6,4,1,4,1,4,12,33.3,8,12,1,11,4,10,5,1,Matches
2421,Florent da Silva,fr FRA,FW,Lyon,fr Ligue 1,17,2003,0.0,0,0,0,0,0,0,0,,0,0,0,0,0,0,0,0,Matches
2422,Gabriel Silva,br BRA,DF,Saint-Étienne,fr Ligue 1,29,1991,3.9,7,6,7,0,0,1,2,50.0,1,4,1,3,6,13,8,0,Matches
2423,Gastón Silva,uy URU,DF,Huesca,es La Liga,26,1994,6.7,16,12,11,5,0,8,14,57.1,6,10,4,6,11,27,16,0,Matches
2424,Rui Silva,pt POR,GK,Granada,es La Liga,26,1994,32.0,1,0,1,0,0,1,3,33.3,2,0,0,0,2,3,14,0,Matches
2425,Thiago Silva,br BRA,DF,Chelsea,eng Premier League,35,1984,21.5,20,12,11,8,1,14,21,66.7,7,21,13,8,33,53,86,1,Matches
2426,Marco Silvestri,it ITA,GK,Hellas Verona,it Serie A,29,1991,34.0,0,0,0,0,0,0,0,,0,0,0,0,0,0,14,1,Matches
2427,Mohamed Simakan,fr FRA,DF,Strasbourg,fr Ligue 1,20,2000,17.9,32,22,21,6,5,9,18,50.0,9,17,11,6,31,63,41,0,Matches
2428,Giovanni Simeone,ar ARG,FW,Cagliari,it Serie A,25,1995,19.3,24,11,2,15,7,7,31,22.6,24,23,1,22,10,34,18,0,Matches
2429,Moses Simon,ng NGA,"FW,MF",Nantes,fr Ligue 1,25,1995,25.8,27,14,11,9,7,17,36,47.2,19,24,1,23,15,42,15,1,Matches
2430,Unai Simón,es ESP,GK,Athletic Club,es La Liga,23,1997,37.0,1,0,1,0,0,1,2,50.0,1,0,0,0,0,1,7,7,Matches
2431,Xavi Simons,nl NED,MF,Paris S-G,fr Ligue 1,17,2003,0.0,0,0,0,0,0,0,0,,0,0,0,0,0,0,0,0,Matches
2432,Jóan Símun Edmundsson,fo FRO,"FW,MF",Arminia,de Bundesliga,29,1991,0.6,0,0,0,0,0,0,0,,0,1,0,1,1,1,0,0,Matches
2433,Wilfried Singo,ci CIV,DF,Torino,it Serie A,19,2000,20.6,29,14,16,6,7,17,33,51.5,16,13,3,10,29,58,40,0,Matches
2434,Daley Sinkgraven,nl NED,DF,Leverkusen,de Bundesliga,25,1995,17.4,32,17,13,16,3,18,35,51.4,17,22,5,17,23,55,23,0,Matches
2435,Dimitris Siovas,gr GRE,DF,Huesca,es La Liga,31,1988,34.1,46,24,34,10,2,20,30,66.7,10,38,17,21,62,108,125,2,Matches
2436,Tobias Sippel,de GER,GK,Gladbach,de Bundesliga,32,1988,3.8,0,0,0,0,0,0,0,,0,0,0,0,1,1,4,0,Matches
2437,Salvatore Sirigu,it ITA,GK,Torino,it Serie A,33,1987,32.0,1,0,1,0,0,1,2,50.0,1,0,0,0,0,1,6,2,Matches
2438,Issouf Sissokho,ml MLI,"MF,DF",Bordeaux,fr Ligue 1,18,2002,0.9,6,4,4,2,0,3,6,50.0,3,2,0,2,1,7,0,0,Matches
2439,Ibrahima Sissoko,ml MLI,MF,Strasbourg,fr Ligue 1,22,1997,28.7,68,48,25,35,8,28,68,41.2,40,22,5,17,48,116,44,0,Matches
2440,Moussa Sissoko,fr FRA,MF,Tottenham,eng Premier League,30,1989,17.6,22,16,19,3,0,8,20,40.0,12,11,4,7,23,45,25,0,Matches
2441,Nelson Sissoko,fr FRA,DF,Saint-Étienne,fr Ligue 1,23,1997,5.3,12,6,6,3,3,7,12,58.3,5,2,1,1,12,24,16,1,Matches
2442,Antonio Sivera,es ESP,GK,Alavés,es La Liga,23,1996,0.8,0,0,0,0,0,0,0,,0,0,0,0,0,0,0,0,Matches
2443,Jacques Siwe,fr FRA,FW,Dijon,fr Ligue 1,19,2001,1.9,4,1,1,1,2,0,1,0.0,1,1,0,1,1,5,1,0,Matches
2444,Ellyes Skhiri,tn TUN,MF,Köln,de Bundesliga,25,1995,30.9,83,48,44,31,8,33,65,50.8,32,49,13,36,82,165,38,2,Matches
2445,Łukasz Skorupski,pl POL,GK,Bologna,it Serie A,29,1991,28.0,1,1,1,0,0,1,4,25.0,3,0,0,0,0,1,23,5,Matches
2446,Andreas Skov Olsen,dk DEN,"FW,DF",Bologna,it Serie A,20,1999,13.1,19,10,11,4,4,11,21,52.4,10,15,0,15,3,22,25,0,Matches
2447,Robert Skov,dk DEN,"FW,MF",Hoffenheim,de Bundesliga,24,1996,12.9,19,10,9,7,3,7,16,43.8,9,9,2,7,15,34,10,1,Matches
2448,Milan Škriniar,sk SVK,DF,Inter,it Serie A,25,1995,30.9,48,32,29,16,3,23,34,67.6,11,30,19,11,30,78,89,1,Matches
2449,Steven Skrzybski,de GER,"FW,DF",Schalke 04,de Bundesliga,27,1992,4.7,5,4,0,5,0,1,7,14.3,6,13,1,12,5,10,1,1,Matches
2450,Petar Škuletić,rs SRB,"FW,MF",Montpellier,fr Ligue 1,30,1990,2.6,3,2,1,2,0,0,5,0.0,5,4,2,2,0,3,4,0,Matches
2451,Islam Slimani,dz ALG,FW,Leicester City,eng Premier League,32,1988,0.2,0,0,0,0,0,0,0,,0,0,0,0,0,0,0,0,Matches
2452,Islam Slimani,dz ALG,FW,Lyon,fr Ligue 1,32,1988,6.4,7,5,3,1,3,3,12,25.0,9,4,1,3,1,8,6,0,Matches
2453,William Smallbone,ie IRL,MF,Southampton,eng Premier League,20,2000,1.9,6,3,2,4,0,1,3,33.3,2,5,0,5,2,8,1,0,Matches
2454,Chris Smalling,eng ENG,DF,Roma,it Serie A,30,1989,12.3,14,8,5,7,2,6,10,60.0,4,17,11,6,28,42,46,1,Matches
2455,Emile Smith Rowe,eng ENG,"MF,FW",Arsenal,eng Premier League,20,2000,16.0,14,7,5,5,4,6,17,35.3,11,15,1,14,10,24,12,0,Matches
2456,Robert Snodgrass,sct SCO,"MF,FW",West Brom,eng Premier League,32,1987,5.8,17,12,12,4,1,10,16,62.5,6,11,2,9,1,18,12,0,Matches
2457,Robert Snodgrass,sct SCO,"FW,MF",West Ham,eng Premier League,32,1987,0.1,0,0,0,0,0,0,0,,0,0,0,0,0,0,0,0,Matches
2458,Cédric Soares,pt POR,DF,Arsenal,eng Premier League,28,1991,8.3,12,8,6,4,2,6,21,28.6,15,6,1,5,8,20,16,1,Matches
2459,Rafa Soares,pt POR,DF,Eibar,es La Liga,25,1995,12.6,28,17,16,8,4,15,21,71.4,6,14,4,10,20,48,32,0,Matches
2460,Rubén Sobrino,es ESP,"MF,FW",Valencia,es La Liga,28,1992,0.5,1,1,1,0,0,0,1,0.0,1,0,0,0,0,1,1,0,Matches
2461,Rubén Sobrino,es ESP,"FW,MF",Cádiz,es La Liga,28,1992,12.4,29,13,8,16,5,8,18,44.4,10,19,0,19,15,44,11,0,Matches
2462,Simon Sohm,ch SUI,MF,Parma,it Serie A,19,2001,10.0,18,12,11,6,1,11,26,42.3,15,8,0,8,5,23,7,0,Matches
2463,Augusto Solari,ar ARG,MF,Celta Vigo,es La Liga,28,1992,5.4,18,13,9,8,1,6,26,23.1,20,13,1,12,6,24,5,0,Matches
2464,Roberto Soldado,es ESP,FW,Granada,es La Liga,35,1985,16.0,7,4,1,4,2,2,11,18.2,9,8,0,8,4,11,13,1,Matches
2465,Carlos Soler,es ESP,MF,Valencia,es La Liga,23,1997,30.4,41,24,14,24,3,19,52,36.5,33,35,11,24,23,64,41,0,Matches
2466,Yann Sommer,ch SUI,GK,Gladbach,de Bundesliga,31,1988,30.1,1,1,1,0,0,1,1,100.0,0,0,0,0,2,3,9,2,Matches
2467,Son,es ESP,"DF,MF",Levante,es La Liga,26,1994,12.3,18,10,11,6,1,9,19,47.4,10,11,2,9,12,30,20,0,Matches
2468,Brandon Soppy,fr FRA,DF,Rennes,fr Ligue 1,18,2002,6.2,21,15,16,5,0,10,16,62.5,6,3,0,3,6,27,12,0,Matches
2469,David Soria,es ESP,GK,Getafe,es La Liga,27,1993,28.0,2,2,2,0,0,1,3,33.3,2,0,0,0,1,3,12,0,Matches
2470,Roberto Soriano,it ITA,MF,Bologna,it Serie A,29,1991,36.1,48,26,15,20,13,15,64,23.4,49,31,8,23,18,66,43,0,Matches
2471,Alberto Soro,es ESP,"FW,MF",Granada,es La Liga,21,1999,4.4,7,2,2,4,1,4,10,40.0,6,7,0,7,1,8,2,0,Matches
2472,Borna Sosa,hr CRO,"DF,FW",Stuttgart,de Bundesliga,22,1998,22.7,14,10,6,6,2,8,25,32.0,17,23,4,19,31,45,74,0,Matches
2473,Hugo Sotelo,es ESP,MF,Celta Vigo,es La Liga,16,2003,0.0,0,0,0,0,0,0,0,,0,0,0,0,0,0,0,0,Matches
2474,Florian Sotoca,fr FRA,FW,Lens,fr Ligue 1,29,1990,26.8,31,20,3,20,8,6,22,27.3,16,27,0,27,9,40,24,0,Matches
2475,Riccardo Sottil,it ITA,"FW,MF",Cagliari,it Serie A,21,1999,13.2,7,3,2,3,2,0,7,0.0,7,4,0,4,5,12,3,0,Matches
2476,Cheick Souaré,fr FRA,MF,Marseille,fr Ligue 1,17,2002,0.1,0,0,0,0,0,0,0,,0,1,1,0,1,1,0,0,Matches
2477,Tomáš Souček,cz CZE,MF,West Ham,eng Premier League,25,1995,38.0,78,41,37,36,5,28,77,36.4,49,43,18,25,62,140,107,0,Matches
2478,Rayan Souici,fr FRA,DF,Saint-Étienne,fr Ligue 1,22,1998,0.1,0,0,0,0,0,0,0,,0,0,0,0,0,0,0,0,Matches
2479,Cebio Soukou,bj BEN,"FW,MF",Arminia,de Bundesliga,27,1992,5.1,12,8,5,5,2,6,11,54.5,5,3,0,3,3,15,4,0,Matches
2480,Adama Soumaoro,fr FRA,DF,Bologna,it Serie A,28,1992,19.5,24,14,17,7,0,6,12,50.0,6,28,23,5,20,44,72,0,Matches
2481,Adama Soumaoro,fr FRA,DF,Lille,fr Ligue 1,28,1992,1.6,1,0,0,0,1,0,0,,0,1,1,0,2,3,2,0,Matches
2482,Boubakary Soumaré,fr FRA,MF,Lille,fr Ligue 1,21,1999,21.3,44,29,16,25,3,14,29,48.3,15,14,6,8,39,83,21,0,Matches
2483,Yaya Soumaré,ml MLI,FW,Lyon,fr Ligue 1,20,2000,0.0,1,1,1,0,0,1,2,50.0,1,0,0,0,2,3,0,0,Matches
2484,Arnaud Souquet,fr FRA,DF,Montpellier,fr Ligue 1,28,1992,13.6,50,33,35,13,2,27,48,56.3,21,15,6,9,17,67,34,0,Matches
2485,Ansou Sow,sn SEN,MF,Lens,fr Ligue 1,20,2000,0.1,0,0,0,0,0,0,0,,0,1,0,1,0,0,0,0,Matches
2486,Djibril Sow,ch SUI,MF,Eint Frankfurt,de Bundesliga,23,1997,24.2,58,33,19,32,7,18,41,43.9,23,31,8,23,51,109,17,0,Matches
2487,Saidou Sow,gn GUI,DF,Saint-Étienne,fr Ligue 1,18,2002,11.1,23,12,17,6,0,13,19,68.4,6,12,8,4,14,37,39,1,Matches
2488,Çağlar Söyüncü,tr TUR,DF,Leicester City,eng Premier League,24,1996,20.2,27,17,13,14,0,17,30,56.7,13,12,9,3,28,55,80,1,Matches
2489,Leonardo Spinazzola,it ITA,DF,Roma,it Serie A,27,1993,23.6,12,6,3,9,0,8,20,40.0,12,16,1,15,25,37,31,0,Matches
2490,Marco Sportiello,it ITA,GK,Atalanta,it Serie A,28,1992,14.0,2,2,2,0,0,1,3,33.3,2,0,0,0,2,4,5,1,Matches
2491,Mattia Sprocati,it ITA,"MF,FW",Parma,it Serie A,27,1993,0.2,1,0,0,1,0,1,1,100.0,0,0,0,0,1,2,0,0,Matches
2492,Jerry St. Juste,nl NED,DF,Mainz 05,de Bundesliga,23,1996,32.0,65,38,37,26,2,20,36,55.6,16,46,27,19,64,129,82,1,Matches
2493,Benjamin Stambouli,fr FRA,"DF,MF",Schalke 04,de Bundesliga,29,1990,21.7,45,29,24,18,3,15,37,40.5,22,42,14,28,49,94,45,1,Matches
2494,Josip Stanišić,hr CRO,DF,Bayern Munich,de Bundesliga,20,2000,1.0,2,2,1,1,0,1,1,100.0,0,3,0,3,2,4,2,0,Matches
2495,Niklas Stark,de GER,"DF,MF",Hertha BSC,de Bundesliga,25,1995,31.0,49,28,20,27,2,13,31,41.9,18,43,16,27,42,91,101,0,Matches
2496,Renato Steffen,ch SUI,"FW,MF",Wolfsburg,de Bundesliga,28,1991,17.4,24,15,6,12,6,13,24,54.2,11,21,2,19,22,46,15,0,Matches
2497,Zack Steffen,us USA,GK,Manchester City,eng Premier League,25,1995,1.0,0,0,0,0,0,0,0,,0,0,0,0,0,0,0,0,Matches
2498,Pascal Stenzel,de GER,DF,Stuttgart,de Bundesliga,24,1996,14.2,33,14,15,17,1,22,50,44.0,28,19,4,15,26,59,39,1,Matches
2499,Dale Stephens,eng ENG,MF,Burnley,eng Premier League,31,1989,2.9,11,6,2,7,2,3,6,50.0,3,3,0,3,8,19,2,0,Matches
2500,Jack Stephens,eng ENG,DF,Southampton,eng Premier League,26,1994,17.1,34,19,19,15,0,17,38,44.7,21,25,14,11,28,62,64,2,Matches
2501,Raheem Sterling,eng ENG,FW,Manchester City,eng Premier League,25,1994,28.2,21,10,5,12,4,5,12,41.7,7,15,0,15,15,36,4,0,Matches
2502,Enda Stevens,ie IRL,DF,Sheffield Utd,eng Premier League,30,1990,30.0,59,26,32,19,8,33,58,56.9,25,41,12,29,22,81,81,1,Matches
2503,Lars Stindl,de GER,"MF,FW",Gladbach,de Bundesliga,31,1988,21.8,24,17,3,16,5,7,32,21.9,25,26,3,23,13,37,14,0,Matches
2504,Kevin Stöger,at AUT,"MF,FW",Mainz 05,de Bundesliga,26,1993,6.0,12,6,2,9,1,5,16,31.3,11,5,0,5,6,18,4,0,Matches
2505,John Stones,eng ENG,DF,Manchester City,eng Premier League,26,1994,21.5,21,10,13,5,3,9,14,64.3,5,23,15,8,18,39,56,1,Matches
2506,Thomas Strakosha,al ALB,GK,Lazio,it Serie A,25,1995,9.0,1,1,1,0,0,0,0,,0,0,0,0,1,2,4,0,Matches
2507,Tobias Strobl,de GER,MF,Augsburg,de Bundesliga,30,1990,20.5,21,10,12,9,0,10,30,33.3,20,21,8,13,28,49,27,0,Matches
2508,Kevin Strootman,nl NED,MF,Genoa,it Serie A,30,1990,14.6,30,18,13,15,2,14,32,43.8,18,35,3,32,25,55,18,0,Matches
2509,Kevin Strootman,nl NED,"MF,FW",Marseille,fr Ligue 1,30,1990,2.6,9,6,5,4,0,4,8,50.0,4,5,2,3,5,14,7,0,Matches
2510,Pascal Struijk,nl NED,"DF,MF",Leeds United,eng Premier League,20,1999,23.1,49,30,28,19,2,17,28,60.7,11,35,21,14,47,96,92,0,Matches
2511,Jens Stryger Larsen,dk DEN,DF,Udinese,it Serie A,29,1991,29.3,17,11,14,3,0,8,25,32.0,17,26,11,15,24,41,65,0,Matches
2512,Stefano Sturaro,it ITA,MF,Hellas Verona,it Serie A,27,1993,4.7,4,3,3,0,1,2,8,25.0,6,5,1,4,5,9,10,0,Matches
2513,Stefano Sturaro,it ITA,MF,Genoa,it Serie A,27,1993,4.9,11,5,3,6,2,3,15,20.0,12,5,0,5,7,18,2,0,Matches
2514,Damián Suárez,uy URU,DF,Getafe,es La Liga,32,1988,27.0,59,39,29,23,7,30,81,37.0,51,43,2,41,31,90,42,0,Matches
2515,Denis Suárez,es ESP,MF,Celta Vigo,es La Liga,26,1994,31.7,64,32,22,30,12,21,94,22.3,73,30,2,28,22,86,15,2,Matches
2516,Luis Suárez,uy URU,FW,Atlético Madrid,es La Liga,33,1987,27.9,11,7,0,4,7,3,12,25.0,9,7,0,7,5,16,13,0,Matches
2517,Marek Suchý,cz CZE,DF,Augsburg,de Bundesliga,32,1988,3.4,4,2,1,3,0,1,2,50.0,1,3,3,0,4,8,9,0,Matches
2518,Niklas Süle,de GER,DF,Bayern Munich,de Bundesliga,24,1995,16.7,32,21,15,14,3,13,21,61.9,8,24,12,12,21,53,36,1,Matches
2519,Suso,es ESP,FW,Sevilla,es La Liga,26,1993,24.6,20,10,8,6,6,10,41,24.4,31,12,0,12,8,28,8,0,Matches
2520,Bosko Sutalo,hr CRO,DF,Atalanta,it Serie A,20,2000,2.6,5,5,0,3,2,4,5,80.0,1,2,1,1,2,7,7,1,Matches
2521,Mattias Svanberg,se SWE,MF,Bologna,it Serie A,21,1999,20.6,38,17,21,9,8,16,45,35.6,29,25,4,21,30,68,25,1,Matches
2522,Abdoulaye Sylla,gn GUI,DF,Nantes,fr Ligue 1,20,2000,0.1,2,1,2,0,0,1,1,100.0,0,1,0,1,0,2,1,0,Matches
2523,Issiaga Sylla,gn GUI,"DF,MF",Lens,fr Ligue 1,26,1994,12.4,28,20,11,17,0,11,21,52.4,10,13,3,10,16,44,21,0,Matches
2524,Eddy Sylvestre,fr FRA,"FW,MF",Nice,fr Ligue 1,20,1999,1.1,1,1,1,0,0,0,1,0.0,1,1,0,1,1,2,0,0,Matches
2525,Ádám Szalai,hu HUN,FW,Mainz 05,de Bundesliga,32,1987,8.1,7,6,3,2,2,2,8,25.0,6,4,1,3,2,9,4,0,Matches
2526,Wojciech Szczęsny,pl POL,GK,Juventus,it Serie A,30,1990,29.7,0,0,0,0,0,0,0,,0,2,0,2,3,3,5,1,Matches
2527,Frederik Sørensen,dk DEN,DF,Köln,de Bundesliga,28,1992,1.1,2,1,0,2,0,1,1,100.0,0,2,0,2,0,2,0,0,Matches
2528,Alexander Sørloth,no NOR,FW,RB Leipzig,de Bundesliga,24,1995,16.0,7,5,0,5,2,2,14,14.3,12,13,2,11,3,10,13,0,Matches
2529,Tachi,es ESP,DF,Alavés,es La Liga,22,1997,9.4,11,9,9,2,0,6,14,42.9,8,9,6,3,11,22,32,0,Matches
2530,Jonathan Tah,de GER,DF,Leverkusen,de Bundesliga,24,1996,24.7,30,17,19,9,2,11,21,52.4,10,19,12,7,33,63,89,1,Matches
2531,Waniss Taibi,fr FRA,MF,Angers,fr Ligue 1,18,2002,0.4,0,0,0,0,0,0,2,0.0,2,1,0,1,0,0,0,0,Matches
2532,Flavien Tait,fr FRA,"MF,FW",Rennes,fr Ligue 1,27,1993,15.2,26,11,11,12,3,10,32,31.3,22,17,3,14,13,39,2,0,Matches
2533,Adrien Tameze,cm CMR,MF,Hellas Verona,it Serie A,26,1994,25.6,39,25,23,15,1,11,27,40.7,16,31,8,23,32,71,46,2,Matches
2534,Japhet Tanganga,eng ENG,DF,Tottenham,eng Premier League,21,1999,5.4,5,4,3,2,0,1,3,33.3,2,6,5,1,3,8,15,0,Matches
2535,Renato Tapia,pe PER,MF,Celta Vigo,es La Liga,25,1995,30.0,93,44,50,34,9,32,83,38.6,51,56,13,43,53,146,75,2,Matches
2536,Edmond Tapsoba,bf BFA,DF,Leverkusen,de Bundesliga,21,1999,29.5,54,28,35,18,1,21,45,46.7,24,55,29,26,48,102,96,0,Matches
2537,Matt Targett,eng ENG,DF,Aston Villa,eng Premier League,24,1995,37.8,83,39,52,20,11,56,88,63.6,32,40,14,26,55,138,102,1,Matches
2538,James Tarkowski,eng ENG,DF,Burnley,eng Premier League,27,1992,36.0,66,39,52,11,3,25,49,51.0,24,54,42,12,44,110,163,1,Matches
2539,Ciprian Tătărușanu,ro ROU,GK,Milan,it Serie A,34,1986,1.0,0,0,0,0,0,0,0,,0,0,0,0,0,0,0,1,Matches
2540,Percy Tau,za RSA,FW,Brighton,eng Premier League,26,1994,1.1,1,1,1,0,0,0,2,0.0,2,1,0,1,0,1,1,0,Matches
2541,Niklas Tauer,de GER,"MF,DF",Mainz 05,de Bundesliga,19,2001,0.8,1,1,0,1,0,1,2,50.0,1,3,1,2,3,4,1,0,Matches
2542,Heriberto Tavares,pt POR,"FW,MF",Brest,fr Ligue 1,23,1997,0.5,2,0,0,0,2,1,3,33.3,2,0,0,0,1,3,1,0,Matches
2543,Sidnei Tavares,pt POR,MF,Leicester City,eng Premier League,18,2001,0.9,1,1,0,1,0,0,0,,0,1,1,0,0,1,0,0,Matches
2544,Tomás Tavares,pt POR,"MF,DF",Alavés,es La Liga,19,2001,0.7,2,1,2,0,0,2,2,100.0,0,1,0,1,0,2,1,0,Matches
2545,Charlie Taylor,eng ENG,DF,Burnley,eng Premier League,26,1993,27.0,48,28,30,15,3,25,46,54.3,21,36,19,17,29,77,87,2,Matches
2546,Neil Taylor,wls WAL,DF,Aston Villa,eng Premier League,31,1989,0.2,1,1,1,0,0,0,0,,0,1,0,1,0,1,0,0,Matches
2547,Allan Tchaptchet,fr FRA,DF,Southampton,eng Premier League,18,2001,0.1,0,0,0,0,0,0,0,,0,0,0,0,0,0,0,0,Matches
2548,Warren Tchimbembé,cg CGO,"MF,FW",Metz,fr Ligue 1,22,1998,5.5,7,4,4,3,0,3,9,33.3,6,6,1,5,2,9,3,0,Matches
2549,Aurélien Tchouaméni,fr FRA,MF,Monaco,fr Ligue 1,20,2000,34.0,127,68,47,62,18,48,92,52.2,44,39,11,28,60,187,47,0,Matches
2550,Álvaro Tejero,es ESP,DF,Eibar,es La Liga,24,1996,1.2,1,1,0,0,1,1,3,33.3,2,1,0,1,3,4,6,0,Matches
2551,Nathan Tella,ng NGA,"FW,MF",Southampton,eng Premier League,21,1999,8.3,8,5,1,4,3,6,15,40.0,9,13,0,13,3,11,2,0,Matches
2552,Alex Telles,br BRA,DF,Manchester Utd,eng Premier League,27,1992,7.7,14,7,10,3,1,8,17,47.1,9,7,2,5,16,30,20,0,Matches
2553,Andrés Tello,co COL,"DF,MF",Benevento,it Serie A,23,1996,4.6,9,6,8,0,1,5,20,25.0,15,8,1,7,6,15,6,0,Matches
2554,Cristian Tello,es ESP,"FW,MF",Betis,es La Liga,28,1991,14.3,16,10,5,9,2,4,22,18.2,18,14,0,14,11,27,8,0,Matches
2555,Lino Tempelmann,de GER,MF,Freiburg,de Bundesliga,21,1999,3.0,5,3,2,2,1,0,4,0.0,4,6,1,5,2,7,6,0,Matches
2556,Hidde ter Avest,nl NED,DF,Udinese,it Serie A,23,1997,3.9,5,2,3,2,0,2,5,40.0,3,3,1,2,2,7,5,0,Matches
2557,Marc-André ter Stegen,de GER,GK,Barcelona,es La Liga,28,1992,31.0,0,0,0,0,0,0,2,0.0,2,0,0,0,0,0,12,2,Matches
2558,Pietro Terracciano,it ITA,GK,Fiorentina,it Serie A,30,1990,3.0,0,0,0,0,0,0,0,,0,0,0,0,0,0,1,0,Matches
2559,Martin Terrier,fr FRA,"FW,MF",Rennes,fr Ligue 1,23,1997,27.1,33,15,5,15,13,10,36,27.8,26,23,0,23,16,49,7,0,Matches
2560,Claudio Terzi,it ITA,DF,Spezia,it Serie A,36,1984,20.8,34,21,19,14,1,19,28,67.9,9,23,12,11,35,69,55,1,Matches
2561,Kenny Tete,nl NED,"DF,MF",Fulham,eng Premier League,24,1995,16.5,48,30,27,16,5,10,18,55.6,8,14,5,9,27,75,49,0,Matches
2562,Kenny Tete,nl NED,DF,Lyon,fr Ligue 1,24,1995,0.2,2,0,1,1,0,0,0,,0,0,0,0,2,4,0,0,Matches
2563,Cedric Teuchert,de GER,"FW,MF",Union Berlin,de Bundesliga,23,1997,8.4,7,5,2,4,1,3,16,18.8,13,12,0,12,5,12,6,0,Matches
2564,Florian Thauvin,fr FRA,"FW,MF",Marseille,fr Ligue 1,27,1993,30.4,40,22,14,21,5,20,54,37.0,34,26,2,24,14,54,11,0,Matches
2565,Malick Thiaw,de GER,DF,Schalke 04,de Bundesliga,18,2001,16.1,42,27,24,17,1,15,26,57.7,11,17,12,5,33,75,70,0,Matches
2566,Jan Thielmann,de GER,"FW,MF",Köln,de Bundesliga,18,2002,11.4,11,6,1,8,2,5,9,55.6,4,10,1,9,9,20,2,0,Matches
2567,Sada Thioub,sn SEN,"FW,MF",Angers,fr Ligue 1,25,1995,14.0,17,14,7,6,4,7,23,30.4,16,10,0,10,9,26,3,0,Matches
2568,William Thomas Fish,eng ENG,FW,Manchester Utd,eng Premier League,17,2003,0.0,0,0,0,0,0,0,0,,0,0,0,0,0,0,0,0,Matches
2569,Luke Thomas,eng ENG,DF,Leicester City,eng Premier League,19,2001,10.8,23,14,11,5,7,14,21,66.7,7,15,2,13,17,40,21,0,Matches
2570,Romain Thomas,fr FRA,DF,Angers,fr Ligue 1,32,1988,33.6,47,25,34,11,2,20,35,57.1,15,35,20,15,50,97,138,0,Matches
2571,Adrien Thomasson,fr FRA,"MF,FW",Strasbourg,fr Ligue 1,26,1993,29.2,36,17,8,16,12,12,58,20.7,46,44,5,39,22,58,2,0,Matches
2572,Erik Thommy,de GER,"MF,DF",Stuttgart,de Bundesliga,25,1994,3.5,3,1,0,3,0,0,3,0.0,3,3,0,3,3,6,4,0,Matches
2573,Morten Thorsby,no NOR,MF,Sampdoria,it Serie A,24,1996,29.4,76,42,32,36,8,20,60,33.3,40,51,16,35,25,101,30,0,Matches
2574,Khéphren Thuram,fr FRA,MF,Nice,fr Ligue 1,19,2001,16.6,32,16,5,21,6,9,27,33.3,18,21,9,12,18,50,22,1,Matches
2575,Marcus Thuram,fr FRA,"FW,MF",Gladbach,de Bundesliga,22,1997,19.2,24,14,9,10,5,10,23,43.5,13,27,4,23,15,39,13,1,Matches
2576,Cheikh Tidiane Sabaly,sn SEN,FW,Metz,fr Ligue 1,21,1999,0.1,0,0,0,0,0,0,0,,0,0,0,0,0,0,0,0,Matches
2577,Youri Tielemans,be BEL,MF,Leicester City,eng Premier League,23,1997,37.3,86,45,32,38,16,45,108,41.7,63,35,8,27,46,132,20,1,Matches
2578,Kieran Tierney,sct SCO,DF,Arsenal,eng Premier League,23,1997,25.5,27,15,5,14,8,11,31,35.5,20,31,10,21,16,43,63,0,Matches
2579,Steffen Tigges,de GER,"FW,DF",Dortmund,de Bundesliga,22,1998,0.6,4,4,0,1,3,2,3,66.7,1,1,0,1,0,4,1,0,Matches
2580,Guus Til,nl NED,FW,Freiburg,de Bundesliga,22,1997,1.4,4,3,2,1,1,2,3,66.7,1,2,0,2,2,6,2,0,Matches
2581,David Timor,es ESP,"MF,DF",Getafe,es La Liga,30,1989,15.5,13,9,5,6,2,9,21,42.9,12,5,1,4,19,32,32,1,Matches
2582,Jean-Clair Todibo,fr FRA,DF,Nice,fr Ligue 1,20,1999,14.8,25,15,16,9,0,16,31,51.6,15,13,7,6,19,44,48,1,Matches
2583,Karl Toko Ekambi,cm CMR,FW,Lyon,fr Ligue 1,27,1992,31.2,16,10,5,3,8,8,32,25.0,24,20,1,19,26,42,8,0,Matches
2584,Corentin Tolisso,fr FRA,MF,Bayern Munich,de Bundesliga,25,1994,8.7,19,19,4,11,4,9,29,31.0,20,15,2,13,6,25,8,0,Matches
2585,Jeremy Toljan,de GER,DF,Sassuolo,it Serie A,25,1994,16.6,21,12,16,3,2,12,27,44.4,15,15,7,8,13,34,28,0,Matches
2586,Rafael Tolói,it ITA,DF,Atalanta,it Serie A,29,1990,28.2,51,23,21,26,4,26,48,54.2,22,37,7,30,33,84,66,0,Matches
2587,Takehiro Tomiyasu,jp JPN,DF,Bologna,it Serie A,21,1998,30.2,47,31,27,14,6,21,34,61.8,13,37,19,18,54,101,106,0,Matches
2588,James Tomkins,eng ENG,DF,Crystal Palace,eng Premier League,31,1989,6.1,4,2,4,0,0,3,4,75.0,1,4,3,1,4,8,45,0,Matches
2589,Fikayo Tomori,eng ENG,DF,Chelsea,eng Premier League,22,1997,0.5,2,1,2,0,0,0,0,,0,1,1,0,2,4,8,0,Matches
2590,Fikayo Tomori,eng ENG,DF,Milan,it Serie A,22,1997,16.3,28,18,17,9,2,8,14,57.1,6,32,20,12,18,46,61,1,Matches
2591,Sandro Tonali,it ITA,MF,Milan,it Serie A,20,2000,14.8,28,19,14,13,1,13,28,46.4,15,18,5,13,22,50,18,0,Matches
2592,Lorenzo Tonelli,it ITA,DF,Sampdoria,it Serie A,30,1990,19.8,33,18,20,11,2,10,21,47.6,11,21,14,7,25,58,94,1,Matches
2593,Toño,es ESP,"DF,FW",Levante,es La Liga,30,1989,8.1,4,0,4,0,0,0,2,0.0,2,10,1,9,7,11,12,0,Matches
2594,Ömer Toprak,tr TUR,DF,Werder Bremen,de Bundesliga,31,1989,21.6,23,16,15,6,2,12,24,50.0,12,27,16,11,36,59,115,1,Matches
2595,Tyron Tormin,fr FRA,"FW,MF",Saint-Étienne,fr Ligue 1,19,2001,0.2,0,0,0,0,0,0,0,,0,0,0,0,0,0,0,0,Matches
2596,Ernesto Torregrossa,ve VEN,FW,Sampdoria,it Serie A,28,1992,1.9,1,1,0,0,1,0,2,0.0,2,4,0,4,1,2,1,0,Matches
2597,Lucas Torreira,uy URU,MF,Atlético Madrid,es La Liga,24,1996,5.8,8,4,2,3,3,0,3,0.0,3,5,3,2,12,20,8,0,Matches
2598,Ferrán Torres,es ESP,"FW,MF",Manchester City,eng Premier League,20,2000,14.5,12,5,4,6,2,5,16,31.3,11,16,0,16,3,15,8,0,Matches
2599,Óliver Torres,es ESP,"MF,FW",Sevilla,es La Liga,25,1994,15.6,34,22,13,15,6,19,53,35.8,34,15,0,15,15,49,9,0,Matches
2600,Pau Torres,es ESP,DF,Villarreal,es La Liga,23,1997,33.0,17,11,10,5,2,11,18,61.1,7,33,25,8,23,40,111,1,Matches
2601,Roberto Torres,es ESP,"MF,FW",Osasuna,es La Liga,31,1989,21.0,15,8,6,5,4,8,29,27.6,21,12,0,12,16,31,13,0,Matches
2602,Lucas Torró,es ESP,MF,Osasuna,es La Liga,26,1994,17.2,32,15,11,19,2,21,34,61.8,13,16,7,9,27,59,43,0,Matches
2603,Jordan Torunarigha,de GER,DF,Hertha BSC,de Bundesliga,22,1997,10.8,7,4,7,0,0,5,8,62.5,3,8,2,6,15,22,54,1,Matches
2604,Cenk Tosun,tr TUR,FW,Everton,eng Premier League,29,1991,0.5,0,0,0,0,0,0,1,0.0,1,0,0,0,0,0,0,0,Matches
2605,Abdoulaye Touré,gn GUI,MF,Nantes,fr Ligue 1,26,1994,18.7,28,12,10,16,2,14,31,45.2,17,17,2,15,22,50,19,0,Matches
2606,Almamy Touré,ml MLI,DF,Eint Frankfurt,de Bundesliga,24,1996,7.8,18,12,8,7,3,10,14,71.4,4,5,1,4,8,26,22,0,Matches
2607,Lucas Tousart,fr FRA,MF,Hertha BSC,de Bundesliga,23,1997,23.2,33,18,16,15,2,13,27,48.1,14,33,6,27,40,73,52,0,Matches
2608,Andros Townsend,eng ENG,"MF,FW",Crystal Palace,eng Premier League,29,1991,25.1,78,41,45,20,13,30,79,38.0,49,48,2,46,41,119,19,0,Matches
2609,Conor Townsend,eng ENG,DF,West Brom,eng Premier League,27,1993,24.8,44,28,32,9,3,30,49,61.2,19,38,15,23,36,80,55,2,Matches
2610,Mattéo Tramoni,fr FRA,"MF,FW",Cagliari,it Serie A,20,2000,0.8,4,2,2,1,1,1,2,50.0,1,5,0,5,1,5,2,0,Matches
2611,Adama Traoré,es ESP,"FW,MF",Wolves,eng Premier League,24,1996,29.4,28,16,11,13,4,13,21,61.9,8,23,1,22,7,35,12,1,Matches
2612,Amadou Traore,fr FRA,"FW,MF",Bordeaux,fr Ligue 1,18,2002,3.4,6,1,2,2,2,2,9,22.2,7,9,0,9,1,7,2,0,Matches
2613,Bertrand Traoré,bf BFA,FW,Aston Villa,eng Premier League,24,1995,25.7,26,10,8,10,8,10,34,29.4,24,23,1,22,15,41,14,1,Matches
2614,Boubacar Traoré,ml MLI,MF,Metz,fr Ligue 1,18,2001,0.6,3,2,1,2,0,1,1,100.0,0,1,0,1,0,3,0,0,Matches
2615,Chaka Traorè,ci CIV,"FW,DF",Parma,it Serie A,15,2004,0.2,0,0,0,0,0,0,0,,0,0,0,0,0,0,1,1,Matches
2616,Charles Traore,ml MLI,DF,Nantes,fr Ligue 1,28,1992,18.9,53,34,30,17,6,27,54,50.0,27,26,5,21,36,89,65,0,Matches
2617,Cheick Traoré,ml MLI,DF,Lens,fr Ligue 1,25,1995,0.4,2,2,1,1,0,2,4,50.0,2,1,0,1,2,4,1,0,Matches
2618,Hamari Traoré,ml MLI,DF,Rennes,fr Ligue 1,28,1992,33.3,56,38,23,27,6,22,59,37.3,37,31,5,26,76,132,50,0,Matches
2619,Ibrahima Traoré,gn GUI,"FW,DF",Gladbach,de Bundesliga,32,1988,1.1,4,1,1,2,1,0,0,,0,2,0,2,0,4,0,0,Matches
2620,Ismaël Traoré,ci CIV,DF,Angers,fr Ligue 1,33,1986,33.3,32,14,23,9,0,20,37,54.1,17,27,13,14,40,72,107,0,Matches
2621,Kevin Trapp,de GER,GK,Eint Frankfurt,de Bundesliga,30,1990,33.0,0,0,0,0,0,0,1,0.0,1,1,0,1,3,3,11,3,Matches
2622,Miguel Trauco,pe PER,DF,Saint-Étienne,fr Ligue 1,27,1992,22.6,47,29,25,14,8,23,43,53.5,20,19,4,15,30,77,34,1,Matches
2623,Trézéguet,eg EGY,FW,Aston Villa,eng Premier League,25,1994,13.0,33,18,14,15,4,13,45,28.9,32,13,1,12,19,52,17,0,Matches
2624,Manu Trigueros,es ESP,MF,Villarreal,es La Liga,28,1991,28.1,51,30,25,21,5,21,77,27.3,56,32,2,30,17,68,19,0,Matches
2625,Christopher Trimmel,at AUT,"DF,FW",Union Berlin,de Bundesliga,33,1987,28.6,50,25,28,18,4,28,54,51.9,26,32,7,25,50,100,99,0,Matches
2626,Francisco Trincão,pt POR,"FW,MF",Barcelona,es La Liga,20,1999,7.8,4,2,0,3,1,2,5,40.0,3,4,0,4,1,5,2,0,Matches
2627,Alessandro Tripaldelli,it ITA,DF,Cagliari,it Serie A,21,1999,3.3,13,6,5,6,2,5,6,83.3,1,6,1,5,3,16,15,0,Matches
2628,Kieran Trippier,eng ENG,DF,Atlético Madrid,es La Liga,29,1990,27.5,61,39,30,25,6,26,52,50.0,26,22,4,18,40,101,58,1,Matches
2629,Leandro Trossard,be BEL,"MF,FW",Brighton,eng Premier League,25,1994,29.0,33,14,11,16,6,10,36,27.8,26,34,2,32,26,59,7,1,Matches
2630,Alexis Trouillet,fr FRA,"MF,FW",Nice,fr Ligue 1,19,2000,1.2,5,4,1,4,0,4,5,80.0,1,0,0,0,3,8,0,0,Matches
2631,Adrien Truffert,fr FRA,"DF,MF",Rennes,fr Ligue 1,18,2001,21.7,38,18,18,12,8,13,24,54.2,11,26,5,21,18,56,38,1,Matches
2632,Marvin Tshibuabua,fr FRA,DF,Saint-Étienne,fr Ligue 1,18,2002,0.5,1,0,1,0,0,0,0,,0,0,0,0,1,2,1,0,Matches
2633,Kostas Tsimikas,gr GRE,"DF,FW",Liverpool,eng Premier League,24,1996,0.1,0,0,0,0,0,0,0,,0,0,0,0,0,0,0,0,Matches
2634,Axel Tuanzebe,cd COD,DF,Manchester Utd,eng Premier League,22,1997,4.5,13,7,5,7,1,8,9,88.9,1,7,5,2,3,16,18,0,Matches
2635,Alessandro Tuia,it ITA,DF,Benevento,it Serie A,30,1990,19.6,39,17,34,4,1,15,25,60.0,10,22,10,12,36,75,91,1,Matches
2636,Ľubomír Tupta,sk SVK,FW,Hellas Verona,it Serie A,22,1998,0.6,0,0,0,0,0,0,0,,0,0,0,0,0,0,0,0,Matches
2637,Tuta,br BRA,DF,Eint Frankfurt,de Bundesliga,21,1999,16.2,35,20,22,13,0,24,43,55.8,19,19,2,17,29,64,53,0,Matches
2638,Destiny Udogie,it ITA,"DF,MF",Hellas Verona,it Serie A,17,2002,1.9,6,4,2,2,2,2,2,100.0,0,3,0,3,2,8,4,0,Matches
2639,Matthieu Udol,fr FRA,DF,Metz,fr Ligue 1,24,1996,19.2,34,21,18,12,4,17,39,43.6,22,25,5,20,39,73,30,0,Matches
2640,Naomichi Ueda,jp JPN,DF,Nîmes,fr Ligue 1,25,1994,7.9,4,2,3,1,0,4,6,66.7,2,5,4,1,6,10,30,1,Matches
2641,Lesley Ugochukwu,fr FRA,MF,Rennes,fr Ligue 1,16,2004,0.7,3,1,0,3,0,2,3,66.7,1,1,0,1,0,3,0,0,Matches
2642,Hwang Ui-jo,kr KOR,"FW,MF",Bordeaux,fr Ligue 1,27,1992,27.8,14,6,5,8,1,6,25,24.0,19,17,2,15,8,22,14,0,Matches
2643,Samir Ujkani,xk KVX,GK,Torino,it Serie A,32,1988,1.0,0,0,0,0,0,0,0,,0,0,0,0,0,0,1,0,Matches
2644,Samuel Umtiti,fr FRA,DF,Barcelona,es La Liga,26,1993,7.2,5,1,3,2,0,1,2,50.0,1,11,6,5,9,14,15,0,Matches
2645,Enes Ünal,tr TUR,FW,Getafe,es La Liga,23,1997,14.6,11,3,0,8,3,4,15,26.7,11,11,0,11,2,13,14,0,Matches
2646,Cengiz Ünder,tr TUR,"FW,MF",Leicester City,eng Premier League,23,1997,3.1,4,1,0,3,1,3,5,60.0,2,3,0,3,2,6,0,0,Matches
2647,Dayot Upamecano,fr FRA,DF,RB Leipzig,de Bundesliga,21,1998,25.9,37,30,18,19,0,14,20,70.0,6,25,14,11,33,70,74,2,Matches
2648,Kacper Urbanski,pl POL,FW,Bologna,it Serie A,15,2004,0.0,0,0,0,0,0,0,0,,0,0,0,0,0,0,0,0,Matches
2649,Mark Uth,de GER,"FW,MF",Schalke 04,de Bundesliga,28,1991,16.6,25,13,13,10,2,5,23,21.7,18,21,0,21,5,30,10,0,Matches
2650,Tomáš Vaclík,cz CZE,GK,Sevilla,es La Liga,31,1989,5.0,0,0,0,0,0,0,1,0.0,1,0,0,0,0,0,0,1,Matches
2651,Eugeni Valderrama,es ESP,"MF,FW",Huesca,es La Liga,26,1994,1.3,2,2,1,0,1,0,1,0.0,1,0,0,0,5,7,3,0,Matches
2652,Lautaro Valenti,ar ARG,DF,Parma,it Serie A,21,1999,5.5,10,4,7,2,1,6,15,40.0,9,11,3,8,11,21,30,0,Matches
2653,Antoine Valerio,fr FRA,MF,Nîmes,fr Ligue 1,20,1999,0.8,0,0,0,0,0,0,1,0.0,1,1,0,1,2,2,0,0,Matches
2654,Borja Valero,es ESP,"MF,FW",Fiorentina,it Serie A,35,1985,5.5,13,9,7,4,2,3,15,20.0,12,6,1,5,6,19,2,0,Matches
2655,Yan Valery,tn TUN,"DF,MF",Southampton,eng Premier League,21,1999,1.1,5,3,2,3,0,1,5,20.0,4,2,0,2,2,7,5,0,Matches
2656,Jesús Vallejo,es ESP,DF,Granada,es La Liga,23,1997,15.0,11,6,7,3,1,7,18,38.9,11,21,11,10,13,24,55,0,Matches
2657,Manu Vallejo,es ESP,"FW,MF",Valencia,es La Liga,23,1997,10.6,18,8,5,8,5,5,26,19.2,21,8,0,8,3,21,3,0,Matches
2658,Federico Valverde,uy URU,MF,Real Madrid,es La Liga,22,1998,14.8,25,16,9,8,8,10,26,38.5,16,16,2,14,22,47,4,0,Matches
2659,Virgil van Dijk,nl NED,DF,Liverpool,eng Premier League,29,1991,4.1,3,2,1,2,0,0,0,,0,1,1,0,5,8,8,1,Matches
2660,Raphaël Varane,fr FRA,DF,Real Madrid,es La Liga,27,1993,30.2,22,14,16,5,1,10,19,52.6,9,26,18,8,36,58,114,2,Matches
2661,Jamie Vardy,eng ENG,FW,Leicester City,eng Premier League,33,1987,31.6,18,12,1,8,9,2,15,13.3,13,14,5,9,4,22,32,0,Matches
2662,Ruben Vargas,ch SUI,"MF,FW",Augsburg,de Bundesliga,21,1998,17.9,18,12,6,9,3,1,16,6.3,15,26,2,24,18,36,27,0,Matches
2663,Denis Vavro,sk SVK,DF,Lazio,it Serie A,24,1996,0.4,0,0,0,0,0,0,1,0.0,1,0,0,0,1,1,3,0,Matches
2664,Denis Vavro,sk SVK,DF,Huesca,es La Liga,24,1996,6.8,7,4,2,4,1,2,5,40.0,3,2,0,2,11,18,21,0,Matches
2665,Franco Vázquez,ar ARG,"FW,MF",Sevilla,es La Liga,31,1989,1.8,5,1,0,3,2,1,5,20.0,4,2,1,1,1,6,1,0,Matches
2666,Kevin Vázquez,es ESP,DF,Celta Vigo,es La Liga,27,1993,6.2,11,5,9,2,0,3,9,33.3,6,8,0,8,9,20,18,0,Matches
2667,Lucas Vázquez,es ESP,"DF,FW",Real Madrid,es La Liga,29,1991,20.5,61,37,30,22,9,22,52,42.3,30,14,1,13,19,80,31,1,Matches
2668,Matías Vecino,uy URU,MF,Inter,it Serie A,28,1991,3.1,1,1,0,0,1,0,5,0.0,5,7,1,6,4,5,3,0,Matches
2669,Koke Vegas,es ESP,GK,Levante,es La Liga,24,1995,1.0,0,0,0,0,0,0,0,,0,0,0,0,0,0,1,1,Matches
2670,Gabriel Veiga,es ESP,"MF,DF",Celta Vigo,es La Liga,18,2002,1.3,3,0,3,0,0,1,4,25.0,3,3,0,3,3,6,0,0,Matches
2671,Miloš Veljković,rs SRB,DF,Werder Bremen,de Bundesliga,24,1995,19.1,24,14,17,6,1,15,31,48.4,16,22,9,13,29,53,94,1,Matches
2672,Miguel Veloso,pt POR,MF,Hellas Verona,it Serie A,34,1986,14.6,24,17,10,10,4,12,34,35.3,22,12,1,11,12,36,25,0,Matches
2673,Joël Veltman,nl NED,DF,Brighton,eng Premier League,28,1992,25.3,67,33,34,25,8,29,57,50.9,28,24,5,19,33,100,64,0,Matches
2674,Unai Vencedor Paris,es ESP,MF,Athletic Club,es La Liga,19,2000,18.9,31,21,10,15,6,11,42,26.2,31,17,6,11,18,49,14,0,Matches
2675,Lorenzo Venuti,it ITA,DF,Fiorentina,it Serie A,25,1995,19.5,24,11,14,7,3,14,28,50.0,14,18,3,15,17,41,24,0,Matches
2676,Daniele Verde,it ITA,FW,Spezia,it Serie A,24,1996,10.9,5,4,2,2,1,4,10,40.0,6,5,0,5,9,14,7,0,Matches
2677,Simone Verdi,it ITA,"MF,FW",Torino,it Serie A,28,1992,18.0,19,12,10,6,3,6,19,31.6,13,8,0,8,8,27,2,2,Matches
2678,Gonzalo Verdú,es ESP,DF,Elche,es La Liga,31,1988,32.7,34,19,26,8,0,16,28,57.1,12,40,30,10,52,86,113,0,Matches
2679,Jordan Veretout,fr FRA,MF,Roma,it Serie A,27,1993,22.8,20,12,8,12,0,9,33,27.3,24,14,3,11,14,34,21,3,Matches
2680,Edoardo Vergani,it ITA,FW,Bologna,it Serie A,19,2001,0.1,0,0,0,0,0,0,0,,0,0,0,0,0,0,0,0,Matches
2681,Marco Verratti,it ITA,MF,Paris S-G,fr Ligue 1,27,1992,16.6,53,30,17,25,11,24,72,33.3,48,22,5,17,26,79,4,1,Matches
2682,Valerio Verre,it ITA,"FW,MF",Sampdoria,it Serie A,26,1994,11.1,11,7,2,7,2,4,19,21.1,15,14,2,12,9,20,3,0,Matches
2683,Mikel Vesga,es ESP,MF,Athletic Club,es La Liga,27,1993,19.1,28,14,8,16,4,12,50,24.0,38,28,8,20,27,55,35,1,Matches
2684,Jannik Vestergaard,dk DEN,DF,Southampton,eng Premier League,27,1992,28.6,50,31,31,15,4,35,52,67.3,17,29,16,13,42,92,122,0,Matches
2685,Rúben Vezo,pt POR,DF,Levante,es La Liga,26,1994,25.7,34,19,26,7,1,12,29,41.4,17,22,11,11,46,80,106,3,Matches
2686,Guglielmo Vicario,it ITA,GK,Cagliari,it Serie A,23,1996,4.0,0,0,0,0,0,0,0,,0,0,0,0,0,0,1,0,Matches
2687,Iñigo Vicente,es ESP,"FW,MF",Athletic Club,es La Liga,22,1998,0.6,1,1,1,0,0,1,1,100.0,0,0,0,0,0,1,0,0,Matches
2688,Fede Vico,es ESP,"MF,FW",Granada,es La Liga,26,1994,8.5,10,6,5,5,0,3,10,30.0,7,15,1,14,12,22,5,0,Matches
2689,Aleix Vidal,es ESP,DF,Sevilla,es La Liga,30,1989,6.6,9,5,5,3,1,5,12,41.7,7,10,1,9,12,21,9,0,Matches
2690,Arturo Vidal,cl CHI,MF,Inter,it Serie A,33,1987,12.6,27,14,8,13,6,12,41,29.3,29,23,3,20,29,56,11,0,Matches
2691,Clément Vidal,fr FRA,DF,Montpellier,fr Ligue 1,20,2000,1.0,2,1,1,1,0,2,4,50.0,2,4,4,0,1,3,6,1,Matches
2692,Nacho Vidal,es ESP,DF,Osasuna,es La Liga,25,1995,26.1,56,28,27,22,7,22,31,71.0,9,39,10,29,43,99,68,0,Matches
2693,Ronaldo Vieira,eng ENG,"MF,DF",Hellas Verona,it Serie A,22,1998,2.5,5,3,1,3,1,0,2,0.0,2,4,3,1,0,5,2,0,Matches
2694,Luca Vignali,it ITA,DF,Spezia,it Serie A,24,1996,17.7,19,9,10,6,3,7,25,28.0,18,13,5,8,22,41,25,0,Matches
2695,Emanuel Vignato,it ITA,"FW,MF",Bologna,it Serie A,19,2000,13.4,18,9,9,6,3,3,15,20.0,12,6,1,5,10,28,7,0,Matches
2696,Toni Villa,es ESP,"MF,FW",Valladolid,es La Liga,25,1995,10.8,31,16,11,14,6,15,42,35.7,27,15,1,14,5,36,3,0,Matches
2697,Asier Villalibre,es ESP,FW,Athletic Club,es La Liga,22,1997,17.7,3,2,0,2,1,2,8,25.0,6,4,0,4,2,5,16,0,Matches
2698,Gonzalo Villar,es ESP,MF,Roma,it Serie A,22,1998,20.7,44,18,14,24,6,18,61,29.5,43,25,3,22,22,66,14,1,Matches
2699,Iván Villar,es ESP,GK,Celta Vigo,es La Liga,23,1997,19.8,0,0,0,0,0,0,1,0.0,1,0,0,0,0,0,18,0,Matches
2700,Rúben Vinagre,pt POR,"MF,DF",Wolves,eng Premier League,21,1999,1.9,7,5,5,2,0,3,4,75.0,1,3,0,3,2,9,4,0,Matches
2701,Carlos Vinícius,br BRA,FW,Tottenham,eng Premier League,25,1995,3.4,3,1,2,1,0,1,1,100.0,0,0,0,0,2,5,5,0,Matches
2702,Nicolas Viola,it ITA,MF,Benevento,it Serie A,30,1989,11.5,16,9,2,11,3,6,28,21.4,22,10,3,7,9,25,7,0,Matches
2703,João Virgínia,pt POR,GK,Everton,eng Premier League,20,1999,0.5,0,0,0,0,0,0,0,,0,0,0,0,0,0,0,0,Matches
2704,Vitinha,pt POR,MF,Wolves,eng Premier League,20,2000,5.8,7,3,2,5,0,3,8,37.5,5,3,0,3,3,10,1,0,Matches
2705,Vitolo,es ESP,"MF,FW",Atlético Madrid,es La Liga,30,1989,3.3,4,1,2,0,2,1,6,16.7,5,3,0,3,3,7,2,0,Matches
2706,Dušan Vlahović,rs SRB,FW,Fiorentina,it Serie A,20,2000,32.5,13,4,3,4,6,5,16,31.3,11,16,2,14,4,17,15,0,Matches
2707,Michel Vlap,nl NED,"MF,FW",Arminia,de Bundesliga,23,1997,4.1,1,1,0,1,0,0,8,0.0,8,4,0,4,5,6,3,0,Matches
2708,Andreas Voglsammer,de GER,"FW,MF",Arminia,de Bundesliga,28,1992,11.1,12,8,6,6,0,8,17,47.1,9,11,0,11,3,15,11,0,Matches
2709,Kevin Vogt,de GER,DF,Hoffenheim,de Bundesliga,28,1991,20.5,18,12,11,6,1,12,21,57.1,9,21,12,9,16,34,71,0,Matches
2710,Mërgim Vojvoda,xk KVX,"DF,FW",Torino,it Serie A,25,1995,15.1,24,14,18,5,1,12,22,54.5,10,19,4,15,18,42,35,1,Matches
2711,Jake Vokins,eng ENG,DF,Southampton,eng Premier League,20,2000,0.7,0,0,0,0,0,0,1,0.0,1,0,0,0,0,0,0,0,Matches
2712,Kevin Volland,de GER,"FW,MF",Monaco,fr Ligue 1,28,1992,30.8,33,16,11,19,3,8,34,23.5,26,23,0,23,4,37,4,0,Matches
2713,Stefan de Vrij,nl NED,DF,Inter,it Serie A,28,1992,30.4,28,16,15,12,1,15,24,62.5,9,24,18,6,41,69,95,0,Matches
2714,Giacomo Vrioni,al ALB,FW,Juventus,it Serie A,21,1998,0.0,0,0,0,0,0,0,0,,0,0,0,0,0,0,0,0,Matches
2715,Šime Vrsaljko,hr CRO,"FW,DF",Atlético Madrid,es La Liga,28,1992,5.8,18,12,13,5,0,8,12,66.7,4,5,0,5,8,26,14,0,Matches
2716,Nikola Vukčević,me MNE,MF,Levante,es La Liga,28,1991,9.0,14,7,5,8,1,9,18,50.0,9,8,5,3,8,22,12,1,Matches
2717,Miloš Vulić,rs SRB,MF,Crotone,it Serie A,23,1996,14.5,15,8,9,1,5,8,21,38.1,13,10,1,9,8,23,8,0,Matches
2718,Matěj Vydra,cz CZE,FW,Burnley,eng Premier League,28,1992,15.2,9,5,2,4,3,1,8,12.5,7,8,1,7,6,15,5,0,Matches
2719,Franklin Wadja,cm CMR,"MF,FW",Lorient,fr Ligue 1,25,1995,0.4,4,2,0,2,2,2,2,100.0,0,0,0,0,2,6,1,0,Matches
2720,Elye Wahi,fr FRA,FW,Montpellier,fr Ligue 1,17,2003,6.2,4,3,2,1,1,1,6,16.7,5,4,0,4,2,6,5,0,Matches
2721,Walace,br BRA,MF,Udinese,it Serie A,25,1995,22.8,50,23,28,19,3,21,60,35.0,39,36,3,33,34,84,23,0,Matches
2722,Theo Walcott,eng ENG,"MF,FW",Southampton,eng Premier League,31,1989,18.0,23,11,8,9,6,11,32,34.4,21,16,0,16,14,37,5,0,Matches
2723,Theo Walcott,eng ENG,FW,Everton,eng Premier League,31,1989,0.1,0,0,0,0,0,0,0,,0,0,0,0,0,0,0,0,Matches
2724,Kyle Walker,eng ENG,DF,Manchester City,eng Premier League,30,1990,21.6,29,19,15,12,2,16,24,66.7,8,19,7,12,14,43,28,0,Matches
2725,Kyle Walker-Peters,eng ENG,DF,Southampton,eng Premier League,23,1997,29.4,83,53,56,25,2,34,57,59.6,23,41,10,31,38,121,66,2,Matches
2726,Sebastian Walukiewicz,pl POL,DF,Cagliari,it Serie A,20,2000,18.0,27,19,11,13,3,12,30,40.0,18,22,14,8,36,63,60,0,Matches
2727,Aaron Wan-Bissaka,eng ENG,DF,Manchester Utd,eng Premier League,22,1997,34.0,88,54,53,29,6,32,45,71.1,13,65,17,48,62,150,84,2,Matches
2728,Joel Ward,eng ENG,DF,Crystal Palace,eng Premier League,30,1989,25.1,43,25,29,14,0,24,42,57.1,18,27,8,19,41,84,87,2,Matches
2729,James Ward-Prowse,eng ENG,MF,Southampton,eng Premier League,25,1994,38.0,75,49,30,41,4,29,70,41.4,41,36,4,32,42,117,60,0,Matches
2730,Daniel Wass,dk DEN,"MF,DF",Valencia,es La Liga,31,1989,33.1,52,31,21,29,2,22,55,40.0,33,33,13,20,47,99,69,0,Matches
2731,Ollie Watkins,eng ENG,FW,Aston Villa,eng Premier League,24,1995,37.0,29,17,5,16,8,10,33,30.3,23,21,2,19,7,36,24,0,Matches
2732,Caleb Watts,au AUS,MF,Southampton,eng Premier League,18,2002,0.4,2,1,2,0,0,1,2,50.0,1,0,0,0,0,2,0,0,Matches
2733,Timothy Weah,us USA,"FW,MF",Lille,fr Ligue 1,20,2000,9.8,15,7,3,9,3,7,14,50.0,7,7,0,7,4,19,5,0,Matches
2734,Adam Webster,eng ENG,DF,Brighton,eng Premier League,25,1995,28.8,29,16,15,10,4,12,25,48.0,13,29,16,13,47,76,92,3,Matches
2735,Wout Weghorst,nl NED,FW,Wolfsburg,de Bundesliga,27,1992,32.7,13,8,2,8,3,4,20,20.0,16,17,3,14,4,17,26,0,Matches
2736,Mitchell Weiser,de GER,DF,Leverkusen,de Bundesliga,26,1994,2.5,4,1,1,2,1,2,4,50.0,2,1,0,1,3,7,4,0,Matches
2737,Shon Weissman,il ISR,FW,Valladolid,es La Liga,24,1996,23.7,12,9,4,5,3,2,23,8.7,21,17,3,14,8,20,7,0,Matches
2738,Danny Welbeck,eng ENG,FW,Brighton,eng Premier League,29,1990,17.2,12,6,2,6,4,7,19,36.8,12,17,0,17,7,19,13,0,Matches
2739,Wendell,br BRA,DF,Leverkusen,de Bundesliga,27,1993,16.2,53,35,27,18,8,23,49,46.9,26,26,3,23,25,78,39,1,Matches
2740,Oscar Wendt,se SWE,DF,Gladbach,de Bundesliga,34,1985,13.9,12,6,2,9,1,4,12,33.3,8,18,4,14,14,26,23,0,Matches
2741,Timo Werner,de GER,"FW,MF",Chelsea,eng Premier League,24,1996,28.9,20,9,6,11,3,7,43,16.3,36,23,1,22,8,28,8,0,Matches
2742,Ashley Westwood,eng ENG,MF,Burnley,eng Premier League,30,1990,37.9,23,15,6,12,5,10,42,23.8,32,26,9,17,44,67,33,0,Matches
2743,Ben White,eng ENG,"DF,MF",Brighton,eng Premier League,22,1997,35.5,49,26,21,24,4,24,57,42.1,33,46,22,24,62,111,56,0,Matches
2744,Georginio Wijnaldum,nl NED,MF,Liverpool,eng Premier League,29,1990,32.7,23,7,6,14,3,7,31,22.6,24,18,3,15,26,49,18,1,Matches
2745,William,br BRA,"MF,FW",Wolfsburg,de Bundesliga,25,1995,0.0,0,0,0,0,0,0,0,,0,0,0,0,0,0,0,0,Matches
2746,William,br BRA,"DF,FW",Schalke 04,de Bundesliga,25,1995,5.3,14,10,10,4,0,5,15,33.3,10,16,5,11,11,25,15,1,Matches
2747,Brandon Williams,eng ENG,DF,Manchester Utd,eng Premier League,19,2000,2.1,0,0,0,0,0,0,1,0.0,1,1,0,1,1,1,7,0,Matches
2748,Iñaki Williams,gh GHA,FW,Athletic Club,es La Liga,26,1994,26.5,11,7,0,4,7,2,14,14.3,12,13,1,12,5,16,22,0,Matches
2749,Neco Williams,wls WAL,DF,Liverpool,eng Premier League,19,2001,2.8,6,5,4,2,0,5,9,55.6,4,3,1,2,6,12,6,0,Matches
2750,Nico Williams,es ESP,MF,Athletic Club,es La Liga,18,2002,0.6,1,0,1,0,0,0,2,0.0,2,0,0,0,1,2,0,0,Matches
2751,Rhys Williams,eng ENG,DF,Liverpool,eng Premier League,19,2001,7.3,6,4,3,3,0,3,3,100.0,0,4,3,1,6,12,27,1,Matches
2752,Willian,br BRA,FW,Arsenal,eng Premier League,31,1988,15.6,13,7,6,6,1,6,16,37.5,10,13,0,13,8,21,8,0,Matches
2753,Joe Willock,eng ENG,MF,Arsenal,eng Premier League,20,1999,2.6,6,3,1,4,1,3,7,42.9,4,6,1,5,3,9,0,0,Matches
2754,Joe Willock,eng ENG,MF,Newcastle Utd,eng Premier League,20,1999,10.9,26,13,16,7,3,9,42,21.4,33,21,3,18,17,43,15,1,Matches
2755,Callum Wilson,eng ENG,FW,Newcastle Utd,eng Premier League,28,1992,23.2,12,5,1,6,5,2,12,16.7,10,10,3,7,7,19,14,0,Matches
2756,Marten Winkler,de GER,FW,Hertha BSC,de Bundesliga,17,2002,0.0,0,0,0,0,0,0,0,,0,0,0,0,0,0,0,0,Matches
2757,Harry Winks,eng ENG,MF,Tottenham,eng Premier League,24,1996,9.6,16,9,11,5,0,5,20,25.0,15,16,4,12,11,27,12,1,Matches
2758,Florian Wirtz,de GER,MF,Leverkusen,de Bundesliga,17,2003,24.7,35,18,8,22,5,11,37,29.7,26,27,1,26,9,44,8,0,Matches
2759,Yoane Wissa,cd COD,"MF,FW",Lorient,fr Ligue 1,23,1996,29.7,35,20,12,14,9,11,34,32.4,23,25,3,22,20,55,14,0,Matches
2760,Axel Witsel,be BEL,MF,Dortmund,de Bundesliga,31,1989,12.6,18,12,6,11,1,8,16,50.0,8,13,3,10,22,40,13,0,Matches
2761,Hannes Wolf,at AUT,"MF,FW",Gladbach,de Bundesliga,21,1999,15.3,26,13,8,10,8,8,36,22.2,28,18,1,17,9,35,4,0,Matches
2762,Marius Wolf,de GER,"MF,DF",Köln,de Bundesliga,25,1995,28.3,35,19,19,13,3,13,38,34.2,25,29,3,26,28,63,47,1,Matches
2763,Nick Woltemade,de GER,"MF,FW",Werder Bremen,de Bundesliga,18,2002,1.6,3,2,1,1,1,2,4,50.0,2,1,0,1,0,3,0,0,Matches
2764,Jeong Woo-yeong,kr KOR,"FW,MF",Freiburg,de Bundesliga,20,1999,9.1,9,5,1,6,2,2,11,18.2,9,8,1,7,11,20,11,0,Matches
2765,Chris Wood,nz NZL,FW,Burnley,eng Premier League,28,1991,30.5,12,7,2,4,6,5,18,27.8,13,14,3,11,1,13,21,0,Matches
2766,Joscha Wosz,de GER,DF,RB Leipzig,de Bundesliga,18,2002,0.4,1,1,1,0,0,0,0,,0,1,0,1,1,2,0,0,Matches
2767,Xeka,pt POR,MF,Lille,fr Ligue 1,25,1994,13.3,33,17,14,15,4,16,43,37.2,27,14,2,12,20,53,18,0,Matches
2768,Granit Xhaka,ch SUI,"MF,DF",Arsenal,eng Premier League,27,1992,28.0,50,26,18,17,15,30,58,51.7,28,23,7,16,24,74,38,3,Matches
2769,Reinhold Yabo,de GER,"MF,FW",Arminia,de Bundesliga,28,1992,7.2,5,2,2,2,1,2,9,22.2,7,6,1,5,4,9,1,0,Matches
2770,Jawad El Yamiq,ma MAR,DF,Valladolid,es La Liga,28,1992,15.3,21,14,14,7,0,8,11,72.7,3,15,10,5,46,67,100,0,Matches
2771,Rubén Yáñez,es ESP,GK,Getafe,es La Liga,26,1993,10.0,0,0,0,0,0,0,1,0.0,1,0,0,0,2,2,2,0,Matches
2772,Andriy Yarmolenko,ua UKR,"FW,MF",West Ham,eng Premier League,30,1989,4.2,5,4,2,2,1,2,8,25.0,6,1,0,1,1,6,2,0,Matches
2773,Yusuf Yazıcı,tr TUR,"FW,MF",Lille,fr Ligue 1,23,1997,12.1,12,5,6,2,4,1,24,4.2,23,5,1,4,2,14,2,0,Matches
2774,DeAndre Yedlin,us USA,DF,Newcastle Utd,eng Premier League,27,1993,4.8,9,4,8,1,0,4,10,40.0,6,5,1,4,7,16,17,0,Matches
2775,Burak Yılmaz,tr TUR,FW,Lille,fr Ligue 1,35,1985,22.8,13,6,3,7,3,4,30,13.3,26,7,0,7,5,18,22,0,Matches
2776,Yoel,es ESP,GK,Eibar,es La Liga,31,1988,3.3,0,0,0,0,0,0,0,,0,0,0,0,0,0,2,0,Matches
2777,Okay Yokuşlu,tr TUR,MF,West Brom,eng Premier League,26,1994,14.6,38,25,21,13,4,17,35,48.6,18,15,3,12,35,73,33,1,Matches
2778,Okay Yokuşlu,tr TUR,MF,Celta Vigo,es La Liga,26,1994,5.1,14,8,8,4,2,5,9,55.6,4,5,2,3,10,24,9,0,Matches
2779,Maya Yoshida,jp JPN,DF,Sampdoria,it Serie A,31,1988,25.3,17,4,10,7,0,7,13,53.8,6,45,34,11,57,74,93,1,Matches
2780,Amin Younes,de GER,MF,Eint Frankfurt,de Bundesliga,26,1993,15.5,25,14,8,10,7,6,32,18.8,26,19,1,18,13,38,4,0,Matches
2781,Ashley Young,eng ENG,DF,Inter,it Serie A,35,1985,15.8,15,7,8,4,3,3,13,23.1,10,13,0,13,6,21,31,0,Matches
2782,Wilitty Younoussa,cm CMR,MF,Dijon,fr Ligue 1,18,2001,0.9,6,3,3,3,0,3,7,42.9,4,3,0,3,2,8,0,0,Matches
2783,Zaydou Youssouf,fr FRA,MF,Saint-Étienne,fr Ligue 1,21,1999,13.7,30,15,19,10,1,16,40,40.0,24,15,0,15,25,55,12,1,Matches
2784,Mattia Zaccagni,it ITA,MF,Hellas Verona,it Serie A,25,1995,29.0,27,13,8,11,8,8,25,32.0,17,28,4,24,27,54,13,1,Matches
2785,Dan-Axel Zagadou,fr FRA,DF,Dortmund,de Bundesliga,21,1999,3.1,2,2,2,0,0,0,0,,0,3,2,1,6,8,13,0,Matches
2786,Vasilios Zagaritis,gr GRE,DF,Parma,it Serie A,19,2001,0.7,0,0,0,0,0,0,0,,0,1,0,1,0,0,0,0,Matches
2787,Arthur Zagre,fr FRA,"DF,MF",Dijon,fr Ligue 1,18,2001,1.4,3,1,2,1,0,2,2,100.0,0,1,1,0,3,6,1,0,Matches
2788,Wilfried Zaha,ci CIV,FW,Crystal Palace,eng Premier League,27,1992,29.0,26,18,8,15,3,11,30,36.7,19,21,0,21,9,35,4,0,Matches
2789,Miha Zajc,si SVN,MF,Genoa,it Serie A,26,1994,20.7,22,14,9,10,3,13,39,33.3,26,30,4,26,27,49,19,0,Matches
2790,Denis Zakaria,ch SUI,"MF,DF",Gladbach,de Bundesliga,23,1996,15.8,30,15,12,15,3,11,20,55.0,9,20,7,13,23,53,29,1,Matches
2791,Joseba Zaldúa,es ESP,DF,Real Sociedad,es La Liga,28,1992,7.1,15,12,7,5,3,6,18,33.3,12,6,2,4,6,21,13,0,Matches
2792,Nicola Zalewski,pl POL,MF,Roma,it Serie A,18,2002,0.1,1,1,0,1,0,1,1,100.0,0,0,0,0,0,1,0,0,Matches
2793,Andre-Frank Zambo Anguissa,cm CMR,MF,Fulham,eng Premier League,24,1995,28.7,78,37,27,38,13,27,68,39.7,41,35,6,29,56,134,17,2,Matches
2794,Niccolò Zanellato,it ITA,MF,Crotone,it Serie A,22,1998,18.2,24,14,16,6,2,13,36,36.1,23,19,5,14,16,40,12,2,Matches
2795,Cristián Zapata,co COL,DF,Genoa,it Serie A,33,1986,10.8,18,12,11,7,0,10,14,71.4,4,15,11,4,15,33,56,0,Matches
2796,Duván Zapata,co COL,FW,Atalanta,it Serie A,29,1991,26.4,12,5,2,3,7,4,13,30.8,9,19,5,14,6,18,19,0,Matches
2797,Gabriele Zappa,it ITA,DF,Cagliari,it Serie A,20,1999,26.6,34,17,16,15,3,22,49,44.9,27,36,4,32,24,58,50,0,Matches
2798,Davide Zappacosta,it ITA,DF,Genoa,it Serie A,28,1992,22.7,33,16,15,13,5,15,30,50.0,15,17,1,16,18,51,41,0,Matches
2799,Oier Zarraga,es ESP,MF,Athletic Club,es La Liga,21,1999,1.1,1,1,0,1,0,1,2,50.0,1,1,0,1,0,1,0,0,Matches
2800,Simone Zaza,it ITA,FW,Torino,it Serie A,29,1991,16.6,15,9,4,6,5,6,20,30.0,14,14,0,14,3,18,5,1,Matches
2801,Deyovaisio Zeefuik,nl NED,"DF,FW",Hertha BSC,de Bundesliga,22,1998,10.1,13,9,8,3,2,8,19,42.1,11,15,3,12,12,25,36,0,Matches
2802,Marvin Zeegelaar,nl NED,DF,Udinese,it Serie A,29,1990,19.3,40,18,23,16,1,20,39,51.3,19,21,9,12,24,64,43,0,Matches
2803,Arber Zeneli,xk KVX,"MF,FW",Reims,fr Ligue 1,25,1995,14.3,20,10,11,1,8,8,22,36.4,14,12,1,11,3,23,8,0,Matches
2804,Robin Zentner,de GER,GK,Mainz 05,de Bundesliga,25,1994,31.0,1,1,1,0,0,1,3,33.3,2,0,0,0,3,4,9,2,Matches
2805,Andi Zeqiri,ch SUI,"FW,DF",Brighton,eng Premier League,21,1999,1.9,3,2,0,2,1,1,2,50.0,1,1,0,1,0,3,2,0,Matches
2806,Mehdi Zerkane,dz ALG,"MF,FW",Bordeaux,fr Ligue 1,21,1999,13.2,23,15,7,10,6,5,18,27.8,13,15,2,13,9,32,5,0,Matches
2807,Ron-Robert Zieler,de GER,GK,Köln,de Bundesliga,31,1989,0.6,0,0,0,0,0,0,0,,0,0,0,0,0,0,0,0,Matches
2808,Piotr Zieliński,pl POL,MF,Napoli,it Serie A,26,1994,28.0,18,10,8,7,3,7,20,35.0,13,23,4,19,18,36,12,0,Matches
2809,Oleksandr Zinchenko,ua UKR,DF,Manchester City,eng Premier League,23,1996,16.4,25,15,12,9,4,14,24,58.3,10,17,4,13,23,48,28,0,Matches
2810,Joshua Zirkzee,nl NED,"FW,MF",Parma,it Serie A,19,2001,1.3,2,2,1,1,0,1,3,33.3,2,1,1,0,0,2,1,0,Matches
2811,Joshua Zirkzee,nl NED,FW,Bayern Munich,de Bundesliga,19,2001,1.0,1,0,0,1,0,1,2,50.0,1,0,0,0,0,1,0,0,Matches
2812,Hakim Ziyech,ma MAR,"MF,FW",Chelsea,eng Premier League,27,1993,13.0,14,10,5,7,2,5,19,26.3,14,9,1,8,10,24,2,0,Matches
2813,Jeroen Zoet,nl NED,GK,Spezia,it Serie A,29,1991,6.7,0,0,0,0,0,0,1,0.0,1,0,0,0,0,0,4,2,Matches
2814,Kévin Zohi,ml MLI,"FW,MF",Strasbourg,fr Ligue 1,23,1996,4.8,9,5,3,4,2,2,6,33.3,4,6,0,6,6,15,3,0,Matches
2815,Kurt Zouma,fr FRA,DF,Chelsea,eng Premier League,25,1994,22.5,16,10,8,6,2,4,8,50.0,4,13,9,4,28,44,93,0,Matches
2816,Igor Zubeldia,es ESP,DF,Real Sociedad,es La Liga,23,1997,21.8,23,16,15,8,0,8,14,57.1,6,20,13,7,12,35,46,0,Matches
2817,Steven Zuber,ch SUI,"DF,MF",Eint Frankfurt,de Bundesliga,28,1991,6.5,24,12,8,13,3,8,16,50.0,8,4,1,3,4,28,1,0,Matches
2818,Martín Zubimendi,es ESP,MF,Real Sociedad,es La Liga,21,1999,20.9,41,22,18,20,3,20,34,58.8,14,22,10,12,40,81,39,0,Matches
2819,Martin Ødegaard,no NOR,MF,Arsenal,eng Premier League,21,1998,9.6,9,3,2,6,1,4,14,28.6,10,2,0,2,2,11,5,0,Matches
2820,Martin Ødegaard,no NOR,MF,Real Madrid,es La Liga,21,1998,2.6,1,0,0,1,0,1,2,50.0,1,1,0,1,1,2,0,0,Matches
2821,Filip Đuričić,rs SRB,"MF,FW",Sassuolo,it Serie A,28,1992,23.1,32,23,6,16,10,12,30,40.0,18,20,2,18,9,41,12,0,Matches
