,Player,Nation,Pos,Squad,Comp,Age,Born,90s,Tackles,Tackles_Won,Tackles_Def_3rd,Tackles_Mid_3rd,Tackles_Att_3rd,Dribblers_Tackled,Dribblers_Challenged,Dribblers_Tackle_W%,Dribblers_Tackle_Lost,Blocks,Shots_Blocked,Passes_Blocked,Interceptions,Tackles+Interceptions,Clearances,Errors_Shots,Matches
0,Ismael Aaneba,fr FRA,DF,Strasbourg,fr Ligue 1,19,1999,2.3,12,6,7,5,0,5,10,50.0,5,5,0,5,8,20,9,0,Matches
1,Patrick van Aanholt,nl NED,DF,Crystal Palace,eng Premier League,27,1990,35.5,48,24,35,11,2,24,40,60.0,16,33,9,24,40,88,91,2,Matches
2,Ignazio Abate,it ITA,DF,Milan,it Serie A,31,1986,14.5,34,19,16,13,5,14,22,63.6,8,19,6,13,18,52,50,0,Matches
3,Issah Abbas,gh GHA,FW,Mainz 05,de Bundesliga,19,1998,0.1,0,0,0,0,0,0,0,,0,0,0,0,0,0,0,0,Matches
4,Yunis Abdelhamid,ma MAR,DF,Reims,fr Ligue 1,30,1987,38.0,60,33,48,11,1,30,40,75.0,10,44,24,20,65,125,196,0,Matches
5,Mehdi Abeid,dz ALG,MF,Dijon,fr Ligue 1,25,1992,22.5,51,33,27,16,8,15,45,33.3,30,33,7,26,29,80,23,1,Matches
6,Charles Abi,fr FRA,"DF,FW",Saint-Étienne,fr Ligue 1,18,2000,0.4,4,4,2,1,1,2,2,100.0,0,1,0,1,0,4,1,0,Matches
7,David Abraham,ar ARG,DF,Eint Frankfurt,de Bundesliga,32,1986,15.8,22,14,13,8,1,11,25,44.0,14,23,12,11,24,46,64,0,Matches
8,Amir Abrashi,al ALB,MF,Freiburg,de Bundesliga,28,1990,8.8,20,11,7,10,3,6,19,31.6,13,11,3,8,14,34,15,0,Matches
9,Francesco Acerbi,it ITA,DF,Lazio,it Serie A,30,1988,36.8,40,30,22,13,5,12,16,75.0,4,50,32,18,61,101,169,1,Matches
10,Afriyie Acquah,gh GHA,MF,Empoli,it Serie A,26,1992,16.8,27,9,9,12,6,4,11,36.4,7,11,1,10,12,39,16,0,Matches
11,Tyler Adams,us USA,MF,RB Leipzig,de Bundesliga,19,1999,8.0,29,17,12,16,1,11,26,42.3,15,17,1,16,16,45,8,0,Matches
12,Antonio Adán,es ESP,GK,Atlético Madrid,es La Liga,31,1987,1.0,0,0,0,0,0,0,0,,0,0,0,0,0,0,0,0,Matches
13,Aday,es ESP,"DF,MF",Girona,es La Liga,30,1987,7.2,9,8,2,5,2,6,7,85.7,1,1,0,1,7,16,17,1,Matches
14,Khaled Adénon,bj BEN,DF,Amiens,fr Ligue 1,33,1985,22.2,31,22,20,11,0,16,28,57.1,12,26,11,15,31,62,101,0,Matches
15,Claud Adjapong,it ITA,"MF,FW",Sassuolo,it Serie A,20,1998,3.0,4,2,1,3,0,1,2,50.0,1,3,1,2,1,5,4,0,Matches
16,Yacine Adli,fr FRA,MF,Bordeaux,fr Ligue 1,18,2000,2.4,7,2,2,3,2,3,9,33.3,6,3,0,3,2,9,0,0,Matches
17,Ali Adnan Kadhim,iq IRQ,DF,Atalanta,it Serie A,24,1993,1.8,1,1,1,0,0,1,2,50.0,1,1,1,0,3,4,6,0,Matches
18,Aritz Aduriz,es ESP,FW,Athletic Club,es La Liga,37,1981,10.5,4,2,1,1,2,1,7,14.3,6,2,1,1,0,4,4,0,Matches
19,Luis Advíncula,pe PER,DF,Rayo Vallecano,es La Liga,28,1990,26.5,52,38,38,12,2,21,31,67.7,10,22,2,20,19,71,60,1,Matches
20,Martin Agirregabiria,es ESP,DF,Alavés,es La Liga,22,1996,22.6,45,29,32,10,3,28,46,60.9,18,33,11,22,27,72,65,1,Matches
21,Nayef Aguerd,ma MAR,DF,Dijon,fr Ligue 1,22,1996,11.7,17,12,8,9,0,8,19,42.1,11,20,11,9,14,31,59,1,Matches
22,Sergio Agüero,ar ARG,FW,Manchester City,eng Premier League,30,1988,27.3,17,9,1,10,6,5,9,55.6,4,15,1,14,9,26,3,0,Matches
23,Ruben Aguilar,fr FRA,DF,Montpellier,fr Ligue 1,25,1993,28.1,88,51,40,33,15,39,69,56.5,30,23,3,20,37,125,50,1,Matches
24,Juan Aguilera,es ESP,MF,Huesca,es La Liga,32,1985,3.8,2,2,0,1,1,1,4,25.0,3,4,2,2,4,6,2,0,Matches
25,Emmanuel Agyemang-Badu,gh GHA,MF,Udinese,it Serie A,27,1990,1.8,4,0,1,2,1,1,1,100.0,0,2,0,2,1,5,2,0,Matches
26,Jean-Eudes Aholou,ci CIV,MF,Monaco,fr Ligue 1,24,1994,11.9,20,11,6,11,3,8,16,50.0,8,7,0,7,17,37,12,0,Matches
27,Antonis Aidonis,de GER,DF,Stuttgart,de Bundesliga,17,2001,0.9,3,1,1,1,1,1,4,25.0,3,1,0,1,2,5,2,0,Matches
28,Ola Aina,ng NGA,DF,Torino,it Serie A,21,1996,24.0,54,36,32,20,2,23,48,47.9,25,30,3,27,39,93,59,2,Matches
29,Youssef Aït Bennasser,ma MAR,MF,Saint-Étienne,fr Ligue 1,22,1996,10.4,25,13,9,12,4,13,28,46.4,15,15,2,13,19,44,6,2,Matches
30,Youssef Aït Bennasser,ma MAR,MF,Monaco,fr Ligue 1,22,1996,11.9,33,16,14,18,1,13,29,44.8,16,15,5,10,15,48,19,0,Matches
31,Rayan Aït Nouri,dz ALG,"DF,MF",Angers,fr Ligue 1,17,2001,0.6,2,2,1,1,0,0,1,0.0,1,0,0,0,0,2,1,0,Matches
32,Ludovic Ajorque,fr FRA,FW,Strasbourg,fr Ligue 1,24,1994,17.0,17,13,1,10,6,4,9,44.4,5,5,0,5,5,22,9,0,Matches
33,Manuel Akanji,ch SUI,DF,Dortmund,de Bundesliga,23,1995,24.5,29,19,14,13,2,14,25,56.0,11,22,13,9,27,56,92,2,Matches
34,Carlos Akapo,gq EQG,DF,Huesca,es La Liga,25,1993,11.4,28,15,18,8,2,19,33,57.6,14,12,2,10,23,51,36,0,Matches
35,Nathan Aké,nl NED,DF,Bournemouth,eng Premier League,23,1995,37.9,66,35,42,21,3,22,35,62.9,13,51,35,16,32,98,241,0,Matches
36,Sergio Akieme,es ESP,DF,Rayo Vallecano,es La Liga,20,1997,2.0,3,3,3,0,0,2,2,100.0,0,0,0,0,1,4,5,0,Matches
37,Chadrac Akolo,cd COD,"MF,FW",Stuttgart,de Bundesliga,23,1995,5.8,9,6,2,7,0,1,3,33.3,2,7,0,7,4,13,1,0,Matches
38,Kevin Akpoguma,ng NGA,DF,Hoffenheim,de Bundesliga,23,1995,5.5,23,15,13,10,0,11,21,52.4,10,18,5,13,12,35,20,2,Matches
39,Kevin Akpoguma,ng NGA,DF,Hannover 96,de Bundesliga,23,1995,3.5,10,6,5,5,0,6,7,85.7,1,7,2,5,10,20,7,2,Matches
40,David Alaba,at AUT,DF,Bayern Munich,de Bundesliga,26,1992,28.1,34,21,13,13,8,17,26,65.4,9,24,3,21,31,65,40,0,Matches
41,Sofiane Alakouch,ma MAR,DF,Nîmes,fr Ligue 1,20,1998,21.1,81,44,44,31,6,36,63,57.1,27,15,4,11,46,127,57,0,Matches
42,Lucas Alario,ar ARG,"FW,MF",Leverkusen,de Bundesliga,25,1992,14.1,15,8,5,6,4,4,14,28.6,10,9,0,9,1,16,16,0,Matches
43,Jordi Alba,es ESP,DF,Barcelona,es La Liga,29,1989,33.2,42,22,20,15,7,20,48,41.7,28,24,6,18,60,102,76,1,Matches
44,Luis Alberto,es ESP,"MF,FW",Lazio,it Serie A,25,1992,22.1,53,22,15,29,9,21,55,38.2,34,23,3,20,10,63,10,0,Matches
45,Raúl Albiol,es ESP,DF,Napoli,it Serie A,32,1985,19.0,16,8,12,4,0,8,15,53.3,7,19,16,3,20,36,90,1,Matches
46,Miiko Albornoz,cl CHI,"DF,MF",Hannover 96,de Bundesliga,27,1990,18.4,46,26,31,10,5,21,45,46.7,24,23,3,20,16,62,37,1,Matches
47,Marc Albrighton,eng ENG,"FW,MF",Leicester City,eng Premier League,28,1989,18.1,35,22,18,14,3,13,31,41.9,18,26,3,23,23,58,30,0,Matches
48,Paco Alcácer,es ESP,FW,Dortmund,de Bundesliga,24,1993,13.5,3,1,2,0,1,0,6,0.0,6,5,0,5,6,9,7,0,Matches
49,Pedro Alcalá,es ESP,DF,Girona,es La Liga,29,1989,20.8,32,23,23,9,0,15,23,65.2,8,21,18,3,36,68,120,0,Matches
50,Thiago Alcántara,es ESP,MF,Bayern Munich,de Bundesliga,27,1991,26.8,87,65,31,44,12,25,48,52.1,23,23,4,19,44,131,17,1,Matches
51,Rubén Alcaraz,es ESP,MF,Valladolid,es La Liga,27,1991,33.1,96,54,50,40,6,32,89,36.0,57,59,10,49,38,134,52,1,Matches
52,Toby Alderweireld,be BEL,DF,Tottenham,eng Premier League,29,1989,32.5,37,23,25,10,2,12,22,54.5,10,41,22,19,24,61,175,0,Matches
53,Álex Alegría,es ESP,"FW,MF",Rayo Vallecano,es La Liga,25,1992,1.6,1,1,0,1,0,0,3,0.0,3,1,0,1,0,1,0,0,Matches
54,Alexis Alegue,fr FRA,FW,Nantes,fr Ligue 1,21,1996,0.1,1,0,0,1,0,0,0,,0,0,0,0,0,1,0,0,Matches
55,Iván Alejo,es ESP,MF,Getafe,es La Liga,23,1995,1.6,2,0,0,2,0,0,4,0.0,4,2,0,2,0,2,3,0,Matches
56,Carles Aleñá,es ESP,MF,Barcelona,es La Liga,20,1998,7.1,7,4,0,6,1,2,8,25.0,6,4,0,4,2,9,0,0,Matches
57,Rúnar Alex Rúnarsson,is ISL,GK,Dijon,fr Ligue 1,23,1995,25.0,2,0,2,0,0,2,6,33.3,4,0,0,0,1,3,7,2,Matches
58,Alexander,ar ARG,FW,Leganés,es La Liga,29,1988,0.1,1,0,1,0,0,1,1,100.0,0,0,0,0,0,1,0,0,Matches
59,Trent Alexander-Arnold,eng ENG,DF,Liverpool,eng Premier League,19,1998,27.4,61,39,31,22,8,36,68,52.9,32,19,3,16,35,96,68,0,Matches
60,Rachid Alioui,ma MAR,FW,Nîmes,fr Ligue 1,26,1992,13.9,15,5,3,9,3,4,9,44.4,5,8,1,7,10,25,11,0,Matches
61,Alisson,br BRA,GK,Liverpool,eng Premier League,25,1992,38.0,2,1,2,0,0,2,2,100.0,0,0,0,0,1,3,14,6,Matches
62,Bobby Allain,fr FRA,GK,Dijon,fr Ligue 1,26,1991,13.0,0,0,0,0,0,0,1,0.0,1,1,0,1,0,0,16,1,Matches
63,Allan,br BRA,MF,Napoli,it Serie A,27,1991,29.1,106,70,39,55,12,36,107,33.6,71,55,13,42,36,142,28,0,Matches
64,Allan,br BRA,MF,Eint Frankfurt,de Bundesliga,21,1997,2.0,4,4,2,2,0,0,4,0.0,4,4,2,2,0,4,1,0,Matches
65,Dele Alli,eng ENG,MF,Tottenham,eng Premier League,22,1996,20.3,33,19,6,14,13,5,24,20.8,19,33,5,28,19,52,20,0,Matches
66,Miguel Almirón,py PAR,MF,Newcastle Utd,eng Premier League,24,1994,8.4,20,12,7,10,3,4,10,40.0,6,14,1,13,8,28,5,0,Matches
67,Júnior Alonso,py PAR,"DF,MF",Celta Vigo,es La Liga,25,1993,6.0,13,9,8,4,1,7,12,58.3,5,8,3,5,5,18,24,1,Matches
68,Marcos Alonso,es ESP,DF,Chelsea,eng Premier League,27,1990,30.7,73,46,44,22,7,33,58,56.9,25,25,2,23,39,112,101,0,Matches
69,Mickaël Alphonse,gp GLP,DF,Dijon,fr Ligue 1,29,1989,6.3,10,5,6,1,3,3,4,75.0,1,3,1,2,9,19,30,0,Matches
70,Sergio Álvarez,es ESP,"DF,MF",Eibar,es La Liga,26,1992,11.9,34,25,12,20,2,13,23,56.5,10,9,4,5,17,51,43,0,Matches
71,Sergio Álvarez,es ESP,GK,Celta Vigo,es La Liga,31,1986,13.0,0,0,0,0,0,0,0,,0,0,0,0,0,0,4,0,Matches
72,Yeray Álvarez,es ESP,DF,Athletic Club,es La Liga,23,1995,29.0,55,30,39,14,2,19,33,57.6,14,35,16,19,63,118,149,1,Matches
73,Bruno Alves,pt POR,DF,Parma,it Serie A,36,1981,32.5,15,8,11,4,0,4,7,57.1,3,36,28,8,29,44,210,0,Matches
74,Dani Alves,br BRA,"MF,DF",Paris S-G,fr Ligue 1,35,1983,18.0,42,22,16,23,3,13,38,34.2,25,18,5,13,8,50,11,0,Matches
75,Alfons Amade,de GER,MF,Hoffenheim,de Bundesliga,18,1999,0.1,1,1,0,1,0,1,2,50.0,1,0,0,0,1,2,0,0,Matches
76,Ibrahim Amadou,fr FRA,"MF,DF",Sevilla,es La Liga,25,1993,8.5,27,20,9,15,3,2,9,22.2,7,7,4,3,11,38,24,0,Matches
77,Romain Amalfitano,fr FRA,"MF,FW",Dijon,fr Ligue 1,28,1989,28.0,52,33,20,28,4,25,67,37.3,42,45,13,32,47,99,35,0,Matches
78,Daniel Amartey,gh GHA,DF,Leicester City,eng Premier League,23,1994,7.1,18,12,11,6,1,10,15,66.7,5,6,4,2,17,35,28,1,Matches
79,Jordi Amat,id IDN,DF,Rayo Vallecano,es La Liga,26,1992,30.7,54,31,34,19,1,24,42,57.1,18,31,10,21,43,97,133,1,Matches
80,Amath,sn SEN,MF,Getafe,es La Liga,22,1996,11.1,20,13,7,11,2,6,27,22.2,21,17,0,17,10,30,12,0,Matches
81,Jordan Amavi,fr FRA,DF,Marseille,fr Ligue 1,24,1994,24.2,74,50,34,26,14,35,56,62.5,21,24,8,16,46,120,93,4,Matches
82,Kelvin Amian,fr FRA,DF,Toulouse,fr Ligue 1,20,1998,32.0,68,45,54,12,2,20,30,66.7,10,36,13,23,36,104,113,1,Matches
83,Nadiem Amiri,de GER,MF,Hoffenheim,de Bundesliga,21,1996,8.4,14,9,8,4,2,3,13,23.1,10,11,0,11,7,21,4,0,Matches
84,Yanis Ammour,fr FRA,MF,Montpellier,fr Ligue 1,19,1999,0.0,0,0,0,0,0,0,0,,0,0,0,0,0,0,0,0,Matches
85,Luke Amos,eng ENG,MF,Tottenham,eng Premier League,21,1997,0.0,1,0,0,1,0,0,0,,0,0,0,0,0,1,0,0,Matches
86,Joachim Andersen,dk DEN,DF,Sampdoria,it Serie A,22,1996,32.0,40,27,31,8,1,19,31,61.3,12,30,15,15,35,75,147,1,Matches
87,Felipe Anderson,br BRA,"MF,FW",West Ham,eng Premier League,25,1993,33.8,89,49,33,44,12,31,101,30.7,70,71,0,71,41,130,18,1,Matches
88,Florin Andone,ro ROU,FW,Brighton,eng Premier League,25,1993,9.8,10,2,3,4,3,1,6,16.7,5,9,1,8,3,13,12,0,Matches
89,Benjamin André,fr FRA,MF,Rennes,fr Ligue 1,27,1990,27.7,101,60,39,50,12,33,85,38.8,52,40,6,34,54,155,58,0,Matches
90,Marco Andreolli,it ITA,DF,Cagliari,it Serie A,32,1986,1.2,1,1,1,0,0,1,1,100.0,0,2,1,1,1,2,5,0,Matches
91,Marco Andreolli,it ITA,DF,Chievo,it Serie A,32,1986,7.2,10,6,7,2,1,6,10,60.0,4,4,2,2,6,16,33,0,Matches
92,Yoann Andreu,fr FRA,DF,Angers,fr Ligue 1,29,1989,0.0,1,0,1,0,0,0,1,0.0,1,0,0,0,1,2,0,0,Matches
93,José Ángel,es ESP,DF,Eibar,es La Liga,28,1989,33.6,66,46,36,23,7,31,56,55.4,25,24,5,19,41,107,113,1,Matches
94,Miguel Ángel Moyá,es ESP,GK,Real Sociedad,es La Liga,34,1984,11.0,1,1,1,0,0,1,2,50.0,1,0,0,0,1,2,9,2,Matches
95,Cristian Ansaldi,ar ARG,"DF,MF",Torino,it Serie A,31,1986,20.1,50,26,19,21,10,15,30,50.0,15,21,4,17,15,65,31,0,Matches
96,Mirco Antenucci,it ITA,FW,SPAL,it Serie A,33,1984,23.7,11,9,5,1,5,1,10,10.0,9,14,0,14,5,16,5,0,Matches
97,Waldemar Anton,de GER,DF,Hannover 96,de Bundesliga,22,1996,34.0,49,32,33,14,2,22,50,44.0,28,56,33,23,69,118,169,3,Matches
98,Luca Antonelli,it ITA,DF,Empoli,it Serie A,31,1987,8.4,13,11,4,5,4,7,17,41.2,10,19,4,15,16,29,25,1,Matches
99,Mauro Antonio Burruchaga,ar ARG,MF,Chievo,it Serie A,20,1998,0.6,2,2,1,1,0,0,2,0.0,2,2,1,1,0,2,3,0,Matches
100,Michail Antonio,jm JAM,"MF,FW",West Ham,eng Premier League,28,1990,23.4,23,14,12,6,5,6,12,50.0,6,38,3,35,18,41,26,1,Matches
101,Antoñito,es ESP,"DF,MF",Valladolid,es La Liga,30,1987,20.7,35,21,16,15,4,18,42,42.9,24,21,8,13,18,53,31,0,Matches
102,Vitorino Antunes,pt POR,"DF,MF",Getafe,es La Liga,31,1987,24.2,41,26,22,17,2,27,45,60.0,18,33,7,26,43,84,75,1,Matches
103,Anuar,ma MAR,"MF,FW",Valladolid,es La Liga,23,1995,12.0,33,19,15,16,2,6,14,42.9,8,14,1,13,11,44,25,1,Matches
104,Dennis Aogo,de GER,MF,Stuttgart,de Bundesliga,31,1987,11.4,15,10,6,7,2,6,15,40.0,9,8,1,7,9,24,19,0,Matches
105,Houssem Aouar,dz ALG,MF,Lyon,fr Ligue 1,20,1998,34.0,63,38,28,25,10,17,61,27.9,44,33,6,27,32,95,25,3,Matches
106,Emmanuel Apeh,ng NGA,"FW,MF",Celta Vigo,es La Liga,21,1996,0.2,0,0,0,0,0,0,1,0.0,1,0,0,0,0,0,0,0,Matches
107,Mauro Arambarri,uy URU,MF,Getafe,es La Liga,22,1995,29.7,59,33,18,37,4,23,76,30.3,53,44,9,35,30,89,36,0,Matches
108,Guilherme Arana,br BRA,DF,Sevilla,es La Liga,21,1997,7.0,11,6,5,5,1,6,7,85.7,1,6,3,3,9,20,8,0,Matches
109,Charles Aránguiz,cl CHI,MF,Leverkusen,de Bundesliga,29,1989,21.0,48,30,21,22,5,21,66,31.8,45,31,2,29,25,73,27,1,Matches
110,Luiz Araújo,br BRA,"FW,MF",Lille,fr Ligue 1,22,1996,8.7,23,17,8,9,6,9,24,37.5,15,6,1,5,3,26,4,0,Matches
111,Néstor Araujo,mx MEX,DF,Celta Vigo,es La Liga,26,1991,29.8,42,22,32,9,1,18,22,81.8,4,32,21,11,35,77,153,1,Matches
112,Anaitz Arbilla,es ESP,DF,Eibar,es La Liga,31,1987,21.7,31,24,25,5,1,17,27,63.0,10,12,5,7,46,77,92,2,Matches
113,Joaquín Ardaiz,uy URU,FW,Frosinone,it Serie A,19,1999,0.2,0,0,0,0,0,0,0,,0,0,0,0,0,0,0,0,Matches
114,Alphonse Areola,fr FRA,GK,Paris S-G,fr Ligue 1,25,1993,21.0,1,1,1,0,0,1,1,100.0,0,0,0,0,0,1,4,1,Matches
115,Santiago Arias,co COL,DF,Atlético Madrid,es La Liga,26,1992,19.7,48,32,31,16,1,20,31,64.5,11,14,2,12,34,82,43,0,Matches
116,Lorenzo Ariaudo,it ITA,DF,Frosinone,it Serie A,29,1989,18.7,20,14,15,4,1,6,10,60.0,4,31,20,11,14,34,103,0,Matches
117,Nicolò Armini,it ITA,DF,Lazio,it Serie A,17,2001,0.4,1,1,0,1,0,1,2,50.0,1,1,0,1,0,1,0,0,Matches
118,Yoël Armougom,fr FRA,DF,Caen,fr Ligue 1,20,1998,20.6,31,21,20,9,2,15,29,51.7,14,9,3,6,21,52,66,0,Matches
119,Stuart Armstrong,sct SCO,MF,Southampton,eng Premier League,26,1992,15.9,28,20,14,6,8,8,42,19.0,34,14,0,14,12,40,12,0,Matches
120,José Arnaiz,es ESP,"MF,FW",Leganés,es La Liga,23,1995,1.3,1,1,1,0,0,0,3,0.0,3,0,0,0,2,3,1,0,Matches
121,Marko Arnautović,at AUT,FW,West Ham,eng Premier League,29,1989,22.1,9,5,4,3,2,1,7,14.3,6,4,2,2,3,12,6,0,Matches
122,Maximilian Arnold,de GER,MF,Wolfsburg,de Bundesliga,24,1994,31.9,52,30,21,27,4,21,61,34.4,40,31,10,21,35,87,48,1,Matches
123,Kepa Arrizabalaga,es ESP,GK,Chelsea,eng Premier League,23,1994,36.0,1,1,1,0,0,1,2,50.0,1,1,0,1,0,1,4,2,Matches
124,Harry Arter,ie IRL,MF,Cardiff City,eng Premier League,28,1989,22.2,62,37,27,26,9,16,46,34.8,30,33,5,28,21,83,21,2,Matches
125,Kwadwo Asamoah,gh GHA,DF,Inter,it Serie A,29,1988,29.7,44,26,22,14,8,29,51,56.9,22,21,4,17,40,84,46,1,Matches
126,Takuma Asano,jp JPN,"MF,FW",Hannover 96,de Bundesliga,23,1994,7.8,5,3,1,1,3,1,6,16.7,5,9,0,9,2,7,2,0,Matches
127,Santiago Ascacíbar,ar ARG,MF,Stuttgart,de Bundesliga,21,1997,27.0,78,50,43,29,6,34,74,45.9,40,48,10,38,43,121,34,1,Matches
128,Sergio Asenjo,es ESP,GK,Villarreal,es La Liga,29,1989,32.0,0,0,0,0,0,0,1,0.0,1,0,0,0,3,3,26,2,Matches
129,Marco Asensio,es ESP,FW,Real Madrid,es La Liga,22,1996,19.8,12,8,3,5,4,2,24,8.3,22,16,1,15,14,26,7,0,Matches
130,Iago Aspas,es ESP,"FW,MF",Celta Vigo,es La Liga,30,1987,25.0,16,11,4,8,4,4,20,20.0,16,14,0,14,16,32,5,0,Matches
131,Simon Asta,de GER,DF,Augsburg,de Bundesliga,17,2001,1.0,6,3,4,2,0,2,2,100.0,0,2,1,1,3,9,1,0,Matches
132,Youcef Atal,dz ALG,"DF,FW",Nice,fr Ligue 1,22,1996,25.1,68,44,34,25,9,34,67,50.7,33,38,8,30,56,124,42,0,Matches
133,Christian Atsu,gh GHA,MF,Newcastle Utd,eng Premier League,26,1992,16.6,24,15,9,11,4,5,16,31.3,11,13,3,10,7,31,16,0,Matches
134,Pierre-Emerick Aubameyang,ga GAB,FW,Arsenal,eng Premier League,29,1989,30.3,21,17,6,9,6,8,28,28.6,20,26,0,26,8,29,22,0,Matches
135,Emil Audero,it ITA,GK,Sampdoria,it Serie A,21,1997,36.0,4,3,4,0,0,3,3,100.0,0,0,0,0,1,5,21,4,Matches
136,Jean-Kévin Augustin,fr FRA,FW,RB Leipzig,de Bundesliga,21,1997,5.1,2,0,0,0,2,0,1,0.0,1,6,0,6,3,5,0,0,Matches
137,Ludwig Augustinsson,se SWE,DF,Werder Bremen,de Bundesliga,24,1994,33.6,53,31,25,22,6,23,39,59.0,16,37,11,26,38,91,86,1,Matches
138,Serge Aurier,ci CIV,DF,Tottenham,eng Premier League,25,1992,6.3,20,12,12,4,4,8,15,53.3,7,8,2,6,7,27,20,0,Matches
139,Charlie Austin,eng ENG,FW,Southampton,eng Premier League,29,1989,10.9,13,7,3,6,4,6,11,54.5,5,12,2,10,2,15,13,0,Matches
140,Ezequiel Ávila,ar ARG,"FW,MF",Huesca,es La Liga,24,1994,22.2,18,10,7,7,4,4,26,15.4,22,21,2,19,13,31,22,0,Matches
141,Jordan Ayew,gh GHA,FW,Crystal Palace,eng Premier League,26,1991,13.1,38,23,12,19,7,6,20,30.0,14,16,0,16,7,45,6,0,Matches
142,Kaan Ayhan,tr TUR,DF,Düsseldorf,de Bundesliga,23,1994,27.2,53,29,38,15,0,23,47,48.9,24,34,16,18,59,112,118,3,Matches
143,Floyd Ayité,tg TOG,"FW,MF",Fulham,eng Premier League,29,1988,5.3,4,4,2,1,1,2,6,33.3,4,8,1,7,7,11,5,0,Matches
144,César Azpilicueta,es ESP,DF,Chelsea,eng Premier League,28,1989,37.8,105,60,52,40,13,38,67,56.7,29,63,16,47,43,148,91,3,Matches
145,Abdoulaye Ba,sn SEN,DF,Rayo Vallecano,es La Liga,27,1991,23.4,46,33,37,8,1,29,39,74.4,10,32,18,14,29,75,165,4,Matches
146,Florian Baak,de GER,MF,Hertha BSC,de Bundesliga,19,1999,0.0,0,0,0,0,0,0,0,,0,0,0,0,0,0,0,0,Matches
147,Ludovic Baal,gf GUF,DF,Rennes,fr Ligue 1,32,1986,1.4,4,3,3,1,0,0,0,,0,1,0,1,2,6,1,0,Matches
148,Khouma Babacar,sn SEN,FW,Sassuolo,it Serie A,25,1993,16.5,7,3,2,5,0,2,10,20.0,8,8,2,6,3,10,25,1,Matches
149,Ryan Babel,nl NED,"FW,MF",Fulham,eng Premier League,31,1986,13.9,8,4,1,5,2,3,9,33.3,6,12,0,12,6,14,13,1,Matches
150,Carlos Bacca,co COL,FW,Villarreal,es La Liga,31,1986,14.1,4,2,1,2,1,0,5,0.0,5,4,0,4,8,12,5,0,Matches
151,Juninho Bacuna,cw CUW,"MF,DF",Huddersfield,eng Premier League,20,1997,15.7,46,29,22,19,5,22,54,40.7,32,21,1,20,24,70,12,1,Matches
152,Leandro Bacuna,cw CUW,MF,Cardiff City,eng Premier League,26,1991,6.2,15,10,5,7,3,8,22,36.4,14,5,2,3,15,30,9,0,Matches
153,Milan Badelj,hr CRO,MF,Lazio,it Serie A,29,1989,12.7,33,20,10,19,4,16,37,43.2,21,27,9,18,33,66,20,1,Matches
154,Benoît Badiashile,fr FRA,DF,Monaco,fr Ligue 1,17,2001,19.6,25,18,18,7,0,17,25,68.0,8,12,5,7,21,46,79,2,Matches
155,Holger Badstuber,de GER,DF,Stuttgart,de Bundesliga,29,1989,5.8,12,4,8,4,0,7,8,87.5,1,6,2,4,9,21,21,1,Matches
156,Stéphane Bahoken,cm CMR,FW,Angers,fr Ligue 1,26,1992,27.4,15,7,0,10,5,3,21,14.3,18,35,3,32,8,23,5,0,Matches
157,Daniel Baier,de GER,MF,Augsburg,de Bundesliga,34,1984,31.3,62,39,21,37,4,24,66,36.4,42,27,8,19,60,122,48,2,Matches
158,Leon Bailey,jm JAM,FW,Leverkusen,de Bundesliga,20,1997,21.3,15,11,9,2,4,6,20,30.0,14,20,0,20,14,29,11,0,Matches
159,Eric Bailly,ci CIV,DF,Manchester Utd,eng Premier League,24,1994,7.1,15,9,14,1,0,8,10,80.0,2,9,4,5,13,28,39,1,Matches
160,Leighton Baines,eng ENG,DF,Everton,eng Premier League,33,1984,4.2,8,6,4,3,1,4,6,66.7,2,2,0,2,2,10,8,0,Matches
161,Marvin Bakalorz,de GER,MF,Hannover 96,de Bundesliga,28,1989,16.3,18,11,7,9,2,6,36,16.7,30,29,4,25,28,46,47,0,Matches
162,Tiemoué Bakayoko,fr FRA,MF,Milan,it Serie A,23,1994,25.6,69,43,22,40,7,26,62,41.9,36,34,5,29,50,119,42,2,Matches
163,Ridle Baku,de GER,MF,Mainz 05,de Bundesliga,20,1998,10.4,18,9,6,9,3,2,7,28.6,5,13,1,12,8,26,9,0,Matches
164,Fabián Balbuena,py PAR,DF,West Ham,eng Premier League,26,1991,22.4,40,20,34,6,0,16,42,38.1,26,23,15,8,53,93,175,0,Matches
165,Keita Baldé,sn SEN,FW,Inter,it Serie A,23,1995,9.9,10,6,4,2,4,2,9,22.2,7,8,0,8,3,13,1,0,Matches
166,Gareth Bale,wls WAL,FW,Real Madrid,es La Liga,29,1989,19.8,16,8,5,7,4,6,20,30.0,14,19,3,16,11,27,13,0,Matches
167,Mikel Balenziaga,es ESP,DF,Athletic Club,es La Liga,30,1988,5.8,10,6,7,1,2,5,8,62.5,3,6,2,4,2,12,21,0,Matches
168,Andrija Balić,hr CRO,"FW,MF",Udinese,it Serie A,20,1997,0.3,1,0,0,0,1,0,1,0.0,1,0,0,0,0,1,1,0,Matches
169,Fodé Ballo-Touré,sn SEN,DF,Lille,fr Ligue 1,21,1997,17.7,47,35,26,19,2,21,32,65.6,11,25,7,18,27,74,42,2,Matches
170,Fodé Ballo-Touré,sn SEN,DF,Monaco,fr Ligue 1,21,1997,17.7,46,31,26,16,4,20,40,50.0,20,20,2,18,28,74,38,2,Matches
171,Florent Balmont,fr FRA,MF,Dijon,fr Ligue 1,38,1980,12.0,29,16,16,10,3,9,36,25.0,27,13,2,11,6,35,8,0,Matches
172,Leon Balogun,ng NGA,DF,Brighton,eng Premier League,30,1988,6.6,12,6,11,1,0,8,9,88.9,1,5,3,2,17,29,32,1,Matches
173,Mario Balotelli,it ITA,FW,Nice,fr Ligue 1,27,1990,8.4,1,0,0,1,0,1,4,25.0,3,9,1,8,1,2,8,0,Matches
174,Mario Balotelli,it ITA,FW,Marseille,fr Ligue 1,27,1990,10.4,5,3,1,3,1,2,7,28.6,5,8,2,6,3,8,6,0,Matches
175,Abdoulaye Bamba,ci CIV,DF,Angers,fr Ligue 1,28,1990,28.6,51,29,31,14,6,24,44,54.5,20,20,4,16,37,88,86,0,Matches
176,Jonathan Bamba,ci CIV,"FW,MF",Lille,fr Ligue 1,22,1996,33.4,29,19,7,17,5,13,39,33.3,26,24,1,23,41,70,18,0,Matches
177,Sol Bamba,ci CIV,DF,Cardiff City,eng Premier League,33,1985,27.5,74,42,44,30,0,31,55,56.4,24,72,32,40,82,156,181,3,Matches
178,Yacine Bammou,ma MAR,"FW,MF",Caen,fr Ligue 1,26,1991,10.3,14,7,7,4,3,3,8,37.5,5,14,3,11,9,23,17,0,Matches
179,Éver Banega,ar ARG,MF,Sevilla,es La Liga,30,1988,29.6,71,50,32,35,4,20,70,28.6,50,26,5,21,28,99,28,0,Matches
180,Mattia Bani,it ITA,DF,Chievo,it Serie A,24,1993,29.0,67,40,46,21,0,27,40,67.5,13,51,35,16,57,124,162,2,Matches
181,Léo Baptistão,br BRA,"FW,MF",Espanyol,es La Liga,25,1992,13.7,22,14,11,5,6,8,27,29.6,19,17,0,17,8,30,14,0,Matches
182,Antonín Barák,cz CZE,"MF,FW",Udinese,it Serie A,23,1994,3.7,9,6,4,5,0,2,11,18.2,9,4,0,4,2,11,2,0,Matches
183,Federico Barba,it ITA,DF,Chievo,it Serie A,24,1993,27.6,30,14,21,9,0,8,21,38.1,13,29,15,14,65,95,129,0,Matches
184,Danilo Barbosa,br BRA,MF,Nice,fr Ligue 1,22,1996,17.2,29,20,13,13,3,6,17,35.3,11,17,2,15,15,44,25,1,Matches
185,Enis Bardhi,mk MKD,MF,Levante,es La Liga,23,1995,31.5,70,43,30,34,6,28,87,32.2,59,35,3,32,31,101,36,1,Matches
186,Francesco Bardi,it ITA,GK,Frosinone,it Serie A,26,1992,3.0,0,0,0,0,0,0,0,,0,0,0,0,0,0,2,0,Matches
187,Phil Bardsley,sct SCO,DF,Burnley,eng Premier League,33,1985,18.6,32,19,15,14,3,12,21,57.1,9,25,12,13,31,63,68,1,Matches
188,Nicolò Barella,it ITA,MF,Cagliari,it Serie A,21,1997,34.5,99,65,38,41,20,30,82,36.6,52,61,2,59,38,137,27,0,Matches
189,Philipp Bargfrede,de GER,"MF,DF",Werder Bremen,de Bundesliga,29,1989,12.0,23,15,9,12,2,10,28,35.7,18,35,11,24,34,57,45,1,Matches
190,Antonino Barillà,it ITA,MF,Parma,it Serie A,30,1988,29.1,64,36,40,17,7,19,53,35.8,34,40,13,27,36,100,50,1,Matches
191,Ross Barkley,eng ENG,MF,Chelsea,eng Premier League,24,1993,13.8,15,10,5,7,3,4,14,28.6,10,8,1,7,9,24,17,2,Matches
192,Aymen Barkok,ma MAR,MF,Düsseldorf,de Bundesliga,20,1998,5.7,13,6,4,9,0,4,19,21.1,15,8,1,7,4,17,3,0,Matches
193,Ashley Barnes,eng ENG,FW,Burnley,eng Premier League,28,1989,26.5,28,17,4,17,7,6,29,20.7,23,29,8,21,2,30,25,0,Matches
194,Harvey Barnes,eng ENG,"MF,FW",Leicester City,eng Premier League,20,1997,11.2,10,6,5,4,1,4,6,66.7,2,7,1,6,3,13,7,0,Matches
195,Antonio Barragán,es ESP,"DF,FW",Betis,es La Liga,31,1987,10.4,14,8,9,4,1,2,12,16.7,10,15,4,11,5,19,30,2,Matches
196,Antonio Barreca,it ITA,DF,Newcastle Utd,eng Premier League,23,1995,0.1,0,0,0,0,0,0,0,,0,0,0,0,0,0,0,0,Matches
197,Antonio Barreca,it ITA,DF,Monaco,fr Ligue 1,23,1995,6.6,11,8,8,3,0,7,11,63.6,4,3,2,1,7,18,18,0,Matches
198,Leandro Barreiro Martins,lu LUX,MF,Mainz 05,de Bundesliga,18,2000,1.0,4,4,2,0,2,1,2,50.0,1,0,0,0,2,6,1,0,Matches
199,Ander Barrenetxea,es ESP,"FW,MF",Real Sociedad,es La Liga,16,2001,4.4,7,2,2,0,5,2,8,25.0,6,8,0,8,4,11,1,0,Matches
200,Édgar Barreto,py PAR,MF,Sampdoria,it Serie A,34,1984,8.7,28,19,15,6,7,10,26,38.5,16,11,3,8,17,45,7,0,Matches
201,Musa Barrow,gm GAM,FW,Atalanta,it Serie A,19,1998,6.7,9,5,5,3,1,4,6,66.7,2,4,0,4,0,9,2,0,Matches
202,Fin Bartels,de GER,"MF,FW",Werder Bremen,de Bundesliga,31,1987,0.3,0,0,0,0,0,0,1,0.0,1,0,0,0,1,1,0,0,Matches
203,Marc Bartra,es ESP,DF,Betis,es La Liga,27,1991,32.5,86,55,55,26,5,41,76,53.9,35,46,21,25,60,146,132,2,Matches
204,Andrea Barzagli,it ITA,DF,Juventus,it Serie A,37,1981,2.9,1,1,0,1,0,1,2,50.0,1,2,2,0,4,5,10,0,Matches
205,Daniele Baselli,it ITA,MF,Torino,it Serie A,26,1992,26.4,65,45,22,34,9,16,44,36.4,28,30,6,24,34,99,32,0,Matches
206,Toma Bašić,hr CRO,MF,Bordeaux,fr Ligue 1,21,1996,14.8,32,16,5,21,6,11,31,35.5,20,13,1,12,9,41,22,1,Matches
207,Thomas Basila,fr FRA,DF,Nantes,fr Ligue 1,19,1999,1.0,2,1,1,1,0,0,0,,0,2,1,1,0,2,8,0,Matches
208,Borja Bastón,es ESP,FW,Alavés,es La Liga,25,1992,16.0,16,7,4,9,3,2,24,8.3,22,16,5,11,4,20,10,0,Matches
209,Alessandro Bastoni,it ITA,DF,Parma,it Serie A,19,1999,18.8,25,12,20,5,0,6,15,40.0,9,26,18,8,22,47,96,0,Matches
210,Bastos,ao ANG,DF,Lazio,it Serie A,27,1991,12.7,22,17,16,4,2,17,27,63.0,10,16,8,8,7,29,49,1,Matches
211,Michy Batshuayi,be BEL,FW,Crystal Palace,eng Premier League,24,1993,8.3,2,1,1,1,0,1,2,50.0,1,8,3,5,3,5,0,0,Matches
212,Michy Batshuayi,be BEL,FW,Valencia,es La Liga,24,1993,5.9,1,1,0,1,0,0,3,0.0,3,5,2,3,0,1,3,0,Matches
213,Robert Bauer,de GER,DF,Nürnberg,de Bundesliga,23,1995,19.1,48,29,32,13,3,20,39,51.3,19,19,5,14,28,76,80,0,Matches
214,Oliver Baumann,de GER,GK,Hoffenheim,de Bundesliga,28,1990,33.0,0,0,0,0,0,0,0,,0,0,0,0,2,2,11,5,Matches
215,Timo Baumgartl,de GER,DF,Stuttgart,de Bundesliga,22,1996,18.0,33,23,21,12,0,11,19,57.9,8,31,22,9,26,59,100,0,Matches
216,Julian Baumgartlinger,at AUT,MF,Leverkusen,de Bundesliga,30,1988,17.3,52,30,24,20,8,20,45,44.4,25,18,6,12,26,78,21,1,Matches
217,Christoph Baumgartner,at AUT,MF,Hoffenheim,de Bundesliga,18,1999,0.9,1,0,0,0,1,1,3,33.3,2,2,0,2,0,1,0,0,Matches
218,Jon Bautista,es ESP,FW,Real Sociedad,es La Liga,23,1995,6.6,5,3,0,3,2,0,3,0.0,3,8,1,7,5,10,4,0,Matches
219,Paul Baysse,fr FRA,DF,Bordeaux,fr Ligue 1,30,1988,0.8,1,0,1,0,0,0,1,0.0,1,1,1,0,1,2,6,0,Matches
220,Paul Baysse,fr FRA,DF,Caen,fr Ligue 1,30,1988,19.9,25,14,20,5,0,13,18,72.2,5,25,20,5,31,56,113,1,Matches
221,Noah Joel Sarenren Bazee,ng NGA,"FW,MF",Hannover 96,de Bundesliga,21,1996,1.7,0,0,0,0,0,0,0,,0,1,0,1,0,0,3,0,Matches
222,Claudio Beauvue,gp GLP,"FW,MF",Caen,fr Ligue 1,30,1988,16.7,18,11,7,9,2,1,14,7.1,13,11,2,9,10,28,21,0,Matches
223,Bebé,cv CPV,"FW,MF",Rayo Vallecano,es La Liga,28,1990,14.5,19,9,10,4,5,9,19,47.4,10,16,1,15,9,28,16,1,Matches
224,Bebé,cv CPV,MF,Eibar,es La Liga,28,1990,0.7,0,0,0,0,0,0,0,,0,1,0,1,1,1,0,0,Matches
225,Ihlas Bebou,tg TOG,"MF,FW",Hannover 96,de Bundesliga,24,1994,11.8,15,9,4,10,1,4,9,44.4,5,18,2,16,9,24,9,0,Matches
226,Uffe Bech,dk DEN,FW,Hannover 96,de Bundesliga,25,1993,0.2,0,0,0,0,0,0,1,0.0,1,0,0,0,0,0,0,0,Matches
227,Andreas Beck,de GER,DF,Stuttgart,de Bundesliga,31,1987,19.7,35,19,17,17,1,11,27,40.7,16,32,6,26,22,57,54,0,Matches
228,Jan Bednarek,pl POL,DF,Southampton,eng Premier League,22,1996,23.9,41,25,25,16,0,21,37,56.8,16,44,27,17,71,112,171,0,Matches
229,Andrea Beghetto,it ITA,DF,Frosinone,it Serie A,23,1994,24.7,26,14,13,10,3,15,25,60.0,10,20,4,16,17,43,59,0,Matches
230,Asmir Begović,ba BIH,GK,Bournemouth,eng Premier League,31,1987,24.0,0,0,0,0,0,0,3,0.0,3,1,0,1,1,1,15,7,Matches
231,Valon Behrami,ch SUI,MF,Udinese,it Serie A,33,1985,15.1,65,38,25,34,6,18,44,40.9,26,29,12,17,18,83,26,0,Matches
232,Hanno Behrens,de GER,MF,Nürnberg,de Bundesliga,28,1990,29.3,46,26,29,17,0,21,47,44.7,26,43,13,30,33,79,49,0,Matches
233,Ishak Belfodil,dz ALG,"FW,MF",Hoffenheim,de Bundesliga,26,1992,20.7,13,10,5,6,2,4,16,25.0,12,6,0,6,3,16,14,0,Matches
234,Stefan Bell,de GER,DF,Mainz 05,de Bundesliga,26,1991,25.0,31,20,18,13,0,15,34,44.1,19,31,11,20,54,85,122,1,Matches
235,Karim Bellarabi,de GER,FW,Leverkusen,de Bundesliga,28,1990,11.7,13,6,7,4,2,3,19,15.8,16,13,0,13,10,23,8,0,Matches
236,Héctor Bellerín,es ESP,DF,Arsenal,eng Premier League,23,1995,17.0,15,12,8,4,3,6,13,46.2,7,17,5,12,20,35,37,3,Matches
237,Andrea Belotti,it ITA,FW,Torino,it Serie A,24,1993,36.7,33,22,8,15,10,6,30,20.0,24,36,5,31,15,48,23,0,Matches
238,Fran Beltrán,es ESP,MF,Celta Vigo,es La Liga,19,1999,16.9,23,17,8,12,3,13,31,41.9,18,19,2,17,19,42,15,1,Matches
239,Hatem Ben Arfa,fr FRA,"FW,MF",Rennes,fr Ligue 1,31,1987,22.6,15,7,4,8,3,7,16,43.8,9,9,0,9,4,19,0,0,Matches
240,Wissam Ben Yedder,fr FRA,FW,Sevilla,es La Liga,27,1990,31.2,18,16,3,11,4,2,12,16.7,10,18,0,18,11,29,2,0,Matches
241,Diego Benaglio,ch SUI,GK,Monaco,fr Ligue 1,34,1983,22.9,1,0,1,0,0,1,1,100.0,0,0,0,0,0,1,16,0,Matches
242,Marco Benassi,it ITA,MF,Fiorentina,it Serie A,23,1994,25.4,30,19,8,15,7,14,41,34.1,27,16,3,13,9,39,27,1,Matches
243,Medhi Benatia,ma MAR,DF,Juventus,it Serie A,31,1987,5.0,7,6,6,1,0,3,5,60.0,2,10,5,5,16,23,18,0,Matches
244,Lars Bender,de GER,"MF,DF",Leverkusen,de Bundesliga,29,1989,15.1,43,29,20,20,3,18,35,51.4,17,26,4,22,21,64,26,0,Matches
245,Sven Bender,de GER,DF,Leverkusen,de Bundesliga,29,1989,22.1,40,25,25,15,0,18,30,60.0,12,31,14,17,52,92,98,0,Matches
246,László Bénes,sk SVK,"MF,FW",M'Gladbach,de Bundesliga,20,1997,0.3,3,1,3,0,0,3,3,100.0,0,1,0,1,0,3,0,0,Matches
247,Nicolas Benezet,fr FRA,"MF,FW",Guingamp,fr Ligue 1,27,1991,18.5,32,19,14,15,3,5,19,26.3,14,12,0,12,19,51,4,0,Matches
248,Walter Benítez,ar ARG,GK,Nice,fr Ligue 1,25,1993,35.0,1,0,1,0,0,1,2,50.0,1,0,0,0,2,3,6,2,Matches
249,Ismaël Bennacer,dz ALG,MF,Empoli,it Serie A,20,1997,32.9,94,57,43,41,10,32,75,42.7,43,38,9,29,57,151,34,0,Matches
250,Joe Bennett,eng ENG,DF,Cardiff City,eng Premier League,28,1990,29.3,50,29,34,16,0,22,38,57.9,16,30,8,22,60,110,93,0,Matches
251,Ryan Bennett,eng ENG,DF,Wolves,eng Premier League,28,1990,34.0,58,32,41,16,1,25,41,61.0,16,42,21,21,43,101,131,1,Matches
252,Yassine Benrahou,fr FRA,"MF,FW",Bordeaux,fr Ligue 1,19,1999,2.0,9,6,1,7,1,2,5,40.0,3,4,0,4,2,11,1,0,Matches
253,Ramy Bensebaini,dz ALG,DF,Rennes,fr Ligue 1,23,1995,23.9,69,48,42,19,8,40,58,69.0,18,24,10,14,41,110,98,0,Matches
254,Nabil Bentaleb,dz ALG,MF,Schalke 04,de Bundesliga,23,1994,19.9,32,17,8,21,3,4,18,22.2,14,28,8,20,35,67,19,0,Matches
255,Rodrigo Bentancur,uy URU,MF,Juventus,it Serie A,21,1997,22.3,53,34,22,29,2,18,39,46.2,21,20,8,12,43,96,42,1,Matches
256,Christian Benteke,be BEL,FW,Crystal Palace,eng Premier League,27,1990,9.0,5,1,0,4,1,1,4,25.0,3,7,2,5,0,5,14,0,Matches
257,Karim Benzema,fr FRA,FW,Real Madrid,es La Liga,30,1987,32.8,24,11,2,11,11,2,17,11.8,15,16,1,15,8,32,25,0,Matches
258,Yassine Benzia,dz ALG,MF,Lille,fr Ligue 1,23,1994,1.8,1,1,0,1,0,1,1,100.0,0,0,0,0,1,2,1,0,Matches
259,Domenico Berardi,it ITA,"FW,MF",Sassuolo,it Serie A,23,1994,31.9,38,21,16,9,13,15,73,20.5,58,31,2,29,27,65,24,0,Matches
260,Yuri Berchiche,es ESP,"DF,FW",Athletic Club,es La Liga,28,1990,34.7,46,31,26,11,9,23,46,50.0,23,34,9,25,42,88,82,0,Matches
261,Álex Berenguer,es ESP,"MF,DF",Torino,it Serie A,23,1995,16.5,31,20,12,17,2,14,34,41.2,20,20,1,19,8,39,14,0,Matches
262,Bartosz Bereszyński,pl POL,DF,Sampdoria,it Serie A,26,1992,24.4,46,30,27,15,4,24,51,47.1,27,22,7,15,31,77,76,0,Matches
263,Jóhann Berg Guðmundsson,is ISL,MF,Burnley,eng Premier League,27,1990,19.5,27,11,14,10,3,16,34,47.1,18,25,4,21,33,60,34,0,Matches
264,Markel Bergara,es ESP,MF,Getafe,es La Liga,32,1986,0.6,2,2,0,1,1,2,3,66.7,1,3,0,3,1,3,2,0,Matches
265,Robert Berić,si SVN,FW,Saint-Étienne,fr Ligue 1,27,1991,13.1,12,5,1,9,2,1,11,9.1,10,8,2,6,4,16,3,0,Matches
266,Etrit Berisha,al ALB,GK,Atalanta,it Serie A,29,1989,18.0,0,0,0,0,0,0,2,0.0,2,0,0,0,0,0,5,3,Matches
267,Valon Berisha,xk KVX,"MF,FW",Lazio,it Serie A,25,1993,2.2,8,5,1,6,1,4,6,66.7,2,6,0,6,4,12,3,0,Matches
268,Bernard,br BRA,"FW,MF",Everton,eng Premier League,25,1992,23.5,49,30,19,22,8,15,55,27.3,40,37,2,35,27,76,14,1,Matches
269,Federico Bernardeschi,it ITA,"MF,FW",Juventus,it Serie A,24,1994,16.4,14,8,5,6,3,7,18,38.9,11,9,0,9,6,20,10,0,Matches
270,Bernardo,br BRA,DF,Brighton,eng Premier League,23,1995,19.5,62,43,43,13,6,31,45,68.9,14,32,13,19,34,96,82,0,Matches
271,Paul Bernardoni,fr FRA,GK,Nîmes,fr Ligue 1,21,1997,38.0,1,1,1,0,0,1,2,50.0,1,0,0,0,1,2,20,1,Matches
272,Juan Bernat,es ESP,"DF,MF",Paris S-G,fr Ligue 1,25,1993,20.4,47,32,22,19,6,22,46,47.8,24,19,5,14,20,67,41,1,Matches
273,Antoine Bernede,fr FRA,MF,Paris S-G,fr Ligue 1,19,1999,1.9,13,7,3,8,2,5,9,55.6,4,3,1,2,3,16,1,1,Matches
274,Dimitry Bertaud,fr FRA,GK,Montpellier,fr Ligue 1,20,1998,1.0,0,0,0,0,0,0,0,,0,0,0,0,0,0,0,0,Matches
275,Ryan Bertrand,eng ENG,DF,Southampton,eng Premier League,28,1989,24.0,46,27,22,20,4,16,31,51.6,15,27,5,22,28,74,51,0,Matches
276,Daniel Bessa,it ITA,MF,Genoa,it Serie A,25,1993,27.1,60,35,28,23,9,11,39,28.2,28,30,4,26,19,79,16,1,Matches
277,Marcus Bettinelli,eng ENG,GK,Fulham,eng Premier League,26,1992,7.0,0,0,0,0,0,0,0,,0,0,0,0,0,0,5,0,Matches
278,Jordan Beyer,de GER,DF,M'Gladbach,de Bundesliga,18,2000,8.0,32,18,21,10,1,17,24,70.8,7,12,6,6,11,43,32,0,Matches
279,Jonathan Biabiany,fr FRA,FW,Parma,it Serie A,30,1988,11.9,30,22,18,10,2,9,17,52.9,8,8,1,7,11,41,11,1,Matches
280,Giulian Biancone,fr FRA,DF,Monaco,fr Ligue 1,18,2000,1.0,4,3,4,0,0,1,3,33.3,2,0,0,0,3,7,2,0,Matches
281,Ermin Bičakčić,ba BIH,DF,Hoffenheim,de Bundesliga,28,1990,19.9,32,19,18,11,3,13,22,59.1,9,36,15,21,56,88,79,1,Matches
282,Pedro Bigas,es ESP,DF,Eibar,es La Liga,27,1990,6.5,4,3,2,0,2,1,5,20.0,4,6,2,4,8,12,22,0,Matches
283,Lucas Biglia,ar ARG,MF,Milan,it Serie A,32,1986,12.4,60,33,31,25,4,20,45,44.4,25,19,3,16,22,82,21,1,Matches
284,Philip Billing,dk DEN,MF,Huddersfield,eng Premier League,22,1996,24.3,73,44,26,39,8,19,42,45.2,23,57,16,41,53,126,43,0,Matches
285,Cristiano Biraghi,it ITA,DF,Fiorentina,it Serie A,25,1992,35.5,52,33,31,17,4,18,38,47.4,20,40,17,23,44,96,113,0,Matches
286,Davide Biraschi,it ITA,DF,Genoa,it Serie A,24,1994,31.6,58,38,37,19,2,25,42,59.5,17,32,13,19,64,122,107,1,Matches
287,Valter Birsa,si SVN,"MF,FW",Cagliari,it Serie A,31,1986,3.9,5,3,1,3,1,4,8,50.0,4,5,0,5,4,9,3,0,Matches
288,Valter Birsa,si SVN,"MF,FW",Chievo,it Serie A,31,1986,12.2,14,9,4,7,3,4,17,23.5,13,9,1,8,6,20,13,0,Matches
289,Yves Bissouma,ml MLI,MF,Brighton,eng Premier League,21,1996,19.7,62,30,33,27,2,20,38,52.6,18,21,5,16,33,95,29,2,Matches
290,Leonardo Bittencourt,de GER,MF,Hoffenheim,de Bundesliga,24,1993,11.9,37,26,9,22,6,8,32,25.0,24,22,1,21,13,50,7,0,Matches
291,Alejandro Blanco,es ESP,"FW,MF",Alavés,es La Liga,19,1998,0.2,1,1,1,0,0,1,3,33.3,2,1,0,1,0,1,0,0,Matches
292,Rubén Blanco,es ESP,GK,Celta Vigo,es La Liga,23,1995,25.0,1,0,1,0,0,1,2,50.0,1,1,0,1,2,3,13,2,Matches
293,Ludovic Blas,fr FRA,"MF,FW",Guingamp,fr Ligue 1,20,1997,26.4,62,38,22,32,8,20,43,46.5,23,44,7,37,26,88,14,0,Matches
294,Pablo de Blasis,ar ARG,"DF,MF",Eibar,es La Liga,30,1988,16.9,32,19,17,8,7,12,32,37.5,20,18,0,18,13,45,20,0,Matches
295,Pablo de Blasis,ar ARG,FW,Mainz 05,de Bundesliga,30,1988,1.0,2,0,0,1,1,2,3,66.7,1,0,0,0,1,3,0,0,Matches
296,Alexis Blin,fr FRA,MF,Amiens,fr Ligue 1,21,1996,22.1,77,45,33,36,8,35,89,39.3,54,39,14,25,33,110,48,1,Matches
297,Danny Blum,de GER,MF,Eint Frankfurt,de Bundesliga,27,1991,0.0,0,0,0,0,0,0,0,,0,0,0,0,0,0,5,0,Matches
298,Emmanuel Boateng,gh GHA,FW,Levante,es La Liga,22,1996,7.8,4,3,0,0,4,0,3,0.0,3,5,0,5,1,5,7,0,Matches
299,Jérôme Boateng,de GER,DF,Bayern Munich,de Bundesliga,29,1988,18.8,21,15,12,9,0,10,22,45.5,12,8,3,5,25,46,49,0,Matches
300,Kevin-Prince Boateng,gh GHA,FW,Sassuolo,it Serie A,31,1987,10.4,5,4,0,4,1,1,4,25.0,3,7,3,4,3,8,13,0,Matches
301,Kevin-Prince Boateng,gh GHA,FW,Barcelona,es La Liga,31,1987,2.7,3,2,0,1,2,0,1,0.0,1,1,0,1,1,4,4,0,Matches
302,Antonin Bobichon,fr FRA,MF,Nîmes,fr Ligue 1,22,1995,23.9,34,16,17,12,5,16,58,27.6,42,15,3,12,15,49,13,0,Matches
303,Yann Bodiger,fr FRA,MF,Toulouse,fr Ligue 1,23,1995,0.1,0,0,0,0,0,0,1,0.0,1,0,0,0,0,0,0,0,Matches
304,Mathieu Bodmer,fr FRA,"MF,FW",Amiens,fr Ligue 1,35,1982,11.9,15,11,3,11,1,3,10,30.0,7,3,0,3,2,17,10,0,Matches
305,Adam Bodzek,de GER,"MF,DF",Düsseldorf,de Bundesliga,32,1985,17.7,44,27,27,16,1,17,43,39.5,26,15,6,9,26,70,39,0,Matches
306,Jean-Paul Boëtius,nl NED,MF,Mainz 05,de Bundesliga,24,1994,23.6,51,32,21,25,5,16,44,36.4,28,59,2,57,37,88,13,0,Matches
307,Sacha Boey,fr FRA,DF,Rennes,fr Ligue 1,17,2000,0.2,0,0,0,0,0,0,0,,0,0,0,0,0,0,0,0,Matches
308,Jeremie Boga,ci CIV,"FW,MF",Sassuolo,it Serie A,21,1997,16.0,7,4,5,1,1,4,14,28.6,10,19,0,19,2,9,4,0,Matches
309,Willy Boly,ci CIV,DF,Wolves,eng Premier League,27,1991,35.2,85,52,49,34,2,34,56,60.7,22,55,32,23,72,157,177,6,Matches
310,Léo Bonatini,br BRA,FW,Wolves,eng Premier League,24,1994,1.5,1,1,0,0,1,1,5,20.0,4,1,0,1,0,1,0,0,Matches
311,Giacomo Bonaventura,it ITA,MF,Milan,it Serie A,28,1989,7.2,6,2,2,4,0,2,7,28.6,5,3,0,3,7,13,8,0,Matches
312,Daniele Bonera,it ITA,DF,Villarreal,es La Liga,37,1981,2.6,2,2,2,0,0,1,1,100.0,0,5,5,0,4,6,10,0,Matches
313,Gaëtan Bong,cm CMR,DF,Brighton,eng Premier League,30,1988,20.1,16,10,7,6,3,6,10,60.0,4,16,6,10,25,41,57,2,Matches
314,Kevin Bonifazi,it ITA,DF,SPAL,it Serie A,22,1996,25.6,40,24,31,8,1,15,33,45.5,18,38,21,17,36,76,79,0,Matches
315,Leonardo Bonucci,it ITA,DF,Juventus,it Serie A,31,1987,27.5,18,9,11,6,1,10,13,76.9,3,32,21,11,38,56,88,3,Matches
316,Fabio Borini,it ITA,"FW,DF",Milan,it Serie A,27,1991,11.7,14,10,7,7,0,3,9,33.3,6,17,0,17,12,26,28,0,Matches
317,Robin Bormuth,de GER,DF,Düsseldorf,de Bundesliga,22,1995,6.8,7,4,7,0,0,5,10,50.0,5,6,4,2,10,17,49,1,Matches
318,Artur Boruc,pl POL,GK,Bournemouth,eng Premier League,38,1980,12.0,1,0,1,0,0,1,3,33.3,2,0,0,0,0,1,1,0,Matches
319,Olivier Boscagli,fr FRA,DF,Nice,fr Ligue 1,20,1997,9.6,20,12,14,4,2,9,20,45.0,11,12,1,11,17,37,37,0,Matches
320,Gabriel Boschilia,br BRA,"FW,MF",Nantes,fr Ligue 1,22,1996,14.7,33,23,11,9,13,8,33,24.2,25,14,2,12,8,41,7,0,Matches
321,John Bostock,tt TRI,MF,Toulouse,fr Ligue 1,26,1992,10.9,24,14,14,10,0,9,30,30.0,21,12,2,10,17,41,11,0,Matches
322,Denis Bouanga,ga GAB,"MF,FW",Nîmes,fr Ligue 1,23,1994,29.3,52,32,21,22,9,13,61,21.3,48,24,3,21,20,72,16,0,Matches
323,Zacharie Boucher,fr FRA,GK,Angers,fr Ligue 1,26,1992,2.0,0,0,0,0,0,0,0,,0,1,0,1,0,0,1,0,Matches
324,Ryad Boudebouz,dz ALG,"MF,FW",Celta Vigo,es La Liga,28,1990,8.0,14,4,4,6,4,3,8,37.5,5,9,1,8,3,17,9,0,Matches
325,Ryad Boudebouz,dz ALG,"MF,FW",Betis,es La Liga,28,1990,6.0,8,4,4,1,3,4,10,40.0,6,5,1,4,5,13,2,0,Matches
326,Sofiane Boufal,ma MAR,"MF,FW",Celta Vigo,es La Liga,24,1993,23.2,35,21,18,11,6,15,47,31.9,32,24,0,24,10,45,12,0,Matches
327,Nassim Boujellab,ma MAR,MF,Schalke 04,de Bundesliga,19,1999,4.2,10,4,3,6,1,3,11,27.3,8,6,0,6,2,12,3,0,Matches
328,Arnold Bouka Moutou,cg CGO,"DF,FW",Dijon,fr Ligue 1,29,1988,0.7,3,1,2,1,0,0,4,0.0,4,1,0,1,3,6,1,0,Matches
329,Yassine Bounou,ma MAR,GK,Girona,es La Liga,27,1991,31.8,0,0,0,0,0,0,2,0.0,2,0,0,0,1,1,7,2,Matches
330,Mehdi Bourabia,ma MAR,MF,Sassuolo,it Serie A,26,1991,22.3,51,28,23,21,7,15,46,32.6,31,28,5,23,33,84,32,0,Matches
331,Benjamin Bourigeaud,fr FRA,"MF,FW",Rennes,fr Ligue 1,24,1994,26.9,55,35,23,21,11,20,67,29.9,47,44,5,39,32,87,34,1,Matches
332,Bilal Boutobba,fr FRA,"FW,MF",Montpellier,fr Ligue 1,19,1998,0.4,0,0,0,0,0,0,2,0.0,2,0,0,0,0,0,0,0,Matches
333,Umut Bozok,tr TUR,FW,Nîmes,fr Ligue 1,21,1996,13.7,9,6,0,3,6,2,4,50.0,2,3,0,3,5,14,1,0,Matches
334,Filip Bradarić,hr CRO,MF,Cagliari,it Serie A,26,1992,16.6,26,21,11,12,3,10,20,50.0,10,13,3,10,39,65,50,0,Matches
335,Robbie Brady,ie IRL,MF,Burnley,eng Premier League,26,1992,8.0,15,7,5,5,5,6,17,35.3,11,7,1,6,7,22,18,1,Matches
336,Martin Braithwaite,dk DEN,FW,Leganés,es La Liga,27,1991,15.6,5,3,0,0,5,0,4,0.0,4,9,0,9,3,8,4,0,Matches
337,Julian Brandt,de GER,"MF,FW",Leverkusen,de Bundesliga,22,1996,29.6,27,16,13,10,4,7,43,16.3,36,27,1,26,17,44,12,1,Matches
338,Darko Brašanac,rs SRB,MF,Alavés,es La Liga,26,1992,17.6,32,16,15,13,4,10,26,38.5,16,17,4,13,13,45,19,0,Matches
339,Pedro Brazão,pt POR,"MF,FW",Nice,fr Ligue 1,15,2002,0.2,0,0,0,0,0,0,1,0.0,1,0,0,0,0,0,0,0,Matches
340,Fabian Bredlow,de GER,GK,Nürnberg,de Bundesliga,23,1995,12.5,1,1,1,0,0,1,1,100.0,0,0,0,0,1,2,3,4,Matches
341,Josip Brekalo,hr CRO,"FW,MF",Wolfsburg,de Bundesliga,20,1998,15.7,15,7,7,6,2,5,18,27.8,13,15,1,14,12,27,9,1,Matches
342,Gleison Bremer,br BRA,DF,Torino,it Serie A,21,1997,2.0,3,1,1,2,0,1,2,50.0,1,4,1,3,8,11,9,0,Matches
343,Joshua Brenet,nl NED,DF,Hoffenheim,de Bundesliga,24,1994,10.1,20,13,12,5,3,7,13,53.8,6,16,1,15,8,28,19,0,Matches
344,Rajko Brežančić,rs SRB,DF,Huesca,es La Liga,28,1989,0.7,1,0,0,0,1,0,0,,0,0,0,0,0,1,0,0,Matches
345,Anthony Briançon,fr FRA,DF,Nîmes,fr Ligue 1,23,1994,32.5,46,27,36,10,0,27,50,54.0,23,51,38,13,70,116,184,1,Matches
346,Jimmy Briand,fr FRA,FW,Bordeaux,fr Ligue 1,32,1985,27.7,14,8,2,10,2,4,24,16.7,20,14,6,8,4,18,29,0,Matches
347,Nicolò Brighenti,it ITA,DF,Frosinone,it Serie A,28,1989,11.0,27,17,9,15,3,6,14,42.9,8,17,8,9,31,58,37,0,Matches
348,Matteo Brighi,it ITA,MF,Empoli,it Serie A,37,1981,2.6,11,4,2,9,0,2,9,22.2,7,2,0,2,3,14,4,0,Matches
349,Enrico Brignola,it ITA,"FW,MF",Sassuolo,it Serie A,19,1999,1.9,2,2,2,0,0,0,2,0.0,2,0,0,0,1,3,1,0,Matches
350,Miguel Britos,uy URU,DF,Watford,eng Premier League,33,1985,2.1,4,2,4,0,0,2,4,50.0,2,1,1,0,3,7,11,1,Matches
351,David Brooks,wls WAL,"MF,FW",Bournemouth,eng Premier League,21,1997,25.1,37,26,12,19,6,19,44,43.2,25,36,7,29,24,61,28,0,Matches
352,John Brooks,us USA,DF,Wolfsburg,de Bundesliga,25,1993,29.0,29,15,18,9,2,13,27,48.1,14,28,13,15,37,66,135,3,Matches
353,Daniel Brosinski,de GER,DF,Mainz 05,de Bundesliga,30,1988,24.5,27,16,16,10,1,18,33,54.5,15,30,9,21,26,53,58,0,Matches
354,Marcelo Brozović,hr CRO,MF,Inter,it Serie A,25,1992,29.4,101,70,47,40,14,31,86,36.0,55,45,8,37,44,145,32,3,Matches
355,Bruma,pt POR,MF,RB Leipzig,de Bundesliga,23,1994,6.1,5,2,3,1,1,1,5,20.0,4,4,0,4,4,9,2,0,Matches
356,Jeffrey Bruma,nl NED,DF,Schalke 04,de Bundesliga,26,1991,6.9,12,11,8,4,0,6,12,50.0,6,8,2,6,4,16,35,0,Matches
357,Bruno,es ESP,DF,Brighton,eng Premier League,37,1980,12.6,25,16,20,3,2,14,18,77.8,4,7,2,5,11,36,30,1,Matches
358,Jacob Bruun Larsen,dk DEN,FW,Dortmund,de Bundesliga,19,1998,14.1,15,9,8,2,5,7,17,41.2,10,15,1,14,13,28,12,0,Matches
359,Joe Bryan,eng ENG,"DF,MF",Fulham,eng Premier League,24,1993,26.1,61,41,35,21,5,24,42,57.1,18,34,12,22,31,92,82,1,Matches
360,Gianluigi Buffon,it ITA,GK,Paris S-G,fr Ligue 1,40,1978,17.0,0,0,0,0,0,0,1,0.0,1,0,0,0,0,0,5,0,Matches
361,Niko Bungert,de GER,DF,Mainz 05,de Bundesliga,31,1986,3.2,7,5,5,2,0,5,5,100.0,0,7,6,1,4,11,16,0,Matches
362,Guido Burgstaller,at AUT,FW,Schalke 04,de Bundesliga,29,1989,17.0,11,9,2,5,4,3,8,37.5,5,5,0,5,2,13,10,0,Matches
363,Burgui,es ESP,"MF,FW",Alavés,es La Liga,24,1993,6.2,6,6,4,2,0,1,3,33.3,2,4,0,4,0,6,2,1,Matches
364,Jonathan Burkardt,de GER,"FW,MF",Mainz 05,de Bundesliga,18,2000,2.9,4,4,2,1,1,1,2,50.0,1,2,0,2,3,7,5,0,Matches
365,Roman Bürki,ch SUI,GK,Dortmund,de Bundesliga,27,1990,32.0,1,0,1,0,0,1,2,50.0,1,1,0,1,2,3,8,4,Matches
366,Patrick Burner,mq MTQ,DF,Nice,fr Ligue 1,22,1996,15.0,36,23,22,10,4,16,34,47.1,18,15,5,10,31,67,40,0,Matches
367,Sergio Busquets,es ESP,MF,Barcelona,es La Liga,30,1988,30.2,90,60,35,45,10,41,89,46.1,48,43,8,35,54,144,22,1,Matches
368,Gaëtan Bussmann,fr FRA,DF,Mainz 05,de Bundesliga,27,1991,1.0,2,1,2,0,0,2,5,40.0,3,0,0,0,1,3,2,0,Matches
369,Unai Bustinza,es ESP,DF,Leganés,es La Liga,26,1992,22.5,41,31,25,14,2,17,33,51.5,16,31,13,18,53,94,110,2,Matches
370,Ludovic Butelle,fr FRA,GK,Angers,fr Ligue 1,35,1983,36.0,1,0,1,0,0,1,1,100.0,0,0,0,0,1,2,31,1,Matches
371,David Button,eng ENG,GK,Brighton,eng Premier League,29,1989,4.0,0,0,0,0,0,0,0,,0,0,0,0,0,0,2,0,Matches
372,Jakub Błaszczykowski,pl POL,MF,Wolfsburg,de Bundesliga,32,1985,0.1,0,0,0,0,0,0,0,,0,0,0,0,0,0,0,0,Matches
373,Erick Cabaco,uy URU,DF,Levante,es La Liga,23,1995,18.1,22,13,19,3,0,12,29,41.4,17,29,14,15,29,51,69,0,Matches
374,Willy Caballero,ar ARG,GK,Chelsea,eng Premier League,36,1981,2.0,0,0,0,0,0,0,0,,0,0,0,0,0,0,1,0,Matches
375,Rémy Cabella,fr FRA,"MF,FW",Saint-Étienne,fr Ligue 1,28,1990,33.3,88,51,31,38,19,30,87,34.5,57,39,1,38,19,107,5,3,Matches
376,Gustavo Cabral,ar ARG,DF,Celta Vigo,es La Liga,32,1985,21.1,37,26,28,7,2,17,27,63.0,10,31,11,20,33,70,102,1,Matches
377,Rafael Cabral,br BRA,GK,Sampdoria,it Serie A,28,1990,2.0,0,0,0,0,0,0,0,,0,0,0,0,0,0,0,0,Matches
378,Leandro Cabrera,uy URU,DF,Getafe,es La Liga,27,1991,31.0,47,26,28,17,2,24,41,58.5,17,29,16,13,52,99,216,2,Matches
379,Fabrizio Cacciatore,it ITA,DF,Cagliari,it Serie A,31,1986,6.4,9,7,7,0,2,1,5,20.0,4,6,4,2,7,16,17,0,Matches
380,Fabrizio Cacciatore,it ITA,DF,Chievo,it Serie A,31,1986,5.5,8,4,6,2,0,4,9,44.4,5,8,2,6,5,13,20,0,Matches
381,Martín Cáceres,uy URU,DF,Lazio,it Serie A,31,1987,3.4,4,2,3,1,0,4,6,66.7,2,4,0,4,0,4,12,1,Matches
382,Martín Cáceres,uy URU,DF,Juventus,it Serie A,31,1987,7.0,7,3,6,0,1,4,4,100.0,0,6,3,3,4,11,14,0,Matches
383,Anthony Caci,fr FRA,DF,Strasbourg,fr Ligue 1,21,1997,25.5,56,30,38,14,4,24,46,52.2,22,20,10,10,47,103,63,0,Matches
384,Mathieu Cafaro,fr FRA,"FW,MF",Reims,fr Ligue 1,21,1997,23.3,59,28,29,24,6,18,63,28.6,45,28,0,28,20,79,14,0,Matches
385,Gary Cahill,eng ENG,DF,Chelsea,eng Premier League,32,1985,0.3,0,0,0,0,0,0,0,,0,0,0,0,0,0,1,0,Matches
386,Yannick Cahuzac,fr FRA,"MF,DF",Toulouse,fr Ligue 1,33,1985,15.9,33,19,15,15,3,17,32,53.1,15,16,4,12,24,57,55,0,Matches
387,Felipe Caicedo,ec ECU,FW,Lazio,it Serie A,29,1988,15.2,16,12,4,6,6,1,8,12.5,7,9,2,7,5,21,5,0,Matches
388,Marc-Aurèle Caillard,fr FRA,GK,Guingamp,fr Ligue 1,24,1994,21.0,0,0,0,0,0,0,2,0.0,2,0,0,0,2,2,8,3,Matches
389,Tom Cairney,sct SCO,"MF,FW",Fulham,eng Premier League,27,1991,24.4,37,21,9,22,6,12,16,75.0,4,21,5,16,10,47,13,1,Matches
390,Caiuby,br BRA,"MF,FW",Augsburg,de Bundesliga,30,1988,11.2,12,10,5,6,1,3,11,27.3,8,16,1,15,5,17,10,0,Matches
391,Arturo Calabresi,it ITA,DF,Bologna,it Serie A,22,1996,15.7,46,27,22,17,7,22,40,55.0,18,18,3,15,34,80,60,0,Matches
392,Davide Calabria,it ITA,DF,Milan,it Serie A,21,1996,21.7,79,51,58,16,5,37,67,55.2,30,33,1,32,32,111,78,1,Matches
393,Jordi Calavera,es ESP,DF,Eibar,es La Liga,22,1995,0.0,0,0,0,0,0,0,0,,0,0,0,0,0,0,0,0,Matches
394,Fernando Calero,es ESP,DF,Valladolid,es La Liga,22,1995,34.8,51,31,33,18,0,23,38,60.5,15,55,31,24,55,106,170,0,Matches
395,Duje Ćaleta-Car,hr CRO,DF,Marseille,fr Ligue 1,21,1996,17.2,22,16,14,8,0,14,18,77.8,4,15,9,6,20,42,86,2,Matches
396,Hakan Çalhanoğlu,tr TUR,"MF,FW",Milan,it Serie A,24,1994,32.0,52,31,27,16,9,23,46,50.0,23,27,5,22,28,80,19,0,Matches
397,Daniel Caligiuri,it ITA,"DF,FW",Schalke 04,de Bundesliga,30,1988,30.6,93,52,55,29,9,44,103,42.7,59,66,10,56,50,143,72,1,Matches
398,José Callejón,es ESP,"MF,FW",Napoli,it Serie A,31,1987,29.4,34,18,12,14,8,18,57,31.6,39,34,5,29,22,56,11,0,Matches
399,Jonathan Calleri,ar ARG,FW,Alavés,es La Liga,24,1993,31.9,20,13,3,11,6,1,24,4.2,23,34,7,27,7,27,53,0,Matches
400,Jan-Ingwer Callsen-Bracker,de GER,DF,Augsburg,de Bundesliga,33,1984,0.1,0,0,0,0,0,0,0,,0,0,0,0,0,0,0,0,Matches
401,Dominic Calvert-Lewin,eng ENG,FW,Everton,eng Premier League,21,1997,19.8,13,7,3,3,7,7,15,46.7,8,16,3,13,7,20,19,0,Matches
402,Ignacio Camacho,es ESP,MF,Wolfsburg,de Bundesliga,28,1990,6.0,15,9,9,6,0,3,7,42.9,4,7,2,5,18,33,12,0,Matches
403,Juanjo Camacho,es ESP,"MF,DF",Huesca,es La Liga,37,1980,0.4,1,1,1,0,0,1,1,100.0,0,0,0,0,0,1,1,0,Matches
404,Rafael Camacho,pt POR,DF,Liverpool,eng Premier League,18,2000,0.0,1,0,1,0,0,1,1,100.0,0,0,0,0,0,1,0,0,Matches
405,Mahdi Camara,fr FRA,FW,Saint-Étienne,fr Ligue 1,20,1998,0.1,0,0,0,0,0,0,0,,0,0,0,0,0,0,2,0,Matches
406,Souleymane Camara,sn SEN,"FW,MF",Montpellier,fr Ligue 1,35,1982,1.5,0,0,0,0,0,0,2,0.0,2,0,0,0,0,0,3,0,Matches
407,Víctor Camarasa,es ESP,MF,Cardiff City,eng Premier League,24,1994,28.5,28,15,8,15,5,6,31,19.4,25,17,2,15,33,61,28,1,Matches
408,Eduardo Camavinga,fr FRA,MF,Rennes,fr Ligue 1,15,2002,4.0,23,15,8,12,3,8,18,44.4,10,13,2,11,4,27,4,0,Matches
409,Sergio Camello,es ESP,FW,Atlético Madrid,es La Liga,17,2001,0.5,1,0,1,0,0,1,1,100.0,0,0,0,0,0,1,0,0,Matches
410,José Campaña,es ESP,MF,Levante,es La Liga,25,1993,35.7,65,45,31,29,5,27,86,31.4,59,51,7,44,48,113,46,1,Matches
411,Joel Campbell,cr CRC,"FW,MF",Frosinone,it Serie A,26,1992,9.9,15,10,5,8,2,3,17,17.6,14,2,0,2,3,18,2,1,Matches
412,Emre Can,de GER,MF,Juventus,it Serie A,24,1994,20.1,64,38,28,27,9,24,40,60.0,16,43,13,30,28,92,36,2,Matches
413,Sergio Canales,es ESP,MF,Betis,es La Liga,27,1991,29.5,44,30,19,18,7,11,53,20.8,42,34,3,31,9,53,8,1,Matches
414,João Cancelo,pt POR,DF,Juventus,it Serie A,24,1994,21.9,43,28,18,18,7,27,49,55.1,22,14,4,10,15,58,48,0,Matches
415,Antonio Candreva,it ITA,"FW,MF",Inter,it Serie A,31,1987,5.6,1,1,0,1,0,1,8,12.5,7,0,0,0,4,5,9,0,Matches
416,Ander Capa,es ESP,"DF,FW",Athletic Club,es La Liga,26,1992,18.2,43,27,32,8,3,13,27,48.1,14,20,2,18,30,73,47,0,Matches
417,Luan Capanni,br BRA,FW,Lazio,it Serie A,18,2000,0.1,1,1,0,0,1,0,0,,0,0,0,0,0,1,0,0,Matches
418,Pierrick Capelle,fr FRA,"DF,MF",Angers,fr Ligue 1,31,1987,20.5,51,31,23,22,6,19,54,35.2,35,23,2,21,38,89,49,0,Matches
419,Leonardo Capezzi,it ITA,MF,Empoli,it Serie A,23,1995,8.6,14,9,6,8,0,7,13,53.8,6,14,4,10,10,24,13,0,Matches
420,Étienne Capoue,fr FRA,MF,Watford,eng Premier League,30,1988,32.7,91,56,36,48,7,33,87,37.9,54,50,13,37,85,176,96,1,Matches
421,Gianluca Caprari,it ITA,"FW,MF",Sampdoria,it Serie A,25,1993,11.5,15,9,4,9,2,5,12,41.7,7,7,0,7,4,19,3,0,Matches
422,Marco Capuano,it ITA,DF,Frosinone,it Serie A,26,1991,25.6,53,33,37,15,1,26,46,56.5,20,44,31,13,34,87,101,2,Matches
423,Francesco Caputo,it ITA,FW,Empoli,it Serie A,30,1987,38.0,13,9,2,4,7,3,10,30.0,7,11,1,10,2,15,11,0,Matches
424,Yoan Cardinale,fr FRA,GK,Nice,fr Ligue 1,24,1994,3.0,1,0,1,0,0,1,1,100.0,0,0,0,0,0,1,1,0,Matches
425,Marc Cardona,es ESP,"FW,MF",Eibar,es La Liga,23,1995,6.7,7,5,2,1,4,2,6,33.3,4,7,0,7,1,8,3,0,Matches
426,Diego Carlos,br BRA,DF,Nantes,fr Ligue 1,25,1993,35.0,58,34,43,14,1,26,33,78.8,7,44,31,13,50,108,186,1,Matches
427,Jonas Carls,de GER,FW,Schalke 04,de Bundesliga,21,1997,1.0,5,2,4,0,1,5,5,100.0,0,0,0,0,1,6,0,0,Matches
428,Louis Carnot,fr FRA,MF,Guingamp,fr Ligue 1,17,2001,0.1,0,0,0,0,0,0,0,,0,0,0,0,0,0,0,0,Matches
429,Lionel Carole,fr FRA,"DF,FW",Strasbourg,fr Ligue 1,27,1991,19.2,25,12,16,7,2,11,16,68.8,5,19,5,14,32,57,51,0,Matches
430,Daniel Carriço,pt POR,DF,Sevilla,es La Liga,29,1988,23.7,35,18,23,11,1,12,20,60.0,8,19,12,7,31,66,104,1,Matches
431,Guido Carrillo,ar ARG,FW,Leganés,es La Liga,27,1991,22.1,25,14,4,12,9,6,19,31.6,13,12,1,11,8,33,25,0,Matches
432,Andy Carroll,eng ENG,FW,West Ham,eng Premier League,29,1989,5.1,4,2,1,3,0,1,4,25.0,3,3,2,1,1,5,8,0,Matches
433,Dani Carvajal,es ESP,DF,Real Madrid,es La Liga,26,1992,23.4,40,24,17,15,8,18,41,43.9,23,31,7,24,26,66,35,0,Matches
434,William Carvalho,pt POR,MF,Betis,es La Liga,26,1992,26.5,45,27,20,21,4,16,29,55.2,13,8,0,8,12,57,30,0,Matches
435,Casemiro,br BRA,MF,Real Madrid,es La Liga,26,1992,25.7,86,52,44,35,7,38,94,40.4,56,52,12,40,41,127,56,3,Matches
436,Santiago Cáseres,ar ARG,MF,Villarreal,es La Liga,21,1997,17.6,67,35,20,38,9,25,57,43.9,32,22,9,13,14,81,24,1,Matches
437,Moreto Cassamã,gw GNB,MF,Reims,fr Ligue 1,20,1998,0.7,3,3,1,2,0,1,7,14.3,6,1,0,1,1,4,2,0,Matches
438,Francesco Cassata,it ITA,MF,Frosinone,it Serie A,21,1997,12.5,20,11,12,4,4,9,23,39.1,14,8,1,7,6,26,15,1,Matches
439,Timothy Castagne,be BEL,DF,Atalanta,it Serie A,22,1995,22.3,61,39,30,22,9,32,57,56.1,25,32,6,26,28,89,50,0,Matches
440,Koen Casteels,be BEL,GK,Wolfsburg,de Bundesliga,26,1992,25.5,1,0,1,0,0,1,2,50.0,1,1,0,1,0,1,11,1,Matches
441,Samu Castillejo,es ESP,"FW,MF",Milan,it Serie A,23,1995,11.4,15,10,10,2,3,4,25,16.0,21,16,0,16,8,23,11,0,Matches
442,Gonzalo Castro,de GER,MF,Stuttgart,de Bundesliga,31,1987,18.8,50,28,21,25,4,19,43,44.2,24,23,5,18,29,79,22,1,Matches
443,Jonny Castro,es ESP,"DF,MF",Wolves,eng Premier League,24,1994,30.8,79,43,42,33,4,31,60,51.7,29,45,8,37,60,139,64,2,Matches
444,Lucas Castro,ar ARG,MF,Cagliari,it Serie A,29,1989,10.0,18,11,8,8,2,8,23,34.8,15,20,4,16,17,35,6,0,Matches
445,Danilo Cataldi,it ITA,"MF,FW",Lazio,it Serie A,23,1994,6.4,12,7,4,5,3,2,9,22.2,7,3,0,3,7,19,6,0,Matches
446,Catena,es ESP,DF,Rayo Vallecano,es La Liga,23,1994,2.0,4,4,3,1,0,2,2,100.0,0,4,2,2,8,12,8,0,Matches
447,Craig Cathcart,nir NIR,DF,Watford,eng Premier League,29,1989,34.4,50,31,36,11,3,21,37,56.8,16,42,30,12,38,88,184,4,Matches
448,Ivan Cavaleiro,pt POR,"FW,MF",Wolves,eng Premier League,24,1993,7.7,5,4,3,1,1,1,14,7.1,13,12,0,12,4,9,5,0,Matches
449,Edinson Cavani,uy URU,FW,Paris S-G,fr Ligue 1,31,1987,18.6,11,8,1,4,6,3,13,23.1,10,11,2,9,6,17,16,0,Matches
450,Santi Cazorla,es ESP,"MF,FW",Villarreal,es La Liga,33,1984,29.4,69,34,32,26,11,24,69,34.8,45,35,6,29,28,97,17,1,Matches
451,Dani Ceballos,es ESP,"MF,FW",Real Madrid,es La Liga,21,1996,13.9,32,21,9,16,7,11,31,35.5,20,26,1,25,15,47,6,0,Matches
452,Federico Ceccherini,it ITA,DF,Fiorentina,it Serie A,26,1992,11.0,13,10,8,3,2,5,9,55.6,4,12,8,4,21,34,40,0,Matches
453,Petr Čech,cz CZE,GK,Arsenal,eng Premier League,36,1982,6.5,1,1,1,0,0,1,1,100.0,0,0,0,0,0,1,5,2,Matches
454,Žan Celar,si SVN,FW,Roma,it Serie A,19,1999,0.1,0,0,0,0,0,0,0,,0,0,0,0,0,0,0,0,Matches
455,Zeki Çelik,tr TUR,DF,Lille,fr Ligue 1,21,1997,33.0,90,59,40,39,11,36,89,40.4,53,34,5,29,34,124,89,1,Matches
456,Luca Ceppitelli,it ITA,DF,Cagliari,it Serie A,28,1989,22.8,40,24,28,11,1,13,22,59.1,9,34,24,10,20,60,111,2,Matches
457,Fabio Ceravolo,it ITA,FW,Parma,it Serie A,31,1987,13.2,5,1,2,1,2,1,11,9.1,10,9,1,8,2,7,19,0,Matches
458,Alberto Cerri,it ITA,FW,Cagliari,it Serie A,22,1996,7.4,3,2,2,1,0,0,7,0.0,7,7,1,6,2,5,4,0,Matches
459,Boštjan Cesar,si SVN,DF,Chievo,it Serie A,36,1982,12.0,16,10,9,7,0,7,17,41.2,10,14,8,6,14,30,60,2,Matches
460,Nacer Chadli,be BEL,"MF,DF",Monaco,fr Ligue 1,28,1989,7.7,11,5,4,4,3,3,8,37.5,5,7,1,6,3,14,7,0,Matches
461,Fouad Chafik,ma MAR,DF,Dijon,fr Ligue 1,31,1986,20.5,44,31,29,12,3,23,36,63.9,13,17,3,14,25,69,71,0,Matches
462,Nathaniel Chalobah,eng ENG,MF,Watford,eng Premier League,23,1994,3.0,3,2,1,2,0,2,7,28.6,5,2,1,1,5,8,7,0,Matches
463,Calum Chambers,eng ENG,"MF,DF",Fulham,eng Premier League,23,1995,28.8,64,36,32,27,5,16,48,33.3,32,37,12,25,69,133,113,4,Matches
464,Timothy Chandler,us USA,DF,Eint Frankfurt,de Bundesliga,28,1990,0.2,0,0,0,0,0,0,0,,0,0,0,0,0,0,0,0,Matches
465,Kwon Chang-hoon,kr KOR,"FW,MF",Dijon,fr Ligue 1,24,1994,10.4,7,4,3,2,2,0,12,0.0,12,16,0,16,8,15,8,0,Matches
466,Charles,br BRA,FW,Eibar,es La Liga,34,1984,19.3,7,5,1,3,3,2,13,15.4,11,14,1,13,4,11,14,0,Matches
467,Xavier Chavalerin,fr FRA,MF,Reims,fr Ligue 1,27,1991,36.0,106,61,56,39,11,28,72,38.9,44,44,12,32,72,178,39,1,Matches
468,Pablo Chavarría,ar ARG,FW,Reims,fr Ligue 1,30,1988,21.9,20,12,8,6,6,3,15,20.0,12,11,0,11,4,24,19,0,Matches
469,Chechu,es ESP,DF,Rayo Vallecano,es La Liga,36,1982,1.0,0,0,0,0,0,0,2,0.0,2,0,0,0,2,2,5,0,Matches
470,Pape Cheikh Diop,sn SEN,MF,Lyon,fr Ligue 1,20,1997,5.0,1,0,0,1,0,0,5,0.0,5,6,2,4,2,3,2,1,Matches
471,Chema,es ESP,DF,Levante,es La Liga,26,1992,13.9,27,19,16,9,2,13,19,68.4,6,19,11,8,19,46,83,0,Matches
472,Denis Cheryshev,ru RUS,MF,Valencia,es La Liga,27,1990,19.0,46,32,15,22,9,17,37,45.9,20,35,3,32,15,61,16,0,Matches
473,Raman Chibsah,gh GHA,MF,Frosinone,it Serie A,25,1993,29.1,46,27,25,19,2,16,54,29.6,38,45,10,35,32,78,28,1,Matches
474,Leandro Chichizola,ar ARG,GK,Getafe,es La Liga,28,1990,1.0,0,0,0,0,0,0,0,,0,0,0,0,0,0,1,0,Matches
475,Giorgio Chiellini,it ITA,DF,Juventus,it Serie A,33,1984,22.1,24,13,20,2,2,5,8,62.5,3,22,15,7,30,54,96,1,Matches
476,Federico Chiesa,it ITA,FW,Fiorentina,it Serie A,20,1997,33.7,46,27,8,17,21,10,40,25.0,30,24,1,23,10,56,12,0,Matches
477,Ben Chilwell,eng ENG,DF,Leicester City,eng Premier League,21,1996,36.0,55,29,34,18,3,24,55,43.6,31,37,7,30,38,93,156,0,Matches
478,Vlad Chiricheș,ro ROU,DF,Napoli,it Serie A,28,1989,1.6,2,1,1,1,0,0,2,0.0,2,2,2,0,1,3,2,0,Matches
479,Tahith Chong,nl NED,FW,Manchester Utd,eng Premier League,18,1999,0.4,0,0,0,0,0,0,0,,0,1,0,1,0,0,1,0,Matches
480,Hamza Choudhury,eng ENG,MF,Leicester City,eng Premier League,20,1997,6.6,24,10,13,10,1,9,15,60.0,6,12,3,9,15,39,13,0,Matches
481,Andreas Christensen,dk DEN,DF,Chelsea,eng Premier League,22,1996,6.9,10,4,2,6,2,2,5,40.0,3,4,2,2,4,14,29,0,Matches
482,Cyrus Christie,ie IRL,"DF,MF",Fulham,eng Premier League,25,1992,21.6,43,23,26,13,4,18,41,43.9,23,25,11,14,29,72,96,1,Matches
483,Samuel Chukwueze,ng NGA,"MF,FW",Villarreal,es La Liga,19,1999,19.0,19,11,7,10,2,9,31,29.0,22,11,2,9,10,29,2,0,Matches
484,Camillo Ciano,it ITA,"FW,MF",Frosinone,it Serie A,28,1990,27.3,33,15,12,10,11,8,50,16.0,42,28,4,24,8,41,16,0,Matches
485,Amato Ciciretti,it ITA,"FW,MF",Parma,it Serie A,24,1993,1.5,1,0,1,0,0,0,0,,0,3,0,3,3,4,0,0,Matches
486,Luca Cigarini,it ITA,MF,Cagliari,it Serie A,32,1986,18.7,54,33,27,22,5,28,63,44.4,35,28,5,23,26,80,41,0,Matches
487,Per Ciljan Skjelbred,no NOR,MF,Hertha BSC,de Bundesliga,31,1987,11.1,26,18,13,12,1,5,22,22.7,17,10,1,9,20,46,14,0,Matches
488,Jasper Cillessen,nl NED,GK,Barcelona,es La Liga,29,1989,3.0,0,0,0,0,0,0,0,,0,0,0,0,0,0,3,2,Matches
489,Laurent Ciman,be BEL,DF,Dijon,fr Ligue 1,32,1985,8.0,11,6,9,2,0,7,16,43.8,9,13,9,4,7,18,37,0,Matches
490,Daniel Ciofani,it ITA,FW,Frosinone,it Serie A,33,1985,18.0,8,6,2,5,1,3,7,42.9,4,4,0,4,3,11,9,0,Matches
491,Thiago Cionek,pl POL,DF,SPAL,it Serie A,32,1986,28.2,75,44,46,25,4,29,56,51.8,27,34,22,12,55,130,144,0,Matches
492,Ibrahima Cissé,gn GUI,MF,Fulham,eng Premier League,24,1994,1.0,0,0,0,0,0,0,1,0.0,1,0,0,0,3,3,4,0,Matches
493,Till Cissokho,fr FRA,DF,Bordeaux,fr Ligue 1,18,2000,0.9,1,0,1,0,0,0,0,,0,0,0,0,2,3,3,0,Matches
494,Ciaran Clark,ie IRL,DF,Newcastle Utd,eng Premier League,28,1989,9.5,20,17,15,5,0,9,12,75.0,3,11,7,4,12,32,58,0,Matches
495,Tom Cleverley,eng ENG,MF,Watford,eng Premier League,28,1989,5.3,17,9,11,4,2,6,22,27.3,16,4,0,4,5,22,11,0,Matches
496,Nathaniel Clyne,eng ENG,DF,Bournemouth,eng Premier League,27,1991,12.7,33,18,16,14,3,11,23,47.8,12,13,3,10,16,49,33,1,Matches
497,Nathaniel Clyne,eng ENG,DF,Liverpool,eng Premier League,27,1991,1.2,4,3,2,2,0,2,4,50.0,2,1,0,1,2,6,1,0,Matches
498,Conor Coady,eng ENG,DF,Wolves,eng Premier League,25,1993,38.0,31,19,26,5,0,17,32,53.1,15,35,27,8,30,61,133,3,Matches
499,Marcus Coco,fr FRA,"FW,MF",Guingamp,fr Ligue 1,22,1996,20.4,39,23,20,10,9,16,33,48.5,17,24,0,24,23,62,14,0,Matches
500,Coke,es ESP,DF,Levante,es La Liga,31,1987,20.2,44,27,24,17,3,26,56,46.4,30,18,8,10,40,84,54,1,Matches
501,Joel Coleman,eng ENG,GK,Huddersfield,eng Premier League,22,1995,1.0,0,0,0,0,0,0,0,,0,0,0,0,0,0,0,0,Matches
502,Séamus Coleman,ie IRL,DF,Everton,eng Premier League,29,1988,28.4,44,25,23,18,3,19,30,63.3,11,14,5,9,26,70,86,0,Matches
503,Álex Collado,es ESP,FW,Barcelona,es La Liga,19,1999,0.9,1,0,0,1,0,0,1,0.0,1,3,0,3,0,1,2,0,Matches
504,Omar Colley,gm GAM,DF,Sampdoria,it Serie A,25,1992,19.6,18,11,12,6,0,12,13,92.3,1,24,16,8,22,40,102,0,Matches
505,Racine Coly,sn SEN,"DF,MF",Nice,fr Ligue 1,22,1995,5.6,7,2,1,5,1,4,11,36.4,7,6,1,5,9,16,11,1,Matches
506,Kingsley Coman,fr FRA,"FW,MF",Bayern Munich,de Bundesliga,22,1996,15.3,11,6,4,4,3,6,19,31.6,13,20,0,20,5,16,3,0,Matches
507,Santi Comesaña,es ESP,MF,Rayo Vallecano,es La Liga,21,1996,22.6,56,35,29,25,2,22,61,36.1,39,30,5,25,30,86,45,2,Matches
508,Daniel Congré,fr FRA,DF,Montpellier,fr Ligue 1,33,1985,36.6,75,45,46,26,3,38,65,58.5,27,35,15,20,67,142,106,1,Matches
509,Andrea Consigli,it ITA,GK,Sassuolo,it Serie A,31,1987,35.7,0,0,0,0,0,0,2,0.0,2,0,0,0,1,1,15,6,Matches
510,Andrea Conti,it ITA,DF,Milan,it Serie A,24,1994,5.6,9,5,3,4,2,2,9,22.2,7,4,0,4,15,24,12,1,Matches
511,Lewis Cook,eng ENG,MF,Bournemouth,eng Premier League,21,1997,8.0,13,6,6,7,0,8,19,42.1,11,8,2,6,8,21,7,1,Matches
512,Steve Cook,eng ENG,DF,Bournemouth,eng Premier League,27,1991,31.0,36,19,31,5,0,20,27,74.1,7,36,21,15,50,86,202,1,Matches
513,Duje Čop,hr CRO,FW,Valladolid,es La Liga,28,1990,7.6,5,4,1,2,2,0,8,0.0,8,8,3,5,3,8,3,0,Matches
514,Francis Coquelin,fr FRA,MF,Valencia,es La Liga,27,1991,19.6,46,31,25,14,7,17,35,48.6,18,21,5,16,49,95,29,1,Matches
515,Gabriele Corbo,it ITA,DF,Bologna,it Serie A,18,2000,0.1,0,0,0,0,0,0,0,,0,0,0,0,0,0,0,0,Matches
516,Iñigo Córdoba,es ESP,"FW,MF",Athletic Club,es La Liga,21,1997,14.7,37,23,15,17,5,14,47,29.8,33,27,0,27,17,54,13,0,Matches
517,Sergio Córdova,ve VEN,FW,Augsburg,de Bundesliga,20,1997,5.9,9,5,3,4,2,2,6,33.3,4,0,0,0,3,12,5,0,Matches
518,Benjamin Corgnet,fr FRA,"MF,FW",Strasbourg,fr Ligue 1,31,1987,7.5,21,12,7,9,5,4,11,36.4,7,1,0,1,6,27,9,0,Matches
519,Ante Ćorić,hr CRO,MF,Roma,it Serie A,21,1997,0.3,0,0,0,0,0,0,0,,0,0,0,0,0,0,0,0,Matches
520,Jack Cork,eng ENG,MF,Burnley,eng Premier League,29,1989,36.8,51,27,12,34,5,18,46,39.1,28,39,16,23,29,80,82,2,Matches
521,Andreas Cornelius,dk DEN,FW,Bordeaux,fr Ligue 1,25,1993,8.8,4,1,1,3,0,1,4,25.0,3,4,1,3,1,5,21,0,Matches
522,Maxwel Cornet,ci CIV,FW,Lyon,fr Ligue 1,21,1996,14.2,14,11,4,7,3,1,11,9.1,10,10,0,10,5,19,8,0,Matches
523,Quentin Cornette,fr FRA,"FW,MF",Amiens,fr Ligue 1,24,1994,2.3,5,1,2,2,1,3,6,50.0,3,3,0,3,1,6,5,0,Matches
524,Ángel Correa,ar ARG,"MF,FW",Atlético Madrid,es La Liga,23,1995,21.3,38,19,19,12,7,10,53,18.9,43,28,5,23,17,55,20,0,Matches
525,Joaquín Correa,ar ARG,"FW,MF",Lazio,it Serie A,23,1994,21.4,21,13,6,12,3,5,18,27.8,13,14,3,11,2,23,7,0,Matches
526,Danny da Costa,de GER,"DF,FW",Eint Frankfurt,de Bundesliga,25,1993,33.7,61,35,29,25,7,18,42,42.9,24,51,9,42,32,93,67,0,Matches
527,Diego Costa,es ESP,FW,Atlético Madrid,es La Liga,29,1988,12.4,4,1,0,4,0,1,8,12.5,7,5,0,5,2,6,6,0,Matches
528,Douglas Costa,br BRA,"FW,MF",Juventus,it Serie A,27,1990,6.9,10,8,2,8,0,4,9,44.4,5,8,0,8,4,14,2,0,Matches
529,Filippo Costa,it ITA,"DF,FW",SPAL,it Serie A,23,1995,6.3,15,13,6,6,3,4,9,44.4,5,10,3,7,8,23,31,1,Matches
530,Hélder Costa,ao ANG,"FW,MF",Wolves,eng Premier League,24,1994,14.9,18,14,7,7,4,7,23,30.4,16,15,0,15,9,27,6,0,Matches
531,Jaume Costa,es ESP,DF,Villarreal,es La Liga,30,1988,16.6,33,21,26,5,2,20,33,60.6,13,12,3,9,21,54,61,0,Matches
532,Nuno da Costa,cv CPV,FW,Strasbourg,fr Ligue 1,27,1991,22.8,39,27,10,19,10,10,38,26.3,28,24,1,23,14,53,9,0,Matches
533,David Costas,es ESP,DF,Celta Vigo,es La Liga,23,1995,13.0,25,13,21,4,0,10,15,66.7,5,12,6,6,18,43,58,1,Matches
534,Benoît Costil,fr FRA,GK,Bordeaux,fr Ligue 1,31,1987,37.0,2,0,2,0,0,2,2,100.0,0,0,0,0,0,2,14,3,Matches
535,Kalifa Coulibaly,ml MLI,FW,Nantes,fr Ligue 1,26,1991,19.5,15,7,1,10,4,4,11,36.4,7,8,1,7,4,19,22,0,Matches
536,Senou Coulibaly,ml MLI,DF,Dijon,fr Ligue 1,23,1994,4.6,13,7,10,3,0,3,8,37.5,5,8,2,6,11,24,20,0,Matches
537,Thibaut Courtois,be BEL,GK,Real Madrid,es La Liga,26,1992,27.0,0,0,0,0,0,0,2,0.0,2,0,0,0,2,2,5,0,Matches
538,Philippe Coutinho,br BRA,"FW,MF",Barcelona,es La Liga,26,1992,22.4,16,11,1,6,9,7,22,31.8,15,21,2,19,12,28,8,0,Matches
539,Nicolas Cozza,fr FRA,DF,Montpellier,fr Ligue 1,19,1999,10.9,19,15,14,5,0,4,10,40.0,6,13,10,3,23,42,37,1,Matches
540,Alessio Cragno,it ITA,GK,Cagliari,it Serie A,24,1994,38.0,0,0,0,0,0,0,1,0.0,1,0,0,0,2,2,19,1,Matches
541,Aaron Cresswell,eng ENG,DF,West Ham,eng Premier League,28,1989,17.7,29,16,14,11,4,13,25,52.0,12,28,7,21,23,52,58,0,Matches
542,Domenico Criscito,it ITA,DF,Genoa,it Serie A,31,1986,34.1,111,75,64,36,11,57,83,68.7,26,40,11,29,70,181,142,0,Matches
543,Lorenzo Crisetig,it ITA,MF,Frosinone,it Serie A,25,1993,5.6,14,11,4,8,2,6,15,40.0,9,8,3,5,12,26,12,0,Matches
544,Bryan Cristante,it ITA,MF,Roma,it Serie A,23,1995,26.9,63,34,21,35,7,19,49,38.8,30,37,5,32,29,92,48,0,Matches
545,Sebastián Cristóforo,uy URU,MF,Getafe,es La Liga,24,1993,5.0,15,8,4,8,3,5,14,35.7,9,13,0,13,8,23,5,0,Matches
546,Enzo Crivelli,fr FRA,FW,Caen,fr Ligue 1,23,1995,25.1,20,14,10,8,2,8,13,61.5,5,5,0,5,4,24,28,1,Matches
547,Peter Crouch,eng ENG,FW,Burnley,eng Premier League,37,1981,1.0,1,1,0,1,0,1,1,100.0,0,0,0,0,0,1,2,0,Matches
548,Alessio da Cruz,,"FW,MF",Parma,it Serie A,21,1997,1.6,2,1,0,2,0,0,1,0.0,1,0,0,0,0,2,0,0,Matches
549,Juan Cuadrado,co COL,"MF,DF",Juventus,it Serie A,30,1988,13.6,20,15,6,9,5,5,23,21.7,18,14,3,11,18,38,11,0,Matches
550,Cucho,co COL,FW,Huesca,es La Liga,19,1999,23.9,22,13,6,10,6,6,18,33.3,12,23,2,21,9,31,21,0,Matches
551,Marc Cucurella,es ESP,"MF,FW",Eibar,es La Liga,20,1998,26.2,49,37,13,21,15,10,23,43.5,13,36,3,33,20,69,24,0,Matches
552,Iván Cuéllar,es ESP,GK,Leganés,es La Liga,34,1984,33.9,0,0,0,0,0,0,1,0.0,1,0,0,0,2,2,10,0,Matches
553,Mickaël Cuisance,fr FRA,MF,M'Gladbach,de Bundesliga,18,1999,3.1,11,6,6,3,2,3,8,37.5,5,3,0,3,5,16,4,0,Matches
554,Matheus Cunha,br BRA,"FW,MF",RB Leipzig,de Bundesliga,19,1999,9.5,10,6,3,5,2,3,13,23.1,10,13,1,12,4,14,8,0,Matches
555,Greg Cunningham,ie IRL,DF,Cardiff City,eng Premier League,27,1991,7.0,18,7,11,4,3,9,16,56.3,7,9,3,6,17,35,16,1,Matches
556,Patrick Cutrone,it ITA,FW,Milan,it Serie A,20,1998,16.2,9,5,0,3,6,2,16,12.5,14,13,2,11,7,16,13,0,Matches
557,Wylan Cyprien,fr FRA,MF,Nice,fr Ligue 1,23,1995,26.2,40,20,16,21,3,15,43,34.9,28,20,5,15,11,51,15,0,Matches
558,Marco D'Alessandro,it ITA,DF,Udinese,it Serie A,27,1991,16.6,55,34,34,15,6,29,49,59.2,20,24,2,22,9,64,50,1,Matches
559,Danilo D'Ambrosio,it ITA,DF,Inter,it Serie A,29,1988,28.7,69,40,34,27,8,24,57,42.1,33,25,8,17,27,96,39,0,Matches
560,Damien Da Silva,fr FRA,DF,Rennes,fr Ligue 1,30,1988,31.9,41,25,31,9,1,18,24,75.0,6,42,36,6,39,80,152,0,Matches
561,Kouadio-Yves Dabila,ci CIV,DF,Lille,fr Ligue 1,21,1997,8.7,11,6,10,1,0,5,6,83.3,1,13,9,4,6,17,44,0,Matches
562,Abdoulaye Dabo,fr FRA,FW,Nantes,fr Ligue 1,17,2001,1.3,3,1,1,0,2,0,0,,0,0,0,0,0,3,0,0,Matches
563,Bryan Dabo,bf BFA,"MF,DF",Fiorentina,it Serie A,26,1992,9.2,10,6,1,8,1,1,6,16.7,5,11,6,5,10,20,21,0,Matches
564,Christoph Daferner,de GER,FW,Freiburg,de Bundesliga,20,1998,0.3,1,0,1,0,0,0,0,,0,0,0,0,1,2,0,0,Matches
565,Colin Dagba,fr FRA,"DF,MF",Paris S-G,fr Ligue 1,19,1998,10.2,24,12,10,12,2,13,19,68.4,6,10,0,10,9,33,10,1,Matches
566,Mahmoud Dahoud,de GER,MF,Dortmund,de Bundesliga,22,1996,7.7,16,10,4,10,2,3,15,20.0,12,10,0,10,17,33,8,0,Matches
567,Leon Dajaku,de GER,"DF,MF",Stuttgart,de Bundesliga,17,2001,0.3,2,1,0,1,1,0,0,,0,1,0,1,0,2,0,0,Matches
568,Felipe dal Belo,br BRA,DF,SPAL,it Serie A,34,1984,26.2,36,25,21,13,2,16,32,50.0,16,29,18,11,17,53,88,1,Matches
569,Nicola Dalmonte,it ITA,"FW,MF",Genoa,it Serie A,20,1997,0.5,2,2,0,2,0,0,0,,0,0,0,0,0,2,0,0,Matches
570,Diogo Dalot,pt POR,"DF,FW",Manchester Utd,eng Premier League,19,1999,11.3,24,12,8,14,2,14,19,73.7,5,15,2,13,10,34,35,1,Matches
571,Matty Daly,eng ENG,MF,Huddersfield,eng Premier League,17,2001,0.8,0,0,0,0,0,0,0,,0,0,0,0,0,0,0,0,Matches
572,Vitalie Damașcan,md MDA,MF,Torino,it Serie A,19,1999,0.0,1,1,0,1,0,1,1,100.0,0,0,0,0,0,1,0,0,Matches
573,Loïc Damour,fr FRA,MF,Cardiff City,eng Premier League,27,1991,0.3,0,0,0,0,0,0,1,0.0,1,0,0,0,0,0,0,0,Matches
574,Charlie Daniels,eng ENG,DF,Bournemouth,eng Premier League,31,1986,17.6,25,15,18,6,1,13,22,59.1,9,14,4,10,20,45,56,2,Matches
575,Danilo,br BRA,DF,Manchester City,eng Premier League,27,1991,9.0,20,16,6,12,2,12,17,70.6,5,5,0,5,15,35,22,1,Matches
576,Scott Dann,eng ENG,DF,Crystal Palace,eng Premier League,31,1987,7.4,6,2,5,1,0,3,7,42.9,4,16,12,4,5,11,46,0,Matches
577,Kevin Danso,at AUT,DF,Augsburg,de Bundesliga,19,1998,13.9,25,14,21,3,1,11,14,78.6,3,25,17,8,19,44,72,0,Matches
578,Dante,br BRA,DF,Nice,fr Ligue 1,34,1983,35.8,54,40,36,16,2,24,41,58.5,17,56,30,26,38,92,156,2,Matches
579,Palkó Dárdai,hu HUN,"FW,MF",Hertha BSC,de Bundesliga,19,1999,1.3,1,1,1,0,0,0,0,,0,1,0,1,0,1,0,0,Matches
580,Sergi Darder,es ESP,MF,Espanyol,es La Liga,24,1993,30.1,60,35,23,32,5,25,69,36.2,44,18,3,15,22,82,30,0,Matches
581,Vladimír Darida,cz CZE,MF,Hertha BSC,de Bundesliga,27,1990,4.2,8,5,3,4,1,2,3,66.7,1,5,0,5,8,16,5,0,Matches
582,Matteo Darmian,it ITA,DF,Manchester Utd,eng Premier League,28,1989,4.9,14,8,10,4,0,4,11,36.4,7,9,0,9,7,21,20,0,Matches
583,Alphonso Davies,ca CAN,"MF,FW",Bayern Munich,de Bundesliga,17,2000,0.9,1,1,1,0,0,0,0,,0,2,0,2,2,3,1,0,Matches
584,Ben Davies,wls WAL,DF,Tottenham,eng Premier League,25,1993,20.5,56,30,39,13,4,38,54,70.4,16,23,10,13,23,79,68,1,Matches
585,Tom Davies,eng ENG,MF,Everton,eng Premier League,20,1998,10.9,27,17,9,17,1,7,23,30.4,16,15,1,14,16,43,9,1,Matches
586,Steven Davis,nir NIR,MF,Southampton,eng Premier League,33,1985,1.1,2,2,0,2,0,0,0,,0,2,0,2,1,3,5,0,Matches
587,Kevin De Bruyne,be BEL,MF,Manchester City,eng Premier League,27,1991,10.8,22,15,6,12,4,7,21,33.3,14,13,1,12,3,25,2,1,Matches
588,Sebastien De Maio,fr FRA,DF,Udinese,it Serie A,31,1987,13.0,11,7,7,4,0,3,12,25.0,9,22,17,5,12,23,93,0,Matches
589,Sebastien De Maio,fr FRA,DF,Bologna,it Serie A,31,1987,5.5,5,4,3,2,0,1,2,50.0,1,8,5,3,1,6,32,0,Matches
590,Rodrigo De Paul,ar ARG,"MF,FW",Udinese,it Serie A,24,1994,35.4,53,33,21,27,5,13,42,31.0,29,35,2,33,32,85,28,0,Matches
591,Daniele De Rossi,it ITA,MF,Roma,it Serie A,35,1983,14.1,16,10,6,7,3,3,14,21.4,11,18,12,6,26,42,33,0,Matches
592,Mattia De Sciglio,it ITA,DF,Juventus,it Serie A,25,1992,19.4,40,28,24,14,2,17,28,60.7,11,18,6,12,26,66,58,1,Matches
593,Lorenzo De Silvestri,it ITA,DF,Torino,it Serie A,30,1988,26.8,15,11,8,5,2,7,24,29.2,17,53,3,50,22,37,69,2,Matches
594,Lucas Deaux,fr FRA,MF,Guingamp,fr Ligue 1,29,1988,13.2,41,28,21,18,2,20,41,48.8,21,10,0,10,11,52,7,0,Matches
595,Mathieu Debuchy,fr FRA,DF,Saint-Étienne,fr Ligue 1,33,1985,21.6,43,26,25,13,5,22,37,59.5,15,17,7,10,47,90,64,0,Matches
596,Troy Deeney,eng ENG,FW,Watford,eng Premier League,30,1988,28.3,24,14,8,10,6,7,32,21.9,25,22,4,18,7,31,29,0,Matches
597,Jermain Defoe,eng ENG,FW,Bournemouth,eng Premier League,35,1982,0.3,0,0,0,0,0,0,0,,0,0,0,0,0,0,0,0,Matches
598,Steven Defour,be BEL,MF,Burnley,eng Premier League,30,1988,5.0,8,4,2,4,2,3,14,21.4,11,11,3,8,8,16,7,0,Matches
599,Grégoire Defrel,mq MTQ,"FW,MF",Sampdoria,it Serie A,27,1991,26.0,40,29,10,16,14,9,21,42.9,12,15,0,15,3,43,9,0,Matches
600,Alessandro Deiola,it ITA,MF,Cagliari,it Serie A,22,1995,5.0,7,3,1,6,0,3,13,23.1,10,14,0,14,6,13,8,0,Matches
601,Alessandro Deiola,it ITA,"MF,FW",Parma,it Serie A,22,1995,6.1,12,8,4,7,1,4,10,40.0,6,15,4,11,11,23,10,0,Matches
602,Romain Del Castillo,fr FRA,"MF,FW",Rennes,fr Ligue 1,22,1996,14.9,36,20,15,13,8,13,37,35.1,24,19,0,19,20,56,7,1,Matches
603,Thomas Delaney,dk DEN,MF,Dortmund,de Bundesliga,26,1991,25.4,69,54,28,39,2,19,30,63.3,11,30,9,21,58,127,43,0,Matches
604,Moisés Delgado,es ESP,DF,Valladolid,es La Liga,24,1994,3.0,7,6,3,3,1,2,3,66.7,1,2,1,1,3,10,9,0,Matches
605,Cristian Dell'Orco,it ITA,DF,Empoli,it Serie A,24,1994,11.5,18,11,11,5,2,4,11,36.4,7,13,7,6,17,35,44,0,Matches
606,Cristian Dell'Orco,it ITA,DF,Sassuolo,it Serie A,24,1994,1.2,1,1,1,0,0,1,3,33.3,2,1,0,1,1,2,3,0,Matches
607,Andy Delort,dz ALG,FW,Montpellier,fr Ligue 1,26,1991,34.6,34,20,7,20,7,8,34,23.5,26,28,7,21,4,38,7,0,Matches
608,Fabian Delph,eng ENG,DF,Manchester City,eng Premier League,28,1989,8.1,23,14,11,7,5,12,23,52.2,11,3,0,3,13,36,19,1,Matches
609,Mousa Dembélé,be BEL,MF,Tottenham,eng Premier League,31,1987,5.7,13,9,6,6,1,4,7,57.1,3,4,1,3,7,20,5,2,Matches
610,Moussa Dembélé,fr FRA,FW,Lyon,fr Ligue 1,22,1996,22.4,12,4,0,8,4,4,14,28.6,10,15,2,13,2,14,13,0,Matches
611,Ousmane Dembélé,fr FRA,"FW,MF",Barcelona,es La Liga,21,1997,18.5,23,15,4,13,6,6,18,33.3,12,13,0,13,5,28,4,0,Matches
612,Jessy Deminguet,fr FRA,MF,Caen,fr Ligue 1,20,1998,14.1,37,25,18,17,2,15,40,37.5,25,19,3,16,18,55,28,1,Matches
613,Merih Demiral,tr TUR,DF,Sassuolo,it Serie A,20,1998,14.0,24,16,23,1,0,10,13,76.9,3,16,11,5,19,43,80,0,Matches
614,Kerem Demirbay,de GER,MF,Hoffenheim,de Bundesliga,25,1993,22.4,57,35,20,27,10,11,51,21.6,40,34,10,24,22,79,25,0,Matches
615,Diego Demme,de GER,MF,RB Leipzig,de Bundesliga,26,1991,22.8,75,47,24,43,8,33,67,49.3,34,36,3,33,26,101,15,0,Matches
616,Jason Denayer,be BEL,DF,Lyon,fr Ligue 1,23,1995,30.6,33,21,22,11,0,16,24,66.7,8,36,32,4,26,59,122,1,Matches
617,Leander Dendoncker,be BEL,MF,Wolves,eng Premier League,23,1995,16.3,53,26,25,25,3,16,47,34.0,31,35,6,29,23,76,34,1,Matches
618,Fabio Depaoli,it ITA,DF,Chievo,it Serie A,21,1997,27.4,74,43,37,32,5,34,67,50.7,33,42,16,26,35,109,99,3,Matches
619,Laurent Depoitre,be BEL,FW,Huddersfield,eng Premier League,29,1988,11.9,6,4,2,3,1,0,3,0.0,3,9,0,9,2,8,8,0,Matches
620,Clément Depres,fr FRA,FW,Nîmes,fr Ligue 1,23,1994,4.9,2,2,1,1,0,1,4,25.0,3,3,0,3,0,2,6,0,Matches
621,Kiril Despodov,bg BUL,"FW,MF",Cagliari,it Serie A,21,1996,1.2,0,0,0,0,0,0,1,0.0,1,1,0,1,0,0,0,0,Matches
622,Daniele Dessena,it ITA,MF,Cagliari,it Serie A,31,1987,3.9,2,2,0,2,0,1,3,33.3,2,3,1,2,3,5,5,0,Matches
623,Mattia Destro,it ITA,FW,Bologna,it Serie A,27,1991,5.5,3,2,2,0,1,0,0,,0,4,0,4,0,3,6,0,Matches
624,Gerard Deulofeu,es ESP,"FW,MF",Watford,eng Premier League,24,1994,23.0,11,6,5,3,3,4,26,15.4,22,16,0,16,14,25,3,0,Matches
625,Jacopo Dezi,it ITA,MF,Parma,it Serie A,26,1992,1.0,1,1,1,0,0,0,1,0.0,1,1,0,1,3,4,2,0,Matches
626,Federico Di Francesco,it ITA,"FW,MF",Sassuolo,it Serie A,24,1994,11.9,10,6,3,4,3,4,7,57.1,3,12,1,11,5,15,5,0,Matches
627,Antonio Di Gaudio,it ITA,FW,Parma,it Serie A,28,1989,7.8,2,0,0,1,1,1,5,20.0,4,6,1,5,3,5,5,0,Matches
628,Giovanni Di Lorenzo,it ITA,"DF,FW",Empoli,it Serie A,24,1993,37.0,66,43,38,23,5,24,44,54.5,20,34,13,21,36,102,93,3,Matches
629,Ángel Di María,ar ARG,"FW,MF",Paris S-G,fr Ligue 1,30,1988,25.8,29,17,12,10,7,10,42,23.8,32,24,1,23,16,45,4,0,Matches
630,Franco Di Santo,ar ARG,FW,Rayo Vallecano,es La Liga,29,1989,1.9,2,2,1,0,1,1,2,50.0,1,0,0,0,0,2,2,0,Matches
631,Franco Di Santo,ar ARG,"MF,FW",Schalke 04,de Bundesliga,29,1989,2.7,2,1,0,2,0,1,4,25.0,3,3,1,2,1,3,3,0,Matches
632,Boulaye Dia,sn SEN,FW,Reims,fr Ligue 1,21,1996,8.3,12,6,3,8,1,5,11,45.5,6,4,2,2,4,16,9,0,Matches
633,Fousseni Diabaté,ml MLI,FW,Leicester City,eng Premier League,22,1995,0.6,2,0,2,0,0,0,1,0.0,1,2,0,2,0,2,0,0,Matches
634,Moussa Diaby,fr FRA,"MF,DF",Paris S-G,fr Ligue 1,19,1999,12.7,14,8,7,2,5,2,11,18.2,9,7,1,6,12,26,6,0,Matches
635,Adama Diakhaby,fr FRA,"FW,MF",Huddersfield,eng Premier League,22,1996,6.1,6,3,4,1,1,3,11,27.3,8,7,0,7,1,7,2,0,Matches
636,Mouctar Diakhaby,gn GUI,DF,Valencia,es La Liga,21,1996,17.6,14,8,10,4,0,5,10,50.0,5,24,16,8,20,34,94,1,Matches
637,Bafodé Diakité,fr FRA,DF,Toulouse,fr Ligue 1,17,2001,7.0,15,7,5,9,1,10,14,71.4,4,15,3,12,11,26,29,0,Matches
638,Abdou Diallo,sn SEN,DF,Dortmund,de Bundesliga,22,1996,26.4,36,20,20,13,3,11,15,73.3,4,28,15,13,26,62,91,1,Matches
639,Abdoulaye Diallo,sn SEN,GK,Rennes,fr Ligue 1,26,1992,5.5,1,1,1,0,0,1,1,100.0,0,0,0,0,0,1,1,0,Matches
640,Mustapha Diallo,sn SEN,MF,Nîmes,fr Ligue 1,32,1986,5.1,16,11,6,9,1,5,13,38.5,8,7,1,6,10,26,14,1,Matches
641,Mohamed Diamé,sn SEN,MF,Newcastle Utd,eng Premier League,31,1987,24.1,76,46,35,36,5,16,54,29.6,38,42,9,33,30,106,39,1,Matches
642,Grady Diangana,eng ENG,"MF,FW",West Ham,eng Premier League,20,1998,6.8,20,9,8,8,4,5,14,35.7,9,11,0,11,1,21,4,0,Matches
643,Lassana Diarra,fr FRA,MF,Paris S-G,fr Ligue 1,33,1985,1.8,2,1,0,2,0,0,1,0.0,1,0,0,0,2,4,3,0,Matches
644,Amadou Diawara,gn GUI,MF,Napoli,it Serie A,21,1997,7.3,12,4,1,9,2,4,5,80.0,1,6,0,6,11,23,12,0,Matches
645,Brahim Díaz,es ESP,FW,Real Madrid,es La Liga,18,1999,4.2,9,7,5,4,0,3,8,37.5,5,2,0,2,0,9,0,0,Matches
646,Javier Díaz,es ESP,GK,Sevilla,es La Liga,21,1997,1.0,0,0,0,0,0,0,0,,0,0,0,0,0,0,0,0,Matches
647,Bakaye Dibassy,ml MLI,DF,Amiens,fr Ligue 1,28,1989,32.7,38,26,18,16,4,18,27,66.7,9,40,21,19,44,82,102,0,Matches
648,Lorenzo Dickmann,it ITA,"DF,MF",SPAL,it Serie A,21,1996,1.9,5,4,4,1,0,5,7,71.4,2,0,0,0,1,6,5,0,Matches
649,Daniel Didavi,de GER,"MF,FW",Stuttgart,de Bundesliga,28,1990,10.6,21,15,8,10,3,7,20,35.0,13,11,1,10,4,25,5,0,Matches
650,Étienne Didot,fr FRA,MF,Guingamp,fr Ligue 1,35,1983,23.4,41,29,12,27,2,17,44,38.6,27,37,10,27,37,78,35,0,Matches
651,Adrián Diéguez,es ESP,DF,Huesca,es La Liga,22,1996,8.3,16,10,11,4,1,9,16,56.3,7,9,4,5,12,28,46,1,Matches
652,Eric Dier,eng ENG,"MF,DF",Tottenham,eng Premier League,24,1994,16.7,26,16,7,15,4,19,47,40.4,28,27,12,15,21,47,46,1,Matches
653,Tim Dierßen,de GER,MF,Hannover 96,de Bundesliga,22,1996,0.2,0,0,0,0,0,0,0,,0,1,0,1,0,0,0,0,Matches
654,Lucas Digne,fr FRA,DF,Everton,eng Premier League,25,1993,32.9,71,46,45,18,8,28,45,62.2,17,43,9,34,60,131,116,0,Matches
655,Mitchell Dijks,nl NED,DF,Bologna,it Serie A,25,1993,22.5,30,18,19,7,4,13,36,36.1,23,18,1,17,23,53,49,0,Matches
656,Javairô Dilrosun,nl NED,"FW,MF",Hertha BSC,de Bundesliga,20,1998,10.0,14,10,7,5,2,3,7,42.9,4,18,2,16,7,21,9,0,Matches
657,Federico Dimarco,it ITA,"DF,MF",Parma,it Serie A,20,1997,9.9,22,7,10,8,4,10,20,50.0,10,13,6,7,15,37,27,0,Matches
658,Stole Dimitrievski,mk MKD,GK,Rayo Vallecano,es La Liga,24,1993,21.0,0,0,0,0,0,0,1,0.0,1,0,0,0,0,0,8,1,Matches
659,Tristan Dingomé,cm CMR,MF,Reims,fr Ligue 1,27,1991,14.9,27,15,11,10,6,7,24,29.2,17,16,3,13,11,38,5,0,Matches
660,Ismaël Diomandé,ci CIV,"MF,DF",Caen,fr Ligue 1,25,1992,14.4,28,15,15,12,1,11,20,55.0,9,17,7,10,10,38,37,0,Matches
661,Federico Dionisi,it ITA,"FW,MF",Frosinone,it Serie A,31,1987,2.3,3,1,0,2,1,0,2,0.0,2,0,0,0,0,3,0,0,Matches
662,Lois Diony,fr FRA,FW,Saint-Étienne,fr Ligue 1,25,1992,17.7,17,12,3,9,5,4,10,40.0,6,14,0,14,1,18,9,0,Matches
663,Issa Diop,fr FRA,DF,West Ham,eng Premier League,21,1997,33.0,68,38,47,21,0,37,57,64.9,20,58,36,22,64,132,161,4,Matches
664,Papakouli Diop,sn SEN,MF,Eibar,es La Liga,32,1986,26.1,66,40,14,44,8,14,34,41.2,20,21,1,20,37,103,27,0,Matches
665,Sofiane Diop,fr FRA,"MF,FW",Monaco,fr Ligue 1,18,2000,8.2,12,7,3,6,3,1,15,6.7,14,6,0,6,8,20,6,0,Matches
666,Assane Dioussé,sn SEN,MF,Chievo,it Serie A,20,1997,9.9,24,16,11,8,5,10,23,43.5,13,14,4,10,19,43,13,2,Matches
667,Assane Dioussé,sn SEN,MF,Saint-Étienne,fr Ligue 1,20,1997,2.4,6,4,3,3,0,2,4,50.0,2,2,0,2,1,7,7,1,Matches
668,Axel Disasi,fr FRA,DF,Reims,fr Ligue 1,20,1998,1.8,2,1,1,1,0,1,2,50.0,1,2,1,1,2,4,16,0,Matches
669,Djené,tg TOG,DF,Getafe,es La Liga,26,1991,33.1,54,34,43,11,0,26,43,60.5,17,27,11,16,74,128,154,3,Matches
670,Koffi Djidji,ci CIV,DF,Torino,it Serie A,25,1992,15.4,37,23,27,9,1,12,20,60.0,8,26,19,7,24,61,72,1,Matches
671,Koffi Djidji,ci CIV,DF,Nantes,fr Ligue 1,25,1992,1.0,1,1,1,0,0,0,0,,0,1,1,0,1,2,3,0,Matches
672,Alexander Djiku,gh GHA,DF,Caen,fr Ligue 1,23,1994,30.6,48,37,33,13,2,23,43,53.5,20,56,31,25,83,131,183,3,Matches
673,Papy Djilobodji,sn SEN,DF,Guingamp,fr Ligue 1,29,1988,1.9,1,1,1,0,0,0,0,,0,4,2,2,0,1,11,0,Matches
674,Berat Djimsiti,al ALB,DF,Atalanta,it Serie A,25,1993,20.1,32,22,18,12,2,13,29,44.8,16,21,11,10,34,66,96,0,Matches
675,Johan Djourou,ch SUI,DF,SPAL,it Serie A,31,1987,3.1,3,1,3,0,0,2,2,100.0,0,5,3,2,4,7,20,0,Matches
676,Marko Dmitrović,rs SRB,GK,Eibar,es La Liga,26,1992,24.0,0,0,0,0,0,0,0,,0,0,0,0,2,2,11,3,Matches
677,Matt Doherty,ie IRL,"DF,MF",Wolves,eng Premier League,26,1992,34.9,67,42,48,15,4,35,58,60.3,23,49,7,42,60,127,107,2,Matches
678,Keagan Dolly,za RSA,FW,Montpellier,fr Ligue 1,25,1993,1.0,1,1,0,1,0,0,3,0.0,3,0,0,0,0,1,0,0,Matches
679,Jaume Doménech,es ESP,GK,Valencia,es La Liga,27,1990,4.0,0,0,0,0,0,0,1,0.0,1,0,0,0,0,0,1,0,Matches
680,Giulio Donati,it ITA,DF,Mainz 05,de Bundesliga,28,1990,6.9,9,7,6,3,0,8,10,80.0,2,5,3,2,16,25,24,0,Matches
681,Ji Dong-won,kr KOR,"MF,FW",Augsburg,de Bundesliga,27,1991,9.9,10,6,5,3,2,6,16,37.5,10,13,2,11,8,18,10,0,Matches
682,Anastasios Donis,gr GRE,"FW,MF",Stuttgart,de Bundesliga,21,1996,10.7,15,13,8,4,3,3,11,27.3,8,7,0,7,4,19,0,0,Matches
683,Gianluigi Donnarumma,it ITA,GK,Milan,it Serie A,19,1999,34.3,1,1,1,0,0,1,2,50.0,1,0,0,0,1,2,13,3,Matches
684,Godfred Donsah,gh GHA,MF,Bologna,it Serie A,22,1996,1.7,3,1,3,0,0,3,5,60.0,2,4,2,2,0,3,7,0,Matches
685,Riccardo Doratiotto,it ITA,FW,Cagliari,it Serie A,19,1999,0.9,1,1,0,0,1,0,0,,0,0,0,0,0,1,0,0,Matches
686,Gabriel Dos Santos,br BRA,DF,Lille,fr Ligue 1,20,1997,11.8,18,11,13,4,1,4,7,57.1,3,14,6,8,19,37,60,2,Matches
687,Mathieu Dossevi,tg TOG,"FW,MF",Toulouse,fr Ligue 1,30,1988,27.4,42,28,20,11,11,13,40,32.5,27,29,1,28,33,75,13,0,Matches
688,Abdoulaye Doucouré,ml MLI,MF,Watford,eng Premier League,25,1993,34.0,71,38,27,32,12,19,57,33.3,38,31,8,23,34,105,55,5,Matches
689,Cheick Doukouré,ci CIV,MF,Levante,es La Liga,25,1992,3.5,13,7,3,7,3,4,15,26.7,11,10,2,8,3,16,3,1,Matches
690,Moussa Doumbia,ml MLI,"FW,MF",Reims,fr Ligue 1,23,1994,17.8,28,13,13,13,2,11,39,28.2,28,7,2,5,7,35,13,0,Matches
691,Seydou Doumbia,ci CIV,FW,Girona,es La Liga,30,1987,6.0,5,1,1,2,2,0,2,0.0,2,2,0,2,3,8,1,0,Matches
692,Souleyman Doumbia,ci CIV,DF,Rennes,fr Ligue 1,21,1996,6.7,11,7,9,2,0,6,10,60.0,4,6,1,5,4,15,20,0,Matches
693,Aleksandar Dragović,at AUT,DF,Leverkusen,de Bundesliga,27,1991,14.8,18,12,14,4,0,9,14,64.3,5,15,8,7,25,43,66,0,Matches
694,Bartłomiej Drągowski,pl POL,GK,Fiorentina,it Serie A,20,1997,2.5,0,0,0,0,0,0,0,,0,0,0,0,0,0,2,0,Matches
695,Bartłomiej Drągowski,pl POL,GK,Empoli,it Serie A,20,1997,14.0,0,0,0,0,0,0,1,0.0,1,0,0,0,0,0,7,1,Matches
696,Julian Draxler,de GER,"MF,FW",Paris S-G,fr Ligue 1,24,1993,22.7,41,22,11,19,11,16,43,37.2,27,20,1,19,15,56,2,1,Matches
697,Luke Dreher,eng ENG,FW,Crystal Palace,eng Premier League,19,1998,0.0,0,0,0,0,0,0,0,,0,0,0,0,0,0,0,0,Matches
698,Josip Drmić,ch SUI,FW,M'Gladbach,de Bundesliga,25,1992,2.5,2,0,0,2,0,1,2,50.0,1,1,0,1,1,3,0,0,Matches
699,Jaroslav Drobný,cz CZE,GK,Düsseldorf,de Bundesliga,38,1979,2.0,0,0,0,0,0,0,0,,0,0,0,0,0,0,1,0,Matches
700,Óscar Duarte,cr CRC,"DF,MF",Espanyol,es La Liga,29,1989,7.3,12,5,7,5,0,4,7,57.1,3,7,7,0,13,25,34,0,Matches
701,Rubén Duarte,es ESP,DF,Alavés,es La Liga,22,1995,30.8,72,35,45,20,7,34,64,53.1,30,46,12,34,57,129,130,1,Matches
702,Leo Dubois,fr FRA,DF,Lyon,fr Ligue 1,23,1994,22.7,51,22,25,21,5,20,35,57.1,15,30,10,20,22,73,61,1,Matches
703,Martin Dúbravka,sk SVK,GK,Newcastle Utd,eng Premier League,29,1989,38.0,2,0,2,0,0,1,3,33.3,2,0,0,0,0,2,20,5,Matches
704,Marvin Ducksch,de GER,FW,Düsseldorf,de Bundesliga,24,1994,9.1,3,1,0,2,1,1,5,20.0,4,4,0,4,4,7,11,0,Matches
705,Ondrej Duda,sk SVK,MF,Hertha BSC,de Bundesliga,23,1994,28.5,54,33,13,35,6,15,55,27.3,40,36,4,32,15,69,17,1,Matches
706,Shane Duffy,ie IRL,DF,Brighton,eng Premier League,26,1992,34.3,35,20,23,7,5,14,25,56.0,11,57,47,10,36,71,244,3,Matches
707,Demeaco Duhaney,eng ENG,DF,Huddersfield,eng Premier League,19,1998,0.5,1,0,1,0,0,1,3,33.3,2,2,0,2,1,2,1,0,Matches
708,Paul Dummett,wls WAL,DF,Newcastle Utd,eng Premier League,26,1991,22.1,34,22,24,9,1,19,32,59.4,13,25,11,14,37,71,133,0,Matches
709,Alfred Duncan,gh GHA,MF,Sassuolo,it Serie A,25,1993,20.5,33,21,15,15,3,19,48,39.6,29,20,6,14,15,48,18,0,Matches
710,Lewis Dunk,eng ENG,DF,Brighton,eng Premier League,26,1991,35.0,42,26,31,10,1,17,39,43.6,22,49,38,11,46,88,196,5,Matches
711,Maxime Dupé,fr FRA,GK,Nantes,fr Ligue 1,25,1993,10.4,0,0,0,0,0,0,0,,0,0,0,0,0,0,3,1,Matches
712,Erik Durm,de GER,DF,Huddersfield,eng Premier League,26,1992,22.8,35,22,24,8,3,14,33,42.4,19,26,6,20,41,76,42,0,Matches
713,Jimmy Durmaz,se SWE,"MF,FW",Toulouse,fr Ligue 1,29,1989,21.1,34,22,8,13,13,15,38,39.5,23,14,2,12,11,45,16,1,Matches
714,Riza Durmisi,dk DEN,DF,Lazio,it Serie A,24,1994,3.6,4,4,2,0,2,2,3,66.7,1,0,0,0,1,5,9,0,Matches
715,Hugo Duro,es ESP,"MF,FW",Getafe,es La Liga,18,1999,4.6,6,4,1,2,3,3,6,50.0,3,6,1,5,3,9,4,0,Matches
716,Raphael Dwamena,gh GHA,FW,Levante,es La Liga,22,1995,2.5,0,0,0,0,0,0,0,,0,2,1,1,0,0,2,0,Matches
717,Paulo Dybala,ar ARG,"FW,MF",Juventus,it Serie A,24,1993,23.7,17,8,3,9,5,7,23,30.4,16,20,2,18,14,31,1,0,Matches
718,Edin Džeko,ba BIH,FW,Roma,it Serie A,32,1986,28.7,13,7,3,5,5,4,16,25.0,12,10,1,9,0,13,36,1,Matches
719,Blerim Džemaili,ch SUI,MF,Bologna,it Serie A,32,1986,19.4,44,27,22,19,3,19,58,32.8,39,22,1,21,17,61,12,1,Matches
720,Félix Eboa Eboa,cm CMR,DF,Guingamp,fr Ligue 1,21,1997,27.0,47,33,26,20,1,16,22,72.7,6,37,24,13,39,86,136,2,Matches
721,Dennis Eckert,de GER,FW,Celta Vigo,es La Liga,21,1997,2.4,3,2,0,1,2,0,2,0.0,2,1,0,1,2,5,3,0,Matches
722,Bruno Ecuele Manga,ga GAB,DF,Cardiff City,eng Premier League,30,1988,37.5,69,36,48,16,5,29,58,50.0,29,62,28,34,81,150,179,4,Matches
723,Simone Edera,it ITA,MF,Torino,it Serie A,21,1997,0.9,0,0,0,0,0,0,1,0.0,1,1,0,1,1,1,0,0,Matches
724,Simone Edera,it ITA,FW,Bologna,it Serie A,21,1997,2.2,4,4,3,0,1,1,3,33.3,2,5,1,4,0,4,1,0,Matches
725,Ederson,br BRA,GK,Manchester City,eng Premier League,24,1993,38.0,3,3,2,1,0,3,3,100.0,0,0,0,0,1,4,12,2,Matches
726,Johannes Eggestein,de GER,"FW,MF",Werder Bremen,de Bundesliga,20,1998,12.4,13,9,7,4,2,5,19,26.3,14,13,0,13,4,17,7,0,Matches
727,Maximilian Eggestein,de GER,MF,Werder Bremen,de Bundesliga,21,1996,33.9,68,42,29,34,5,24,54,44.4,30,49,10,39,30,98,69,0,Matches
728,Albin Ekdal,se SWE,MF,Sampdoria,it Serie A,29,1989,29.4,61,39,16,38,7,37,68,54.4,31,42,12,30,53,114,62,1,Matches
729,Josip Elez,hr CRO,DF,Hannover 96,de Bundesliga,24,1994,7.2,8,3,5,3,0,2,11,18.2,9,13,4,9,6,14,27,0,Matches
730,Harvey Elliott,eng ENG,MF,Fulham,eng Premier League,15,2003,0.2,0,0,0,0,0,0,0,,0,1,0,1,0,0,0,0,Matches
731,Mohamed Elneny,eg EGY,MF,Arsenal,eng Premier League,26,1992,4.2,13,4,9,1,3,1,2,50.0,1,7,4,3,2,15,8,0,Matches
732,Aritz Elustondo,es ESP,DF,Real Sociedad,es La Liga,24,1994,25.0,47,29,31,14,2,26,41,63.4,15,23,7,16,39,86,150,0,Matches
733,Gorka Elustondo,es ESP,"MF,DF",Rayo Vallecano,es La Liga,31,1987,3.2,7,5,4,3,0,5,8,62.5,3,6,1,5,6,13,10,0,Matches
734,Nico Elvedi,ch SUI,DF,M'Gladbach,de Bundesliga,21,1996,29.1,41,19,34,7,0,23,33,69.7,10,30,13,17,47,88,135,6,Matches
735,Rodrigo Ely,br BRA,DF,Alavés,es La Liga,24,1993,4.8,8,5,5,3,0,5,7,71.4,2,9,7,2,7,15,30,0,Matches
736,Mohamed Elyounoussi,no NOR,MF,Southampton,eng Premier League,23,1994,8.8,16,12,7,6,3,6,19,31.6,13,11,1,10,6,22,5,0,Matches
737,Adri Embarba,es ESP,"MF,FW",Rayo Vallecano,es La Liga,26,1992,25.4,54,26,20,24,10,22,61,36.1,39,38,2,36,29,83,22,0,Matches
738,Breel Embolo,ch SUI,FW,Schalke 04,de Bundesliga,21,1997,14.9,22,17,4,13,5,1,9,11.1,8,11,0,11,4,26,6,0,Matches
739,Emerson,br BRA,"FW,DF",Betis,es La Liga,19,1999,3.5,9,7,6,1,2,3,10,30.0,7,6,0,6,7,16,12,0,Matches
740,Youssef En-Nesyri,ma MAR,FW,Leganés,es La Liga,21,1997,23.4,16,8,6,5,5,4,24,16.7,20,18,3,15,6,22,23,0,Matches
741,Björn Engels,be BEL,DF,Reims,fr Ligue 1,23,1994,33.0,11,8,6,5,0,6,16,37.5,10,30,24,6,44,55,181,3,Matches
742,Sergi Enrich,es ESP,FW,Eibar,es La Liga,28,1990,28.7,27,17,3,11,13,7,30,23.3,23,11,1,10,6,33,14,0,Matches
743,Javier Eraso,es ESP,"MF,FW",Leganés,es La Liga,28,1990,7.0,6,3,3,2,1,0,6,0.0,6,3,1,2,7,13,4,0,Matches
744,Christian Eriksen,dk DEN,MF,Tottenham,eng Premier League,26,1992,30.8,41,25,8,20,13,17,59,28.8,42,26,3,23,15,56,13,0,Matches
745,Patrick Erras,de GER,MF,Nürnberg,de Bundesliga,23,1995,13.6,15,10,7,7,1,7,19,36.8,12,24,13,11,23,38,45,0,Matches
746,Gonzalo Escalante,ar ARG,MF,Eibar,es La Liga,25,1993,19.9,49,28,11,35,3,19,46,41.3,27,37,2,35,21,70,21,0,Matches
747,Sergio Escudero,es ESP,"DF,FW",Sevilla,es La Liga,28,1989,17.2,43,29,20,18,5,18,35,51.4,17,22,4,18,24,67,52,0,Matches
748,Bernardo Espinosa,co COL,DF,Girona,es La Liga,29,1989,30.3,20,14,16,4,0,8,17,47.1,9,46,31,15,40,60,197,5,Matches
749,Michael Esser,de GER,GK,Hannover 96,de Bundesliga,30,1987,32.0,3,2,3,0,0,2,5,40.0,3,1,0,1,1,4,15,0,Matches
750,Alexander Esswein,de GER,"MF,FW",Stuttgart,de Bundesliga,28,1990,13.9,17,11,6,4,7,6,21,28.6,15,17,0,17,12,29,16,0,Matches
751,Neil Etheridge,ph PHI,GK,Cardiff City,eng Premier League,28,1990,38.0,1,1,1,0,0,1,2,50.0,1,0,0,0,7,8,19,1,Matches
752,Beñat Etxebarria,es ESP,MF,Athletic Club,es La Liga,31,1987,22.6,47,24,14,25,8,19,59,32.2,40,18,1,17,24,71,11,0,Matches
753,Xabier Etxeita,es ESP,DF,Huesca,es La Liga,30,1987,29.7,47,23,32,12,3,26,47,55.3,21,38,25,13,39,86,163,3,Matches
754,Lucas Evangelista,br BRA,"FW,MF",Nantes,fr Ligue 1,23,1995,8.0,30,17,11,12,7,14,25,56.0,11,10,0,10,9,39,6,0,Matches
755,Jonny Evans,nir NIR,DF,Leicester City,eng Premier League,30,1988,22.2,24,13,20,4,0,13,18,72.2,5,28,10,18,33,57,152,3,Matches
756,Ewerton,br BRA,DF,Nürnberg,de Bundesliga,29,1989,14.9,24,20,21,3,0,8,14,57.1,6,23,16,7,25,49,108,1,Matches
757,Valentin Eysseric,fr FRA,"FW,MF",Fiorentina,it Serie A,26,1992,4.0,6,5,3,2,1,2,4,50.0,2,6,1,5,4,10,1,0,Matches
758,Valentin Eysseric,fr FRA,"MF,FW",Nantes,fr Ligue 1,26,1992,2.3,1,1,0,1,0,0,2,0.0,2,2,0,2,0,1,0,0,Matches
759,Marco Fabián,mx MEX,FW,Eint Frankfurt,de Bundesliga,29,1989,0.7,3,2,2,1,0,1,1,100.0,0,0,0,0,3,6,0,0,Matches
760,Łukasz Fabiański,pl POL,GK,West Ham,eng Premier League,33,1985,38.0,1,0,1,0,0,1,3,33.3,2,0,0,0,1,2,10,1,Matches
761,Fabinho,br BRA,MF,Liverpool,eng Premier League,24,1993,22.4,59,31,17,38,4,24,59,40.7,35,34,6,28,28,87,27,2,Matches
762,Fábio,br BRA,"DF,FW",Nantes,fr Ligue 1,28,1990,14.2,53,34,25,27,1,26,53,49.1,27,18,4,14,18,71,27,0,Matches
763,Cesc Fàbregas,es ESP,MF,Chelsea,eng Premier League,31,1987,2.0,6,4,4,2,0,1,5,20.0,4,2,1,1,1,7,0,0,Matches
764,Cesc Fàbregas,es ESP,MF,Monaco,fr Ligue 1,31,1987,10.7,14,10,5,5,4,8,28,28.6,20,12,3,9,9,23,5,1,Matches
765,Fabricio,es ESP,GK,Fulham,eng Premier League,30,1987,2.0,1,1,1,0,0,0,0,,0,0,0,0,0,1,3,2,Matches
766,Ralf Fährmann,de GER,GK,Schalke 04,de Bundesliga,29,1988,16.3,0,0,0,0,0,0,0,,0,0,0,0,2,2,10,4,Matches
767,Romain Faivre,fr FRA,MF,Monaco,fr Ligue 1,20,1998,1.0,1,0,0,1,0,0,1,0.0,1,0,0,0,1,2,1,1,Matches
768,Fayçal Fajr,ma MAR,MF,Caen,fr Ligue 1,29,1988,36.0,65,32,22,33,10,25,66,37.9,41,27,6,21,29,94,19,2,Matches
769,Radamel Falcao,co COL,FW,Monaco,fr Ligue 1,32,1986,28.4,34,15,6,16,12,8,27,29.6,19,11,6,5,3,37,23,2,Matches
770,Diego Falcinelli,it ITA,FW,Bologna,it Serie A,27,1991,7.8,8,5,1,3,4,2,3,66.7,1,4,1,3,1,9,5,0,Matches
771,Simon Falette,gn GUI,DF,Eint Frankfurt,de Bundesliga,26,1992,6.7,9,6,7,1,1,2,6,33.3,4,11,5,6,14,23,32,0,Matches
772,Iago Falque,es ESP,"FW,MF",Torino,it Serie A,28,1990,17.9,13,8,3,8,2,3,16,18.8,13,14,0,14,3,16,2,0,Matches
773,Paolo Faragò,it ITA,"MF,DF",Cagliari,it Serie A,25,1993,18.9,46,29,20,16,10,13,43,30.2,30,28,2,26,15,61,38,0,Matches
774,Mohamed Fares,dz ALG,DF,SPAL,it Serie A,22,1996,32.8,63,43,37,18,8,25,54,46.3,29,48,4,44,54,117,83,2,Matches
775,Diego Farias,br BRA,FW,Empoli,it Serie A,28,1990,13.3,11,4,2,8,1,3,10,30.0,7,7,1,6,0,11,4,0,Matches
776,Diego Farias,br BRA,FW,Cagliari,it Serie A,28,1990,7.8,13,9,3,7,3,2,11,18.2,9,7,1,6,1,14,5,0,Matches
777,Andrea Favilli,it ITA,"FW,DF",Genoa,it Serie A,21,1997,1.9,1,1,0,0,1,0,1,0.0,1,1,0,1,0,1,1,0,Matches
778,Federico Fazio,ar ARG,DF,Roma,it Serie A,31,1987,31.2,28,20,14,11,3,12,25,48.0,13,45,33,12,53,81,171,2,Matches
779,Zouhair Feddal,ma MAR,DF,Betis,es La Liga,29,1989,18.9,38,23,31,6,1,16,28,57.1,12,19,8,11,31,69,94,2,Matches
780,Nabil Fekir,fr FRA,MF,Lyon,fr Ligue 1,25,1993,22.1,51,31,16,19,16,13,38,34.2,25,42,0,42,7,58,3,0,Matches
781,Yassin Fekir,fr FRA,FW,Lyon,fr Ligue 1,21,1997,0.1,0,0,0,0,0,0,1,0.0,1,0,0,0,0,0,0,0,Matches
782,Felipe,br BRA,DF,Hannover 96,de Bundesliga,31,1987,12.2,23,15,21,2,0,9,17,52.9,8,17,9,8,35,58,71,0,Matches
783,Luiz Felipe,it ITA,DF,Lazio,it Serie A,21,1997,14.3,27,18,20,7,0,13,20,65.0,7,27,15,12,26,53,57,1,Matches
784,Ohis Felix Uduokhai,de GER,DF,Wolfsburg,de Bundesliga,20,1997,2.7,13,7,7,5,1,9,10,90.0,1,6,2,4,6,19,11,1,Matches
785,Marouane Fellaini,be BEL,MF,Manchester Utd,eng Premier League,30,1987,8.4,21,13,11,9,1,9,17,52.9,8,9,5,4,4,25,34,1,Matches
786,Kiko Femenía,es ESP,DF,Watford,eng Premier League,27,1991,22.8,48,30,34,12,2,24,51,47.1,27,24,6,18,36,84,68,0,Matches
787,Edimilson Fernandes,ch SUI,MF,Fiorentina,it Serie A,22,1996,21.9,36,24,17,16,3,14,36,38.9,22,31,6,25,26,62,31,0,Matches
788,Gelson Fernandes,ch SUI,MF,Eint Frankfurt,de Bundesliga,31,1986,24.7,74,48,33,38,3,23,65,35.4,42,45,9,36,53,127,16,0,Matches
789,Aitor Fernández,es ESP,GK,Levante,es La Liga,27,1991,16.0,1,0,1,0,0,1,1,100.0,0,0,0,0,1,2,10,1,Matches
790,Andrés Fernández,es ESP,GK,Villarreal,es La Liga,31,1986,6.0,1,0,1,0,0,1,1,100.0,0,0,0,0,0,1,4,1,Matches
791,Borja Fernández,es ESP,"MF,DF",Valladolid,es La Liga,37,1981,9.3,17,12,7,9,1,6,16,37.5,10,14,2,12,14,31,25,0,Matches
792,Federico Fernández,ar ARG,DF,Newcastle Utd,eng Premier League,29,1989,16.5,16,12,12,4,0,10,18,55.6,8,19,12,7,25,41,106,1,Matches
793,Joaquín Fernández,es ESP,"DF,MF",Valladolid,es La Liga,22,1996,9.3,16,9,14,1,1,8,16,50.0,8,9,7,2,17,33,45,0,Matches
794,Fernandinho,br BRA,MF,Manchester City,eng Premier League,33,1985,26.4,57,43,19,30,8,26,47,55.3,21,28,4,24,41,98,70,0,Matches
795,Juan Ferney Otero,co COL,"FW,MF",Amiens,fr Ligue 1,23,1995,24.2,29,13,11,12,6,13,46,28.3,33,23,3,20,22,51,18,0,Matches
796,Alex Ferrari,it ITA,DF,Sampdoria,it Serie A,24,1994,6.0,10,8,4,6,0,5,7,71.4,2,7,4,3,9,19,26,0,Matches
797,David Ferreiro,es ESP,"MF,FW",Huesca,es La Liga,30,1988,25.3,36,22,13,19,4,11,64,17.2,53,27,1,26,24,60,14,2,Matches
798,Facundo Ferreyra,ar ARG,FW,Espanyol,es La Liga,27,1991,2.3,5,2,0,4,1,1,3,33.3,2,3,0,3,0,5,5,0,Matches
799,Jordan Ferri,fr FRA,MF,Nîmes,fr Ligue 1,26,1992,20.8,52,31,22,23,7,26,62,41.9,36,27,2,25,15,67,9,1,Matches
800,Jordan Ferri,fr FRA,MF,Lyon,fr Ligue 1,26,1992,1.3,5,3,3,1,1,1,4,25.0,3,4,2,2,1,6,3,0,Matches
801,Oliver Fink,de GER,MF,Düsseldorf,de Bundesliga,36,1982,11.7,38,22,17,17,4,12,38,31.6,26,20,3,17,13,51,19,0,Matches
802,Alfreð Finnbogason,is ISL,FW,Augsburg,de Bundesliga,29,1989,14.8,7,3,2,5,0,1,9,11.1,8,6,1,5,3,10,11,0,Matches
803,Roberto Firmino,br BRA,"FW,MF",Liverpool,eng Premier League,26,1991,29.0,30,20,5,16,9,7,34,20.6,27,35,1,34,6,36,16,0,Matches
804,Junior Firpo,es ESP,"DF,FW",Betis,es La Liga,21,1996,21.5,38,25,16,14,8,10,24,41.7,14,27,2,25,23,61,48,0,Matches
805,Mathieu Flamini,fr FRA,MF,Getafe,es La Liga,34,1984,5.0,9,4,4,4,1,4,7,57.1,3,3,1,2,5,14,4,0,Matches
806,Mark Flekken,nl NED,GK,Freiburg,de Bundesliga,25,1993,1.0,0,0,0,0,0,0,0,,0,0,0,0,0,0,0,0,Matches
807,Sergio Floccari,it ITA,FW,SPAL,it Serie A,36,1981,10.8,13,5,1,5,7,1,7,14.3,6,6,2,4,2,15,6,0,Matches
808,Alessandro Florenzi,it ITA,"DF,FW",Roma,it Serie A,27,1991,24.2,38,21,22,11,5,17,37,45.9,20,27,5,22,46,84,58,0,Matches
809,Phil Foden,eng ENG,MF,Manchester City,eng Premier League,18,2000,3.7,7,6,1,3,3,2,9,22.2,7,1,0,1,4,11,1,0,Matches
810,Guessouma Fofana,mr MTN,MF,Amiens,fr Ligue 1,25,1992,2.1,6,4,3,3,0,1,3,33.3,2,2,1,1,3,9,0,0,Matches
811,Guessouma Fofana,mr MTN,MF,Guingamp,fr Ligue 1,25,1992,5.3,14,9,2,10,2,4,10,40.0,6,3,0,3,6,20,8,0,Matches
812,Seko Fofana,ci CIV,MF,Udinese,it Serie A,23,1995,29.3,25,13,14,10,1,6,36,16.7,30,20,7,13,29,54,18,3,Matches
813,Wesley Fofana,fr FRA,DF,Saint-Étienne,fr Ligue 1,17,2000,1.8,7,6,5,2,0,6,13,46.2,7,1,0,1,4,11,9,0,Matches
814,Youssouf Fofana,fr FRA,MF,Strasbourg,fr Ligue 1,19,1999,10.1,28,20,5,20,3,9,27,33.3,18,7,0,7,11,39,8,0,Matches
815,Thomas Foket,be BEL,DF,Reims,fr Ligue 1,23,1994,32.0,91,52,55,23,13,42,69,60.9,27,30,4,26,49,140,80,1,Matches
816,Thomas Fontaine,mg MAD,"DF,MF",Reims,fr Ligue 1,27,1991,4.7,6,3,5,0,1,2,5,40.0,3,6,2,4,7,13,28,1,Matches
817,José Fonte,pt POR,DF,Lille,fr Ligue 1,34,1983,34.6,27,15,15,9,3,17,24,70.8,7,33,26,7,37,64,153,1,Matches
818,Rui Fonte,pt POR,"FW,MF",Lille,fr Ligue 1,28,1990,7.0,25,12,4,16,5,6,11,54.5,5,4,0,4,2,27,8,0,Matches
819,Pablo Fornals,es ESP,"MF,FW",Villarreal,es La Liga,22,1996,27.5,49,26,14,26,9,15,54,27.8,39,32,4,28,24,73,19,0,Matches
820,Emil Forsberg,se SWE,"MF,FW",RB Leipzig,de Bundesliga,26,1991,13.9,12,7,0,12,0,5,16,31.3,11,16,1,15,3,15,6,0,Matches
821,Fraser Forster,eng ENG,GK,Southampton,eng Premier League,30,1988,1.0,0,0,0,0,0,0,0,,0,0,0,0,0,0,1,0,Matches
822,Steven Fortes,cv CPV,DF,Toulouse,fr Ligue 1,26,1992,1.5,3,1,1,2,0,0,0,,0,1,1,0,2,5,9,2,Matches
823,Iver Fossum,no NOR,MF,Hannover 96,de Bundesliga,22,1996,5.1,9,5,1,7,1,4,8,50.0,4,8,2,6,7,16,10,0,Matches
824,Ben Foster,eng ENG,GK,Watford,eng Premier League,35,1983,38.0,2,2,2,0,0,2,6,33.3,4,0,0,0,2,4,34,3,Matches
825,Timothy Fosu-Mensah,nl NED,DF,Fulham,eng Premier League,20,1998,8.8,18,7,12,6,0,8,13,61.5,5,11,5,6,12,30,30,1,Matches
826,Dimitri Foulquier,fr FRA,"MF,DF",Getafe,es La Liga,25,1993,20.0,29,12,10,14,5,11,22,50.0,11,23,2,21,20,49,38,0,Matches
827,Juan Foyth,ar ARG,DF,Tottenham,eng Premier League,20,1998,9.9,31,17,20,11,0,14,19,73.7,5,12,5,7,10,41,50,1,Matches
828,Raphael Framberger,de GER,"DF,MF",Augsburg,de Bundesliga,22,1995,6.1,8,6,4,4,0,0,3,0.0,3,10,3,7,11,19,15,1,Matches
829,Simon Francis,eng ENG,DF,Bournemouth,eng Premier League,33,1985,13.7,25,14,19,5,1,12,24,50.0,12,15,7,8,19,44,73,1,Matches
830,Mike Frantz,de GER,"MF,FW",Freiburg,de Bundesliga,31,1986,24.6,34,26,15,15,4,6,20,30.0,14,24,4,20,21,55,32,0,Matches
831,Ryan Fraser,sct SCO,"MF,FW",Bournemouth,eng Premier League,24,1994,35.2,19,11,9,8,2,10,32,31.3,22,23,6,17,22,41,33,0,Matches
832,Pierluigi Frattali,it ITA,GK,Parma,it Serie A,32,1985,1.0,0,0,0,0,0,0,0,,0,0,0,0,0,0,1,0,Matches
833,Fred,br BRA,MF,Manchester Utd,eng Premier League,25,1993,11.6,29,17,12,16,1,15,33,45.5,18,26,2,24,16,45,14,2,Matches
834,Ryan Fredericks,eng ENG,DF,West Ham,eng Premier League,25,1992,12.1,38,23,33,5,0,21,32,65.6,11,15,5,10,13,51,49,1,Matches
835,Remo Freuler,ch SUI,MF,Atalanta,it Serie A,26,1992,33.6,84,45,34,34,16,30,70,42.9,40,62,12,50,38,122,45,0,Matches
836,Nicolas Frey,fr FRA,DF,Chievo,it Serie A,34,1984,2.5,3,1,2,1,0,0,3,0.0,3,3,3,0,7,10,18,0,Matches
837,Marco Friedl,at AUT,DF,Werder Bremen,de Bundesliga,20,1998,5.3,8,6,4,3,1,3,11,27.3,8,9,6,3,13,21,21,0,Matches
838,Alexander Fuchs,de GER,"MF,FW",Nürnberg,de Bundesliga,21,1997,7.3,14,12,5,7,2,5,15,33.3,10,9,1,8,5,19,10,0,Matches
839,Christian Fuchs,at AUT,DF,Leicester City,eng Premier League,32,1986,2.3,4,3,0,4,0,1,2,50.0,1,0,0,0,4,8,8,0,Matches
840,Javi Fuego,es ESP,MF,Villarreal,es La Liga,34,1984,2.6,6,3,5,1,0,4,8,50.0,4,2,0,2,3,9,9,0,Matches
841,Angelo Fulgini,fr FRA,"MF,FW",Angers,fr Ligue 1,21,1996,18.2,38,22,18,13,7,12,31,38.7,19,21,3,18,28,66,15,0,Matches
842,Niclas Füllkrug,de GER,FW,Hannover 96,de Bundesliga,25,1993,12.4,3,0,0,1,2,1,5,20.0,4,10,4,6,1,4,17,0,Matches
843,Ramiro Funes Mori,ar ARG,"DF,MF",Villarreal,es La Liga,27,1991,29.2,41,29,30,9,2,19,44,43.2,25,36,24,12,42,83,149,2,Matches
844,Manolo Gabbiadini,it ITA,"FW,MF",Southampton,eng Premier League,26,1991,5.3,6,2,1,4,1,1,2,50.0,1,5,0,5,3,9,6,0,Matches
845,Manolo Gabbiadini,it ITA,FW,Sampdoria,it Serie A,26,1991,9.0,5,2,1,3,1,3,11,27.3,8,6,1,5,4,9,4,0,Matches
846,Mijat Gaćinović,rs SRB,MF,Eint Frankfurt,de Bundesliga,23,1995,18.1,31,20,7,13,11,11,42,26.2,31,26,1,25,24,55,10,0,Matches
847,Gianluca Gaetano,it ITA,"MF,FW",Napoli,it Serie A,18,2000,0.1,0,0,0,0,0,0,0,,0,0,0,0,0,0,0,0,Matches
848,Roberto Gagliardini,it ITA,MF,Inter,it Serie A,24,1994,12.1,23,14,13,8,2,10,27,37.0,17,21,3,18,16,39,19,0,Matches
849,Riccardo Gagliolo,se SWE,DF,Parma,it Serie A,28,1990,33.8,69,45,52,15,2,33,68,48.5,35,60,33,27,66,135,213,2,Matches
850,Milan Gajić,rs SRB,DF,Bordeaux,fr Ligue 1,22,1996,1.0,2,1,1,0,1,1,1,100.0,0,0,0,0,1,3,7,0,Matches
851,Javi Galán,es ESP,"DF,FW",Huesca,es La Liga,23,1994,16.0,61,39,36,23,2,34,59,57.6,25,22,1,21,19,80,52,1,Matches
852,Sam Gallagher,eng ENG,FW,Southampton,eng Premier League,22,1995,0.4,0,0,0,0,0,0,0,,0,1,0,1,0,0,1,0,Matches
853,Álex Gallar,es ESP,"MF,FW",Huesca,es La Liga,26,1992,11.2,15,9,6,5,4,8,19,42.1,11,9,1,8,9,24,5,0,Matches
854,Enric Gallego,es ESP,FW,Huesca,es La Liga,31,1986,17.1,21,15,3,13,5,3,19,15.8,16,17,2,15,8,29,32,0,Matches
855,Álex Gálvez,es ESP,DF,Rayo Vallecano,es La Liga,29,1989,15.7,38,28,25,13,0,14,28,50.0,14,7,2,5,45,83,69,1,Matches
856,Kévin Gameiro,fr FRA,FW,Valencia,es La Liga,31,1987,17.9,14,9,4,6,4,1,6,16.7,5,12,2,10,5,19,3,0,Matches
857,Idrissa Gana Gueye,sn SEN,MF,Everton,eng Premier League,28,1989,31.4,142,89,70,63,9,38,76,50.0,38,52,8,44,74,216,48,1,Matches
858,Ignatius Ganago,cm CMR,FW,Nice,fr Ligue 1,19,1999,11.5,3,1,0,2,1,0,7,0.0,7,2,0,2,1,4,7,0,Matches
859,Cristian Ganea,ro ROU,DF,Athletic Club,es La Liga,26,1992,0.5,0,0,0,0,0,0,3,0.0,3,1,0,1,1,1,2,0,Matches
860,Ganso,br BRA,"MF,FW",Amiens,fr Ligue 1,28,1989,5.8,12,8,2,8,2,2,15,13.3,13,5,1,4,6,18,0,0,Matches
861,Ezequiel Garay,ar ARG,DF,Valencia,es La Liga,31,1986,23.7,20,17,15,3,2,9,18,50.0,9,30,23,7,16,36,140,0,Matches
862,Borja Garcés,es ESP,FW,Atlético Madrid,es La Liga,18,1999,0.2,0,0,0,0,0,0,0,,0,0,0,0,0,0,0,0,Matches
863,Alberto García,es ESP,GK,Rayo Vallecano,es La Liga,33,1985,17.0,1,1,1,0,0,1,3,33.3,2,1,0,1,2,3,1,2,Matches
864,Aleix García,es ESP,MF,Girona,es La Liga,21,1997,18.5,37,19,17,20,0,13,36,36.1,23,21,6,15,21,58,18,0,Matches
865,Álvaro García,es ESP,"FW,MF",Rayo Vallecano,es La Liga,25,1992,19.6,22,19,11,7,4,4,25,16.0,21,24,0,24,19,41,30,0,Matches
866,Borja García,es ESP,"MF,FW",Girona,es La Liga,27,1990,29.2,39,27,17,15,7,22,44,50.0,22,23,2,21,38,77,17,0,Matches
867,Dani García,es ESP,MF,Athletic Club,es La Liga,28,1990,27.5,56,34,21,32,3,24,63,38.1,39,28,8,20,49,105,46,1,Matches
868,Javi García,es ESP,"DF,MF",Betis,es La Liga,31,1987,5.8,3,1,3,0,0,2,3,66.7,1,5,1,4,5,8,27,0,Matches
869,Manu García,es ESP,MF,Alavés,es La Liga,32,1986,25.9,83,48,29,40,14,24,77,31.2,53,42,7,35,23,106,67,0,Matches
870,Manu García,es ESP,MF,Toulouse,fr Ligue 1,20,1998,20.5,37,26,14,17,6,15,49,30.6,34,16,1,15,15,52,5,0,Matches
871,Raúl García,es ESP,"MF,FW",Athletic Club,es La Liga,32,1986,26.3,61,41,13,37,11,22,68,32.4,46,56,1,55,21,82,39,0,Matches
872,Raúl García,es ESP,DF,Leganés,es La Liga,29,1989,4.2,8,6,4,4,0,6,8,75.0,2,5,2,3,6,14,28,1,Matches
873,Raúl García,es ESP,DF,Girona,es La Liga,29,1989,9.4,21,12,11,7,3,11,16,68.8,5,14,4,10,11,32,35,1,Matches
874,Sergio García,es ESP,"FW,MF",Espanyol,es La Liga,35,1983,16.5,18,10,4,11,3,3,16,18.8,13,6,1,5,10,28,4,0,Matches
875,James Garner,eng ENG,MF,Manchester Utd,eng Premier League,17,2001,0.0,0,0,0,0,0,0,0,,0,0,0,0,0,0,0,0,Matches
876,Mario Gaspar,es ESP,DF,Villarreal,es La Liga,27,1990,28.9,62,43,39,17,6,29,49,59.2,20,48,11,37,42,104,91,0,Matches
877,Paulo Gazzaniga,ar ARG,GK,Tottenham,eng Premier League,26,1992,3.0,0,0,0,0,0,0,0,,0,0,0,0,0,0,1,0,Matches
878,Marcello Gazzola,it ITA,"DF,MF",Parma,it Serie A,33,1985,10.2,9,4,2,5,2,5,9,55.6,4,6,3,3,4,13,33,0,Matches
879,Jean-Philippe Gbamin,ci CIV,MF,Mainz 05,de Bundesliga,22,1995,29.7,51,31,29,15,7,23,51,45.1,28,39,5,34,30,81,32,1,Matches
880,David de Gea,es ESP,GK,Manchester Utd,eng Premier League,27,1990,38.0,0,0,0,0,0,0,2,0.0,2,1,0,1,0,0,11,4,Matches
881,Theodor Gebre Selassie,cz CZE,DF,Werder Bremen,de Bundesliga,31,1986,31.3,53,38,27,16,10,22,51,43.1,29,33,8,25,69,122,100,0,Matches
882,Dennis Geiger,de GER,MF,Hoffenheim,de Bundesliga,20,1998,2.7,2,1,1,1,0,1,6,16.7,5,1,0,1,3,5,1,0,Matches
883,Jérémy Gélin,fr FRA,"DF,MF",Rennes,fr Ligue 1,21,1997,14.2,30,16,18,10,2,18,34,52.9,16,14,6,8,19,49,29,0,Matches
884,Romain Genevois,ht HAI,DF,Caen,fr Ligue 1,30,1987,4.0,10,6,9,1,0,6,11,54.5,5,3,0,3,8,18,13,0,Matches
885,Christian Gentner,de GER,"MF,FW",Stuttgart,de Bundesliga,32,1985,22.4,61,38,29,26,6,16,50,32.0,34,30,3,27,31,92,41,1,Matches
886,Yannick Gerhardt,de GER,MF,Wolfsburg,de Bundesliga,24,1994,27.3,52,34,22,20,10,16,43,37.2,27,35,7,28,30,82,34,0,Matches
887,Valère Germain,fr FRA,FW,Marseille,fr Ligue 1,28,1990,24.1,38,25,8,22,8,8,33,24.2,25,20,5,15,6,44,30,0,Matches
888,Gerson,br BRA,"MF,FW",Fiorentina,it Serie A,21,1997,27.0,42,26,22,15,5,12,38,31.6,26,46,9,37,16,58,32,0,Matches
889,Gervinho,ci CIV,FW,Parma,it Serie A,31,1987,25.6,19,12,11,5,3,5,13,38.5,8,7,0,7,10,29,2,0,Matches
890,Willem Geubbels,fr FRA,MF,Monaco,fr Ligue 1,16,2001,0.1,0,0,0,0,0,0,0,,0,0,0,0,0,0,0,0,Matches
891,Lamine Ghezali,fr FRA,"FW,MF",Saint-Étienne,fr Ligue 1,19,1999,0.5,1,1,0,1,0,1,2,50.0,1,0,0,0,0,1,2,0,Matches
892,Rachid Ghezzal,dz ALG,"FW,MF",Leicester City,eng Premier League,26,1992,8.3,14,5,3,7,4,3,18,16.7,15,10,1,9,7,21,4,1,Matches
893,Paolo Ghiglione,it ITA,DF,Frosinone,it Serie A,21,1997,5.7,8,4,6,1,1,6,14,42.9,8,2,0,2,4,12,22,0,Matches
894,Saman Ghoddos,ir IRN,"FW,MF",Amiens,fr Ligue 1,24,1993,20.3,33,17,14,15,4,13,32,40.6,19,15,2,13,7,40,13,0,Matches
895,Faouzi Ghoulam,dz ALG,DF,Napoli,it Serie A,27,1991,12.8,9,7,3,5,1,8,9,88.9,1,6,2,4,8,17,17,0,Matches
896,Emanuele Giaccherini,it ITA,"MF,FW",Chievo,it Serie A,33,1985,22.3,14,8,5,7,2,6,31,19.4,25,21,2,19,16,30,10,2,Matches
897,Morgan Gibbs-White,eng ENG,"MF,FW",Wolves,eng Premier League,18,2000,7.4,6,3,2,4,0,1,4,25.0,3,6,0,6,1,7,0,0,Matches
898,Ben Gibson,eng ENG,DF,Burnley,eng Premier League,25,1993,0.7,1,1,1,0,0,0,0,,0,1,1,0,0,1,2,0,Matches
899,Fabian Giefer,de GER,GK,Augsburg,de Bundesliga,28,1990,4.0,0,0,0,0,0,0,2,0.0,2,0,0,0,0,0,1,2,Matches
900,Niko Gießelmann,de GER,DF,Düsseldorf,de Bundesliga,26,1991,28.8,57,37,38,14,5,26,59,44.1,33,25,6,19,36,93,85,1,Matches
901,Bryan Gil,es ESP,"MF,FW",Sevilla,es La Liga,17,2001,1.9,6,4,4,1,1,1,5,20.0,4,0,0,0,1,7,0,0,Matches
902,Daniel Ginczek,de GER,FW,Wolfsburg,de Bundesliga,27,1991,14.2,9,7,4,3,2,5,19,26.3,14,12,2,10,3,12,23,1,Matches
903,Matthias Ginter,de GER,DF,M'Gladbach,de Bundesliga,24,1994,26.4,24,14,16,7,1,9,17,52.9,8,31,19,12,17,41,98,1,Matches
904,Andrei Girotto,br BRA,MF,Nantes,fr Ligue 1,26,1992,16.4,57,40,18,36,3,20,44,45.5,24,22,6,16,29,86,43,1,Matches
905,Olivier Giroud,fr FRA,FW,Chelsea,eng Premier League,31,1986,9.4,3,2,0,1,2,1,4,25.0,3,6,1,5,3,6,7,0,Matches
906,Kamil Glik,pl POL,DF,Monaco,fr Ligue 1,30,1988,33.0,32,23,26,5,1,16,32,50.0,16,25,17,8,61,93,200,1,Matches
907,Serge Gnabry,de GER,"FW,MF",Bayern Munich,de Bundesliga,23,1995,19.6,36,20,12,13,11,5,30,16.7,25,18,0,18,11,47,3,0,Matches
908,Joris Gnagnon,fr FRA,"DF,MF",Sevilla,es La Liga,21,1997,5.0,11,8,6,4,1,4,7,57.1,3,2,2,0,10,21,16,0,Matches
909,Eddy Gnahoré,fr FRA,MF,Amiens,fr Ligue 1,24,1993,24.9,39,27,17,17,5,9,39,23.1,30,29,4,25,23,62,23,1,Matches
910,Massimo Gobbi,it ITA,DF,Parma,it Serie A,37,1980,13.1,14,7,5,5,4,8,25,32.0,17,16,8,8,9,23,48,0,Matches
911,Kevin Goden,de GER,"DF,MF",Nürnberg,de Bundesliga,19,1999,3.0,4,3,3,1,0,2,7,28.6,5,4,1,3,4,8,11,0,Matches
912,Diego Godín,uy URU,DF,Atlético Madrid,es La Liga,32,1986,27.9,52,30,33,19,0,20,42,47.6,22,22,9,13,45,97,141,2,Matches
913,Mauro Goicoechea,uy URU,GK,Toulouse,fr Ligue 1,30,1988,7.9,0,0,0,0,0,0,0,,0,0,0,0,0,0,7,0,Matches
914,Edoardo Goldaniga,it ITA,DF,Frosinone,it Serie A,24,1993,29.0,43,28,34,7,2,19,32,59.4,13,29,16,13,57,100,119,0,Matches
915,Pierluigi Gollini,it ITA,GK,Atalanta,it Serie A,23,1995,20.0,2,2,2,0,0,1,2,50.0,1,0,0,0,0,2,3,2,Matches
916,Aleksandr Golovin,ru RUS,"MF,FW",Monaco,fr Ligue 1,22,1996,25.4,36,17,3,20,13,10,44,22.7,34,34,3,31,22,58,12,0,Matches
917,André Gomes,pt POR,MF,Everton,eng Premier League,25,1993,22.0,39,23,12,24,3,13,59,22.0,46,27,4,23,20,59,18,0,Matches
918,Angel Gomes,eng ENG,"MF,FW",Manchester Utd,eng Premier League,17,2000,0.3,1,0,0,0,1,0,0,,0,0,0,0,0,1,0,0,Matches
919,Ibai Gómez,es ESP,FW,Athletic Club,es La Liga,28,1989,6.4,6,3,3,2,1,4,9,44.4,5,8,1,7,2,8,8,0,Matches
920,Ibai Gómez,es ESP,"MF,FW",Alavés,es La Liga,28,1989,16.1,14,8,9,3,2,6,19,31.6,13,10,0,10,8,22,17,0,Matches
921,Joe Gomez,eng ENG,DF,Liverpool,eng Premier League,21,1997,11.8,18,11,10,7,1,9,15,60.0,6,10,5,5,14,32,42,0,Matches
922,Mario Gómez,de GER,FW,Stuttgart,de Bundesliga,33,1985,24.6,19,11,6,10,3,2,12,16.7,10,17,6,11,5,24,33,0,Matches
923,Maxi Gómez,uy URU,FW,Celta Vigo,es La Liga,21,1996,32.9,6,4,1,4,1,1,12,8.3,11,3,0,3,2,8,43,0,Matches
924,Moi Gómez,es ESP,MF,Huesca,es La Liga,24,1994,33.9,42,28,15,25,2,11,46,23.9,35,27,3,24,28,70,27,0,Matches
925,Papu Gómez,ar ARG,"MF,FW",Atalanta,it Serie A,30,1988,32.2,19,14,5,10,4,6,30,20.0,24,21,0,21,16,35,4,0,Matches
926,Sergi Gómez,es ESP,DF,Sevilla,es La Liga,26,1992,30.7,49,38,33,12,4,18,28,64.3,10,30,20,10,40,89,135,1,Matches
927,Alfred Gomis,sn SEN,GK,SPAL,it Serie A,24,1993,19.2,0,0,0,0,0,0,1,0.0,1,0,0,0,1,1,14,1,Matches
928,Maxime Gonalons,fr FRA,MF,Sevilla,es La Liga,29,1989,6.0,8,4,2,5,1,1,15,6.7,14,10,4,6,5,13,12,0,Matches
929,Anthony Gonçalves,fr FRA,"MF,FW",Strasbourg,fr Ligue 1,32,1986,11.8,22,15,12,8,2,7,22,31.8,15,21,2,19,10,32,17,0,Matches
930,Jérôme Gondorf,de GER,"MF,FW",Freiburg,de Bundesliga,30,1988,14.4,33,18,12,19,2,14,28,50.0,14,29,5,24,19,52,23,1,Matches
931,Álvaro González,es ESP,DF,Villarreal,es La Liga,28,1990,32.9,49,35,33,14,2,25,35,71.4,10,34,24,10,37,86,177,2,Matches
932,Bruno González,es ESP,DF,Getafe,es La Liga,28,1990,18.9,23,10,14,8,1,9,18,50.0,9,13,6,7,22,45,110,0,Matches
933,Cristo González,es ESP,FW,Real Madrid,es La Liga,20,1997,0.5,1,0,0,1,0,0,0,,0,0,0,0,1,2,0,0,Matches
934,Giancarlo González,cr CRC,DF,Bologna,it Serie A,30,1988,8.3,13,7,12,1,0,5,9,55.6,4,15,11,4,12,25,42,0,Matches
935,Nicolás González,ar ARG,"FW,MF",Stuttgart,de Bundesliga,20,1998,24.0,19,14,3,7,9,9,19,47.4,10,32,2,30,11,30,27,0,Matches
936,Jon Gorenc Stanković,si SVN,"MF,DF",Huddersfield,eng Premier League,22,1996,7.9,26,18,18,7,1,14,26,53.8,12,16,9,7,9,35,20,1,Matches
937,Leon Goretzka,de GER,MF,Bayern Munich,de Bundesliga,23,1995,22.5,41,22,7,27,7,14,38,36.8,24,25,4,21,26,67,14,1,Matches
938,Mathieu Gorgelin,fr FRA,GK,Lyon,fr Ligue 1,27,1990,4.0,0,0,0,0,0,0,0,,0,0,0,0,0,0,3,0,Matches
939,Mirko Gori,it ITA,MF,Frosinone,it Serie A,25,1993,3.7,16,13,7,9,0,5,16,31.3,11,2,0,2,4,20,9,0,Matches
940,Andoni Gorosabel,es ESP,DF,Real Sociedad,es La Liga,21,1996,5.1,16,9,10,5,1,8,13,61.5,5,5,1,4,4,20,20,1,Matches
941,Robin Gosens,de GER,"DF,MF",Atalanta,it Serie A,24,1994,21.6,63,46,32,26,5,37,54,68.5,17,41,3,38,38,101,60,0,Matches
942,Dan Gosling,eng ENG,MF,Bournemouth,eng Premier League,28,1990,19.3,57,23,27,21,9,28,53,52.8,25,33,11,22,20,77,46,1,Matches
943,Felix Götze,de GER,MF,Augsburg,de Bundesliga,20,1998,1.4,4,2,2,2,0,3,3,100.0,0,1,0,1,3,7,7,0,Matches
944,Mario Götze,de GER,"FW,MF",Dortmund,de Bundesliga,26,1992,18.6,26,19,6,11,9,4,25,16.0,21,10,0,10,8,34,4,1,Matches
945,Prince-Désir Gouano,fr FRA,DF,Amiens,fr Ligue 1,24,1993,29.1,31,18,25,5,1,12,22,54.5,10,36,27,9,46,77,127,6,Matches
946,Yoann Gourcuff,fr FRA,"MF,FW",Dijon,fr Ligue 1,32,1986,1.5,0,0,0,0,0,0,2,0.0,2,1,1,0,0,0,1,0,Matches
947,Jeffrey Gouweleeuw,nl NED,DF,Augsburg,de Bundesliga,27,1991,23.2,42,31,23,19,0,24,39,61.5,15,44,21,23,56,98,71,1,Matches
948,Paolo Gozzi Iweru,it ITA,DF,Juventus,it Serie A,17,2001,1.0,3,2,2,1,0,0,0,,0,0,0,0,3,6,3,0,Matches
949,Max Gradel,ci CIV,"FW,MF",Toulouse,fr Ligue 1,30,1987,36.0,58,35,34,19,5,24,70,34.3,46,53,9,44,18,76,41,0,Matches
950,Jonathan Gradit,fr FRA,DF,Caen,fr Ligue 1,25,1992,22.3,52,28,30,21,1,28,52,53.8,24,40,15,25,45,97,82,3,Matches
951,Samuel Grandsir,fr FRA,"MF,FW",Strasbourg,fr Ligue 1,21,1996,2.6,9,6,5,3,1,3,7,42.9,4,2,0,2,1,10,0,0,Matches
952,Samuel Grandsir,fr FRA,"FW,MF",Monaco,fr Ligue 1,21,1996,5.2,12,7,4,5,3,2,10,20.0,8,11,0,11,1,13,5,1,Matches
953,Álex Granell,es ESP,"MF,DF",Girona,es La Liga,29,1988,26.6,64,28,30,31,3,34,83,41.0,49,34,5,29,35,99,36,1,Matches
954,Esteban Granero,es ESP,MF,Espanyol,es La Liga,31,1987,22.4,50,32,26,18,6,17,50,34.0,33,42,8,34,26,76,34,2,Matches
955,Karlan Grant,eng ENG,FW,Huddersfield,eng Premier League,20,1997,9.7,5,2,1,2,2,1,3,33.3,2,8,0,8,2,7,1,1,Matches
956,Alberto Grassi,it ITA,MF,Parma,it Serie A,23,1995,5.1,20,12,7,10,3,2,10,20.0,8,8,2,6,8,28,10,0,Matches
957,Andre Gray,jm JAM,FW,Watford,eng Premier League,27,1991,15.2,3,1,0,2,1,1,6,16.7,5,3,1,2,2,5,6,0,Matches
958,Demarai Gray,jm JAM,"FW,MF",Leicester City,eng Premier League,22,1996,22.1,25,12,7,14,4,6,16,37.5,10,19,0,19,9,34,15,0,Matches
959,Mason Greenwood,eng ENG,FW,Manchester Utd,eng Premier League,16,2001,1.3,3,3,2,0,1,2,3,66.7,1,2,0,2,0,3,1,0,Matches
960,Michael Gregoritsch,at AUT,"MF,FW",Augsburg,de Bundesliga,24,1994,27.6,22,13,7,9,6,4,28,14.3,24,29,10,19,15,37,58,0,Matches
961,Clément Grenier,fr FRA,MF,Rennes,fr Ligue 1,27,1991,29.6,44,27,7,33,4,21,61,34.4,40,28,4,24,29,73,34,1,Matches
962,Antoine Griezmann,fr FRA,"FW,MF",Atlético Madrid,es La Liga,27,1991,35.5,31,19,8,13,10,8,28,28.6,20,18,1,17,12,43,21,0,Matches
963,Vincenzo Grifo,it ITA,"MF,FW",Hoffenheim,de Bundesliga,25,1993,3.7,6,3,2,3,1,0,5,0.0,5,2,1,1,2,8,5,0,Matches
964,Vincenzo Grifo,it ITA,"MF,FW",Freiburg,de Bundesliga,25,1993,15.9,26,14,11,8,7,14,27,51.9,13,10,1,9,2,28,10,0,Matches
965,Florian Grillitsch,at AUT,MF,Hoffenheim,de Bundesliga,22,1995,26.6,77,49,30,38,9,36,80,45.0,44,34,8,26,72,149,56,1,Matches
966,Jérémy Grimm,fr FRA,MF,Strasbourg,fr Ligue 1,31,1987,1.9,4,2,2,2,0,3,5,60.0,2,1,0,1,4,8,5,0,Matches
967,Pascal Groß,de GER,"MF,FW",Brighton,eng Premier League,27,1991,20.7,27,12,12,12,3,11,36,30.6,25,20,8,12,13,40,23,0,Matches
968,Sergej Grubac,me MNE,FW,Chievo,it Serie A,18,2000,1.7,2,1,1,0,1,1,1,100.0,0,1,0,1,0,2,1,0,Matches
969,Marko Grujić,rs SRB,MF,Hertha BSC,de Bundesliga,22,1996,19.8,45,33,17,20,8,13,38,34.2,25,29,6,23,29,74,51,1,Matches
970,Vicente Guaita,es ESP,GK,Crystal Palace,eng Premier League,31,1987,19.5,0,0,0,0,0,0,0,,0,0,0,0,0,0,5,2,Matches
971,Andrés Guardado,mx MEX,"MF,DF",Betis,es La Liga,31,1986,25.9,24,15,9,12,3,11,47,23.4,36,27,1,26,28,52,28,1,Matches
972,Sergi Guardiola,es ESP,FW,Valladolid,es La Liga,27,1991,16.8,19,11,1,10,8,2,13,15.4,11,12,0,12,5,24,17,0,Matches
973,Sergi Guardiola,es ESP,"MF,FW",Getafe,es La Liga,27,1991,0.3,1,1,0,1,0,0,0,,0,0,0,0,0,1,0,0,Matches
974,Metehan Güçlü,tr TUR,MF,Paris S-G,fr Ligue 1,19,1999,0.2,0,0,0,0,0,0,0,,0,0,0,0,0,0,0,0,Matches
975,Gonçalo Guedes,pt POR,"MF,FW",Valencia,es La Liga,21,1996,16.3,31,13,16,12,3,14,43,32.6,29,15,0,15,7,38,1,0,Matches
976,Mattéo Guendouzi,fr FRA,MF,Arsenal,eng Premier League,19,1999,23.9,44,26,18,23,3,17,47,36.2,30,28,5,23,30,74,24,3,Matches
977,Javi Guerra,es ESP,"FW,MF",Rayo Vallecano,es La Liga,36,1982,2.6,3,3,1,1,1,0,3,0.0,3,2,0,2,1,4,0,0,Matches
978,Raphaël Guerreiro,pt POR,"FW,DF",Dortmund,de Bundesliga,24,1993,17.0,25,12,11,7,7,12,23,52.2,11,7,1,6,18,43,12,1,Matches
979,Francis Guerrero,es ESP,"DF,FW",Betis,es La Liga,22,1996,19.8,51,28,25,16,10,23,41,56.1,18,15,1,14,21,72,47,4,Matches
980,Guido Guerrieri,it ITA,GK,Lazio,it Serie A,22,1996,1.0,0,0,0,0,0,0,0,,0,0,0,0,0,0,2,0,Matches
981,Ander Guevara,es ESP,MF,Real Sociedad,es La Liga,21,1997,1.0,3,1,0,3,0,2,6,33.3,4,1,0,1,1,4,0,0,Matches
982,Makhtar Gueye,sn SEN,"FW,MF",Saint-Étienne,fr Ligue 1,20,1997,0.6,2,1,2,0,0,2,2,100.0,0,2,0,2,0,2,0,0,Matches
983,John Guidetti,se SWE,FW,Alavés,es La Liga,26,1992,7.0,4,1,0,3,1,0,4,0.0,4,4,0,4,1,5,6,0,Matches
984,Josuha Guilavogui,fr FRA,MF,Wolfsburg,de Bundesliga,27,1990,17.4,31,16,18,13,0,14,25,56.0,11,17,8,9,43,74,56,2,Matches
985,Frederic Guilbert,fr FRA,DF,Caen,fr Ligue 1,23,1994,32.4,98,67,59,29,10,41,83,49.4,42,49,21,28,78,176,121,2,Matches
986,Baptiste Guillaume,be BEL,FW,Nîmes,fr Ligue 1,23,1995,13.1,12,6,1,8,3,2,9,22.2,7,6,0,6,2,14,6,0,Matches
987,Serhou Guirassy,gn GUI,FW,Amiens,fr Ligue 1,22,1996,12.3,7,5,1,5,1,0,4,0.0,4,7,0,7,4,11,14,0,Matches
988,Péter Gulácsi,hu HUN,GK,RB Leipzig,de Bundesliga,28,1990,32.5,0,0,0,0,0,0,0,,0,0,0,0,0,0,11,0,Matches
989,Manuel Gulde,de GER,DF,Freiburg,de Bundesliga,27,1991,19.0,24,16,18,5,1,12,16,75.0,4,25,13,12,26,50,90,0,Matches
990,Gerard Gumbau,es ESP,MF,Leganés,es La Liga,23,1994,13.3,22,16,9,13,0,6,25,24.0,19,15,2,13,13,35,13,0,Matches
991,İlkay Gündoğan,de GER,MF,Manchester City,eng Premier League,27,1990,23.7,19,12,4,12,3,6,31,19.4,25,12,3,9,28,47,19,1,Matches
992,Angus Gunn,sct SCO,GK,Southampton,eng Premier League,22,1996,12.0,0,0,0,0,0,0,0,,0,0,0,0,0,0,8,3,Matches
993,Aron Gunnarsson,is ISL,MF,Cardiff City,eng Premier League,29,1989,25.2,51,29,23,25,3,23,84,27.4,61,40,12,28,38,89,55,1,Matches
994,Christian Günter,de GER,"DF,MF",Freiburg,de Bundesliga,25,1993,32.0,38,26,16,16,6,20,43,46.5,23,31,7,24,14,52,55,0,Matches
995,Koray Günter,de GER,DF,Genoa,it Serie A,23,1994,9.3,18,13,13,3,2,9,16,56.3,7,9,7,2,18,36,34,0,Matches
996,Serdar Gürler,tr TUR,"MF,FW",Huesca,es La Liga,26,1991,5.4,5,5,3,2,0,3,11,27.3,8,8,0,8,1,6,2,0,Matches
997,Ahmet Gürleyen,de GER,DF,Mainz 05,de Bundesliga,19,1999,0.1,0,0,0,0,0,0,0,,0,0,0,0,0,0,1,0,Matches
998,Régis Gurtner,fr FRA,GK,Amiens,fr Ligue 1,31,1986,38.0,1,1,1,0,0,0,1,0.0,1,0,0,0,1,2,7,3,Matches
999,Gorka Guruzeta,es ESP,"MF,FW",Athletic Club,es La Liga,21,1996,0.6,1,1,1,0,0,0,2,0.0,2,1,0,1,2,3,0,0,Matches
1000,Luiz Gustavo,br BRA,"MF,DF",Marseille,fr Ligue 1,31,1987,27.1,72,43,49,18,5,30,66,45.5,36,26,12,14,34,106,61,0,Matches
1001,Jonathan de Guzmán,nl NED,MF,Eint Frankfurt,de Bundesliga,30,1987,17.4,34,24,11,20,3,13,28,46.4,15,18,2,16,11,45,16,0,Matches
1002,Janik Haberer,de GER,"MF,FW",Freiburg,de Bundesliga,24,1994,26.0,71,47,37,24,10,30,75,40.0,45,31,4,27,36,107,49,0,Matches
1003,Hacen,mr MTN,MF,Valladolid,es La Liga,20,1997,0.0,0,0,0,0,0,0,0,,0,1,0,1,1,1,1,0,Matches
1004,Alexander Hack,de GER,DF,Mainz 05,de Bundesliga,24,1993,11.3,29,13,20,9,0,19,28,67.9,9,26,15,11,41,70,59,2,Matches
1005,Munir El Haddadi,ma MAR,"FW,MF",Sevilla,es La Liga,22,1995,11.6,17,10,5,7,5,2,7,28.6,5,15,0,15,6,23,9,0,Matches
1006,Munir El Haddadi,ma MAR,FW,Barcelona,es La Liga,22,1995,1.7,3,3,1,1,1,1,3,33.3,2,1,0,1,0,3,1,0,Matches
1007,Oussama Haddadi,tn TUN,DF,Dijon,fr Ligue 1,26,1992,29.7,51,25,38,11,2,24,43,55.8,19,33,8,25,45,96,93,2,Matches
1008,Florent Hadergjonaj,xk KVX,"DF,MF",Huddersfield,eng Premier League,24,1994,20.5,30,17,10,18,2,13,37,35.1,24,21,7,14,21,51,37,1,Matches
1009,Benjamin Hadžić,ba BIH,"FW,MF",Hannover 96,de Bundesliga,19,1999,0.3,0,0,0,0,0,0,1,0.0,1,0,0,0,0,0,0,0,Matches
1010,André Hahn,de GER,"FW,MF",Augsburg,de Bundesliga,27,1990,22.8,64,38,22,39,3,22,53,41.5,31,28,2,26,27,91,32,0,Matches
1011,Amadou Haidara,ml MLI,MF,RB Leipzig,de Bundesliga,20,1998,4.2,13,11,4,8,1,8,14,57.1,6,9,1,8,4,17,7,0,Matches
1012,Oualid El Hajjam,ma MAR,"DF,MF",Amiens,fr Ligue 1,27,1991,6.0,14,9,10,3,1,5,15,33.3,10,8,2,6,12,26,26,0,Matches
1013,Achraf Hakimi,ma MAR,DF,Dortmund,de Bundesliga,19,1998,19.3,34,19,25,8,1,17,36,47.2,19,27,4,23,29,63,45,2,Matches
1014,Sébastien Haller,ci CIV,FW,Eint Frankfurt,de Bundesliga,24,1994,24.2,24,11,7,10,7,8,21,38.1,13,21,1,20,15,39,23,0,Matches
1015,Emil Hallfreðsson,is ISL,MF,Udinese,it Serie A,34,1984,1.5,0,0,0,0,0,0,1,0.0,1,1,1,0,3,3,4,0,Matches
1016,Emil Hallfreðsson,is ISL,MF,Frosinone,it Serie A,34,1984,4.4,10,6,5,4,1,0,9,0.0,9,4,1,3,2,12,3,0,Matches
1017,Marcel Halstenberg,de GER,"DF,FW",RB Leipzig,de Bundesliga,26,1991,26.8,68,44,31,24,13,42,65,64.6,23,27,4,23,38,106,69,0,Matches
1018,Ben Hamer,eng ENG,GK,Huddersfield,eng Premier League,30,1987,6.1,0,0,0,0,0,0,3,0.0,3,0,0,0,1,1,3,2,Matches
1019,Romain Hamouma,fr FRA,"FW,MF",Saint-Étienne,fr Ligue 1,31,1987,17.6,30,19,6,18,6,12,32,37.5,20,12,1,11,9,39,7,0,Matches
1020,Marek Hamšík,sk SVK,MF,Napoli,it Serie A,31,1987,10.2,7,5,2,4,1,0,11,0.0,11,8,1,7,12,19,14,1,Matches
1021,Dávid Hancko,sk SVK,DF,Fiorentina,it Serie A,20,1997,3.1,7,6,4,3,0,6,9,66.7,3,3,1,2,3,10,12,0,Matches
1022,Samir Handanović,si SVN,GK,Inter,it Serie A,34,1984,38.0,1,0,1,0,0,1,1,100.0,0,0,0,0,0,1,12,1,Matches
1023,Genki Haraguchi,jp JPN,"MF,DF",Hannover 96,de Bundesliga,27,1991,23.7,44,26,21,20,3,17,66,25.8,49,34,5,29,21,65,33,0,Matches
1024,Féthi Harek,dz ALG,DF,Nîmes,fr Ligue 1,35,1982,2.0,4,4,2,2,0,3,4,75.0,1,1,0,1,1,5,6,0,Matches
1025,Amine Harit,ma MAR,"MF,FW",Schalke 04,de Bundesliga,21,1997,12.0,15,8,4,9,2,8,24,33.3,16,11,1,10,9,24,2,0,Matches
1026,Martin Harnik,at AUT,"FW,MF",Werder Bremen,de Bundesliga,31,1987,9.2,12,7,4,3,5,4,15,26.7,11,8,0,8,3,15,10,0,Matches
1027,Kadeem Harris,eng ENG,MF,Cardiff City,eng Premier League,25,1993,4.2,12,5,6,4,2,7,8,87.5,1,3,0,3,3,15,5,0,Matches
1028,Joe Hart,eng ENG,GK,Burnley,eng Premier League,31,1987,19.0,0,0,0,0,0,0,1,0.0,1,0,0,0,0,0,11,3,Matches
1029,Makoto Hasebe,jp JPN,"DF,MF",Eint Frankfurt,de Bundesliga,34,1984,28.0,52,34,35,17,0,25,42,59.5,17,43,22,21,40,92,101,3,Matches
1030,Hans Hateboer,nl NED,DF,Atalanta,it Serie A,24,1994,33.0,43,31,19,19,5,17,34,50.0,17,29,5,24,23,66,47,1,Matches
1031,Kai Havertz,de GER,"MF,FW",Leverkusen,de Bundesliga,19,1999,32.2,26,17,10,11,5,8,32,25.0,24,31,4,27,16,42,29,0,Matches
1032,Isaac Hayden,eng ENG,MF,Newcastle Utd,eng Premier League,23,1995,20.7,73,43,19,45,9,23,41,56.1,18,32,4,28,40,113,30,0,Matches
1033,Eden Hazard,be BEL,FW,Chelsea,eng Premier League,27,1991,32.5,14,9,2,1,11,5,17,29.4,12,10,0,10,13,27,6,1,Matches
1034,Thorgan Hazard,be BEL,"FW,MF",M'Gladbach,de Bundesliga,25,1993,31.9,50,33,22,20,8,17,48,35.4,31,35,2,33,27,77,12,0,Matches
1035,Rhys Healey,wls WAL,FW,Cardiff City,eng Premier League,23,1994,0.6,1,0,0,1,0,0,1,0.0,1,0,0,0,0,1,0,0,Matches
1036,Tom Heaton,eng ENG,GK,Burnley,eng Premier League,32,1986,19.0,0,0,0,0,0,0,2,0.0,2,0,0,0,0,0,8,2,Matches
1037,Dominique Heintz,de GER,DF,Freiburg,de Bundesliga,24,1993,33.9,41,21,34,6,1,18,32,56.3,14,45,22,23,45,86,214,0,Matches
1038,Filip Helander,se SWE,DF,Bologna,it Serie A,25,1993,19.0,42,26,25,13,4,19,23,82.6,4,27,16,11,14,56,84,0,Matches
1039,Jordan Henderson,eng ENG,MF,Liverpool,eng Premier League,28,1990,22.1,46,36,20,22,4,16,39,41.0,23,27,3,24,30,76,17,0,Matches
1040,Jeff Hendrick,ie IRL,"MF,FW",Burnley,eng Premier League,26,1992,22.9,24,12,13,7,4,9,32,28.1,23,20,5,15,12,36,31,0,Matches
1041,Wayne Hennessey,wls WAL,GK,Crystal Palace,eng Premier League,31,1987,17.5,0,0,0,0,0,0,2,0.0,2,0,0,0,0,0,5,1,Matches
1042,Rouwen Hennings,de GER,FW,Düsseldorf,de Bundesliga,30,1987,20.4,14,10,1,8,5,2,13,15.4,11,16,1,15,4,18,20,0,Matches
1043,Benjamin Henrichs,de GER,"DF,MF",Monaco,fr Ligue 1,21,1997,20.3,58,39,32,22,4,16,38,42.1,22,18,0,18,35,93,45,0,Matches
1044,Benjamin Henrichs,de GER,DF,Leverkusen,de Bundesliga,21,1997,0.7,0,0,0,0,0,0,0,,0,2,0,2,3,3,0,0,Matches
1045,Dalbert Henrique,br BRA,DF,Inter,it Serie A,24,1993,8.6,33,24,18,14,1,12,21,57.1,9,9,3,6,8,41,20,0,Matches
1046,Uche Henry Agbo,ng NGA,MF,Rayo Vallecano,es La Liga,22,1995,4.1,7,4,3,4,0,5,10,50.0,5,3,1,2,6,13,1,0,Matches
1047,Christophe Hérelle,mq MTQ,DF,Nice,fr Ligue 1,25,1992,32.6,72,52,51,19,2,40,50,80.0,10,39,16,23,61,133,158,2,Matches
1048,Mario Hermoso,es ESP,DF,Espanyol,es La Liga,23,1995,31.2,38,24,29,7,2,21,39,53.8,18,34,25,9,37,75,175,2,Matches
1049,Javier Hernández,mx MEX,FW,West Ham,eng Premier League,30,1988,14.8,3,0,0,3,0,0,6,0.0,6,8,1,7,1,4,8,0,Matches
1050,Lucas Hernández,fr FRA,DF,Atlético Madrid,es La Liga,22,1996,12.4,35,25,20,14,1,17,20,85.0,3,17,9,8,14,49,49,0,Matches
1051,Theo Hernández,fr FRA,DF,Real Sociedad,es La Liga,20,1997,22.0,54,33,30,15,9,28,44,63.6,16,21,5,16,33,87,42,3,Matches
1052,Ander Herrera,es ESP,MF,Manchester Utd,eng Premier League,28,1989,15.6,54,28,24,22,8,21,61,34.4,40,38,6,32,37,91,25,1,Matches
1053,Yangel Herrera,ve VEN,"MF,DF",Huesca,es La Liga,20,1998,12.8,48,24,18,25,5,23,43,53.5,20,13,1,12,14,62,32,0,Matches
1054,Iago Herrerín,es ESP,GK,Athletic Club,es La Liga,30,1988,31.0,0,0,0,0,0,0,2,0.0,2,0,0,0,0,0,11,2,Matches
1055,Patrick Herrmann,de GER,"FW,DF",M'Gladbach,de Bundesliga,27,1991,12.0,20,14,8,7,5,6,17,35.3,11,6,3,3,6,26,12,0,Matches
1056,Pablo Hervías,es ESP,MF,Valladolid,es La Liga,25,1993,1.8,1,0,0,1,0,0,1,0.0,1,0,0,0,2,3,0,0,Matches
1057,Pablo Hervías,es ESP,MF,Eibar,es La Liga,25,1993,2.0,1,1,0,1,0,0,4,0.0,4,2,0,2,0,1,0,0,Matches
1058,Përparim Hetemaj,fi FIN,MF,Chievo,it Serie A,31,1986,24.0,53,27,27,23,3,20,68,29.4,48,25,1,24,30,83,24,2,Matches
1059,Son Heung-min,kr KOR,"FW,MF",Tottenham,eng Premier League,26,1992,22.7,23,12,7,12,4,10,34,29.4,24,26,2,24,8,31,4,1,Matches
1060,Gonzalo Higuaín,ar ARG,FW,Chelsea,eng Premier League,30,1987,12.1,10,7,2,4,4,2,11,18.2,9,4,0,4,1,11,5,0,Matches
1061,Gonzalo Higuaín,ar ARG,FW,Milan,it Serie A,30,1987,14.2,8,6,1,5,2,5,13,38.5,8,3,0,3,0,8,11,1,Matches
1062,Oscar Hiljemark,se SWE,MF,Genoa,it Serie A,26,1992,13.3,16,9,8,7,1,5,16,31.3,11,13,3,10,13,29,14,0,Matches
1063,Vitorino Hilton,br BRA,DF,Montpellier,fr Ligue 1,40,1977,35.9,33,13,28,5,0,12,30,40.0,18,31,15,16,66,99,198,2,Matches
1064,Martin Hinteregger,at AUT,DF,Augsburg,de Bundesliga,25,1992,17.5,48,35,31,16,1,24,35,68.6,11,24,13,11,22,70,68,0,Matches
1065,Martin Hinteregger,at AUT,DF,Eint Frankfurt,de Bundesliga,25,1992,12.7,34,26,19,12,3,13,28,46.4,15,20,7,13,13,47,51,0,Matches
1066,Marwin Hitz,ch SUI,GK,Dortmund,de Bundesliga,30,1987,2.0,0,0,0,0,0,0,0,,0,0,0,0,0,0,0,1,Matches
1067,Andrew Hjulsager,dk DEN,"MF,FW",Celta Vigo,es La Liga,23,1995,4.0,16,10,11,2,3,2,18,11.1,16,4,0,4,2,18,1,0,Matches
1068,Wesley Hoedt,nl NED,DF,Southampton,eng Premier League,24,1994,13.0,28,12,23,5,0,17,26,65.4,9,20,13,7,23,51,79,2,Matches
1069,Wesley Hoedt,nl NED,DF,Celta Vigo,es La Liga,24,1994,9.9,17,11,15,2,0,12,17,70.6,5,17,11,6,11,28,58,3,Matches
1070,André Hoffmann,de GER,"DF,MF",Düsseldorf,de Bundesliga,25,1993,11.7,22,14,12,10,0,9,25,36.0,16,17,12,5,21,43,44,0,Matches
1071,Nicolas Höfler,de GER,MF,Freiburg,de Bundesliga,28,1990,17.9,45,22,19,22,4,14,36,38.9,22,21,4,17,32,77,41,0,Matches
1072,Jonas Hofmann,de GER,MF,M'Gladbach,de Bundesliga,26,1992,21.2,37,18,11,19,7,9,37,24.3,28,33,2,31,16,53,14,1,Matches
1073,Jonathan Hogg,eng ENG,MF,Huddersfield,eng Premier League,29,1988,26.3,78,41,18,51,9,27,69,39.1,42,46,7,39,73,151,19,1,Matches
1074,Junior Hoilett,ca CAN,"MF,FW",Cardiff City,eng Premier League,28,1990,23.8,40,27,26,11,3,15,53,28.3,38,34,0,34,32,72,30,0,Matches
1075,Rob Holding,eng ENG,DF,Arsenal,eng Premier League,22,1995,9.0,11,7,9,2,0,2,8,25.0,6,9,7,2,12,23,40,0,Matches
1076,José Holebas,gr GRE,DF,Watford,eng Premier League,34,1984,26.6,68,40,44,20,4,28,53,52.8,25,27,8,19,21,89,97,0,Matches
1077,Lucas Höler,de GER,FW,Freiburg,de Bundesliga,24,1994,11.2,18,13,6,9,3,4,18,22.2,14,10,1,9,3,21,15,2,Matches
1078,Mason Holgate,eng ENG,DF,Everton,eng Premier League,21,1996,4.5,5,4,4,1,0,1,1,100.0,0,3,2,1,3,8,32,0,Matches
1079,Gerrit Holtmann,ph PHI,"FW,MF",Mainz 05,de Bundesliga,23,1995,1.6,2,0,1,0,1,1,2,50.0,1,3,2,1,4,6,1,0,Matches
1080,Justin Hoogma,nl NED,"DF,MF",Hoffenheim,de Bundesliga,20,1998,1.2,4,2,2,1,1,2,2,100.0,0,3,1,2,2,6,1,0,Matches
1081,Lukáš Hrádecký,fi FIN,GK,Leverkusen,de Bundesliga,28,1989,32.0,0,0,0,0,0,0,1,0.0,1,0,0,0,1,1,9,1,Matches
1082,Branimir Hrgota,se SWE,FW,Eint Frankfurt,de Bundesliga,25,1993,0.1,0,0,0,0,0,0,0,,0,0,0,0,0,0,0,0,Matches
1083,Benjamin Hübner,de GER,DF,Hoffenheim,de Bundesliga,29,1989,9.0,29,18,18,9,2,14,18,77.8,4,16,7,9,21,50,35,0,Matches
1084,Tomáš Hubočan,sk SVK,DF,Marseille,fr Ligue 1,32,1985,0.8,3,2,3,0,0,3,4,75.0,1,0,0,0,2,5,5,0,Matches
1085,Callum Hudson-Odoi,eng ENG,FW,Chelsea,eng Premier League,17,2000,4.4,8,6,8,0,0,2,4,50.0,2,1,0,1,3,11,0,0,Matches
1086,Will Hughes,eng ENG,MF,Watford,eng Premier League,23,1995,26.9,74,43,27,35,12,25,59,42.4,34,55,6,49,25,99,30,0,Matches
1087,Vitor Hugo,br BRA,DF,Fiorentina,it Serie A,27,1991,27.4,64,42,38,25,1,17,27,63.0,10,28,13,15,74,138,141,2,Matches
1088,Mats Hummels,de GER,DF,Bayern Munich,de Bundesliga,29,1988,19.7,26,17,19,6,1,9,24,37.5,15,20,8,12,34,60,50,1,Matches
1089,Adrien Hunou,fr FRA,"FW,MF",Rennes,fr Ligue 1,24,1994,13.8,11,7,3,5,3,2,9,22.2,7,14,0,14,5,16,8,0,Matches
1090,Emerson Hyndman,us USA,MF,Bournemouth,eng Premier League,22,1996,0.4,6,2,6,0,0,2,3,66.7,1,0,0,0,1,7,0,0,Matches
1091,Elseid Hysaj,al ALB,DF,Napoli,it Serie A,24,1994,23.4,40,28,22,15,3,25,49,51.0,24,11,3,8,24,64,51,0,Matches
1092,Suk Hyun-jun,kr KOR,FW,Reims,fr Ligue 1,27,1991,8.8,11,8,1,6,4,0,8,0.0,8,2,1,1,2,13,4,1,Matches
1093,Pierre Højbjerg,dk DEN,MF,Southampton,eng Premier League,22,1995,30.7,71,49,20,44,7,24,73,32.9,49,51,8,43,60,131,30,1,Matches
1094,Simone Iacoponi,it ITA,DF,Parma,it Serie A,31,1987,37.2,62,43,50,11,1,27,47,57.4,20,40,26,14,37,99,178,3,Matches
1095,Robert Ibáñez,es ESP,MF,Getafe,es La Liga,25,1993,0.8,2,2,1,1,0,0,1,0.0,1,3,0,3,0,2,0,0,Matches
1096,Roger Ibanez,br BRA,"DF,FW",Atalanta,it Serie A,19,1998,0.0,0,0,0,0,0,0,0,,0,0,0,0,0,0,1,0,Matches
1097,Jordon Ibe,eng ENG,"MF,DF",Bournemouth,eng Premier League,22,1995,8.9,6,5,0,5,1,2,7,28.6,5,2,0,2,4,10,4,0,Matches
1098,Vedad Ibišević,ba BIH,FW,Hertha BSC,de Bundesliga,33,1984,20.1,12,8,2,5,5,0,10,0.0,10,10,4,6,3,15,20,0,Matches
1099,Vicente Iborra,es ESP,MF,Leicester City,eng Premier League,30,1988,2.5,4,1,1,3,0,0,7,0.0,7,1,0,1,8,12,4,1,Matches
1100,Vicente Iborra,es ESP,MF,Villarreal,es La Liga,30,1988,18.5,31,18,22,5,4,14,37,37.8,23,25,7,18,22,53,41,1,Matches
1101,Didier Ibrahim Ndong,ga GAB,MF,Guingamp,fr Ligue 1,24,1994,8.3,16,11,3,13,0,5,13,38.5,8,15,3,12,15,31,6,1,Matches
1102,Mauro Icardi,ar ARG,FW,Inter,it Serie A,25,1993,25.2,9,8,2,2,5,1,6,16.7,5,4,1,3,3,12,20,1,Matches
1103,Salvador Ichazo,uy URU,GK,Torino,it Serie A,26,1992,2.8,0,0,0,0,0,0,0,,0,0,0,0,0,0,0,0,Matches
1104,Edgar Ié,gw GNB,DF,Lille,fr Ligue 1,24,1994,2.7,5,4,3,2,0,3,5,60.0,2,2,1,1,7,12,17,0,Matches
1105,Edgar Ié,gw GNB,DF,Nantes,fr Ligue 1,24,1994,8.6,20,13,12,6,2,9,16,56.3,7,10,3,7,8,28,23,0,Matches
1106,Borja Iglesias,es ESP,FW,Espanyol,es La Liga,25,1993,34.2,23,14,7,8,8,5,24,20.8,19,14,6,8,7,30,41,0,Matches
1107,Kelechi Iheanacho,ng NGA,"FW,MF",Leicester City,eng Premier League,21,1996,10.5,6,5,4,1,1,1,5,20.0,4,5,0,5,2,8,3,0,Matches
1108,Jordan Ikoko,cd COD,DF,Guingamp,fr Ligue 1,24,1994,19.0,37,24,22,14,1,16,28,57.1,12,18,5,13,24,61,30,0,Matches
1109,Jonathan Ikone,fr FRA,"MF,FW",Lille,fr Ligue 1,20,1998,31.1,25,14,7,12,6,8,30,26.7,22,24,2,22,6,31,4,0,Matches
1110,Ivo Iličević,hr CRO,MF,Nürnberg,de Bundesliga,31,1986,0.4,1,0,0,1,0,1,2,50.0,1,1,0,1,0,1,0,0,Matches
1111,Josip Iličić,si SVN,"FW,MF",Atalanta,it Serie A,30,1988,23.8,15,7,2,7,6,5,20,25.0,15,20,1,19,5,20,2,0,Matches
1112,Asier Illarramendi,es ESP,MF,Real Sociedad,es La Liga,28,1990,20.2,39,24,22,14,3,21,51,41.2,30,36,9,27,31,70,46,1,Matches
1113,Stefan Ilsanker,at AUT,"DF,MF",RB Leipzig,de Bundesliga,29,1989,10.4,26,17,15,10,1,14,23,60.9,9,9,2,7,18,44,43,1,Matches
1114,Giannelli Imbula,cd COD,MF,Rayo Vallecano,es La Liga,25,1992,19.2,14,7,6,7,1,5,12,41.7,7,12,3,9,8,22,6,0,Matches
1115,Ciro Immobile,it ITA,FW,Lazio,it Serie A,28,1990,31.8,12,6,4,3,5,4,9,44.4,5,18,1,17,1,13,8,0,Matches
1116,Emmanuel Imorou,bj BEN,DF,Caen,fr Ligue 1,29,1988,12.4,18,13,10,7,1,11,17,64.7,6,14,4,10,28,46,49,1,Matches
1117,Svante Ingelsson,se SWE,"DF,MF",Udinese,it Serie A,20,1998,1.1,1,1,1,0,0,0,0,,0,2,0,2,0,1,4,0,Matches
1118,Roberto Inglese,it ITA,FW,Parma,it Serie A,26,1991,21.8,20,14,7,7,6,1,13,7.7,12,26,2,24,6,26,27,0,Matches
1119,Danny Ings,eng ENG,FW,Southampton,eng Premier League,26,1992,18.3,30,14,5,19,6,11,28,39.3,17,30,2,28,5,35,9,0,Matches
1120,Lorenzo Insigne,it ITA,"FW,MF",Napoli,it Serie A,27,1991,23.0,14,4,5,6,3,6,18,33.3,12,7,0,7,8,22,3,0,Matches
1121,Emiliano Insúa,ar ARG,DF,Stuttgart,de Bundesliga,29,1989,23.5,51,33,26,18,7,25,42,59.5,17,29,2,27,31,82,55,1,Matches
1122,Pablo Insua,es ESP,DF,Huesca,es La Liga,24,1993,8.6,23,10,14,9,0,8,15,53.3,7,2,0,2,12,35,40,0,Matches
1123,Takashi Inui,jp JPN,"MF,FW",Alavés,es La Liga,30,1988,9.2,9,5,6,2,1,5,18,27.8,13,5,0,5,4,13,3,0,Matches
1124,Takashi Inui,jp JPN,MF,Betis,es La Liga,30,1988,4.2,4,3,0,4,0,3,7,42.9,4,3,0,3,1,5,1,0,Matches
1125,Artur Ioniță,md MDA,MF,Cagliari,it Serie A,27,1990,33.0,67,38,23,31,13,16,57,28.1,41,40,5,35,27,94,30,0,Matches
1126,Gorka Iraizoz,es ESP,GK,Girona,es La Liga,37,1981,6.2,1,0,1,0,0,1,1,100.0,0,0,0,0,1,2,7,0,Matches
1127,Carlos Isaac,es ESP,DF,Atlético Madrid,es La Liga,20,1998,1.0,0,0,0,0,0,0,2,0.0,2,2,0,2,1,1,2,0,Matches
1128,Isco,es ESP,"MF,FW",Real Madrid,es La Liga,26,1992,13.2,29,14,14,8,7,14,34,41.2,20,9,1,8,6,35,3,0,Matches
1129,Mikael Ishak,se SWE,FW,Nürnberg,de Bundesliga,25,1993,21.3,9,6,3,6,0,3,16,18.8,13,8,3,5,3,12,10,0,Matches
1130,Wilson Isidor,fr FRA,FW,Monaco,fr Ligue 1,17,2000,0.5,0,0,0,0,0,0,0,,0,1,1,0,0,0,1,0,Matches
1131,Gian-Luca Itter,de GER,DF,Wolfsburg,de Bundesliga,19,1999,1.0,4,3,3,1,0,1,2,50.0,1,2,0,2,1,5,2,0,Matches
1132,Manuel Iturra,cl CHI,MF,Villarreal,es La Liga,34,1984,0.8,2,0,0,2,0,0,0,,0,1,0,1,2,4,2,0,Matches
1133,Ander Iturraspe,es ESP,MF,Athletic Club,es La Liga,29,1989,1.1,2,2,1,1,0,1,1,100.0,0,0,0,0,6,8,2,0,Matches
1134,Ivi,es ESP,"MF,FW",Valladolid,es La Liga,24,1994,0.2,0,0,0,0,0,0,0,,0,0,0,0,0,0,0,0,Matches
1135,Alex Iwobi,ng NGA,"FW,MF",Arsenal,eng Premier League,22,1996,21.9,28,14,10,16,2,6,25,24.0,19,21,1,20,12,40,13,1,Matches
1136,José Izquierdo,co COL,"MF,FW",Brighton,eng Premier League,26,1992,8.8,15,9,9,4,2,10,20,50.0,10,7,1,6,5,20,7,0,Matches
1137,Armando Izzo,it ITA,DF,Torino,it Serie A,26,1992,36.3,76,50,35,35,6,33,53,62.3,20,52,24,28,88,164,149,2,Matches
1138,Koo Ja-cheol,kr KOR,MF,Augsburg,de Bundesliga,29,1989,18.2,36,23,10,20,6,12,30,40.0,18,28,5,23,27,63,21,0,Matches
1139,Lukas Jäger,at AUT,"FW,MF",Nürnberg,de Bundesliga,24,1994,0.3,0,0,0,0,0,0,2,0.0,2,0,0,0,0,0,0,0,Matches
1140,Phil Jagielka,eng ENG,DF,Everton,eng Premier League,35,1982,3.7,7,5,3,4,0,1,4,25.0,3,1,0,1,2,9,14,0,Matches
1141,Alireza Jahanbakhsh,ir IRN,"FW,MF",Brighton,eng Premier League,24,1993,11.3,32,18,17,11,4,11,30,36.7,19,16,0,16,11,43,4,0,Matches
1142,Christophe Jallet,fr FRA,DF,Nice,fr Ligue 1,34,1983,9.8,29,21,12,13,4,16,27,59.3,11,21,5,16,14,43,32,0,Matches
1143,Jandrei,br BRA,GK,Genoa,it Serie A,25,1993,1.0,0,0,0,0,0,0,1,0.0,1,0,0,0,0,0,0,0,Matches
1144,Christoph Janker,de GER,"MF,FW",Augsburg,de Bundesliga,33,1985,0.8,2,1,2,0,0,0,0,,0,1,0,1,0,2,1,0,Matches
1145,Marko Janković,me MNE,"DF,MF",SPAL,it Serie A,23,1995,0.6,3,1,2,1,0,0,2,0.0,2,0,0,0,0,3,0,0,Matches
1146,Jakub Jankto,cz CZE,MF,Sampdoria,it Serie A,22,1996,10.7,7,4,5,2,0,4,15,26.7,11,18,2,16,9,16,16,0,Matches
1147,Daryl Janmaat,nl NED,DF,Watford,eng Premier League,29,1989,16.9,36,24,23,11,2,20,29,69.0,9,16,6,10,33,69,71,0,Matches
1148,Vincent Janssen,nl NED,FW,Tottenham,eng Premier League,24,1994,0.4,2,1,0,2,0,0,0,,0,0,0,0,0,2,1,0,Matches
1149,Tony Jantschke,de GER,DF,M'Gladbach,de Bundesliga,28,1990,10.4,15,10,9,5,1,6,8,75.0,2,10,7,3,27,42,51,1,Matches
1150,Adnan Januzaj,be BEL,"FW,MF",Real Sociedad,es La Liga,23,1995,13.9,11,8,5,2,4,3,13,23.1,10,7,0,7,6,17,6,0,Matches
1151,Nicolas Janvier,fr FRA,MF,Rennes,fr Ligue 1,19,1998,0.0,0,0,0,0,0,0,0,,0,0,0,0,0,0,0,0,Matches
1152,Paweł Jaroszyński,pl POL,DF,Chievo,it Serie A,23,1994,15.0,29,18,17,8,4,16,32,50.0,16,15,4,11,24,53,41,1,Matches
1153,Rune Jarstein,no NOR,GK,Hertha BSC,de Bundesliga,33,1984,30.5,0,0,0,0,0,0,0,,0,0,0,0,1,1,8,1,Matches
1154,Jason,es ESP,"DF,FW",Levante,es La Liga,24,1994,25.9,44,25,22,11,11,20,71,28.2,51,25,4,21,46,90,27,0,Matches
1155,Dennis Jastrzembski,pl POL,"FW,DF",Hertha BSC,de Bundesliga,18,2000,0.7,0,0,0,0,0,0,3,0.0,3,0,0,0,1,1,0,0,Matches
1156,Assil Jaziri,tn TUN,FW,Nice,fr Ligue 1,18,1999,0.4,2,2,0,2,0,1,2,50.0,1,1,0,1,1,3,0,0,Matches
1157,Corentin Jean,fr FRA,"FW,MF",Toulouse,fr Ligue 1,23,1995,7.0,9,6,3,6,0,2,8,25.0,6,8,0,8,2,11,5,0,Matches
1158,Benjamin Jeannot,fr FRA,"FW,MF",Dijon,fr Ligue 1,26,1992,16.0,17,12,5,7,5,6,19,31.6,13,15,3,12,12,29,14,0,Matches
1159,Tin Jedvaj,hr CRO,DF,Leverkusen,de Bundesliga,22,1995,12.5,23,15,9,8,6,10,19,52.6,9,28,2,26,22,45,52,0,Matches
1160,Jemerson,br BRA,"DF,MF",Monaco,fr Ligue 1,25,1992,24.7,54,38,34,19,1,29,46,63.0,17,29,17,12,25,79,121,1,Matches
1161,Carl Jenkinson,eng ENG,DF,Arsenal,eng Premier League,26,1992,1.8,3,2,2,0,1,2,3,66.7,1,4,3,1,0,3,2,0,Matches
1162,Fredrik Jensen,fi FIN,"FW,MF",Augsburg,de Bundesliga,20,1997,2.3,5,4,3,1,1,2,4,50.0,2,6,0,6,2,7,3,0,Matches
1163,Mathias Jensen,dk DEN,"MF,FW",Celta Vigo,es La Liga,22,1996,2.6,4,2,2,2,0,2,9,22.2,7,2,0,2,4,8,1,0,Matches
1164,Jesé,es ESP,"FW,MF",Betis,es La Liga,25,1993,8.7,7,4,3,3,1,2,8,25.0,6,8,0,8,1,8,1,0,Matches
1165,Gabriel Jesus,br BRA,FW,Manchester City,eng Premier League,21,1997,11.5,10,3,5,2,3,0,5,0.0,5,16,2,14,3,13,4,0,Matches
1166,Juan Jesus,br BRA,DF,Roma,it Serie A,27,1991,15.6,37,29,30,5,2,17,30,56.7,13,20,12,8,16,53,41,0,Matches
1167,Raúl Jiménez,mx MEX,FW,Wolves,eng Premier League,27,1991,34.6,30,18,5,17,8,6,23,26.1,17,25,3,22,26,56,40,0,Matches
1168,Joaquín,es ESP,"FW,MF",Betis,es La Liga,37,1981,18.8,10,4,4,2,4,3,7,42.9,4,13,2,11,14,24,31,1,Matches
1169,Joelinton,br BRA,"FW,MF",Hoffenheim,de Bundesliga,21,1996,23.7,35,22,9,20,6,10,30,33.3,20,36,3,33,14,49,8,0,Matches
1170,Aron Jóhannsson,us USA,MF,Werder Bremen,de Bundesliga,27,1990,0.0,0,0,0,0,0,0,0,,0,0,0,0,0,0,0,0,Matches
1171,Stefan Johansen,no NOR,MF,Fulham,eng Premier League,27,1991,4.6,11,3,4,7,0,5,8,62.5,3,5,0,5,3,14,6,0,Matches
1172,Jakob Johansson,se SWE,MF,Rennes,fr Ligue 1,28,1990,7.9,17,9,5,12,0,10,20,50.0,10,7,3,4,3,20,17,1,Matches
1173,Ben Johnson,eng ENG,DF,West Ham,eng Premier League,18,2000,0.7,1,0,1,0,0,0,1,0.0,1,0,0,0,1,2,5,0,Matches
1174,Fabian Johnson,us USA,"DF,FW",M'Gladbach,de Bundesliga,30,1987,11.2,13,5,2,8,3,6,8,75.0,2,8,3,5,10,23,16,0,Matches
1175,Tyreke Johnson,eng ENG,MF,Southampton,eng Premier League,19,1998,0.0,0,0,0,0,0,0,0,,0,0,0,0,0,0,0,0,Matches
1176,Karl-Johan Johnsson,se SWE,GK,Guingamp,fr Ligue 1,28,1990,17.0,0,0,0,0,0,0,1,0.0,1,0,0,0,0,0,4,1,Matches
1177,Jonathas,br BRA,FW,Hannover 96,de Bundesliga,29,1989,6.7,7,4,3,4,0,3,10,30.0,7,9,1,8,3,10,4,0,Matches
1178,Phil Jones,eng ENG,DF,Manchester Utd,eng Premier League,26,1992,14.0,19,13,12,7,0,8,13,61.5,5,16,11,5,23,42,67,3,Matches
1179,Jony,es ESP,"MF,FW",Alavés,es La Liga,27,1991,33.0,20,14,6,7,7,7,37,18.9,30,18,0,18,22,42,12,2,Matches
1180,Joan Jordán,es ESP,MF,Eibar,es La Liga,24,1994,31.9,63,40,16,38,9,28,80,35.0,52,38,4,34,32,95,18,1,Matches
1181,Bruno Jordão,pt POR,"MF,DF",Lazio,it Serie A,19,1998,1.0,4,3,2,1,1,1,3,33.3,2,1,0,1,0,4,2,0,Matches
1182,Jorginho,it ITA,MF,Chelsea,eng Premier League,26,1991,35.1,76,38,27,41,8,45,96,46.9,51,46,7,39,64,140,38,1,Matches
1183,Willian José,br BRA,FW,Real Sociedad,es La Liga,26,1991,26.3,5,3,1,3,1,2,7,28.6,5,11,5,6,1,6,27,0,Matches
1184,Joselu,es ESP,FW,Newcastle Utd,eng Premier League,28,1990,6.6,14,8,4,5,5,4,9,44.4,5,5,0,5,3,17,15,0,Matches
1185,Evens Joseph,fr FRA,"MF,FW",Caen,fr Ligue 1,19,1999,3.8,5,2,1,2,2,1,3,33.3,2,3,0,3,2,7,1,0,Matches
1186,Diogo Jota,pt POR,"FW,MF",Wolves,eng Premier League,21,1996,26.2,28,16,11,11,6,10,38,26.3,28,20,1,19,13,41,11,0,Matches
1187,Aleksandar Jovanović,rs SRB,GK,Huesca,es La Liga,25,1992,12.0,0,0,0,0,0,0,0,,0,0,0,0,1,1,3,0,Matches
1188,Vukašin Jovanović,rs SRB,DF,Bordeaux,fr Ligue 1,22,1996,15.3,26,21,21,5,0,13,19,68.4,6,23,12,11,36,62,105,0,Matches
1189,Stevan Jovetić,me MNE,"MF,FW",Monaco,fr Ligue 1,28,1989,4.4,2,1,1,1,0,1,3,33.3,2,1,0,1,1,3,3,0,Matches
1190,Luka Jović,rs SRB,"FW,MF",Eint Frankfurt,de Bundesliga,20,1997,24.9,10,5,1,8,1,1,12,8.3,11,8,0,8,3,13,30,0,Matches
1191,Jozabed,es ESP,MF,Celta Vigo,es La Liga,27,1991,12.8,19,10,8,8,3,8,24,33.3,16,8,2,6,9,28,13,2,Matches
1192,Miguel Juan Llambrich,es ESP,"DF,FW",Villarreal,es La Liga,22,1996,6.0,21,14,11,9,1,6,14,42.9,8,9,2,7,12,33,17,0,Matches
1193,Juanfran,es ESP,"DF,FW",Leganés,es La Liga,29,1988,16.2,20,12,13,5,2,9,16,56.3,7,9,4,5,19,39,37,0,Matches
1194,Juanfran,es ESP,DF,Atlético Madrid,es La Liga,33,1985,17.9,35,22,27,5,3,24,38,63.2,14,13,5,8,19,54,36,1,Matches
1195,Juanmi,es ESP,"FW,MF",Real Sociedad,es La Liga,25,1993,16.9,21,12,7,11,3,8,22,36.4,14,12,0,12,16,37,13,0,Matches
1196,Juanpe,es ESP,DF,Girona,es La Liga,27,1991,30.7,48,25,32,15,1,24,45,53.3,21,31,15,16,57,105,138,0,Matches
1197,Juanpi,ve VEN,"MF,FW",Huesca,es La Liga,24,1994,7.4,16,6,9,5,2,4,12,33.3,8,15,0,15,6,22,3,0,Matches
1198,Nathaël Julan,fr FRA,"FW,MF",Guingamp,fr Ligue 1,22,1996,4.8,1,0,0,0,1,0,3,0.0,3,6,1,5,0,1,2,0,Matches
1199,Christopher Jullien,fr FRA,DF,Toulouse,fr Ligue 1,25,1993,33.5,35,24,23,10,2,12,32,37.5,20,39,27,12,41,76,203,4,Matches
1200,David Juncà,es ESP,DF,Celta Vigo,es La Liga,24,1993,19.5,55,30,40,13,2,28,46,60.9,18,27,6,21,35,90,63,1,Matches
1201,Sebastian Jung,de GER,DF,Wolfsburg,de Bundesliga,28,1990,0.6,1,0,0,1,0,1,1,100.0,0,0,0,0,0,1,1,0,Matches
1202,Hamed Junior Traorè,ci CIV,MF,Empoli,it Serie A,18,2000,25.1,67,38,26,32,9,27,72,37.5,45,29,4,25,30,97,17,0,Matches
1203,Vinicius Júnior,br BRA,"FW,MF",Real Madrid,es La Liga,18,2000,9.7,10,6,3,6,1,3,16,18.8,13,6,1,5,7,17,1,0,Matches
1204,Musa Juwara,gm GAM,FW,Chievo,it Serie A,16,2001,0.1,0,0,0,0,0,0,0,,0,0,0,0,1,1,0,0,Matches
1205,Mathias Jørgensen,dk DEN,DF,Huddersfield,eng Premier League,28,1990,23.9,49,31,27,21,1,27,46,58.7,19,29,14,15,69,118,83,0,Matches
1206,Sory Kaba,gn GUI,"FW,MF",Dijon,fr Ligue 1,23,1995,2.6,1,1,1,0,0,1,3,33.3,2,2,0,2,0,1,1,0,Matches
1207,Ozan Kabak,tr TUR,DF,Stuttgart,de Bundesliga,18,2000,15.0,33,19,22,9,2,9,19,47.4,10,15,8,7,23,56,58,1,Matches
1208,Christian Kabasele,be BEL,DF,Watford,eng Premier League,27,1991,17.6,25,14,20,5,0,10,23,43.5,13,21,16,5,38,63,111,0,Matches
1209,Elias Kachunga,cd COD,"FW,MF",Huddersfield,eng Premier League,26,1992,13.1,22,9,8,12,2,9,25,36.0,16,16,1,15,4,26,10,0,Matches
1210,Pavel Kadeřábek,cz CZE,DF,Hoffenheim,de Bundesliga,26,1992,27.9,30,19,12,13,5,11,24,45.8,13,37,10,27,34,64,71,1,Matches
1211,Shinji Kagawa,jp JPN,MF,Dortmund,de Bundesliga,29,1989,1.1,0,0,0,0,0,0,0,,0,0,0,0,0,0,0,0,Matches
1212,Florian Kainz,at AUT,FW,Werder Bremen,de Bundesliga,25,1992,4.1,6,5,5,1,0,3,6,50.0,3,4,1,3,3,9,5,0,Matches
1213,Gaël Kakuta,cd COD,"MF,FW",Rayo Vallecano,es La Liga,27,1991,8.0,12,7,5,5,2,2,10,20.0,8,4,1,3,9,21,9,0,Matches
1214,Nikola Kalinić,hr CRO,FW,Atlético Madrid,es La Liga,30,1988,7.1,6,4,2,4,0,1,3,33.3,2,1,0,1,2,8,2,0,Matches
1215,Salomon Kalou,ci CIV,"FW,MF",Hertha BSC,de Bundesliga,32,1985,25.7,21,12,5,11,5,6,24,25.0,18,23,1,22,6,27,25,0,Matches
1216,Samuel Kalu,ng NGA,FW,Bordeaux,fr Ligue 1,20,1997,14.2,27,18,15,7,5,4,11,36.4,7,11,3,8,8,35,4,1,Matches
1217,François Kamano,gn GUI,"FW,MF",Bordeaux,fr Ligue 1,22,1996,28.5,29,18,6,17,6,11,30,36.7,19,27,0,27,17,46,6,1,Matches
1218,Aboubakar Kamara,mr MTN,FW,Fulham,eng Premier League,23,1995,7.7,8,4,1,5,2,3,7,42.9,4,6,0,6,1,9,6,0,Matches
1219,Boubacar Kamara,fr FRA,DF,Marseille,fr Ligue 1,18,1999,26.8,67,39,38,24,5,32,49,65.3,17,24,13,11,45,112,95,2,Matches
1220,Hassane Kamara,ci CIV,"DF,FW",Reims,fr Ligue 1,24,1994,10.3,29,21,22,5,2,16,19,84.2,3,6,1,5,14,43,41,0,Matches
1221,Marcin Kamiński,pl POL,DF,Düsseldorf,de Bundesliga,26,1992,27.0,18,13,14,3,1,7,11,63.6,4,21,11,10,39,57,103,2,Matches
1222,Patrick Kammerbauer,de GER,FW,Freiburg,de Bundesliga,21,1997,0.0,0,0,0,0,0,0,0,,0,0,0,0,1,1,1,0,Matches
1223,Kevin Kampl,si SVN,MF,RB Leipzig,de Bundesliga,27,1990,23.5,41,24,16,21,4,8,28,28.6,20,32,2,30,33,74,22,0,Matches
1224,Harry Kane,eng ENG,FW,Tottenham,eng Premier League,25,1993,26.9,10,6,2,8,0,1,14,7.1,13,16,6,10,1,11,14,0,Matches
1225,Wilfried Kanga,ci CIV,FW,Angers,fr Ligue 1,20,1998,5.5,0,0,0,0,0,0,1,0.0,1,3,0,3,0,0,4,0,Matches
1226,N'Golo Kanté,fr FRA,MF,Chelsea,eng Premier League,27,1991,34.4,75,41,21,41,13,23,67,34.3,44,63,6,57,44,119,32,1,Matches
1227,Stefanos Kapino,gr GRE,GK,Werder Bremen,de Bundesliga,24,1994,0.5,0,0,0,0,0,0,0,,0,0,0,0,0,0,0,0,Matches
1228,Wilfrid Kaptoum,cm CMR,MF,Betis,es La Liga,22,1996,8.6,15,6,4,10,1,5,11,45.5,6,9,1,8,10,25,6,2,Matches
1229,Kenan Karaman,tr TUR,"FW,MF",Düsseldorf,de Bundesliga,24,1994,10.2,13,9,3,10,0,7,12,58.3,5,5,1,4,2,15,8,0,Matches
1230,Yann Karamoh,fr FRA,"FW,MF",Inter,it Serie A,20,1998,0.1,0,0,0,0,0,0,0,,0,0,0,0,0,0,0,0,Matches
1231,Yann Karamoh,fr FRA,FW,Bordeaux,fr Ligue 1,20,1998,13.6,7,3,1,4,2,1,13,7.7,12,9,0,9,6,13,3,0,Matches
1232,Ibrahim Karamoko,fr FRA,MF,Chievo,it Serie A,17,2001,0.7,0,0,0,0,0,0,0,,0,1,0,1,0,0,1,0,Matches
1233,Orestis Karnezis,gr GRE,GK,Napoli,it Serie A,33,1985,9.0,0,0,0,0,0,0,0,,0,0,0,0,0,0,3,0,Matches
1234,Rick Karsdorp,nl NED,DF,Roma,it Serie A,23,1995,6.6,9,6,3,5,1,5,11,45.5,6,4,2,2,12,21,12,1,Matches
1235,Grigoris Kastanos,cy CYP,MF,Juventus,it Serie A,20,1998,0.7,3,1,3,0,0,0,0,,0,3,1,2,0,3,0,0,Matches
1236,Eiji Kawashima,jp JPN,GK,Strasbourg,fr Ligue 1,35,1983,1.0,0,0,0,0,0,0,0,,0,0,0,0,0,0,0,0,Matches
1237,Beram Kayal,il ISR,MF,Brighton,eng Premier League,30,1988,10.4,28,17,16,11,1,5,21,23.8,16,17,10,7,15,43,25,0,Matches
1238,Moise Kean,it ITA,FW,Juventus,it Serie A,18,2000,6.0,0,0,0,0,0,0,1,0.0,1,1,0,1,2,2,1,0,Matches
1239,Michael Keane,eng ENG,DF,Everton,eng Premier League,25,1993,33.0,41,25,22,16,3,19,32,59.4,13,30,22,8,43,84,185,4,Matches
1240,Neeskens Kebano,cd COD,"FW,MF",Fulham,eng Premier League,26,1992,1.2,3,1,2,1,0,1,1,100.0,0,3,0,3,0,3,3,0,Matches
1241,Thilo Kehrer,de GER,DF,Paris S-G,fr Ligue 1,21,1996,21.1,64,43,27,31,6,31,55,56.4,24,32,17,15,31,95,69,1,Matches
1242,Jules Keita,gn GUI,"FW,MF",Dijon,fr Ligue 1,20,1998,5.1,10,4,0,3,7,5,12,41.7,7,2,0,2,2,12,1,0,Matches
1243,Naby Keïta,gn GUI,"MF,FW",Liverpool,eng Premier League,23,1995,15.4,37,15,13,19,5,14,42,33.3,28,29,4,25,12,49,16,1,Matches
1244,Keko,es ESP,"MF,FW",Valladolid,es La Liga,26,1991,17.0,42,18,21,15,6,18,50,36.0,32,20,1,19,14,56,17,0,Matches
1245,Martin Kelly,eng ENG,DF,Crystal Palace,eng Premier League,28,1990,12.3,21,13,18,2,1,14,19,73.7,5,18,12,6,11,32,88,1,Matches
1246,Marc-Oliver Kempf,de GER,DF,Stuttgart,de Bundesliga,23,1995,22.5,33,18,26,7,0,12,24,50.0,12,35,21,14,46,79,141,1,Matches
1247,Kenedy,br BRA,"MF,DF",Newcastle Utd,eng Premier League,22,1996,15.0,30,22,11,16,3,12,29,41.4,17,10,0,10,32,62,24,1,Matches
1248,Jonjoe Kenny,eng ENG,DF,Everton,eng Premier League,21,1997,8.8,21,16,16,4,1,10,18,55.6,8,13,2,11,17,38,36,1,Matches
1249,Christophe Kerbrat,fr FRA,DF,Guingamp,fr Ligue 1,31,1986,23.3,40,24,28,12,0,24,38,63.2,14,19,10,9,50,90,140,5,Matches
1250,Sebastian Kerk,de GER,"MF,FW",Nürnberg,de Bundesliga,24,1994,13.1,16,9,8,5,3,7,23,30.4,16,14,5,9,3,19,22,1,Matches
1251,Franck Kessié,ci CIV,MF,Milan,it Serie A,21,1996,33.5,42,27,16,20,6,18,38,47.4,20,35,10,25,27,69,53,2,Matches
1252,Saîf-Eddine Khaoui,tn TUN,"MF,FW",Caen,fr Ligue 1,23,1995,15.0,20,14,5,11,4,8,27,29.6,19,9,1,8,20,40,4,0,Matches
1253,Wahbi Khazri,tn TUN,"FW,MF",Saint-Étienne,fr Ligue 1,27,1991,31.3,41,26,8,14,19,17,49,34.7,32,27,2,25,11,52,5,0,Matches
1254,Rani Khedira,de GER,"DF,MF",Augsburg,de Bundesliga,24,1994,29.2,56,39,22,28,6,18,36,50.0,18,44,22,22,80,136,95,1,Matches
1255,Sami Khedira,de GER,MF,Juventus,it Serie A,31,1987,7.8,10,9,6,2,2,5,9,55.6,4,8,3,5,5,15,6,0,Matches
1256,Isaac Kiese Thelin,se SWE,"FW,MF",Leverkusen,de Bundesliga,26,1992,2.0,2,1,0,2,0,1,2,50.0,1,1,0,1,0,2,4,0,Matches
1257,Kike,es ESP,FW,Eibar,es La Liga,28,1989,14.4,7,4,1,2,4,1,5,20.0,4,18,0,18,4,11,6,0,Matches
1258,Max Kilman,eng ENG,DF,Wolves,eng Premier League,21,1997,0.0,0,0,0,0,0,0,0,,0,0,0,0,0,0,0,0,Matches
1259,Joshua Kimmich,de GER,"DF,MF",Bayern Munich,de Bundesliga,23,1995,34.0,46,26,17,22,7,25,54,46.3,29,35,9,26,34,80,41,3,Matches
1260,Presnel Kimpembe,fr FRA,DF,Paris S-G,fr Ligue 1,22,1995,22.3,55,34,26,25,4,24,40,60.0,16,17,10,7,30,85,48,5,Matches
1261,Joshua King,no NOR,"FW,MF",Bournemouth,eng Premier League,26,1992,32.9,30,19,7,19,4,8,29,27.6,21,28,4,24,7,37,14,0,Matches
1262,Sofian Kiyine,ma MAR,"MF,DF",Chievo,it Serie A,20,1997,9.1,28,13,11,14,3,9,18,50.0,9,10,0,10,10,38,4,0,Matches
1263,Simon Kjær,dk DEN,DF,Sevilla,es La Liga,29,1989,22.3,29,19,25,3,1,9,16,56.3,7,41,34,7,27,56,136,0,Matches
1264,Davy Klaassen,nl NED,MF,Werder Bremen,de Bundesliga,25,1993,31.3,64,47,24,33,7,14,49,28.6,35,44,9,35,47,111,47,0,Matches
1265,Felix Klaus,de GER,"FW,MF",Wolfsburg,de Bundesliga,25,1992,4.9,10,7,4,5,1,2,7,28.6,5,5,0,5,4,14,0,0,Matches
1266,Ragnar Klavan,ee EST,DF,Cagliari,it Serie A,32,1985,13.7,9,8,5,3,1,5,11,45.5,6,19,13,6,10,19,68,1,Matches
1267,Tim Kleindienst,de GER,FW,Freiburg,de Bundesliga,22,1995,2.2,4,3,1,2,1,1,3,33.3,2,3,0,3,0,4,7,0,Matches
1268,Lukas Klostermann,de GER,DF,RB Leipzig,de Bundesliga,22,1996,22.3,50,29,33,12,5,29,45,64.4,16,37,5,32,29,79,74,0,Matches
1269,Justin Kluivert,nl NED,FW,Roma,it Serie A,19,1999,14.9,28,27,12,9,7,10,23,43.5,13,17,0,17,7,35,12,0,Matches
1270,Lukas Klünter,de GER,DF,Hertha BSC,de Bundesliga,22,1996,6.6,11,8,6,5,0,4,5,80.0,1,6,2,4,12,23,20,0,Matches
1271,Robin Knoche,de GER,DF,Wolfsburg,de Bundesliga,26,1992,31.0,26,20,19,6,1,16,29,55.2,13,46,29,17,44,70,138,2,Matches
1272,Anthony Knockaert,fr FRA,"MF,FW",Brighton,eng Premier League,26,1991,20.4,33,21,12,15,6,13,30,43.3,17,13,0,13,29,62,11,0,Matches
1273,Törles Knöll,de GER,"FW,MF",Nürnberg,de Bundesliga,20,1997,4.1,3,2,1,1,1,0,4,0.0,4,5,1,4,0,3,2,0,Matches
1274,Gregor Kobel,ch SUI,GK,Hoffenheim,de Bundesliga,20,1997,1.0,0,0,0,0,0,0,0,,0,0,0,0,0,0,0,0,Matches
1275,Gregor Kobel,ch SUI,GK,Augsburg,de Bundesliga,20,1997,15.4,1,1,1,0,0,1,1,100.0,0,0,0,0,2,3,5,3,Matches
1276,Robin Koch,de GER,"MF,DF",Freiburg,de Bundesliga,22,1996,21.1,25,14,17,7,1,7,24,29.2,17,31,18,13,32,57,77,4,Matches
1277,Kenan Kodro,ba BIH,"FW,MF",Athletic Club,es La Liga,24,1993,1.8,3,1,1,1,1,1,3,33.3,2,1,0,1,0,3,0,0,Matches
1278,Dominik Kohr,de GER,MF,Leverkusen,de Bundesliga,24,1994,10.8,42,29,21,21,0,14,35,40.0,21,25,12,13,15,57,17,1,Matches
1279,Djégui Koita,fr FRA,DF,Guingamp,fr Ligue 1,18,1999,1.9,8,6,8,0,0,3,4,75.0,1,5,3,2,0,8,9,0,Matches
1280,Koke,es ESP,MF,Atlético Madrid,es La Liga,26,1992,28.7,84,46,41,32,11,34,86,39.5,52,25,5,20,31,115,37,1,Matches
1281,Aleksandar Kolarov,rs SRB,DF,Roma,it Serie A,32,1985,32.3,38,26,22,10,6,21,34,61.8,13,23,15,8,41,79,82,2,Matches
1282,Sead Kolašinac,ba BIH,"DF,MF",Arsenal,eng Premier League,25,1993,21.0,34,21,21,7,6,20,34,58.8,14,12,3,9,20,54,28,3,Matches
1283,Randal Kolo Muani,fr FRA,FW,Nantes,fr Ligue 1,19,1998,1.4,2,0,1,1,0,0,1,0.0,1,2,0,2,0,2,2,0,Matches
1284,Timothée Kolodziejczak,fr FRA,DF,Saint-Étienne,fr Ligue 1,26,1991,35.4,34,22,21,10,3,20,45,44.4,25,25,11,14,53,87,118,2,Matches
1285,Vincent Kompany,be BEL,DF,Manchester City,eng Premier League,32,1986,13.6,16,10,11,3,2,8,9,88.9,1,11,8,3,16,32,55,0,Matches
1286,Ghislain Konan,ci CIV,DF,Reims,fr Ligue 1,22,1995,20.0,45,28,31,10,4,24,40,60.0,16,18,4,14,40,85,55,1,Matches
1287,Ibrahima Konaté,fr FRA,DF,RB Leipzig,de Bundesliga,19,1999,27.0,44,32,30,14,0,17,27,63.0,10,29,18,11,58,102,126,0,Matches
1288,Moussa Konaté,sn SEN,FW,Amiens,fr Ligue 1,25,1993,20.8,10,8,3,3,4,2,12,16.7,10,14,3,11,5,15,15,0,Matches
1289,Geoffrey Kondogbia,cf CTA,MF,Valencia,es La Liga,25,1993,13.8,47,33,18,23,6,12,27,44.4,15,20,7,13,27,74,22,2,Matches
1290,Kouadio Koné,fr FRA,MF,Toulouse,fr Ligue 1,17,2001,0.8,4,2,0,4,0,2,4,50.0,2,0,0,0,0,4,0,0,Matches
1291,Lamine Koné,ci CIV,DF,Strasbourg,fr Ligue 1,29,1989,23.9,21,16,9,9,3,6,9,66.7,3,18,13,5,33,54,66,3,Matches
1292,Youssouf Koné,ml MLI,DF,Lille,fr Ligue 1,23,1995,19.0,67,38,45,19,3,41,65,63.1,24,31,3,28,39,106,52,1,Matches
1293,Terence Kongolo,nl NED,DF,Huddersfield,eng Premier League,24,1994,30.2,74,46,44,26,4,27,47,57.4,20,42,16,26,65,139,106,1,Matches
1294,Yevhen Konoplyanka,ua UKR,"FW,MF",Schalke 04,de Bundesliga,28,1989,7.3,2,0,0,0,2,2,4,50.0,2,6,0,6,3,5,3,0,Matches
1295,Pascal Köpke,de GER,"FW,MF",Hertha BSC,de Bundesliga,22,1995,0.8,1,0,1,0,0,1,2,50.0,1,0,0,0,0,1,0,0,Matches
1296,Julian Korb,de GER,DF,Hannover 96,de Bundesliga,26,1992,11.2,26,17,16,9,1,10,29,34.5,19,27,4,23,23,49,34,1,Matches
1297,Laurent Koscielny,fr FRA,DF,Arsenal,eng Premier League,32,1985,14.8,19,11,9,9,1,10,16,62.5,6,20,15,5,30,49,72,0,Matches
1298,Filip Kostić,rs SRB,"DF,FW",Eint Frankfurt,de Bundesliga,25,1992,32.8,64,42,35,22,7,23,65,35.4,42,80,6,74,23,87,50,0,Matches
1299,Christian Kouamé,ci CIV,FW,Genoa,it Serie A,20,1997,34.1,31,22,8,16,7,2,13,15.4,11,23,3,20,25,56,28,0,Matches
1300,Tomáš Koubek,cz CZE,GK,Rennes,fr Ligue 1,25,1992,32.5,0,0,0,0,0,0,1,0.0,1,0,0,0,0,0,26,4,Matches
1301,Kalidou Koulibaly,sn SEN,DF,Napoli,it Serie A,27,1991,34.8,61,40,37,22,2,19,36,52.8,17,55,33,22,40,101,144,0,Matches
1302,Jules Koundé,fr FRA,DF,Bordeaux,fr Ligue 1,19,1998,37.0,48,31,37,11,0,27,41,65.9,14,44,23,21,50,98,193,7,Matches
1303,Cheikhou Kouyaté,sn SEN,MF,Crystal Palace,eng Premier League,28,1989,21.1,59,33,23,31,5,9,33,27.3,24,29,11,18,16,75,33,0,Matches
1304,Mateo Kovačić,hr CRO,MF,Chelsea,eng Premier League,24,1994,19.3,45,29,23,19,3,20,46,43.5,26,19,2,17,8,53,18,1,Matches
1305,Dawid Kownacki,pl POL,FW,Sampdoria,it Serie A,21,1997,1.9,2,1,0,1,1,1,4,25.0,3,0,0,0,0,2,0,0,Matches
1306,Dawid Kownacki,pl POL,"MF,FW",Düsseldorf,de Bundesliga,21,1997,6.4,13,6,9,3,1,7,16,43.8,9,8,0,8,2,15,8,0,Matches
1307,Thomas Kraft,de GER,GK,Hertha BSC,de Bundesliga,30,1988,3.5,0,0,0,0,0,0,0,,0,0,0,0,0,0,1,1,Matches
1308,Emil Krafth,se SWE,DF,Amiens,fr Ligue 1,23,1994,33.0,55,35,34,14,7,32,65,49.2,33,27,12,15,23,78,94,4,Matches
1309,Luka Krajnc,si SVN,DF,Frosinone,it Serie A,23,1994,8.8,10,8,6,3,1,5,6,83.3,1,11,3,8,11,21,42,0,Matches
1310,Andrej Kramarić,hr CRO,"MF,FW",Hoffenheim,de Bundesliga,27,1991,26.6,9,4,1,5,3,4,26,15.4,22,15,3,12,8,17,13,0,Matches
1311,Christoph Kramer,de GER,MF,M'Gladbach,de Bundesliga,27,1991,12.6,41,22,17,23,1,15,40,37.5,25,19,4,15,21,62,23,0,Matches
1312,Vasyl Kravets,ua UKR,"DF,FW",Leganés,es La Liga,20,1997,5.3,16,11,8,6,2,6,13,46.2,7,5,1,4,4,20,10,1,Matches
1313,Ladislav Krejčí,cz CZE,"DF,MF",Bologna,it Serie A,26,1992,11.8,16,12,6,9,1,7,12,58.3,5,8,2,6,6,22,18,0,Matches
1314,Rene Krhin,si SVN,MF,Nantes,fr Ligue 1,28,1990,11.7,22,14,7,12,3,11,19,57.9,8,7,4,3,21,43,32,0,Matches
1315,Toni Kroos,de GER,MF,Real Madrid,es La Liga,28,1990,24.7,51,35,18,24,9,14,57,24.6,43,25,4,21,14,65,13,1,Matches
1316,Rade Krunić,ba BIH,MF,Empoli,it Serie A,24,1993,30.8,38,23,21,14,3,14,41,34.1,27,35,12,23,24,62,32,0,Matches
1317,Max Kruse,de GER,"FW,MF",Werder Bremen,de Bundesliga,30,1988,31.5,17,5,2,13,2,6,38,15.8,32,16,1,15,8,25,6,2,Matches
1318,Lukas Kübler,de GER,"DF,MF",Freiburg,de Bundesliga,25,1992,13.2,35,22,23,12,0,16,26,61.5,10,15,5,10,30,65,50,1,Matches
1319,Yuya Kubo,jp JPN,"FW,MF",Nürnberg,de Bundesliga,24,1993,15.1,21,11,6,10,5,12,33,36.4,21,11,0,11,10,31,6,0,Matches
1320,Juraj Kucka,sk SVK,MF,Parma,it Serie A,31,1987,17.1,51,32,17,29,5,19,53,35.8,34,27,7,20,17,68,37,1,Matches
1321,Dejan Kulusevski,se SWE,MF,Atalanta,it Serie A,18,2000,1.2,3,3,0,2,1,1,3,33.3,2,1,0,1,0,3,0,0,Matches
1322,Pierre Kunde,cm CMR,MF,Mainz 05,de Bundesliga,23,1995,21.2,48,29,20,26,2,16,27,59.3,11,34,14,20,24,72,49,1,Matches
1323,Jasmin Kurtić,si SVN,MF,SPAL,it Serie A,29,1989,28.4,35,20,19,13,3,13,41,31.7,28,30,3,27,20,55,52,0,Matches
1324,Layvin Kurzawa,fr FRA,"DF,MF",Paris S-G,fr Ligue 1,25,1992,11.2,19,11,6,5,8,6,16,37.5,10,10,2,8,10,29,16,0,Matches
1325,Rafał Kurzawa,pl POL,FW,Amiens,fr Ligue 1,25,1993,2.7,8,3,6,2,0,2,6,33.3,4,1,0,1,3,11,3,0,Matches
1326,Ahmed Kutucu,tr TUR,"FW,MF",Schalke 04,de Bundesliga,18,2000,4.7,8,3,3,4,1,1,3,33.3,2,2,1,1,0,8,0,0,Matches
1327,Enock Kwateng,fr FRA,DF,Nantes,fr Ligue 1,21,1997,22.7,65,41,34,27,4,33,70,47.1,37,28,4,24,78,143,56,0,Matches
1328,Grejohn Kyei,fr FRA,FW,Reims,fr Ligue 1,22,1995,0.0,0,0,0,0,0,0,1,0.0,1,0,0,0,0,0,0,0,Matches
1329,Antonino La Gumina,it ITA,"FW,MF",Empoli,it Serie A,22,1996,12.1,5,4,1,2,2,2,6,33.3,4,8,2,6,6,11,5,0,Matches
1330,Rajiv van La Parra,nl NED,"FW,MF",Huddersfield,eng Premier League,27,1991,4.5,8,5,1,7,0,1,6,16.7,5,0,0,0,4,12,3,1,Matches
1331,Gaëtan Laborde,fr FRA,FW,Bordeaux,fr Ligue 1,24,1994,1.0,4,3,0,1,3,2,4,50.0,2,0,0,0,0,4,0,0,Matches
1332,Gaëtan Laborde,fr FRA,"FW,MF",Montpellier,fr Ligue 1,24,1994,32.2,36,15,6,15,15,11,27,40.7,16,18,2,16,6,42,27,0,Matches
1333,Alexandre Lacazette,fr FRA,FW,Arsenal,eng Premier League,27,1991,27.8,35,16,6,19,10,5,28,17.9,23,27,1,26,15,50,31,0,Matches
1334,Alban Lafont,fr FRA,GK,Fiorentina,it Serie A,19,1999,33.5,0,0,0,0,0,0,0,,0,0,0,0,1,1,16,4,Matches
1335,Víctor Laguardia,es ESP,DF,Alavés,es La Liga,28,1989,36.0,47,34,37,10,0,24,33,72.7,9,42,19,23,53,100,232,0,Matches
1336,Abdou Lahat Diakhate,sn SEN,MF,Parma,it Serie A,19,1998,0.0,0,0,0,0,0,0,0,,0,0,0,0,0,0,0,0,Matches
1337,Konrad Laimer,at AUT,"MF,DF",RB Leipzig,de Bundesliga,21,1997,20.8,72,38,21,34,17,20,71,28.2,51,67,2,65,32,104,23,0,Matches
1338,Diego Lainez,mx MEX,"FW,MF",Betis,es La Liga,18,2000,3.9,4,4,0,3,1,1,1,100.0,0,2,0,2,1,5,2,0,Matches
1339,Kenny Lala,fr FRA,"DF,FW",Strasbourg,fr Ligue 1,26,1991,34.0,78,45,48,23,7,30,53,56.6,23,26,9,17,28,106,62,2,Matches
1340,Adam Lallana,eng ENG,"MF,FW",Liverpool,eng Premier League,30,1988,5.2,16,9,6,7,3,5,12,41.7,7,10,1,9,5,21,4,0,Matches
1341,Érik Lamela,ar ARG,"MF,FW",Tottenham,eng Premier League,26,1992,10.8,17,13,6,7,4,5,14,35.7,9,14,0,14,7,24,1,0,Matches
1342,Mohamed Lamine Diaby,fr FRA,FW,Nice,fr Ligue 1,17,2001,1.8,1,1,0,1,0,1,1,100.0,0,2,0,2,2,3,0,0,Matches
1343,Loïck Landre,fr FRA,DF,Nîmes,fr Ligue 1,26,1992,17.7,31,21,23,8,0,14,22,63.6,8,16,11,5,38,69,83,1,Matches
1344,Michael Lang,ch SUI,DF,M'Gladbach,de Bundesliga,27,1991,13.9,14,9,7,6,1,6,16,37.5,10,14,3,11,16,30,42,1,Matches
1345,Sebastian Langkamp,de GER,DF,Werder Bremen,de Bundesliga,30,1988,15.7,24,15,18,6,0,7,14,50.0,7,17,11,6,20,44,79,1,Matches
1346,Manuel Lanzini,ar ARG,MF,West Ham,eng Premier League,25,1993,7.6,12,7,5,6,1,5,18,27.8,13,3,1,2,9,21,7,1,Matches
1347,Gianluca Lapadula,pe PER,FW,Genoa,it Serie A,28,1990,4.5,2,1,2,0,0,1,5,20.0,4,2,0,2,1,3,2,0,Matches
1348,Aymeric Laporte,es ESP,DF,Manchester City,eng Premier League,24,1994,34.0,42,20,27,14,1,22,34,64.7,12,16,9,7,39,81,98,2,Matches
1349,Danilo Larangeira,br BRA,DF,Bologna,it Serie A,34,1984,34.2,40,26,29,11,0,20,30,66.7,10,52,39,13,37,77,182,3,Matches
1350,Johan Larsson,se SWE,DF,Guingamp,fr Ligue 1,28,1990,1.0,1,1,0,1,0,1,2,50.0,1,0,0,0,1,2,1,1,Matches
1351,Kevin Lasagna,it ITA,FW,Udinese,it Serie A,25,1992,27.3,6,1,0,3,3,2,12,16.7,10,20,2,18,8,14,35,0,Matches
1352,Jamaal Lascelles,eng ENG,DF,Newcastle Utd,eng Premier League,24,1993,30.5,32,21,25,5,2,11,14,78.6,3,43,28,15,39,71,218,3,Matches
1353,Paul Lasne,fr FRA,"MF,DF",Montpellier,fr Ligue 1,29,1989,19.9,53,33,32,16,5,24,43,55.8,19,22,2,20,22,75,23,1,Matches
1354,Toni Lato,es ESP,DF,Valencia,es La Liga,20,1997,3.0,6,4,4,1,1,1,5,20.0,4,9,3,6,6,12,13,0,Matches
1355,Danny Latza,de GER,MF,Mainz 05,de Bundesliga,28,1989,20.7,41,22,16,23,2,20,61,32.8,41,49,10,39,20,61,31,0,Matches
1356,Alexandre Lauray,fr FRA,DF,Bordeaux,fr Ligue 1,21,1997,2.9,11,6,9,2,0,6,8,75.0,2,2,0,2,4,15,10,0,Matches
1357,Armand Lauriente,fr FRA,MF,Rennes,fr Ligue 1,19,1998,0.0,0,0,0,0,0,0,0,,0,0,0,0,0,0,0,0,Matches
1358,Vincent Laurini,fr FRA,DF,Fiorentina,it Serie A,29,1989,10.2,13,5,6,5,2,6,10,60.0,4,11,5,6,13,26,30,0,Matches
1359,Wesley Lautoa,nc NCL,"DF,MF",Dijon,fr Ligue 1,30,1987,33.6,81,55,46,31,4,34,75,45.3,41,37,14,23,87,168,110,1,Matches
1360,Diego Laxalt,uy URU,"DF,MF",Milan,it Serie A,25,1993,7.2,26,13,14,7,5,13,22,59.1,9,23,3,20,8,34,12,0,Matches
1361,Miguel Layún,mx MEX,"MF,DF",Villarreal,es La Liga,30,1988,5.6,8,2,0,7,1,2,6,33.3,4,8,2,6,1,9,10,0,Matches
1362,Valentino Lazaro,at AUT,"DF,FW",Hertha BSC,de Bundesliga,22,1996,30.5,46,31,23,17,6,21,53,39.6,32,52,12,40,44,90,65,0,Matches
1363,Darko Lazović,rs SRB,"DF,FW",Genoa,it Serie A,27,1990,28.2,28,17,13,8,7,14,31,45.2,17,21,6,15,20,48,33,0,Matches
1364,Manuel Lazzari,it ITA,DF,SPAL,it Serie A,24,1993,31.5,29,17,16,10,3,13,24,54.2,11,26,5,21,20,49,51,1,Matches
1365,Mickaël Le Bihan,fr FRA,FW,Nice,fr Ligue 1,28,1990,2.3,1,1,0,1,0,1,2,50.0,1,1,0,1,1,2,1,0,Matches
1366,Maxime Le Marchand,fr FRA,DF,Fulham,eng Premier League,28,1989,25.0,56,36,45,11,0,23,47,48.9,24,30,16,14,54,110,129,2,Matches
1367,Robin Le Normand,es ESP,DF,Real Sociedad,es La Liga,21,1996,3.2,5,2,2,3,0,1,3,33.3,2,3,0,3,4,9,13,1,Matches
1368,Damien Le Tallec,fr FRA,MF,Montpellier,fr Ligue 1,28,1990,31.2,95,58,42,43,10,33,89,37.1,56,35,8,27,59,154,50,0,Matches
1369,James Lea Siliki,cm CMR,"MF,FW",Rennes,fr Ligue 1,22,1996,13.6,26,17,13,10,3,12,35,34.3,23,14,1,13,10,36,7,1,Matches
1370,Rafael Leão,pt POR,FW,Lille,fr Ligue 1,19,1999,14.3,5,2,0,4,1,2,15,13.3,13,13,4,9,4,9,12,0,Matches
1371,Mathew Leckie,au AUS,"FW,MF",Hertha BSC,de Bundesliga,27,1991,10.5,20,13,5,10,5,7,16,43.8,9,10,1,9,13,33,16,0,Matches
1372,Benjamin Lecomte,fr FRA,GK,Montpellier,fr Ligue 1,27,1991,37.0,1,0,1,0,0,1,3,33.3,2,0,0,0,5,6,24,3,Matches
1373,Pierre Lees-Melou,fr FRA,MF,Nice,fr Ligue 1,25,1993,26.6,74,46,31,36,7,25,62,40.3,37,44,8,36,36,110,37,0,Matches
1374,Jordan Lefort,fr FRA,DF,Amiens,fr Ligue 1,24,1993,20.0,33,18,23,6,4,16,25,64.0,9,11,8,3,46,79,107,0,Matches
1375,Wu Lei,cn CHN,"FW,MF",Espanyol,es La Liga,26,1991,11.8,13,6,5,6,2,5,16,31.3,11,9,0,9,7,20,7,0,Matches
1376,Tim Leibold,de GER,DF,Nürnberg,de Bundesliga,24,1993,30.7,62,42,45,16,1,33,71,46.5,38,23,3,20,38,100,57,0,Matches
1377,Lucas Leiva,br BRA,MF,Lazio,it Serie A,31,1987,22.1,91,54,40,46,5,38,79,48.1,41,27,11,16,52,143,43,3,Matches
1378,Florian Lejeune,fr FRA,DF,Newcastle Utd,eng Premier League,27,1991,11.7,25,15,17,7,1,11,24,45.8,13,16,5,11,21,46,49,0,Matches
1379,Iñigo Lekue,es ESP,DF,Athletic Club,es La Liga,25,1993,2.3,5,2,3,2,0,2,7,28.6,5,4,0,4,4,9,11,0,Matches
1380,Thomas Lemar,fr FRA,MF,Atlético Madrid,es La Liga,22,1995,20.2,38,21,23,11,4,19,42,45.2,23,26,1,25,22,60,7,1,Matches
1381,Mario Lemina,ga GAB,MF,Southampton,eng Premier League,24,1993,17.9,49,32,23,23,3,15,34,44.1,19,27,3,24,43,92,31,1,Matches
1382,Mauricio Lemos,uy URU,DF,Sassuolo,it Serie A,22,1995,2.0,2,1,2,0,0,1,2,50.0,1,2,1,1,3,5,10,1,Matches
1383,Clément Lenglet,fr FRA,DF,Barcelona,es La Liga,23,1995,21.5,47,29,26,19,2,22,36,61.1,14,30,20,10,21,68,70,0,Matches
1384,Aaron Lennon,eng ENG,MF,Burnley,eng Premier League,31,1987,13.5,26,16,11,12,3,6,14,42.9,8,24,0,24,10,36,18,0,Matches
1385,Bernd Leno,de GER,GK,Arsenal,eng Premier League,26,1992,31.5,0,0,0,0,0,0,3,0.0,3,0,0,0,4,4,16,6,Matches
1386,Pedro León,es ESP,"MF,FW",Eibar,es La Liga,31,1986,4.7,7,4,2,2,3,4,7,57.1,3,10,0,10,4,11,2,0,Matches
1387,Sergio León,es ESP,"FW,MF",Betis,es La Liga,29,1989,7.1,4,2,2,1,1,2,8,25.0,6,4,0,4,2,6,6,0,Matches
1388,Lukas Lerager,dk DEN,MF,Genoa,it Serie A,25,1993,12.5,34,18,12,20,2,13,42,31.0,29,11,1,10,18,52,12,0,Matches
1389,Lukas Lerager,dk DEN,MF,Bordeaux,fr Ligue 1,25,1993,14.4,38,21,14,23,1,18,43,41.9,25,22,10,12,32,70,26,1,Matches
1390,Mehdi Léris,dz ALG,"MF,DF",Chievo,it Serie A,20,1998,17.9,53,33,19,24,10,24,54,44.4,30,34,1,33,28,81,24,1,Matches
1391,Jefferson Lerma,co COL,MF,Bournemouth,eng Premier League,23,1994,27.8,45,31,20,20,5,14,54,25.9,40,35,19,16,54,99,88,1,Matches
1392,Robert Lewandowski,pl POL,FW,Bayern Munich,de Bundesliga,29,1988,32.9,12,9,0,8,4,3,11,27.3,8,11,1,10,7,19,15,0,Matches
1393,Igor Lewczuk,pl POL,DF,Bordeaux,fr Ligue 1,33,1985,5.0,12,7,8,2,2,1,4,25.0,3,2,2,0,4,16,27,0,Matches
1394,Aaron Leya Iseka,be BEL,FW,Toulouse,fr Ligue 1,20,1997,16.0,6,4,1,4,1,1,4,25.0,3,5,3,2,1,7,10,0,Matches
1395,Stephan Lichtsteiner,ch SUI,DF,Arsenal,eng Premier League,34,1984,10.4,15,9,5,4,6,9,16,56.3,7,11,4,7,9,24,25,1,Matches
1396,Dimitri Liénard,fr FRA,"MF,DF",Strasbourg,fr Ligue 1,30,1988,14.3,33,18,20,9,4,21,45,46.7,24,11,2,9,18,51,22,0,Matches
1397,Philipp Lienhart,at AUT,DF,Freiburg,de Bundesliga,22,1996,6.8,6,6,4,2,0,3,6,50.0,3,9,7,2,11,17,42,0,Matches
1398,Lucas Lima,br BRA,"DF,FW",Nantes,fr Ligue 1,26,1991,27.7,49,28,26,15,8,20,53,37.7,33,39,3,36,29,78,62,1,Matches
1399,Anthony Limbombe,be BEL,FW,Nantes,fr Ligue 1,24,1994,13.7,12,10,4,6,2,7,16,43.8,9,5,0,5,8,20,10,0,Matches
1400,Victor Lindelöf,se SWE,DF,Manchester Utd,eng Premier League,24,1994,28.9,40,27,28,12,0,13,23,56.5,10,21,12,9,24,64,121,3,Matches
1401,Karol Linetty,pl POL,MF,Sampdoria,it Serie A,23,1995,27.9,72,48,26,32,14,15,69,21.7,54,39,4,35,25,97,17,0,Matches
1402,Jesse Lingard,eng ENG,"FW,MF",Manchester Utd,eng Premier League,25,1992,18.5,29,18,8,11,10,7,28,25.0,21,18,2,16,10,39,9,1,Matches
1403,Pol Lirola,es ESP,"DF,MF",Sassuolo,it Serie A,20,1997,33.1,35,22,19,11,5,21,34,61.8,13,25,5,20,32,67,89,0,Matches
1404,Adem Ljajić,rs SRB,MF,Torino,it Serie A,26,1991,0.3,0,0,0,0,0,0,1,0.0,1,0,0,0,0,0,0,0,Matches
1405,Diego Llorente,es ESP,DF,Real Sociedad,es La Liga,24,1993,19.5,26,15,16,8,2,17,29,58.6,12,27,15,12,26,52,83,2,Matches
1406,Fernando Llorente,es ESP,FW,Tottenham,eng Premier League,33,1985,7.7,4,2,3,0,1,2,3,66.7,1,7,2,5,1,5,10,0,Matches
1407,Marcos Llorente,es ESP,MF,Real Madrid,es La Liga,23,1995,6.0,16,12,7,7,2,8,18,44.4,10,8,0,8,7,23,12,0,Matches
1408,Hugo Lloris,fr FRA,GK,Tottenham,eng Premier League,31,1986,33.0,1,0,1,0,0,0,2,0.0,2,0,0,0,0,1,13,5,Matches
1409,Giovani Lo Celso,ar ARG,"MF,FW",Betis,es La Liga,22,1996,26.6,52,31,16,28,8,9,35,25.7,26,24,1,23,17,69,8,0,Matches
1410,Giovani Lo Celso,ar ARG,MF,Paris S-G,fr Ligue 1,22,1996,0.1,1,1,0,0,1,0,1,0.0,1,0,0,0,0,1,0,0,Matches
1411,Stanislav Lobotka,sk SVK,MF,Celta Vigo,es La Liga,23,1994,27.7,30,19,10,17,3,9,32,28.1,23,15,1,14,26,56,18,1,Matches
1412,Jürgen Locadia,nl NED,"FW,MF",Brighton,eng Premier League,24,1993,13.7,15,10,5,8,2,3,7,42.9,4,8,0,8,9,24,13,0,Matches
1413,Manuel Locatelli,it ITA,MF,Sassuolo,it Serie A,20,1998,20.5,44,28,19,15,10,13,29,44.8,16,21,3,18,27,71,33,1,Matches
1414,Ruben Loftus-Cheek,eng ENG,"MF,FW",Chelsea,eng Premier League,22,1996,11.1,18,12,7,7,4,3,12,25.0,9,10,4,6,11,29,5,0,Matches
1415,Enzo Loiodice,fr FRA,MF,Dijon,fr Ligue 1,17,2000,9.4,25,14,8,15,2,10,21,47.6,11,7,0,7,11,36,7,0,Matches
1416,Kevin Long,ie IRL,DF,Burnley,eng Premier League,27,1990,5.7,18,10,13,5,0,7,17,41.2,10,7,5,2,7,25,35,1,Matches
1417,Shane Long,ie IRL,"FW,MF",Southampton,eng Premier League,31,1987,14.1,15,8,4,5,6,3,16,18.8,13,10,1,9,7,22,18,0,Matches
1418,Samuele Longo,it ITA,FW,Huesca,es La Liga,26,1992,6.2,4,3,2,2,0,0,6,0.0,6,4,0,4,1,5,7,0,Matches
1419,Sean Longstaff,eng ENG,MF,Newcastle Utd,eng Premier League,20,1997,7.6,17,13,6,11,0,9,24,37.5,15,19,4,15,10,27,7,0,Matches
1420,Ademola Lookman,ng NGA,"FW,MF",Everton,eng Premier League,20,1997,6.9,15,7,7,5,3,4,6,66.7,2,10,0,10,7,22,2,0,Matches
1421,Anthony Lopes,pt POR,GK,Lyon,fr Ligue 1,27,1990,34.0,1,0,1,0,0,1,3,33.3,2,3,0,3,2,3,16,3,Matches
1422,Rony Lopes,pt POR,"FW,MF",Monaco,fr Ligue 1,22,1995,20.5,33,22,10,17,6,9,22,40.9,13,17,1,16,8,41,10,0,Matches
1423,Álex López,es ESP,MF,Espanyol,es La Liga,21,1997,1.2,3,1,1,2,0,2,3,66.7,1,0,0,0,3,6,1,0,Matches
1424,Cristian López,es ESP,FW,Angers,fr Ligue 1,29,1989,4.1,6,3,1,2,3,1,8,12.5,7,4,0,4,1,7,2,0,Matches
1425,David López,es ESP,DF,Espanyol,es La Liga,28,1989,20.2,27,18,15,10,2,10,22,45.5,12,18,12,6,28,55,65,2,Matches
1426,Diego López,es ESP,GK,Espanyol,es La Liga,36,1981,38.0,0,0,0,0,0,0,0,,0,0,0,0,2,2,9,3,Matches
1427,Javi López,es ESP,DF,Espanyol,es La Liga,32,1986,21.6,63,40,37,22,4,28,60,46.7,32,27,5,22,40,103,90,0,Matches
1428,Lluis López,es ESP,DF,Espanyol,es La Liga,21,1997,5.8,5,3,4,1,0,3,6,50.0,3,6,2,4,7,12,21,0,Matches
1429,Maxime Lopez,fr FRA,MF,Marseille,fr Ligue 1,20,1997,24.2,46,24,17,23,6,19,53,35.8,34,10,2,8,20,66,8,0,Matches
1430,Pedro López Muñoz,es ESP,DF,Levante,es La Liga,34,1983,5.2,5,3,5,0,0,3,7,42.9,4,8,3,5,8,13,7,0,Matches
1431,Pau López,es ESP,GK,Betis,es La Liga,23,1994,33.0,0,0,0,0,0,0,2,0.0,2,1,0,1,2,2,17,2,Matches
1432,Roberto López,es ESP,MF,Real Sociedad,es La Liga,18,2000,0.3,0,0,0,0,0,0,1,0.0,1,1,0,1,1,1,2,0,Matches
1433,Unai López,es ESP,MF,Athletic Club,es La Liga,22,1995,3.6,7,5,3,2,2,2,12,16.7,10,10,3,7,1,8,2,0,Matches
1434,Jonas Lössl,dk DEN,GK,Huddersfield,eng Premier League,29,1989,30.9,0,0,0,0,0,0,1,0.0,1,1,0,1,2,2,12,2,Matches
1435,Albert Lottin,fr FRA,"MF,FW",Bordeaux,fr Ligue 1,16,2001,0.2,1,1,0,1,0,0,1,0.0,1,1,0,1,0,1,0,0,Matches
1436,Imran Louza,ma MAR,MF,Nantes,fr Ligue 1,19,1999,1.0,2,0,1,1,0,1,1,100.0,0,1,0,1,0,2,1,0,Matches
1437,Davor Lovren,hr CRO,MF,Düsseldorf,de Bundesliga,19,1998,0.5,1,1,0,0,1,0,0,,0,1,0,1,0,1,0,0,Matches
1438,Dejan Lovren,hr CRO,DF,Liverpool,eng Premier League,29,1989,11.0,15,9,10,5,0,7,15,46.7,8,11,7,4,11,26,51,2,Matches
1439,Chris Löwe,de GER,"DF,MF",Huddersfield,eng Premier League,29,1989,22.9,34,18,17,15,2,12,33,36.4,21,21,3,18,23,57,56,0,Matches
1440,Eduard Löwen,de GER,"MF,FW",Nürnberg,de Bundesliga,21,1997,18.0,30,22,14,13,3,11,34,32.4,23,15,2,13,8,38,23,0,Matches
1441,Matthew Lowton,eng ENG,DF,Burnley,eng Premier League,29,1989,19.4,56,35,21,31,4,32,60,53.3,28,29,7,22,30,86,80,1,Matches
1442,Anthony Lozano,hn HON,"FW,MF",Girona,es La Liga,25,1993,8.1,6,5,3,3,0,0,6,0.0,6,7,1,6,0,6,6,0,Matches
1443,Derrick Luckassen,nl NED,DF,Hertha BSC,de Bundesliga,23,1995,2.8,4,2,4,0,0,1,3,33.3,2,1,0,1,0,4,13,0,Matches
1444,Filipe Luís,br BRA,DF,Atlético Madrid,es La Liga,32,1985,22.6,66,36,33,25,8,32,58,55.2,26,18,3,15,44,110,47,0,Matches
1445,José Luis Gayà,es ESP,DF,Valencia,es La Liga,23,1995,34.9,83,59,56,20,7,46,80,57.5,34,48,6,42,43,126,105,1,Matches
1446,José Luis Morales,es ESP,"FW,MF",Levante,es La Liga,31,1987,35.5,21,15,6,10,5,8,49,16.3,41,22,1,21,12,33,17,0,Matches
1447,José Luis Palomino,ar ARG,DF,Atalanta,it Serie A,28,1990,25.1,49,31,31,15,3,23,38,60.5,15,34,17,17,68,117,79,0,Matches
1448,Luisinho,pt POR,DF,Huesca,es La Liga,33,1985,5.6,14,10,9,5,0,10,17,58.8,7,6,1,5,16,30,17,0,Matches
1449,David Luiz,br BRA,DF,Chelsea,eng Premier League,31,1987,36.0,41,31,27,13,1,21,28,75.0,7,33,18,15,35,76,149,1,Matches
1450,Douglas Luiz,br BRA,MF,Girona,es La Liga,20,1998,16.6,34,19,13,20,1,9,38,23.7,29,19,7,12,21,55,26,0,Matches
1451,Everton Luiz,br BRA,MF,SPAL,it Serie A,30,1988,3.5,11,6,5,5,1,4,7,57.1,3,9,1,8,3,14,7,2,Matches
1452,Jordan Lukaku,be BEL,"DF,MF",Lazio,it Serie A,24,1994,1.9,4,3,2,1,1,3,5,60.0,2,3,0,3,5,9,2,0,Matches
1453,Romelu Lukaku,be BEL,FW,Manchester Utd,eng Premier League,25,1993,23.7,8,4,0,6,2,2,10,20.0,8,12,1,11,2,10,19,0,Matches
1454,Dodi Lukebakio,be BEL,"FW,MF",Düsseldorf,de Bundesliga,20,1997,21.9,25,17,11,6,8,8,15,53.3,7,13,0,13,9,34,19,0,Matches
1455,Saša Lukić,rs SRB,MF,Torino,it Serie A,21,1996,11.0,21,11,5,11,5,5,16,31.3,11,13,4,9,12,33,11,0,Matches
1456,Senad Lulić,ba BIH,"DF,FW",Lazio,it Serie A,32,1986,32.5,71,43,37,27,7,32,76,42.1,44,27,3,24,49,120,58,1,Matches
1457,Antonio Luna,es ESP,"DF,FW",Levante,es La Liga,27,1991,14.0,14,10,6,7,1,6,23,26.1,17,22,7,15,15,29,48,1,Matches
1458,Andriy Lunin,ua UKR,GK,Leganés,es La Liga,19,1999,4.1,0,0,0,0,0,0,0,,0,0,0,0,0,0,0,0,Matches
1459,Sebastiano Luperto,it ITA,DF,Napoli,it Serie A,21,1996,8.1,8,6,5,2,1,2,5,40.0,3,7,3,4,13,21,30,0,Matches
1460,Fabian Lustenberger,ch SUI,"DF,MF",Hertha BSC,de Bundesliga,30,1988,24.1,45,30,23,21,1,15,33,45.5,18,39,18,21,39,84,108,2,Matches
1461,Andreas Luthe,de GER,GK,Augsburg,de Bundesliga,31,1987,14.6,0,0,0,0,0,0,0,,0,0,0,0,0,0,4,0,Matches
1462,Lyanco,br BRA,DF,Torino,it Serie A,21,1997,1.0,1,1,1,0,0,0,0,,0,1,1,0,4,5,5,0,Matches
1463,Lyanco,br BRA,DF,Bologna,it Serie A,21,1997,12.4,29,18,19,10,0,13,18,72.2,5,24,16,8,22,51,64,0,Matches
1464,Hervé Lybohy,ne NIG,DF,Nîmes,fr Ligue 1,35,1983,16.4,22,13,13,9,0,11,16,68.8,5,17,11,6,14,36,70,0,Matches
1465,Charalambos Lykogiannis,gr GRE,DF,Cagliari,it Serie A,24,1993,9.2,14,8,8,3,3,6,11,54.5,5,18,3,15,19,33,33,0,Matches
1466,Yann M'Vila,fr FRA,MF,Saint-Étienne,fr Ligue 1,28,1990,36.2,72,40,22,48,2,29,72,40.3,43,42,12,30,74,146,86,5,Matches
1467,Darwin Machís,ve VEN,"FW,MF",Udinese,it Serie A,25,1993,5.1,7,6,4,3,0,0,4,0.0,4,6,0,6,2,9,8,0,Matches
1468,James Maddison,eng ENG,"MF,FW",Leicester City,eng Premier League,21,1996,31.5,48,32,20,25,3,14,58,24.1,44,20,4,16,12,60,10,1,Matches
1469,Gary Madine,eng ENG,"FW,MF",Cardiff City,eng Premier League,27,1990,0.4,1,1,0,1,0,0,0,,0,0,0,0,0,1,0,0,Matches
1470,Pablo Maffeo,es ESP,"DF,MF",Stuttgart,de Bundesliga,21,1997,6.6,15,13,10,5,0,6,13,46.2,7,8,4,4,13,28,17,0,Matches
1471,Francesco Magnanelli,it ITA,MF,Sassuolo,it Serie A,33,1984,20.7,52,33,29,22,1,22,49,44.9,27,18,5,13,24,76,38,2,Matches
1472,Giangiacomo Magnani,it ITA,DF,Sassuolo,it Serie A,22,1995,16.8,11,9,9,2,0,6,15,40.0,9,17,13,4,16,27,99,1,Matches
1473,Harry Maguire,eng ENG,DF,Leicester City,eng Premier League,25,1993,28.8,31,17,21,9,1,11,17,64.7,6,32,18,14,36,67,155,4,Matches
1474,Riyad Mahrez,dz ALG,"FW,MF",Manchester City,eng Premier League,27,1991,14.9,14,7,3,7,4,6,18,33.3,12,18,1,17,9,23,3,1,Matches
1475,Thiago Maia,br BRA,MF,Lille,fr Ligue 1,21,1997,11.3,32,19,17,13,2,13,33,39.4,20,14,5,9,23,55,23,0,Matches
1476,Raffaele Maiello,it ITA,MF,Frosinone,it Serie A,27,1991,22.7,42,27,30,8,4,16,27,59.3,11,23,10,13,30,72,41,0,Matches
1477,Arne Maier,de GER,MF,Hertha BSC,de Bundesliga,19,1999,22.9,31,16,12,19,0,6,25,24.0,19,32,9,23,28,59,35,0,Matches
1478,Domenico Maietta,it ITA,DF,Empoli,it Serie A,35,1982,19.0,33,15,22,10,1,16,36,44.4,20,19,14,5,24,57,78,2,Matches
1479,Mike Maignan,fr FRA,GK,Lille,fr Ligue 1,23,1995,38.0,0,0,0,0,0,0,0,,0,1,0,1,0,0,12,1,Matches
1480,Linton Maina,de GER,"FW,MF",Hannover 96,de Bundesliga,19,1999,15.7,28,14,13,10,5,12,23,52.2,11,20,0,20,14,42,4,0,Matches
1481,Ainsley Maitland-Niles,eng ENG,DF,Arsenal,eng Premier League,20,1997,11.0,33,22,19,12,2,14,28,50.0,14,22,4,18,19,52,15,2,Matches
1482,Josh Maja,ng NGA,FW,Bordeaux,fr Ligue 1,19,1998,2.2,2,1,1,1,0,0,1,0.0,1,1,0,1,0,2,0,0,Matches
1483,Abdul Majeed Waris,gh GHA,"FW,MF",Nantes,fr Ligue 1,26,1991,25.0,22,13,6,13,3,7,28,25.0,21,9,0,9,7,29,7,0,Matches
1484,Jean-Victor Makengo,fr FRA,"MF,FW",Nice,fr Ligue 1,20,1998,11.4,10,8,3,6,1,1,5,20.0,4,5,1,4,9,19,5,0,Matches
1485,Nemanja Maksimović,rs SRB,MF,Getafe,es La Liga,23,1995,35.7,77,45,21,51,5,21,61,34.4,40,60,15,45,71,148,33,0,Matches
1486,Nikola Maksimović,rs SRB,DF,Napoli,it Serie A,26,1991,15.3,20,13,14,6,0,6,12,50.0,6,16,10,6,28,48,56,1,Matches
1487,Malcom,br BRA,"FW,MF",Barcelona,es La Liga,21,1997,6.8,3,2,0,1,2,2,3,66.7,1,7,0,7,1,4,1,0,Matches
1488,Kévin Malcuit,ma MAR,DF,Napoli,it Serie A,27,1991,20.1,43,31,23,14,6,23,36,63.9,13,18,4,14,44,87,67,0,Matches
1489,Yunus Mallı,tr TUR,"MF,FW",Wolfsburg,de Bundesliga,26,1992,7.8,15,7,8,6,1,2,11,18.2,9,2,0,2,4,19,1,0,Matches
1490,Hugo Mallo,es ESP,DF,Celta Vigo,es La Liga,27,1991,34.4,73,41,41,27,5,27,52,51.9,25,44,13,31,50,123,135,1,Matches
1491,Antonio Mance,hr CRO,FW,Nantes,fr Ligue 1,22,1995,0.6,1,1,0,0,1,1,2,50.0,1,0,0,0,0,1,0,0,Matches
1492,Vincent Manceau,fr FRA,DF,Angers,fr Ligue 1,29,1989,31.0,98,65,64,23,11,33,62,53.2,29,41,10,31,44,142,87,0,Matches
1493,Gianluca Mancini,it ITA,DF,Atalanta,it Serie A,22,1996,25.0,40,30,22,17,1,16,29,55.2,13,19,4,15,48,88,77,1,Matches
1494,Steve Mandanda,fr FRA,GK,Marseille,fr Ligue 1,33,1985,30.4,0,0,0,0,0,0,3,0.0,3,0,0,0,1,1,7,4,Matches
1495,Reinildo Mandava,mz MOZ,DF,Lille,fr Ligue 1,24,1994,1.1,3,2,1,2,0,2,3,66.7,1,1,0,1,1,4,0,0,Matches
1496,Aïssa Mandi,dz ALG,DF,Betis,es La Liga,26,1991,34.0,52,34,27,20,5,12,29,41.4,17,39,23,16,41,93,71,2,Matches
1497,Rolando Mandragora,it ITA,MF,Udinese,it Serie A,21,1997,32.4,66,35,25,34,7,24,69,34.8,45,49,9,40,43,109,59,0,Matches
1498,Mario Mandžukić,hr CRO,FW,Juventus,it Serie A,32,1986,22.4,34,25,13,15,6,9,18,50.0,9,17,5,12,13,47,22,0,Matches
1499,Sadio Mané,sn SEN,FW,Liverpool,eng Premier League,26,1992,34.2,35,29,12,17,6,14,43,32.6,29,28,4,24,15,50,10,1,Matches
1500,Thomas Mangani,fr FRA,MF,Angers,fr Ligue 1,31,1987,17.8,42,27,13,26,3,19,62,30.6,43,13,2,11,23,65,24,0,Matches
1501,Kostas Manolas,gr GRE,DF,Roma,it Serie A,27,1991,25.8,32,24,23,8,1,17,26,65.4,9,34,25,9,50,82,117,2,Matches
1502,Javier Manquillo,es ESP,DF,Newcastle Utd,eng Premier League,24,1994,12.2,27,19,14,11,2,9,14,64.3,5,9,1,8,17,44,58,0,Matches
1503,Martín Mantovani,ar ARG,DF,Huesca,es La Liga,34,1984,7.8,15,9,12,3,0,6,11,54.5,5,4,3,1,22,37,48,0,Matches
1504,Juan Manuel Valencia,co COL,FW,Bologna,it Serie A,20,1998,0.3,0,0,0,0,0,0,0,,0,0,0,0,1,1,0,0,Matches
1505,Harrison Manzala,cd COD,"MF,FW",Angers,fr Ligue 1,24,1994,0.8,2,2,1,0,1,0,0,,0,0,0,0,0,2,1,0,Matches
1506,Fran Manzanara,es ESP,"DF,MF",Levante,es La Liga,21,1996,1.7,7,5,3,3,1,4,4,100.0,0,3,2,1,1,8,7,0,Matches
1507,Myziane Maolida,fr FRA,FW,Nice,fr Ligue 1,19,1999,10.6,12,8,5,5,2,2,4,50.0,2,5,0,5,1,13,5,0,Matches
1508,Faitout Maouassa,fr FRA,DF,Nîmes,fr Ligue 1,20,1998,23.7,55,30,35,15,5,23,39,59.0,16,24,5,19,23,78,81,1,Matches
1509,Fernando Marçal,br BRA,DF,Lyon,fr Ligue 1,29,1989,9.8,25,16,17,7,1,12,15,80.0,3,9,3,6,30,55,42,0,Matches
1510,Iván Marcano,es ESP,DF,Roma,it Serie A,31,1987,9.0,8,4,4,4,0,5,8,62.5,3,13,6,7,24,32,45,0,Matches
1511,Marcelo,br BRA,DF,Real Madrid,es La Liga,30,1988,20.6,34,19,17,12,5,15,39,38.5,24,19,2,17,17,51,21,0,Matches
1512,Marcelo,br BRA,DF,Lyon,fr Ligue 1,31,1987,32.0,48,33,29,17,2,19,24,79.2,5,30,22,8,62,110,152,2,Matches
1513,Solly March,eng ENG,"FW,MF",Brighton,eng Premier League,24,1994,27.4,56,24,27,16,13,19,45,42.2,26,34,4,30,27,83,44,0,Matches
1514,Federico Marchetti,it ITA,GK,Genoa,it Serie A,35,1983,4.0,0,0,0,0,0,0,0,,0,0,0,0,0,0,1,0,Matches
1515,Gian Marco Ferrari,it ITA,DF,Sassuolo,it Serie A,26,1992,31.0,41,23,27,12,2,12,16,75.0,4,36,20,16,36,77,97,1,Matches
1516,Óscar de Marcos,es ESP,"DF,FW",Athletic Club,es La Liga,29,1989,26.9,60,32,34,17,9,29,62,46.8,33,29,4,25,27,87,62,0,Matches
1517,Georg Margreitter,at AUT,DF,Nürnberg,de Bundesliga,29,1988,22.9,39,24,28,8,3,31,38,81.6,7,29,26,3,26,65,141,0,Matches
1518,Miguel Marí,es ESP,MF,Eibar,es La Liga,21,1997,0.8,0,0,0,0,0,0,2,0.0,2,0,0,0,1,1,2,0,Matches
1519,José María Giménez,uy URU,DF,Atlético Madrid,es La Liga,23,1995,19.7,26,15,20,6,0,13,26,50.0,13,27,14,13,44,70,128,2,Matches
1520,Mariano,do DOM,FW,Real Madrid,es La Liga,24,1993,5.0,2,1,1,1,0,0,3,0.0,3,2,0,2,0,2,2,0,Matches
1521,Mariano,do DOM,FW,Lyon,fr Ligue 1,24,1993,1.6,0,0,0,0,0,0,0,,0,0,0,0,1,1,0,0,Matches
1522,Adrian Mariappa,jm JAM,DF,Watford,eng Premier League,31,1986,21.4,35,22,29,6,0,16,32,50.0,16,23,15,8,26,61,120,2,Matches
1523,Jordan Marié,fr FRA,MF,Dijon,fr Ligue 1,26,1991,20.0,52,28,15,31,6,21,58,36.2,37,28,5,23,40,92,32,0,Matches
1524,Adrián Marín,es ESP,"DF,MF",Alavés,es La Liga,21,1997,3.2,13,8,8,5,0,4,7,57.1,3,1,0,1,7,20,13,0,Matches
1525,João Mário,pt POR,"MF,FW",Inter,it Serie A,25,1993,12.0,28,16,9,15,4,9,31,29.0,22,14,0,14,6,34,4,1,Matches
1526,Guillermo Maripán,cl CHI,DF,Alavés,es La Liga,24,1994,22.3,46,26,34,12,0,26,38,68.4,12,35,19,16,40,86,133,2,Matches
1527,Lazar Marković,rs SRB,MF,Fulham,eng Premier League,24,1994,0.5,0,0,0,0,0,0,0,,0,0,0,0,0,0,2,0,Matches
1528,Marlon,br BRA,DF,Sassuolo,it Serie A,22,1995,16.8,29,18,25,3,1,15,21,71.4,6,22,12,10,24,53,39,0,Matches
1529,Marquinhos,br BRA,"DF,MF",Paris S-G,fr Ligue 1,24,1994,29.9,65,41,34,28,3,31,52,59.6,21,30,13,17,44,109,84,1,Matches
1530,Roger Martí,es ESP,FW,Levante,es La Liga,27,1991,21.0,8,6,1,4,3,1,19,5.3,18,14,1,13,4,12,9,0,Matches
1531,Anthony Martial,fr FRA,FW,Manchester Utd,eng Premier League,22,1995,18.0,9,7,2,5,2,1,11,9.1,10,12,0,12,3,12,8,0,Matches
1532,Aarón Martín,es ESP,DF,Mainz 05,de Bundesliga,21,1997,32.0,55,30,29,21,5,20,38,52.6,18,38,11,27,38,93,75,1,Matches
1533,Jonas Martin,fr FRA,MF,Strasbourg,fr Ligue 1,28,1990,22.9,46,28,23,18,5,17,33,51.5,16,30,12,18,30,76,42,0,Matches
1534,Marvin Martin,fr FRA,MF,Reims,fr Ligue 1,30,1988,6.9,2,1,0,2,0,0,6,0.0,6,2,1,1,2,4,1,0,Matches
1535,Iñigo Martínez,es ESP,DF,Athletic Club,es La Liga,27,1991,32.2,53,26,36,16,1,23,37,62.2,14,24,14,10,69,122,144,0,Matches
1536,Javi Martínez,es ESP,MF,Bayern Munich,de Bundesliga,29,1988,14.5,26,15,7,17,2,5,16,31.3,11,17,5,12,31,57,13,0,Matches
1537,Lautaro Martínez,ar ARG,"FW,MF",Inter,it Serie A,20,1997,14.9,6,5,0,2,4,2,6,33.3,4,16,0,16,3,9,7,0,Matches
1538,Pablo Martinez,fr FRA,DF,Strasbourg,fr Ligue 1,29,1989,31.3,51,34,34,17,0,30,49,61.2,19,37,23,14,52,103,132,1,Matches
1539,Gelson Martins,pt POR,"FW,MF",Atlético Madrid,es La Liga,23,1995,2.5,5,3,3,1,1,3,4,75.0,1,1,0,1,1,6,1,0,Matches
1540,Gelson Martins,pt POR,"FW,MF",Monaco,fr Ligue 1,23,1995,15.4,20,12,8,7,5,13,32,40.6,19,9,1,8,8,28,7,0,Matches
1541,Adam Marušić,me MNE,DF,Lazio,it Serie A,25,1992,23.5,32,15,14,14,4,16,25,64.0,9,25,4,21,24,56,36,0,Matches
1542,Omar Mascarell,es ESP,MF,Schalke 04,de Bundesliga,25,1993,11.0,20,10,9,9,2,10,24,41.7,14,21,7,14,23,43,8,0,Matches
1543,Andrea Masiello,it ITA,DF,Atalanta,it Serie A,32,1986,20.4,28,14,13,15,0,17,29,58.6,12,21,6,15,44,72,49,0,Matches
1544,Adam Masina,ma MAR,DF,Watford,eng Premier League,24,1994,11.2,30,17,16,13,1,13,25,52.0,12,19,4,15,17,47,40,0,Matches
1545,Jordi Masip,es ESP,GK,Valladolid,es La Liga,29,1989,35.0,1,1,1,0,0,0,0,,0,1,0,1,1,2,3,3,Matches
1546,Han-Noah Massengo,fr FRA,MF,Monaco,fr Ligue 1,17,2001,0.7,2,2,2,0,0,2,5,40.0,3,0,0,0,2,4,1,0,Matches
1547,Arthur Masuaku,cd COD,DF,West Ham,eng Premier League,24,1993,19.5,57,25,38,13,6,31,56,55.4,25,27,6,21,36,93,72,0,Matches
1548,Jaime Mata,es ESP,"FW,MF",Getafe,es La Liga,29,1988,27.0,30,21,8,14,8,7,26,26.9,19,14,0,14,17,47,27,0,Matches
1549,Juan Mata,es ESP,"FW,MF",Manchester Utd,eng Premier League,30,1988,14.3,9,4,7,1,1,6,21,28.6,15,8,1,7,6,15,6,0,Matches
1550,Luca Matarese,it ITA,FW,Frosinone,it Serie A,20,1998,0.2,0,0,0,0,0,0,0,,0,0,0,0,0,0,0,0,Matches
1551,Jean-Philippe Mateta,fr FRA,FW,Mainz 05,de Bundesliga,21,1997,27.6,13,9,4,4,5,1,10,10.0,9,15,2,13,3,16,22,0,Matches
1552,Christian Mathenia,de GER,GK,Nürnberg,de Bundesliga,26,1992,21.5,0,0,0,0,0,0,0,,0,1,0,1,1,1,18,2,Matches
1553,Nemanja Matić,rs SRB,MF,Manchester Utd,eng Premier League,29,1988,27.1,50,30,27,19,4,30,59,50.8,29,39,18,21,31,81,53,4,Matches
1554,Joël Matip,cm CMR,DF,Liverpool,eng Premier League,26,1991,17.1,39,26,23,12,4,13,24,54.2,11,12,7,5,32,71,78,0,Matches
1555,Rabbi Matondo,wls WAL,"FW,MF",Schalke 04,de Bundesliga,17,2000,2.1,4,1,4,0,0,1,5,20.0,4,2,0,2,0,4,1,0,Matches
1556,Alessandro Matri,it ITA,FW,Sassuolo,it Serie A,33,1984,6.7,2,1,0,0,2,0,3,0.0,3,4,2,2,4,6,7,0,Matches
1557,Federico Mattiello,it ITA,"DF,FW",Bologna,it Serie A,23,1995,14.8,33,20,19,9,5,15,23,65.2,8,9,3,6,20,53,43,0,Matches
1558,Blaise Matuidi,fr FRA,MF,Juventus,it Serie A,31,1987,26.9,59,33,25,21,13,20,36,55.6,16,33,8,25,26,85,21,1,Matches
1559,José Mauri,it ITA,MF,Milan,it Serie A,22,1996,2.3,8,4,2,6,0,2,6,33.3,4,0,0,0,5,13,0,0,Matches
1560,Stephy Mavididi,eng ENG,FW,Juventus,it Serie A,20,1998,0.2,0,0,0,0,0,0,0,,0,1,0,1,0,0,0,0,Matches
1561,Konstantinos Mavropanos,gr GRE,DF,Arsenal,eng Premier League,20,1997,1.6,1,0,0,1,0,1,1,100.0,0,1,1,0,7,8,5,0,Matches
1562,Alfie Mawson,eng ENG,DF,Fulham,eng Premier League,24,1994,12.6,11,7,7,4,0,6,10,60.0,4,20,17,3,19,30,64,1,Matches
1563,Philipp Max,de GER,"DF,MF",Augsburg,de Bundesliga,24,1993,28.5,35,24,17,15,3,21,39,53.8,18,16,3,13,22,57,46,1,Matches
1564,Alexandru Maxim,ro ROU,"MF,FW",Mainz 05,de Bundesliga,28,1990,6.4,16,10,6,9,1,10,19,52.6,9,12,0,12,5,21,7,0,Matches
1565,Eric Maxim Choupo-Moting,cm CMR,FW,Paris S-G,fr Ligue 1,29,1989,8.9,9,4,3,2,4,2,9,22.2,7,7,0,7,3,12,4,0,Matches
1566,Borja Mayoral,es ESP,FW,Levante,es La Liga,21,1997,18.0,9,4,1,6,2,5,16,31.3,11,10,1,9,5,14,5,0,Matches
1567,Róbert Mazáň,sk SVK,DF,Celta Vigo,es La Liga,24,1994,1.0,3,3,3,0,0,2,2,100.0,0,2,0,2,3,6,0,0,Matches
1568,Luca Mazzitelli,it ITA,MF,Genoa,it Serie A,22,1995,3.6,5,2,3,1,1,2,3,66.7,1,4,1,3,6,11,7,0,Matches
1569,Kylian Mbappé,fr FRA,FW,Paris S-G,fr Ligue 1,19,1998,26.0,8,4,2,1,5,1,6,16.7,5,2,0,2,5,13,2,0,Matches
1570,Ibrahima Mbaye,sn SEN,DF,Bologna,it Serie A,23,1994,22.3,48,32,30,16,2,19,32,59.4,13,21,12,9,19,67,66,1,Matches
1571,Loïc Mbe Soh,fr FRA,DF,Paris S-G,fr Ligue 1,17,2001,2.0,0,0,0,0,0,0,3,0.0,3,2,2,0,3,3,5,0,Matches
1572,Nolan Mbemba,cg CGO,"MF,DF",Reims,fr Ligue 1,23,1995,4.0,14,8,10,4,0,6,9,66.7,3,4,1,3,10,24,4,2,Matches
1573,Adama Mbengue,sn SEN,DF,Caen,fr Ligue 1,24,1993,8.2,48,32,34,12,2,19,26,73.1,7,15,4,11,7,55,22,0,Matches
1574,Isaac Mbenza,be BEL,"FW,MF",Huddersfield,eng Premier League,22,1996,11.0,10,9,5,5,0,2,4,50.0,2,4,0,4,5,15,4,0,Matches
1575,Stéphane Mbia,cm CMR,"DF,MF",Toulouse,fr Ligue 1,32,1986,5.0,1,0,1,0,0,1,2,50.0,1,9,4,5,7,8,25,1,Matches
1576,Kara Mbodji,sn SEN,DF,Nantes,fr Ligue 1,28,1989,5.6,12,10,10,1,1,6,8,75.0,2,4,1,3,6,18,25,0,Matches
1577,Jordi Mboula,es ESP,"FW,MF",Monaco,fr Ligue 1,19,1999,3.1,3,0,0,1,2,3,6,50.0,3,1,0,1,1,4,5,0,Matches
1578,James McArthur,sct SCO,MF,Crystal Palace,eng Premier League,30,1987,34.0,84,51,38,32,14,30,78,38.5,48,64,22,42,39,123,55,0,Matches
1579,Alex McCarthy,eng ENG,GK,Southampton,eng Premier League,28,1989,25.0,0,0,0,0,0,0,0,,0,0,0,0,0,0,6,2,Matches
1580,James McCarthy,ie IRL,MF,Everton,eng Premier League,27,1990,0.2,2,1,1,1,0,0,0,,0,0,0,0,1,3,0,0,Matches
1581,Kevin McDonald,sct SCO,MF,Fulham,eng Premier League,29,1988,9.3,15,11,6,8,1,5,13,38.5,8,8,2,6,9,24,22,0,Matches
1582,Levan Mchedlidze,ge GEO,FW,Empoli,it Serie A,28,1990,2.3,1,1,0,0,1,0,1,0.0,1,2,0,2,0,1,5,0,Matches
1583,Weston McKennie,us USA,"MF,FW",Schalke 04,de Bundesliga,19,1998,19.4,28,14,5,17,6,11,35,31.4,24,28,9,19,36,64,46,1,Matches
1584,Dwight McNeil,eng ENG,MF,Burnley,eng Premier League,18,1999,17.7,36,22,16,17,3,13,44,29.5,31,30,3,27,13,49,35,0,Matches
1585,Scott McTominay,sct SCO,"MF,DF",Manchester Utd,eng Premier League,21,1996,9.6,10,9,3,6,1,4,10,40.0,6,9,4,5,15,25,16,0,Matches
1586,Iuri Medeiros,pt POR,"MF,FW",Genoa,it Serie A,24,1994,1.2,2,2,0,1,1,1,2,50.0,1,2,0,2,0,2,1,0,Matches
1587,Nicky Medja,ch SUI,"FW,MF",Fiorentina,it Serie A,18,2000,0.5,1,0,0,0,1,1,2,50.0,1,0,0,0,0,1,0,0,Matches
1588,Álvaro Medrán,es ESP,MF,Rayo Vallecano,es La Liga,24,1994,12.8,15,8,5,6,4,6,21,28.6,15,10,1,9,17,32,9,0,Matches
1589,Ben Mee,eng ENG,DF,Burnley,eng Premier League,28,1989,38.0,55,24,38,17,0,35,44,79.5,9,59,50,9,48,103,235,4,Matches
1590,Riccardo Meggiorini,it ITA,FW,Chievo,it Serie A,32,1985,17.2,17,13,5,9,3,1,10,10.0,9,20,2,18,8,25,26,0,Matches
1591,Admir Mehmedi,ch SUI,"FW,MF",Wolfsburg,de Bundesliga,27,1991,18.8,46,28,19,19,8,18,44,40.9,26,25,0,25,12,58,9,0,Matches
1592,Soualiho Meïté,fr FRA,MF,Torino,it Serie A,24,1994,29.5,46,21,13,22,11,23,46,50.0,23,46,6,40,29,75,26,0,Matches
1593,Farid El Melali,dz ALG,"MF,FW",Angers,fr Ligue 1,21,1997,3.6,8,4,3,4,1,3,12,25.0,9,2,0,2,5,13,1,0,Matches
1594,Óscar Melendo,es ESP,"MF,FW",Espanyol,es La Liga,20,1997,22.2,17,8,7,6,4,10,26,38.5,16,17,1,16,13,30,9,0,Matches
1595,Gonzalo Melero,es ESP,MF,Huesca,es La Liga,24,1994,14.9,26,23,5,19,2,11,48,22.9,37,14,4,10,2,28,23,0,Matches
1596,Arthur Melo,br BRA,MF,Barcelona,es La Liga,21,1996,15.9,15,10,5,6,4,6,13,46.2,7,8,0,8,9,24,9,1,Matches
1597,Memphis,nl NED,"FW,MF",Lyon,fr Ligue 1,24,1994,30.4,12,9,0,7,5,5,21,23.8,16,16,2,14,9,21,1,0,Matches
1598,Pedro Mendes,pt POR,DF,Montpellier,fr Ligue 1,27,1990,29.6,71,42,56,13,2,31,47,66.0,16,42,22,20,48,119,73,1,Matches
1599,Thiago Mendes,br BRA,MF,Lille,fr Ligue 1,26,1992,34.2,85,47,42,41,2,39,71,54.9,32,44,11,33,68,153,49,0,Matches
1600,Brais Méndez,es ESP,"MF,FW",Celta Vigo,es La Liga,21,1997,26.1,61,31,23,29,9,14,53,26.4,39,32,3,29,24,85,24,0,Matches
1601,Nathaniel Mendez-Laing,gt GUA,"MF,FW",Cardiff City,eng Premier League,26,1992,10.9,34,25,18,12,4,12,26,46.2,14,17,1,16,13,47,20,0,Matches
1602,Stiven Mendoza,co COL,"FW,MF",Amiens,fr Ligue 1,26,1992,20.9,29,18,10,12,7,14,38,36.8,24,18,0,18,17,46,12,0,Matches
1603,Alexandre Mendy,gw GNB,FW,Guingamp,fr Ligue 1,24,1994,8.5,5,3,0,4,1,3,8,37.5,5,3,0,3,1,6,6,0,Matches
1604,Benjamin Mendy,fr FRA,DF,Manchester City,eng Premier League,24,1994,10.0,16,10,10,5,1,9,17,52.9,8,13,4,9,10,26,18,0,Matches
1605,Edouard Mendy,sn SEN,GK,Reims,fr Ligue 1,26,1992,38.0,0,0,0,0,0,0,1,0.0,1,1,0,1,2,2,16,3,Matches
1606,Ferland Mendy,fr FRA,DF,Lyon,fr Ligue 1,23,1995,28.1,44,28,25,14,5,14,17,82.4,3,22,5,17,34,78,53,2,Matches
1607,Nampalys Mendy,sn SEN,MF,Leicester City,eng Premier League,26,1992,23.2,33,18,16,16,1,6,22,27.3,16,24,8,16,26,59,26,2,Matches
1608,Hamza Mendyl,ma MAR,DF,Schalke 04,de Bundesliga,20,1997,6.0,17,15,6,8,3,8,18,44.4,10,11,2,9,8,25,8,0,Matches
1609,Chris Mepham,wls WAL,DF,Bournemouth,eng Premier League,20,1997,9.4,9,3,9,0,0,7,11,63.6,4,12,5,7,14,23,57,2,Matches
1610,Gabriel Mercado,ar ARG,DF,Sevilla,es La Liga,31,1987,19.3,35,23,21,12,2,18,36,50.0,18,24,12,12,26,61,75,1,Matches
1611,Alex Meret,it ITA,GK,Napoli,it Serie A,21,1997,12.8,0,0,0,0,0,0,0,,0,0,0,0,0,0,3,1,Matches
1612,Mehdi Merghem,fr FRA,"FW,MF",Guingamp,fr Ligue 1,21,1997,8.0,25,18,15,7,3,11,21,52.4,10,14,1,13,9,34,6,0,Matches
1613,Mikel Merino,es ESP,MF,Real Sociedad,es La Liga,22,1996,22.8,50,28,19,25,6,14,52,26.9,38,37,2,35,29,79,37,1,Matches
1614,Sabin Merino,es ESP,"FW,MF",Leganés,es La Liga,26,1992,3.3,1,1,0,0,1,1,1,100.0,0,1,0,1,0,1,4,0,Matches
1615,Martín Merquelanz,es ESP,MF,Real Sociedad,es La Liga,23,1995,0.1,0,0,0,0,0,0,0,,0,0,0,0,0,0,0,0,Matches
1616,Dries Mertens,be BEL,FW,Napoli,it Serie A,31,1987,25.0,19,11,2,7,10,1,21,4.8,20,7,0,7,13,32,3,0,Matches
1617,Roque Mesa,es ESP,MF,Sevilla,es La Liga,29,1989,19.4,46,27,16,22,8,15,38,39.5,23,16,0,16,14,60,12,4,Matches
1618,Lionel Messi,ar ARG,FW,Barcelona,es La Liga,31,1987,30.1,12,7,5,3,4,1,17,5.9,16,10,0,10,3,15,1,0,Matches
1619,Romain Métanire,mg MAD,DF,Reims,fr Ligue 1,28,1990,3.5,12,9,10,1,1,5,7,71.4,2,4,3,1,6,18,13,0,Matches
1620,Thomas Meunier,be BEL,DF,Paris S-G,fr Ligue 1,26,1991,17.9,44,33,25,15,4,21,35,60.0,14,13,2,11,19,63,29,0,Matches
1621,Mexer,mz MOZ,DF,Rennes,fr Ligue 1,29,1988,27.4,23,12,18,5,0,12,18,66.7,6,26,18,8,30,53,125,0,Matches
1622,Max Meyer,de GER,MF,Crystal Palace,eng Premier League,22,1995,15.7,33,18,14,18,1,11,20,55.0,9,6,0,6,15,48,19,0,Matches
1623,Matt Miazga,us USA,DF,Nantes,fr Ligue 1,23,1995,8.0,12,11,11,1,0,7,9,77.8,2,11,7,4,12,24,41,1,Matches
1624,Míchel,es ESP,MF,Valladolid,es La Liga,30,1988,28.4,60,38,25,31,4,18,73,24.7,55,40,4,36,43,103,30,1,Matches
1625,Clément Michelin,fr FRA,DF,Toulouse,fr Ligue 1,21,1997,1.0,3,2,2,1,0,2,3,66.7,1,0,0,0,3,6,7,0,Matches
1626,Petar Mićin,rs SRB,MF,Udinese,it Serie A,19,1998,0.0,0,0,0,0,0,0,0,,0,0,0,0,0,0,0,0,Matches
1627,Miguel,es ESP,FW,Valladolid,es La Liga,18,1999,0.1,0,0,0,0,0,0,1,0.0,1,0,0,0,1,1,0,0,Matches
1628,Florian Miguel,fr FRA,DF,Nîmes,fr Ligue 1,21,1996,12.4,19,16,13,6,0,7,11,63.6,4,15,7,8,21,40,47,0,Matches
1629,Nikola Milenković,rs SRB,DF,Fiorentina,it Serie A,20,1997,33.4,59,40,36,21,2,17,33,51.5,16,39,21,18,48,107,143,0,Matches
1630,Arkadiusz Milik,pl POL,FW,Napoli,it Serie A,24,1994,26.6,19,9,1,8,10,1,20,5.0,19,7,2,5,3,22,15,0,Matches
1631,Sergej Milinković-Savić,rs SRB,MF,Lazio,it Serie A,23,1995,26.6,44,28,17,21,6,23,60,38.3,37,28,4,24,27,71,48,0,Matches
1632,Vanja Milinković-Savić,rs SRB,GK,SPAL,it Serie A,21,1997,1.8,0,0,0,0,0,0,0,,0,0,0,0,0,0,1,0,Matches
1633,Luka Milivojević,rs SRB,MF,Crystal Palace,eng Premier League,27,1991,38.0,90,69,36,47,7,39,91,42.9,52,47,15,32,72,162,68,3,Matches
1634,Pere Milla,es ESP,"MF,FW",Eibar,es La Liga,25,1992,3.8,7,6,1,5,1,0,5,0.0,5,4,1,3,2,9,1,0,Matches
1635,Vincenzo Millico,it ITA,MF,Torino,it Serie A,17,2000,0.0,0,0,0,0,0,0,0,,0,0,0,0,0,0,0,0,Matches
1636,James Milner,eng ENG,"MF,DF",Liverpool,eng Premier League,32,1986,19.9,43,23,14,24,5,15,41,36.6,26,40,5,35,18,61,30,0,Matches
1637,Santi Mina,es ESP,FW,Valencia,es La Liga,22,1995,20.6,17,10,1,15,1,3,25,12.0,22,19,2,17,4,21,20,0,Matches
1638,Yerry Mina,co COL,DF,Everton,eng Premier League,23,1994,9.9,14,7,8,6,0,6,9,66.7,3,11,5,6,8,22,54,3,Matches
1639,Tyrone Mings,eng ENG,DF,Bournemouth,eng Premier League,25,1993,1.6,4,3,3,1,0,2,3,66.7,1,5,2,3,6,10,8,0,Matches
1640,Ignasi Miquel,es ESP,DF,Getafe,es La Liga,25,1992,3.5,1,0,0,1,0,1,2,50.0,1,4,4,0,5,6,25,0,Matches
1641,Kevin Mirallas,be BEL,"FW,MF",Fiorentina,it Serie A,30,1987,14.4,17,7,8,4,5,6,15,40.0,9,17,0,17,4,21,10,0,Matches
1642,Jorge Miramón,es ESP,DF,Huesca,es La Liga,29,1989,27.7,73,55,49,17,7,34,53,64.2,19,34,11,23,44,117,65,1,Matches
1643,Miranda,br BRA,DF,Inter,it Serie A,33,1984,12.9,11,7,7,4,0,4,8,50.0,4,11,7,4,14,25,48,2,Matches
1644,Antonio Mirante,it ITA,GK,Roma,it Serie A,35,1983,11.0,0,0,0,0,0,0,0,,0,0,0,0,0,0,6,1,Matches
1645,Virgil Misidjan,nl NED,"MF,FW",Nürnberg,de Bundesliga,25,1993,17.1,21,13,10,5,6,4,25,16.0,21,17,0,17,9,30,5,0,Matches
1646,Simone Missiroli,it ITA,MF,SPAL,it Serie A,32,1986,30.5,58,43,31,22,5,25,49,51.0,24,44,11,33,46,104,46,0,Matches
1647,Kostas Mitroglou,gr GRE,FW,Marseille,fr Ligue 1,30,1988,6.4,0,0,0,0,0,0,3,0.0,3,0,0,0,0,0,5,0,Matches
1648,Aleksandar Mitrović,rs SRB,FW,Fulham,eng Premier League,23,1994,36.4,19,9,3,13,3,5,15,33.3,10,22,8,14,6,25,53,0,Matches
1649,Stefan Mitrović,rs SRB,DF,Strasbourg,fr Ligue 1,28,1990,33.6,23,16,20,3,0,12,24,50.0,12,41,31,10,46,69,146,2,Matches
1650,Maximilian Mittelstädt,de GER,"DF,MF",Hertha BSC,de Bundesliga,21,1997,20.0,61,37,33,23,5,23,49,46.9,26,32,4,28,46,107,64,0,Matches
1651,Henrikh Mkhitaryan,am ARM,"FW,MF",Arsenal,eng Premier League,29,1989,18.2,28,22,8,17,3,6,22,27.3,16,34,2,32,16,44,13,0,Matches
1652,Luka Modrić,hr CRO,MF,Real Madrid,es La Liga,32,1985,29.0,49,30,11,25,13,14,48,29.2,34,20,3,17,31,80,7,1,Matches
1653,Kevin Möhwald,de GER,MF,Werder Bremen,de Bundesliga,25,1993,9.7,16,10,3,11,2,3,20,15.0,17,14,0,14,17,33,14,0,Matches
1654,Niklas Moisander,fi FIN,DF,Werder Bremen,de Bundesliga,32,1985,29.3,34,23,26,8,0,22,51,43.1,29,42,19,23,39,73,140,2,Matches
1655,Johan Mojica,co COL,"FW,MF",Girona,es La Liga,25,1992,0.2,1,1,1,0,0,0,0,,0,0,0,0,0,1,0,0,Matches
1656,Hakim El Mokeddem,br BRA,"FW,MF",Toulouse,fr Ligue 1,19,1999,0.3,1,1,1,0,0,0,1,0.0,1,0,0,0,0,1,1,0,Matches
1657,Jorge Molina,es ESP,FW,Getafe,es La Liga,36,1982,29.4,12,9,1,4,7,2,15,13.3,13,22,0,22,7,19,26,1,Matches
1658,Cristian Molinaro,it ITA,"DF,MF",Frosinone,it Serie A,35,1983,12.9,15,10,7,7,1,3,9,33.3,6,11,4,7,15,30,43,0,Matches
1659,Victor Mollejo,es ESP,"FW,DF",Atlético Madrid,es La Liga,17,2001,0.7,0,0,0,0,0,0,2,0.0,2,0,0,0,0,0,0,0,Matches
1660,Florent Mollet,fr FRA,MF,Montpellier,fr Ligue 1,26,1991,28.5,36,20,8,20,8,13,51,25.5,38,32,1,31,23,59,7,0,Matches
1661,Gabriele Moncini,it ITA,MF,SPAL,it Serie A,22,1996,0.1,1,1,1,0,0,0,0,,0,0,0,0,0,1,0,0,Matches
1662,Thomas Monconduit,fr FRA,MF,Amiens,fr Ligue 1,27,1991,31.3,76,47,38,33,5,26,63,41.3,37,46,17,29,36,112,77,1,Matches
1663,Kévin Monnet-Paquet,fr FRA,"DF,MF",Saint-Étienne,fr Ligue 1,29,1988,16.5,46,25,23,16,7,20,36,55.6,16,22,4,18,14,60,28,0,Matches
1664,Nacho Monreal,es ESP,DF,Arsenal,eng Premier League,32,1986,20.7,35,17,21,9,5,15,25,60.0,10,28,10,18,31,66,62,0,Matches
1665,Francisco Montero,es ESP,DF,Atlético Madrid,es La Liga,19,1999,4.5,8,4,5,3,0,5,6,83.3,1,10,4,6,5,13,18,1,Matches
1666,Cristóbal Montiel,es ESP,FW,Fiorentina,it Serie A,18,2000,0.1,0,0,0,0,0,0,0,,0,0,0,0,0,0,0,0,Matches
1667,Martín Montoya,es ESP,DF,Brighton,eng Premier League,27,1991,24.1,58,35,29,21,8,32,55,58.2,23,30,10,20,48,106,76,1,Matches
1668,Aaron Mooy,au AUS,"MF,FW",Huddersfield,eng Premier League,27,1990,25.9,62,42,19,27,16,21,52,40.4,31,43,7,36,14,76,22,0,Matches
1669,Emre Mor,tr TUR,"FW,MF",Celta Vigo,es La Liga,21,1997,4.1,7,4,1,3,3,2,7,28.6,5,5,0,5,3,10,1,0,Matches
1670,Alfredo Morales,us USA,MF,Düsseldorf,de Bundesliga,28,1990,17.0,32,18,16,15,1,6,24,25.0,18,18,9,9,24,56,31,0,Matches
1671,Álvaro Morata,es ESP,FW,Chelsea,eng Premier League,25,1992,10.5,8,5,0,5,3,1,7,14.3,6,6,1,5,0,8,6,0,Matches
1672,Álvaro Morata,es ESP,FW,Atlético Madrid,es La Liga,25,1992,12.0,20,14,2,7,11,3,10,30.0,7,7,0,7,5,25,13,0,Matches
1673,Jan Morávek,cz CZE,MF,Augsburg,de Bundesliga,28,1989,8.4,38,21,17,16,5,19,42,45.2,23,21,1,20,9,47,13,0,Matches
1674,Steven Moreira,fr FRA,"DF,MF",Toulouse,fr Ligue 1,23,1994,9.6,19,8,13,5,1,10,17,58.8,7,14,0,14,10,29,19,1,Matches
1675,Jérémy Morel,mg MAD,DF,Lyon,fr Ligue 1,34,1984,11.8,16,10,11,5,0,9,13,69.2,4,18,14,4,18,34,45,1,Matches
1676,Alberto Moreno,es ESP,DF,Liverpool,eng Premier League,26,1992,1.7,3,2,1,2,0,1,3,33.3,2,1,0,1,2,5,0,0,Matches
1677,Álex Moreno,es ESP,DF,Rayo Vallecano,es La Liga,25,1993,34.8,63,40,41,18,4,29,53,54.7,24,35,9,26,41,104,97,0,Matches
1678,Gerard Moreno,es ESP,FW,Villarreal,es La Liga,26,1992,25.7,22,12,2,15,5,8,27,29.6,19,23,9,14,9,31,39,0,Matches
1679,Héctor Moreno,mx MEX,DF,Real Sociedad,es La Liga,30,1988,21.5,16,9,12,4,0,9,17,52.9,8,34,19,15,31,47,73,0,Matches
1680,Sergio Moreno,es ESP,FW,Rayo Vallecano,es La Liga,19,1999,0.2,0,0,0,0,0,0,0,,0,0,0,0,0,0,0,0,Matches
1681,Emiliano Moretti,it ITA,DF,Torino,it Serie A,37,1981,22.3,30,21,21,9,0,13,20,65.0,7,14,6,8,24,54,65,1,Matches
1682,Wes Morgan,jm JAM,DF,Leicester City,eng Premier League,34,1984,21.4,27,15,14,12,1,6,7,85.7,1,24,10,14,32,59,109,1,Matches
1683,Manu Morlanes,es ESP,MF,Villarreal,es La Liga,19,1999,6.8,21,11,9,9,3,7,19,36.8,12,7,3,4,5,26,9,0,Matches
1684,Loren Morón,es ESP,FW,Betis,es La Liga,24,1993,21.7,18,12,4,11,3,6,27,22.2,21,24,1,23,6,24,18,0,Matches
1685,Sean Morrison,eng ENG,DF,Cardiff City,eng Premier League,27,1991,33.8,35,17,29,4,2,15,28,53.6,13,47,30,17,52,87,204,5,Matches
1686,Victor Moses,ng NGA,FW,Chelsea,eng Premier League,27,1990,0.3,0,0,0,0,0,0,0,,0,1,0,1,0,0,0,0,Matches
1687,Lebo Mothiba,za RSA,FW,Strasbourg,fr Ligue 1,22,1996,19.7,10,9,2,7,1,0,8,0.0,8,5,1,4,0,10,6,0,Matches
1688,Lebo Mothiba,za RSA,FW,Lille,fr Ligue 1,22,1996,2.8,1,1,0,1,0,0,0,,0,0,0,0,0,1,8,0,Matches
1689,François Moubandje,ch SUI,DF,Toulouse,fr Ligue 1,28,1990,21.5,38,22,22,10,6,17,22,77.3,5,18,4,14,27,65,74,0,Matches
1690,Jessy Moulin,fr FRA,GK,Saint-Étienne,fr Ligue 1,32,1986,1.0,1,0,1,0,0,1,1,100.0,0,0,0,0,0,1,2,0,Matches
1691,Steve Mounié,bj BEN,FW,Huddersfield,eng Premier League,23,1994,19.8,9,6,3,4,2,2,12,16.7,10,10,1,9,5,14,15,0,Matches
1692,Lucas Moura,br BRA,"FW,MF",Tottenham,eng Premier League,25,1992,23.6,35,18,8,20,7,9,27,33.3,18,15,1,14,24,59,24,0,Matches
1693,Herman Moussaki,fr FRA,"MF,FW",Caen,fr Ligue 1,19,1999,2.3,3,3,2,1,0,1,4,25.0,3,2,1,1,0,3,3,0,Matches
1694,Lys Mousset,fr FRA,FW,Bournemouth,eng Premier League,22,1996,4.1,3,1,1,1,1,1,4,25.0,3,3,0,3,1,4,3,0,Matches
1695,João Moutinho,pt POR,MF,Wolves,eng Premier League,31,1986,33.7,113,58,50,56,7,44,126,34.9,82,56,11,45,40,153,50,0,Matches
1696,Samuel Moutoussamy,cd COD,"MF,FW",Nantes,fr Ligue 1,21,1996,18.3,35,20,16,11,8,12,34,35.3,22,17,2,15,9,44,17,0,Matches
1697,Toni Moya,es ESP,DF,Atlético Madrid,es La Liga,20,1998,1.0,2,2,2,0,0,0,1,0.0,1,0,0,0,0,2,3,0,Matches
1698,Javi Moyano,es ESP,DF,Valladolid,es La Liga,32,1986,23.3,25,17,17,6,2,15,30,50.0,15,20,9,11,25,50,88,2,Matches
1699,Samuel Mráz,sk SVK,FW,Empoli,it Serie A,21,1997,1.9,0,0,0,0,0,0,0,,0,2,0,2,0,0,2,0,Matches
1700,Ndombe Mubele,cd COD,FW,Toulouse,fr Ligue 1,24,1994,5.2,9,4,5,2,2,4,9,44.4,5,4,0,4,2,11,2,0,Matches
1701,Lukas Mühl,de GER,DF,Nürnberg,de Bundesliga,21,1997,31.0,57,34,49,6,2,32,51,62.7,19,53,18,35,48,105,139,2,Matches
1702,Nordi Mukiele,fr FRA,DF,RB Leipzig,de Bundesliga,20,1997,13.6,38,21,23,12,3,19,22,86.4,3,17,3,14,24,62,35,0,Matches
1703,Florian Müller,de GER,GK,Mainz 05,de Bundesliga,20,1997,24.0,1,1,1,0,0,1,2,50.0,1,0,0,0,3,4,8,5,Matches
1704,Nicolai Müller,de GER,"MF,FW",Hannover 96,de Bundesliga,30,1987,10.0,18,9,7,7,4,8,27,29.6,19,9,1,8,1,19,7,0,Matches
1705,Nicolai Müller,de GER,"FW,MF",Eint Frankfurt,de Bundesliga,30,1987,2.4,4,2,3,1,0,1,2,50.0,1,4,1,3,0,4,0,0,Matches
1706,Thomas Müller,de GER,"MF,FW",Bayern Munich,de Bundesliga,28,1989,26.4,42,23,13,15,14,10,38,26.3,28,46,6,40,9,51,12,0,Matches
1707,Gianni Munari,it ITA,MF,Parma,it Serie A,35,1983,0.0,0,0,0,0,0,0,0,,0,0,0,0,0,0,0,0,Matches
1708,Iker Muniain,es ESP,"MF,FW",Athletic Club,es La Liga,25,1992,26.5,29,20,10,14,5,6,29,20.7,23,17,3,14,12,41,6,0,Matches
1709,Marc Muniesa,es ESP,"DF,MF",Girona,es La Liga,26,1992,15.6,49,34,27,17,5,15,28,53.6,13,18,6,12,37,86,49,1,Matches
1710,Aihen Muñoz,es ESP,DF,Real Sociedad,es La Liga,20,1997,10.6,13,8,11,2,0,10,19,52.6,9,19,9,10,7,20,26,0,Matches
1711,Ezequiel Muñoz,ar ARG,DF,Leganés,es La Liga,27,1990,2.3,3,2,1,2,0,0,0,,0,3,1,2,1,4,10,0,Matches
1712,Joaquín Muñoz,es ESP,FW,Atlético Madrid,es La Liga,19,1999,0.0,0,0,0,0,0,0,0,,0,0,0,0,0,0,0,0,Matches
1713,Alessandro Murgia,it ITA,MF,SPAL,it Serie A,21,1996,11.9,22,15,9,12,1,7,32,21.9,25,14,2,12,19,41,12,1,Matches
1714,Alessandro Murgia,it ITA,MF,Lazio,it Serie A,21,1996,0.1,0,0,0,0,0,0,0,,0,0,0,0,0,0,0,0,Matches
1715,Luis Muriel,co COL,FW,Fiorentina,it Serie A,27,1991,16.0,19,11,4,13,2,6,18,33.3,12,10,0,10,3,22,1,0,Matches
1716,Luis Muriel,co COL,"MF,FW",Sevilla,es La Liga,27,1991,1.4,0,0,0,0,0,0,6,0.0,6,3,0,3,0,0,1,0,Matches
1717,Jeison Murillo,co COL,DF,Valencia,es La Liga,26,1992,1.0,2,1,1,1,0,1,2,50.0,1,1,0,1,2,4,6,0,Matches
1718,Jeison Murillo,co COL,DF,Barcelona,es La Liga,26,1992,1.3,2,2,1,1,0,0,3,0.0,3,0,0,0,0,2,5,1,Matches
1719,Jacob Murphy,eng ENG,"MF,DF",Newcastle Utd,eng Premier League,23,1995,3.4,6,2,4,2,0,2,4,50.0,2,5,2,3,1,7,7,0,Matches
1720,Josh Murphy,eng ENG,"MF,FW",Cardiff City,eng Premier League,23,1995,20.2,26,17,15,7,4,9,29,31.0,20,30,0,30,11,37,17,0,Matches
1721,Glenn Murray,eng ENG,FW,Brighton,eng Premier League,34,1983,27.9,17,7,4,7,6,4,20,20.0,16,20,3,17,2,19,17,1,Matches
1722,Nicola Murru,it ITA,DF,Sampdoria,it Serie A,23,1994,32.6,83,59,42,25,16,41,54,75.9,13,50,22,28,41,124,99,0,Matches
1723,Mateo Musacchio,ar ARG,DF,Milan,it Serie A,27,1990,29.0,41,22,30,8,3,19,27,70.4,8,26,19,7,29,70,114,0,Matches
1724,Florent Muslija,xk KVX,"MF,FW",Hannover 96,de Bundesliga,20,1998,7.5,16,10,8,6,2,8,12,66.7,4,4,0,4,3,19,4,0,Matches
1725,Juan Musso,ar ARG,GK,Udinese,it Serie A,24,1994,29.0,0,0,0,0,0,0,1,0.0,1,0,0,0,0,0,10,4,Matches
1726,Shkodran Mustafi,de GER,DF,Arsenal,eng Premier League,26,1992,29.0,62,45,42,17,3,31,40,77.5,9,34,17,17,58,120,168,1,Matches
1727,Damián Musto,ar ARG,"MF,DF",Huesca,es La Liga,31,1987,18.7,52,34,22,27,3,16,33,48.5,17,30,11,19,34,86,54,1,Matches
1728,Yoshinori Mutō,jp JPN,"FW,MF",Newcastle Utd,eng Premier League,26,1992,5.8,8,4,3,5,0,2,7,28.6,5,9,0,9,5,13,3,1,Matches
1729,Yvon Mvogo,ch SUI,GK,RB Leipzig,de Bundesliga,24,1994,1.5,0,0,0,0,0,0,0,,0,0,0,0,0,0,1,0,Matches
1730,Phillipp Mwene,at AUT,"DF,MF",Mainz 05,de Bundesliga,24,1994,3.0,7,2,3,4,0,5,6,83.3,1,6,0,6,6,13,10,0,Matches
1731,Obite N'Dicka,fr FRA,DF,Eint Frankfurt,de Bundesliga,18,1999,25.6,43,28,31,10,2,31,52,59.6,21,29,11,18,29,72,123,0,Matches
1732,Kévin N'Doram,fr FRA,"DF,MF",Monaco,fr Ligue 1,22,1996,2.2,5,4,1,4,0,3,5,60.0,2,1,1,0,5,10,8,1,Matches
1733,Abdallah N'dour,sn SEN,DF,Strasbourg,fr Ligue 1,24,1993,3.2,6,4,3,3,0,4,9,44.4,5,4,2,2,5,11,8,0,Matches
1734,Cheikh N'Doye,sn SEN,MF,Angers,fr Ligue 1,32,1986,25.9,25,15,14,11,0,10,32,31.3,22,33,8,25,25,50,61,0,Matches
1735,Nathan N'Goumou,fr FRA,FW,Toulouse,fr Ligue 1,18,2000,0.8,1,1,0,1,0,0,1,0.0,1,1,0,1,0,1,3,0,Matches
1736,Clinton N'Jie,cm CMR,FW,Marseille,fr Ligue 1,24,1993,4.0,7,4,2,3,2,3,3,100.0,0,2,0,2,2,9,0,0,Matches
1737,Georges-Kévin N'Koudou,cm CMR,FW,Tottenham,eng Premier League,23,1995,0.1,0,0,0,0,0,0,0,,0,0,0,0,0,0,0,0,Matches
1738,Georges-Kévin N'Koudou,cm CMR,FW,Monaco,fr Ligue 1,23,1995,0.3,2,1,0,0,2,1,1,100.0,0,2,0,2,0,2,0,0,Matches
1739,Stanley N'Soki,fr FRA,DF,Paris S-G,fr Ligue 1,19,1999,7.8,20,14,8,10,2,6,13,46.2,7,10,1,9,18,38,20,1,Matches
1740,Nacho,es ESP,DF,Valladolid,es La Liga,29,1989,35.0,110,66,73,30,7,67,100,67.0,33,43,10,33,45,155,113,2,Matches
1741,Nacho,es ESP,DF,Real Madrid,es La Liga,28,1990,18.9,26,19,14,7,5,11,22,50.0,11,19,7,12,32,58,65,1,Matches
1742,Ádám Nagy,hu HUN,MF,Bologna,it Serie A,23,1995,10.8,29,21,15,13,1,11,21,52.4,10,13,5,8,25,54,12,2,Matches
1743,Radja Nainggolan,be BEL,MF,Inter,it Serie A,30,1988,21.9,35,26,7,20,8,10,24,41.7,14,17,2,15,8,43,5,0,Matches
1744,Naldo,br BRA,DF,Espanyol,es La Liga,29,1988,15.1,18,10,9,5,4,6,10,60.0,4,19,13,6,26,44,112,1,Matches
1745,Naldo,br BRA,DF,Monaco,fr Ligue 1,35,1982,3.3,5,3,4,1,0,2,4,50.0,2,5,2,3,5,10,23,0,Matches
1746,Naldo,br BRA,DF,Schalke 04,de Bundesliga,35,1982,7.0,10,7,8,2,0,5,8,62.5,3,8,3,5,14,24,25,0,Matches
1747,Samir Nasri,fr FRA,MF,West Ham,eng Premier League,31,1987,2.7,0,0,0,0,0,0,0,,0,1,0,1,1,1,1,0,Matches
1748,Matija Nastasić,rs SRB,DF,Schalke 04,de Bundesliga,25,1993,27.2,35,23,22,13,0,20,29,69.0,9,32,20,12,38,73,114,1,Matches
1749,Marc Navarro,es ESP,DF,Watford,eng Premier League,23,1995,0.9,4,2,3,1,0,3,4,75.0,1,0,0,0,0,4,4,0,Matches
1750,Ximo Navarro,es ESP,DF,Alavés,es La Liga,28,1990,28.1,57,35,44,12,1,32,45,71.1,13,25,11,14,47,104,143,1,Matches
1751,Jesús Navas,es ESP,"DF,FW",Sevilla,es La Liga,32,1985,30.1,28,21,15,11,2,16,24,66.7,8,23,5,18,29,57,62,0,Matches
1752,Keylor Navas,cr CRC,GK,Real Madrid,es La Liga,31,1986,10.0,0,0,0,0,0,0,0,,0,0,0,0,1,1,5,0,Matches
1753,Raúl Navas,es ESP,DF,Real Sociedad,es La Liga,30,1988,14.6,23,14,20,3,0,13,21,61.9,8,20,9,11,20,43,60,1,Matches
1754,Wilfred Ndidi,ng NGA,MF,Leicester City,eng Premier League,21,1996,36.6,142,98,66,67,9,46,95,48.4,49,64,9,55,83,225,85,2,Matches
1755,Aly Ndom,fr FRA,MF,Caen,fr Ligue 1,22,1996,0.5,0,0,0,0,0,0,0,,0,0,0,0,1,1,1,0,Matches
1756,Aly Ndom,fr FRA,MF,Reims,fr Ligue 1,22,1996,4.0,11,9,5,5,1,3,7,42.9,4,6,2,4,3,14,9,1,Matches
1757,Tanguy Ndombele,fr FRA,MF,Lyon,fr Ligue 1,21,1996,29.9,66,43,21,35,10,22,54,40.7,32,29,9,20,30,96,13,3,Matches
1758,Angelo Ndrecka,al ALB,DF,Chievo,it Serie A,16,2001,1.0,1,1,1,0,0,1,2,50.0,1,3,2,1,0,1,1,0,Matches
1759,Reiss Nelson,eng ENG,"MF,FW",Hoffenheim,de Bundesliga,18,1999,7.1,17,10,8,4,5,2,13,15.4,11,12,1,11,5,22,2,0,Matches
1760,Neto,br BRA,GK,Valencia,es La Liga,29,1989,34.0,2,0,2,0,0,2,3,66.7,1,0,0,0,1,3,9,3,Matches
1761,Pedro Neto,pt POR,"FW,DF",Lazio,it Serie A,18,2000,0.5,0,0,0,0,0,0,0,,0,1,0,1,0,0,0,0,Matches
1762,Manuel Neuer,de GER,GK,Bayern Munich,de Bundesliga,32,1986,25.6,1,1,1,0,0,0,1,0.0,1,1,0,1,0,1,8,3,Matches
1763,Florian Neuhaus,de GER,MF,M'Gladbach,de Bundesliga,21,1997,22.9,22,15,9,9,4,10,36,27.8,26,20,1,19,10,32,23,0,Matches
1764,Rúben Neves,pt POR,MF,Wolves,eng Premier League,21,1997,33.4,75,32,33,36,6,27,83,32.5,56,57,18,39,73,148,46,3,Matches
1765,Neymar,br BRA,"MF,FW",Paris S-G,fr Ligue 1,26,1992,16.0,14,9,3,10,1,4,21,19.0,17,8,0,8,5,19,1,1,Matches
1766,Yeni Ngbakoto,cd COD,"MF,FW",Guingamp,fr Ligue 1,26,1992,6.3,9,4,4,3,2,4,8,50.0,4,7,0,7,4,13,2,0,Matches
1767,Moussa Niakhate,sn SEN,DF,Mainz 05,de Bundesliga,22,1996,31.0,49,30,35,12,2,20,33,60.6,13,42,24,18,44,93,143,1,Matches
1768,M'Baye Niang,sn SEN,"FW,MF",Rennes,fr Ligue 1,23,1994,19.9,16,10,3,8,5,2,11,18.2,9,19,3,16,8,24,14,0,Matches
1769,Oumar Niasse,sn SEN,FW,Cardiff City,eng Premier League,28,1990,10.3,12,3,1,5,6,4,8,50.0,4,7,0,7,2,14,7,0,Matches
1770,Oumar Niasse,sn SEN,FW,Everton,eng Premier League,28,1990,0.7,0,0,0,0,0,0,1,0.0,1,0,0,0,0,0,0,0,Matches
1771,Hans Nicolussi Caviglia,it ITA,MF,Juventus,it Serie A,18,2000,0.6,2,1,0,2,0,0,2,0.0,2,2,1,1,0,2,0,0,Matches
1772,Florian Niederlechner,de GER,"FW,MF",Freiburg,de Bundesliga,27,1990,10.8,7,5,1,4,2,0,5,0.0,5,12,4,8,6,13,10,0,Matches
1773,Saúl Ñíguez,es ESP,"MF,DF",Atlético Madrid,es La Liga,23,1994,32.5,83,56,35,41,7,32,81,39.5,49,57,10,47,42,125,86,1,Matches
1774,Dimitris Nikolaou,gr GRE,DF,Empoli,it Serie A,19,1998,3.9,5,3,3,2,0,1,2,50.0,1,2,2,0,2,7,14,0,Matches
1775,Casimir Ninga,td CHA,"FW,MF",Caen,fr Ligue 1,25,1993,27.4,53,30,23,21,9,20,49,40.8,29,22,1,21,22,75,12,0,Matches
1776,Eddie Nketiah,eng ENG,"MF,FW",Arsenal,eng Premier League,19,1999,0.7,1,1,0,1,0,0,0,,0,0,0,0,0,1,1,0,Matches
1777,Nicolas Nkoulou,cm CMR,DF,Torino,it Serie A,28,1990,35.7,45,29,34,10,1,15,25,60.0,10,42,28,14,70,115,174,2,Matches
1778,Christopher Nkunku,fr FRA,"MF,FW",Paris S-G,fr Ligue 1,20,1997,12.8,21,16,8,10,3,7,16,43.8,9,12,2,10,9,30,7,1,Matches
1779,Mark Noble,eng ENG,MF,West Ham,eng Premier League,31,1987,25.5,47,26,19,24,4,17,52,32.7,35,17,2,15,21,68,13,0,Matches
1780,Peru Nolaskoain,es ESP,DF,Athletic Club,es La Liga,19,1998,5.2,11,8,7,4,0,5,9,55.6,4,11,6,5,10,21,18,0,Matches
1781,Nolito,es ESP,"FW,DF",Sevilla,es La Liga,31,1986,0.8,3,2,1,1,1,1,2,50.0,1,2,0,2,0,3,1,0,Matches
1782,Arnaud Nordin,fr FRA,"FW,MF",Saint-Étienne,fr Ligue 1,20,1998,11.7,14,12,4,4,6,4,11,36.4,7,13,2,11,5,19,9,0,Matches
1783,Håvard Nordtveit,no NOR,DF,Fulham,eng Premier League,28,1990,4.0,9,4,8,1,0,4,5,80.0,1,3,3,0,8,17,15,1,Matches
1784,Håvard Nordtveit,no NOR,"MF,DF",Hoffenheim,de Bundesliga,28,1990,5.2,8,5,2,4,2,3,7,42.9,4,8,5,3,4,12,14,0,Matches
1785,Will Norris,eng ENG,GK,Wolves,eng Premier League,24,1993,0.0,0,0,0,0,0,0,0,,0,0,0,0,0,0,0,0,Matches
1786,Alexander Nübel,de GER,GK,Schalke 04,de Bundesliga,21,1996,17.6,0,0,0,0,0,0,1,0.0,1,0,0,0,1,1,4,1,Matches
1787,Kasim Nuhu,gh GHA,DF,Hoffenheim,de Bundesliga,23,1995,10.0,19,11,14,3,2,10,23,43.5,13,11,5,6,23,42,44,0,Matches
1788,Unai Núñez,es ESP,DF,Athletic Club,es La Liga,21,1997,11.8,15,11,11,4,0,7,11,63.6,4,20,12,8,28,43,60,2,Matches
1789,Hans Nunoo Sarpei,gh GHA,"FW,MF",Stuttgart,de Bundesliga,19,1998,0.5,1,1,0,1,0,0,0,,0,0,0,0,0,1,0,0,Matches
1790,Bram Nuytinck,nl NED,DF,Udinese,it Serie A,28,1990,23.6,50,35,34,13,3,25,33,75.8,8,44,27,17,29,79,126,0,Matches
1791,Gerzino Nyamsi,fr FRA,DF,Rennes,fr Ligue 1,21,1997,6.0,6,3,5,1,0,4,9,44.4,5,8,4,4,4,10,17,0,Matches
1792,Allan Nyom,cm CMR,"DF,FW",Leganés,es La Liga,30,1988,19.0,32,24,20,10,2,12,17,70.6,5,7,2,5,20,52,35,0,Matches
1793,Steven Nzonzi,fr FRA,MF,Roma,it Serie A,29,1988,29.1,66,45,24,36,6,21,34,61.8,13,40,24,16,27,93,55,2,Matches
1794,Christian Nørgaard,dk DEN,MF,Fiorentina,it Serie A,24,1994,3.6,4,2,1,2,1,2,5,40.0,3,2,0,2,10,14,16,0,Matches
1795,Michael Obafemi,ie IRL,FW,Southampton,eng Premier League,18,2000,1.5,1,1,0,0,1,0,0,,0,1,1,0,1,2,0,0,Matches
1796,Dimitri Oberlin,ch SUI,FW,Empoli,it Serie A,20,1997,1.5,1,1,0,0,1,0,3,0.0,3,1,0,1,0,1,1,0,Matches
1797,Joel Obi,ng NGA,MF,Chievo,it Serie A,27,1991,7.3,22,15,9,11,2,7,17,41.2,10,12,1,11,14,36,15,0,Matches
1798,Pedro Obiang,gq EQG,MF,West Ham,eng Premier League,26,1992,12.5,41,23,23,16,2,18,43,41.9,25,27,9,18,12,53,18,0,Matches
1799,Jan Oblak,si SVN,GK,Atlético Madrid,es La Liga,25,1993,37.0,1,0,1,0,0,1,1,100.0,0,0,0,0,1,2,13,1,Matches
1800,Lucas Ocampos,ar ARG,"FW,MF",Marseille,fr Ligue 1,24,1994,30.1,80,54,37,33,10,34,80,42.5,46,40,5,35,29,109,30,0,Matches
1801,Bastian Oczipka,de GER,"DF,FW",Schalke 04,de Bundesliga,29,1989,20.8,41,27,20,19,2,21,26,80.8,5,23,5,18,24,65,24,2,Matches
1802,Jens Odgaard,dk DEN,FW,Sassuolo,it Serie A,19,1999,0.2,0,0,0,0,0,0,0,,0,1,0,1,0,0,1,0,Matches
1803,Denis Odoi,gh GHA,DF,Fulham,eng Premier League,30,1988,28.8,48,34,29,16,3,21,33,63.6,12,45,24,21,42,90,153,0,Matches
1804,Álvaro Odriozola,es ESP,DF,Real Madrid,es La Liga,22,1995,13.1,28,25,13,11,4,14,18,77.8,4,11,1,10,11,39,17,1,Matches
1805,Angelo Ogbonna,it ITA,DF,West Ham,eng Premier League,30,1988,20.8,31,13,23,6,2,14,23,60.9,9,29,19,10,35,66,101,0,Matches
1806,Dani Ojeda,es ESP,"MF,DF",Leganés,es La Liga,23,1994,2.1,3,2,2,0,1,1,3,33.3,2,2,0,2,2,5,2,0,Matches
1807,Sheyi Ojo,eng ENG,"FW,MF",Reims,fr Ligue 1,21,1997,5.2,8,6,2,4,2,2,8,25.0,6,1,0,1,3,11,2,0,Matches
1808,Stefano Okaka,it ITA,"FW,MF",Watford,eng Premier League,28,1989,0.3,0,0,0,0,0,0,0,,0,1,0,1,0,0,0,0,Matches
1809,Stefano Okaka,it ITA,FW,Udinese,it Serie A,28,1989,10.8,13,7,4,5,4,2,8,25.0,6,6,1,5,0,13,16,1,Matches
1810,Shinji Okazaki,jp JPN,"MF,FW",Leicester City,eng Premier League,32,1986,3.2,5,5,2,3,0,0,1,0.0,1,7,1,6,2,7,1,0,Matches
1811,Chima Okoroji,ng NGA,"DF,MF",Freiburg,de Bundesliga,21,1997,1.2,3,0,1,1,1,1,1,100.0,0,0,0,0,1,4,1,0,Matches
1812,Orji Okwonkwo,ng NGA,FW,Bologna,it Serie A,20,1998,2.9,4,3,1,2,1,2,2,100.0,0,0,0,0,1,5,0,0,Matches
1813,Lucas Olaza,uy URU,DF,Celta Vigo,es La Liga,24,1994,10.0,29,18,19,8,2,14,18,77.8,4,13,6,7,8,37,18,0,Matches
1814,Oier Olazábal,es ESP,GK,Levante,es La Liga,28,1989,21.0,1,1,1,0,0,1,2,50.0,1,1,0,1,1,2,15,2,Matches
1815,Kiko Olivas,es ESP,DF,Valladolid,es La Liga,29,1988,34.4,51,38,35,15,1,22,48,45.8,26,31,18,13,46,97,173,2,Matches
1816,Paulo Oliveira,pt POR,DF,Eibar,es La Liga,26,1992,24.9,49,39,33,16,0,28,44,63.6,16,25,10,15,36,85,116,0,Matches
1817,Mathías Olivera,uy URU,"DF,MF",Getafe,es La Liga,20,1997,11.2,24,17,11,8,5,10,18,55.6,8,25,2,23,10,34,22,0,Matches
1818,Alexandre Olliero,fr FRA,GK,Nantes,fr Ligue 1,22,1996,1.0,0,0,0,0,0,0,0,,0,0,0,0,0,0,0,0,Matches
1819,Robin Olsen,se SWE,GK,Roma,it Serie A,28,1990,27.0,0,0,0,0,0,0,1,0.0,1,1,0,1,0,0,10,4,Matches
1820,Stephane Omeonga,be BEL,MF,Genoa,it Serie A,22,1996,0.6,1,1,1,0,0,0,1,0.0,1,1,0,1,0,1,2,0,Matches
1821,Kenneth Omeruo,ng NGA,DF,Leganés,es La Liga,24,1993,27.0,49,27,41,8,0,20,29,69.0,9,23,11,12,37,86,159,3,Matches
1822,Prince Oniangué,cg CGO,MF,Caen,fr Ligue 1,29,1988,26.0,59,33,22,34,3,24,57,42.1,33,30,10,20,29,88,42,0,Matches
1823,Karim Onisiwo,at AUT,"FW,MF",Mainz 05,de Bundesliga,26,1992,12.9,23,15,6,12,5,4,12,33.3,8,14,3,11,9,32,13,0,Matches
1824,Nicholas Opoku,gh GHA,DF,Udinese,it Serie A,20,1997,10.1,16,9,15,1,0,10,17,58.8,7,8,5,3,18,34,29,0,Matches
1825,Willi Orban,hu HUN,DF,RB Leipzig,de Bundesliga,25,1992,22.8,49,26,31,15,3,24,38,63.2,14,33,15,18,36,85,140,0,Matches
1826,Fabián Orellana,cl CHI,"MF,FW",Eibar,es La Liga,32,1986,30.4,44,21,14,16,14,9,42,21.4,33,17,0,17,19,63,4,0,Matches
1827,Divock Origi,be BEL,FW,Liverpool,eng Premier League,23,1995,4.1,6,1,2,3,1,1,4,25.0,3,2,0,2,0,6,2,0,Matches
1828,Riccardo Orsolini,it ITA,"FW,MF",Bologna,it Serie A,21,1997,21.8,40,24,16,18,6,9,39,23.1,30,23,2,21,14,54,25,1,Matches
1829,Yuya Osako,jp JPN,"FW,MF",Werder Bremen,de Bundesliga,28,1990,15.0,23,11,6,12,5,7,22,31.8,15,15,3,12,7,30,8,0,Matches
1830,David Ospina,co COL,GK,Napoli,it Serie A,29,1988,16.2,1,0,1,0,0,1,1,100.0,0,0,0,0,0,1,7,1,Matches
1831,Matthias Ostrzolek,de GER,DF,Hannover 96,de Bundesliga,28,1990,16.3,32,18,24,8,0,20,33,60.6,13,20,5,15,26,58,44,2,Matches
1832,Nicolás Otamendi,ar ARG,DF,Manchester City,eng Premier League,30,1988,13.7,24,14,17,6,1,5,9,55.6,4,6,4,2,29,53,56,1,Matches
1833,Otávio,br BRA,MF,Bordeaux,fr Ligue 1,24,1994,31.9,127,74,59,64,4,49,109,45.0,60,45,11,34,43,170,54,1,Matches
1834,David Otto,de GER,"MF,FW",Hoffenheim,de Bundesliga,19,1999,0.3,2,1,1,1,0,0,1,0.0,1,0,0,0,0,2,0,0,Matches
1835,Remi Oudin,fr FRA,"FW,MF",Reims,fr Ligue 1,21,1996,29.0,51,32,25,18,8,20,45,44.4,25,29,5,24,42,93,34,0,Matches
1836,Adam Ounas,dz ALG,"MF,FW",Napoli,it Serie A,21,1996,6.0,5,2,0,3,2,2,11,18.2,9,6,0,6,2,7,0,1,Matches
1837,Reece Oxford,eng ENG,DF,Augsburg,de Bundesliga,19,1998,5.6,12,9,9,3,0,4,6,66.7,2,10,9,1,11,23,39,0,Matches
1838,Alex Oxlade-Chamberlain,eng ENG,MF,Liverpool,eng Premier League,24,1993,0.2,1,1,0,1,0,1,1,100.0,0,0,0,0,1,2,0,0,Matches
1839,Mikel Oyarzabal,es ESP,"FW,MF",Real Sociedad,es La Liga,21,1997,35.0,36,20,15,15,6,12,49,24.5,37,54,3,51,14,50,26,0,Matches
1840,Ambroise Oyongo,cm CMR,DF,Montpellier,fr Ligue 1,27,1991,23.7,44,21,23,16,5,20,38,52.6,18,26,6,20,38,82,60,0,Matches
1841,Berkay Özcan,tr TUR,"MF,DF",Stuttgart,de Bundesliga,20,1998,0.6,0,0,0,0,0,0,0,,0,1,0,1,0,0,0,0,Matches
1842,Ramazan Özcan,at AUT,GK,Leverkusen,de Bundesliga,34,1984,2.0,0,0,0,0,0,0,0,,0,0,0,0,1,1,2,0,Matches
1843,Mesut Özil,de GER,"MF,FW",Arsenal,eng Premier League,29,1988,19.3,12,5,6,3,3,3,21,14.3,18,10,2,8,4,16,5,0,Matches
1844,Levin Öztunalı,de GER,"MF,FW",Mainz 05,de Bundesliga,22,1996,10.2,17,7,5,9,3,4,18,22.2,14,14,2,12,7,24,10,0,Matches
1845,Pablo,br BRA,DF,Bordeaux,fr Ligue 1,27,1991,21.5,26,15,22,3,1,13,23,56.5,10,28,22,6,32,58,173,2,Matches
1846,Fernando Pacheco,es ESP,GK,Alavés,es La Liga,26,1992,35.0,0,0,0,0,0,0,1,0.0,1,0,0,0,1,1,23,0,Matches
1847,Gonçalo Paciência,pt POR,FW,Eint Frankfurt,de Bundesliga,23,1994,4.3,3,2,0,2,1,1,2,50.0,1,8,1,7,0,3,1,0,Matches
1848,Simone Padoin,it ITA,"DF,MF",Cagliari,it Serie A,34,1984,21.3,34,25,12,18,4,14,33,42.4,19,18,5,13,14,48,54,0,Matches
1849,Luca Paganini,it ITA,"DF,MF",Frosinone,it Serie A,25,1993,12.5,25,13,8,13,4,8,23,34.8,15,19,4,15,19,44,17,1,Matches
1850,Marko Pajač,hr CRO,"FW,DF",Empoli,it Serie A,25,1993,8.2,7,7,2,3,2,5,11,45.5,6,3,0,3,7,14,18,0,Matches
1851,Marko Pajač,hr CRO,DF,Cagliari,it Serie A,25,1993,1.1,1,1,0,0,1,0,0,,0,1,1,0,1,2,3,0,Matches
1852,Vincent Pajot,fr FRA,MF,Angers,fr Ligue 1,27,1990,7.9,18,14,6,8,4,4,14,28.6,10,9,0,9,8,26,6,0,Matches
1853,Rodrigo Palacio,ar ARG,FW,Bologna,it Serie A,36,1982,25.9,24,13,8,12,4,4,34,11.8,30,35,0,35,5,29,13,0,Matches
1854,Federico Palacios Martínez,de GER,"MF,FW",Nürnberg,de Bundesliga,23,1995,10.5,21,10,11,8,2,10,20,50.0,10,10,0,10,9,30,4,0,Matches
1855,Sergi Palencia,es ESP,DF,Bordeaux,fr Ligue 1,22,1996,22.1,74,50,46,20,8,27,55,49.1,28,22,3,19,17,91,70,1,Matches
1856,Nicolas Pallois,fr FRA,DF,Nantes,fr Ligue 1,30,1987,24.0,77,48,60,17,0,40,69,58.0,29,30,14,16,34,111,114,0,Matches
1857,Emerson Palmieri,it ITA,DF,Chelsea,eng Premier League,23,1994,7.4,14,9,6,5,3,6,10,60.0,4,11,1,10,8,22,14,0,Matches
1858,Alberto Paloschi,it ITA,FW,SPAL,it Serie A,28,1990,9.6,13,9,3,5,5,1,2,50.0,1,2,0,2,1,14,0,0,Matches
1859,Goran Pandev,mk MKD,"FW,MF",Genoa,it Serie A,35,1983,12.5,14,10,0,10,4,2,8,25.0,6,7,0,7,1,15,3,0,Matches
1860,Mickaël Panos,fr FRA,DF,Saint-Étienne,fr Ligue 1,21,1997,0.3,1,0,0,1,0,1,2,50.0,1,2,0,2,1,2,0,0,Matches
1861,Sokratis Papastathopoulos,gr GRE,DF,Arsenal,eng Premier League,30,1988,24.4,42,25,30,11,1,15,28,53.6,13,34,17,17,26,68,112,1,Matches
1862,Elhadji Pape Diaw,sn SEN,DF,Angers,fr Ligue 1,23,1994,0.2,0,0,0,0,0,0,0,,0,0,0,0,1,1,0,0,Matches
1863,Lucas Paquetá,br BRA,MF,Milan,it Serie A,20,1997,9.4,18,9,9,8,1,7,24,29.2,17,12,0,12,4,22,11,2,Matches
1864,Gaëtan Paquiez,fr FRA,DF,Nîmes,fr Ligue 1,24,1994,14.8,43,29,30,10,3,23,48,47.9,25,24,6,18,22,65,50,0,Matches
1865,Rubén Pardo,es ESP,"MF,FW",Real Sociedad,es La Liga,25,1992,15.2,11,7,2,9,0,4,17,23.5,13,14,6,8,21,32,9,0,Matches
1866,Leandro Paredes,ar ARG,MF,Paris S-G,fr Ligue 1,24,1994,13.9,34,19,16,15,3,13,30,43.3,17,17,5,12,14,48,20,2,Matches
1867,Daniel Parejo,es ESP,MF,Valencia,es La Liga,29,1989,34.0,73,42,41,24,8,31,90,34.4,59,41,7,34,46,119,26,2,Matches
1868,Vittorio Parigini,it ITA,"MF,DF",Torino,it Serie A,22,1996,4.2,11,10,3,6,2,6,9,66.7,3,3,0,3,1,12,5,0,Matches
1869,Marco Parolo,it ITA,MF,Lazio,it Serie A,33,1985,28.5,68,45,24,37,7,18,56,32.1,38,48,11,37,28,96,56,0,Matches
1870,Thomas Partey,gh GHA,MF,Atlético Madrid,es La Liga,25,1993,23.0,66,42,32,25,9,21,49,42.9,28,26,5,21,49,115,22,2,Matches
1871,Mario Pašalić,hr CRO,MF,Atalanta,it Serie A,23,1995,18.0,32,19,9,13,10,7,29,24.1,22,19,4,15,12,44,14,1,Matches
1872,Manuel Pasqual,it ITA,DF,Empoli,it Serie A,36,1982,14.9,26,19,12,11,3,17,45,37.8,28,7,0,7,11,37,31,0,Matches
1873,Javier Pastore,ar ARG,"MF,FW",Roma,it Serie A,29,1989,6.6,10,4,4,3,3,4,16,25.0,12,7,0,7,3,13,5,0,Matches
1874,Callum Paterson,sct SCO,"FW,MF",Cardiff City,eng Premier League,23,1994,22.2,21,14,7,7,7,5,26,19.2,21,23,2,21,8,29,29,0,Matches
1875,Patric,es ESP,DF,Lazio,it Serie A,25,1993,12.1,19,11,8,8,3,8,15,53.3,7,14,7,7,12,31,29,1,Matches
1876,Rui Patrício,pt POR,GK,Wolves,eng Premier League,30,1988,37.0,2,0,2,0,0,2,3,66.7,1,0,0,0,1,3,7,4,Matches
1877,Paulinho,br BRA,"FW,MF",Leverkusen,de Bundesliga,18,2000,2.0,4,4,2,2,0,1,2,50.0,1,3,0,3,2,6,0,1,Matches
1878,Gabriel Paulista,br BRA,DF,Valencia,es La Liga,27,1990,29.1,29,16,20,6,3,14,28,50.0,14,37,21,16,70,99,162,1,Matches
1879,Benjamin Pavard,fr FRA,DF,Stuttgart,de Bundesliga,22,1996,29.0,28,20,21,6,1,12,19,63.2,7,27,19,8,48,76,189,2,Matches
1880,Jiří Pavlenka,cz CZE,GK,Werder Bremen,de Bundesliga,26,1992,33.1,3,0,3,0,0,3,6,50.0,3,1,0,1,3,6,14,1,Matches
1881,Mateo Pavlović,ba BIH,DF,Angers,fr Ligue 1,28,1990,27.7,26,18,24,2,0,12,24,50.0,12,37,29,8,20,46,164,2,Matches
1882,Leonardo Pavoletti,it ITA,FW,Cagliari,it Serie A,29,1988,30.4,32,21,6,17,9,6,16,37.5,10,12,3,9,7,39,26,0,Matches
1883,Dimitri Payet,fr FRA,"MF,FW",Marseille,fr Ligue 1,31,1987,21.2,11,9,2,8,1,5,22,22.7,17,14,0,14,8,19,8,0,Matches
1884,Nehuén Paz,ar ARG,DF,Bologna,it Serie A,25,1993,1.3,2,1,2,0,0,1,2,50.0,1,3,1,2,0,2,2,0,Matches
1885,Alfonso Pedraza,es ESP,"DF,FW",Villarreal,es La Liga,22,1996,23.3,59,44,34,19,6,22,62,35.5,40,33,7,26,29,88,55,0,Matches
1886,Pedro,es ESP,FW,Chelsea,eng Premier League,31,1987,19.8,27,14,11,10,6,9,35,25.7,26,13,2,11,18,45,8,1,Matches
1887,João Pedro,it ITA,"FW,MF",Cagliari,it Serie A,26,1992,28.4,17,12,4,8,5,4,11,36.4,7,14,5,9,6,23,14,0,Matches
1888,Adrià Pedrosa,es ESP,DF,Espanyol,es La Liga,20,1998,8.5,14,9,11,2,1,7,14,50.0,7,10,4,6,8,22,27,0,Matches
1889,Stef Peeters,be BEL,MF,Caen,fr Ligue 1,26,1992,4.5,15,8,8,4,3,4,11,36.4,7,1,0,1,6,21,1,0,Matches
1890,Jordan Pefok,us USA,FW,Rennes,fr Ligue 1,22,1996,6.8,6,2,0,3,3,2,4,50.0,2,7,2,5,4,10,5,0,Matches
1891,Gianluca Pegolo,it ITA,GK,Sassuolo,it Serie A,37,1981,2.3,0,0,0,0,0,0,0,,0,0,0,0,0,0,0,0,Matches
1892,Peter Pekarík,sk SVK,DF,Hertha BSC,de Bundesliga,31,1986,2.4,2,1,1,1,0,1,3,33.3,2,2,1,1,1,3,5,0,Matches
1893,Pelé,gw GNB,MF,Monaco,fr Ligue 1,26,1991,5.2,8,7,3,5,0,2,6,33.3,4,2,1,1,3,11,10,0,Matches
1894,Yohann Pelé,fr FRA,GK,Marseille,fr Ligue 1,35,1982,7.6,0,0,0,0,0,0,2,0.0,2,0,0,0,0,0,1,1,Matches
1895,Maxime Pélican,fr FRA,"FW,MF",Nice,fr Ligue 1,20,1998,1.0,1,1,0,1,0,0,0,,0,1,0,1,0,1,0,0,Matches
1896,Pietro Pellegri,it ITA,"FW,MF",Monaco,fr Ligue 1,17,2001,0.9,1,1,0,0,1,0,0,,0,0,0,0,0,1,0,0,Matches
1897,Lorenzo Pellegrini,it ITA,MF,Roma,it Serie A,22,1996,20.2,39,23,16,18,5,10,30,33.3,20,20,2,18,12,51,21,0,Matches
1898,Luca Pellegrini,it ITA,DF,Cagliari,it Serie A,19,1999,10.4,28,19,16,11,1,14,25,56.0,11,13,3,10,18,46,22,0,Matches
1899,Luca Pellegrini,it ITA,DF,Roma,it Serie A,19,1999,1.8,1,1,1,0,0,1,2,50.0,1,2,1,1,3,4,2,0,Matches
1900,Théo Pellenard,fr FRA,DF,Angers,fr Ligue 1,24,1994,5.5,11,6,7,2,2,5,8,62.5,3,6,2,4,5,16,16,0,Matches
1901,Sergio Pellissier,it ITA,FW,Chievo,it Serie A,39,1979,10.6,4,3,1,1,2,3,4,75.0,1,8,1,7,2,6,8,0,Matches
1902,Andy Pelmard,fr FRA,DF,Nice,fr Ligue 1,18,2000,3.1,5,5,3,2,0,1,4,25.0,3,0,0,0,3,8,3,0,Matches
1903,Lee Peltier,eng ENG,DF,Cardiff City,eng Premier League,31,1986,17.2,39,25,27,11,1,15,27,55.6,12,18,12,6,18,57,60,0,Matches
1904,Federico Peluso,it ITA,DF,Sassuolo,it Serie A,34,1984,15.1,23,14,15,5,3,13,16,81.3,3,8,3,5,23,46,70,0,Matches
1905,Rubén Peña,es ESP,DF,Eibar,es La Liga,27,1991,29.7,63,46,24,27,12,24,53,45.3,29,37,9,28,35,98,57,0,Matches
1906,Nicolas Pépé,ci CIV,"FW,MF",Lille,fr Ligue 1,23,1995,36.9,27,10,6,15,6,8,35,22.9,27,33,0,33,13,40,11,1,Matches
1907,Pepín,gq EQG,MF,Parma,it Serie A,21,1996,0.9,4,2,3,1,0,1,4,25.0,3,0,0,0,3,7,0,0,Matches
1908,Andreas Pereira,br BRA,MF,Manchester Utd,eng Premier League,22,1996,6.7,8,6,5,2,1,4,15,26.7,11,9,2,7,11,19,8,1,Matches
1909,Matheus Pereira,pt POR,"MF,FW",Nürnberg,de Bundesliga,22,1996,13.7,16,11,4,8,4,2,13,15.4,11,15,2,13,14,30,7,0,Matches
1910,Pedro Pereira,pt POR,"DF,FW",Genoa,it Serie A,20,1998,15.4,20,14,15,2,3,11,19,57.9,8,10,5,5,14,34,55,1,Matches
1911,Ricardo Pereira,pt POR,"DF,FW",Leicester City,eng Premier League,24,1993,34.7,118,66,66,40,12,54,112,48.2,58,60,6,54,60,178,130,1,Matches
1912,Roberto Pereyra,ar ARG,MF,Watford,eng Premier League,27,1991,31.3,21,12,10,10,1,7,24,29.2,17,26,0,26,24,45,27,2,Matches
1913,Ayoze Pérez,es ESP,"MF,FW",Newcastle Utd,eng Premier League,25,1993,32.4,59,22,24,28,7,17,63,27.0,46,55,4,51,42,101,33,1,Matches
1914,Carles Pérez,es ESP,FW,Barcelona,es La Liga,20,1998,0.2,0,0,0,0,0,0,0,,0,1,0,1,0,0,0,0,Matches
1915,Hernán Pérez,py PAR,"FW,MF",Espanyol,es La Liga,29,1989,8.8,13,10,8,3,2,6,27,22.2,21,14,3,11,5,18,13,0,Matches
1916,Lucas Pérez,es ESP,"FW,MF",West Ham,eng Premier League,29,1988,5.3,6,4,3,2,1,1,3,33.3,2,2,1,1,2,8,2,0,Matches
1917,Rubén Pérez,es ESP,MF,Leganés,es La Liga,29,1989,27.5,71,42,27,40,4,32,80,40.0,48,35,8,27,40,111,34,1,Matches
1918,Stipe Perica,hr CRO,FW,Frosinone,it Serie A,23,1995,5.3,5,3,2,2,1,1,3,33.3,2,3,1,2,0,5,4,0,Matches
1919,Mattia Perin,it ITA,GK,Juventus,it Serie A,25,1992,9.0,0,0,0,0,0,0,0,,0,0,0,0,0,0,3,2,Matches
1920,Ivan Perišić,hr CRO,FW,Inter,it Serie A,29,1989,30.0,34,26,7,20,7,16,51,31.4,35,40,4,36,23,57,55,0,Matches
1921,Diego Perotti,ar ARG,"FW,MF",Roma,it Serie A,30,1988,7.4,14,12,5,5,4,6,19,31.6,13,4,0,4,4,18,2,0,Matches
1922,Loïc Perrin,fr FRA,DF,Saint-Étienne,fr Ligue 1,32,1985,30.0,53,36,34,17,2,20,33,60.6,13,37,24,13,44,97,118,2,Matches
1923,Pavao Pervan,at AUT,GK,Wolfsburg,de Bundesliga,30,1987,8.5,0,0,0,0,0,0,0,,0,0,0,0,0,0,3,1,Matches
1924,Matteo Pessina,it ITA,"MF,FW",Atalanta,it Serie A,21,1997,2.6,4,2,0,4,0,2,3,66.7,1,2,1,1,0,4,4,0,Matches
1925,Andrea Petagna,it ITA,FW,SPAL,it Serie A,23,1995,33.7,15,6,5,5,5,2,9,22.2,7,23,8,15,4,19,15,0,Matches
1926,Nils Petersen,de GER,FW,Freiburg,de Bundesliga,29,1988,21.4,29,21,10,16,3,4,24,16.7,20,28,2,26,13,42,34,0,Matches
1927,Ondřej Petrák,cz CZE,MF,Nürnberg,de Bundesliga,26,1992,18.0,36,24,17,18,1,14,25,56.0,11,18,4,14,40,76,22,0,Matches
1928,Germán Pezzella,ar ARG,DF,Fiorentina,it Serie A,27,1991,31.7,56,36,42,13,1,31,51,60.8,20,42,30,12,60,116,159,1,Matches
1929,Giuseppe Pezzella,it ITA,DF,Udinese,it Serie A,20,1997,2.0,5,4,4,1,0,2,8,25.0,6,2,1,1,1,6,9,0,Matches
1930,Giuseppe Pezzella,it ITA,"DF,MF",Genoa,it Serie A,20,1997,1.2,2,1,1,1,0,0,0,,0,1,0,1,1,3,4,0,Matches
1931,Matthias Phaeton,gp GLP,"FW,MF",Guingamp,fr Ligue 1,18,2000,0.6,1,1,0,1,0,0,0,,0,0,0,0,0,1,0,0,Matches
1932,Maximilian Philipp,de GER,"FW,MF",Dortmund,de Bundesliga,24,1994,8.4,7,5,3,4,0,2,9,22.2,7,10,0,10,3,10,6,0,Matches
1933,Lebogang Phiri,za RSA,MF,Guingamp,fr Ligue 1,23,1994,21.4,60,38,16,41,3,24,43,55.8,19,26,3,23,29,89,19,0,Matches
1934,Krzysztof Piątek,pl POL,FW,Genoa,it Serie A,23,1995,17.7,9,4,2,5,2,1,15,6.7,14,18,3,15,3,12,19,0,Matches
1935,Krzysztof Piątek,pl POL,FW,Milan,it Serie A,23,1995,15.3,8,6,2,1,5,3,10,30.0,7,7,2,5,1,9,15,0,Matches
1936,Pablo Piatti,ar ARG,"FW,MF",Espanyol,es La Liga,29,1989,8.3,21,15,8,10,3,8,16,50.0,8,15,0,15,2,23,8,0,Matches
1937,Lucas Piazon,br BRA,"MF,FW",Chievo,it Serie A,24,1994,0.9,2,0,1,1,0,0,2,0.0,2,1,0,1,1,3,0,0,Matches
1938,Cristiano Piccini,it ITA,DF,Valencia,es La Liga,25,1992,20.8,32,23,25,7,0,13,26,50.0,13,27,7,20,27,59,64,1,Matches
1939,Roberto Piccoli,it ITA,"FW,MF",Atalanta,it Serie A,17,2001,0.5,2,2,0,1,1,1,1,100.0,0,1,0,1,0,2,0,0,Matches
1940,Jordan Pickford,eng ENG,GK,Everton,eng Premier League,24,1994,38.0,0,0,0,0,0,0,0,,0,0,0,0,0,0,20,8,Matches
1941,Jérémy Pied,fr FRA,DF,Lille,fr Ligue 1,29,1989,5.2,12,8,5,6,1,3,9,33.3,6,8,1,7,5,17,13,0,Matches
1942,Ronaël Pierre-Gabriel,fr FRA,DF,Monaco,fr Ligue 1,20,1998,3.9,13,8,10,2,1,9,10,90.0,1,3,1,2,3,16,18,0,Matches
1943,Erik Pieters,nl NED,DF,Amiens,fr Ligue 1,29,1988,14.0,49,28,28,18,3,25,33,75.8,8,21,13,8,17,66,56,0,Matches
1944,Tomás Pina Isla,es ESP,MF,Alavés,es La Liga,30,1987,26.0,64,41,23,36,5,18,46,39.1,28,15,4,11,41,105,43,1,Matches
1945,Andrea Pinamonti,it ITA,FW,Frosinone,it Serie A,19,1999,18.1,14,6,6,5,3,4,20,20.0,16,16,3,13,5,19,17,0,Matches
1946,Carlo Pinsoglio,it ITA,GK,Juventus,it Serie A,28,1990,1.0,0,0,0,0,0,0,0,,0,0,0,0,0,0,0,0,Matches
1947,Virgile Pinson,fr FRA,MF,Reims,fr Ligue 1,22,1996,0.1,0,0,0,0,0,0,0,,0,0,0,0,0,0,0,0,Matches
1948,Lenny Pintor,fr FRA,FW,Lyon,fr Ligue 1,17,2000,0.0,0,0,0,0,0,0,0,,0,0,0,0,0,0,0,0,Matches
1949,Gerard Piqué,es ESP,DF,Barcelona,es La Liga,31,1987,35.0,42,27,25,17,0,24,37,64.9,13,41,27,14,36,78,154,5,Matches
1950,Facundo Píriz,uy URU,"MF,FW",Montpellier,fr Ligue 1,28,1990,1.3,9,6,3,4,2,4,9,44.4,5,2,1,1,0,9,2,0,Matches
1951,Fabio Pisacane,it ITA,DF,Cagliari,it Serie A,32,1986,25.2,33,17,22,8,3,18,31,58.1,13,36,23,13,23,56,108,0,Matches
1952,Łukasz Piszczek,pl POL,DF,Dortmund,de Bundesliga,33,1985,19.5,57,36,34,15,8,18,33,54.5,15,26,3,23,39,96,69,0,Matches
1953,Claudio Pizarro,pe PER,FW,Werder Bremen,de Bundesliga,39,1978,7.7,10,6,4,2,4,4,7,57.1,3,14,1,13,1,11,7,0,Matches
1954,Marko Pjaca,hr CRO,"FW,MF",Fiorentina,it Serie A,23,1995,8.3,9,4,3,4,2,2,6,33.3,4,2,0,2,7,16,6,0,Matches
1955,Miralem Pjanić,ba BIH,MF,Juventus,it Serie A,28,1990,25.3,41,20,15,18,8,16,59,27.1,43,34,6,28,36,77,19,2,Matches
1956,Carles Planas,es ESP,DF,Girona,es La Liga,27,1991,4.7,12,6,7,5,0,4,11,36.4,7,2,0,2,4,16,15,0,Matches
1957,Óscar Plano,es ESP,"MF,FW",Valladolid,es La Liga,27,1991,29.9,63,45,23,28,12,14,48,29.2,34,19,3,16,22,85,28,1,Matches
1958,Jaroslav Plašil,cz CZE,MF,Bordeaux,fr Ligue 1,36,1982,16.0,34,26,11,20,3,18,44,40.9,26,21,5,16,19,53,28,1,Matches
1959,Marvin Plattenhardt,de GER,DF,Hertha BSC,de Bundesliga,26,1992,21.4,27,21,12,10,5,14,21,66.7,7,18,3,15,7,34,56,0,Matches
1960,Stiven Plaza,ec ECU,"FW,MF",Valladolid,es La Liga,19,1999,0.4,0,0,0,0,0,0,0,,0,0,0,0,0,0,0,0,Matches
1961,Alassane Pléa,fr FRA,FW,M'Gladbach,de Bundesliga,25,1993,27.8,14,10,7,4,3,5,22,22.7,17,17,2,15,3,17,15,2,Matches
1962,Luca Plogmann,de GER,GK,Werder Bremen,de Bundesliga,18,2000,0.4,0,0,0,0,0,0,0,,0,0,0,0,0,0,0,0,Matches
1963,Morgan Poaty,cg CGO,MF,Montpellier,fr Ligue 1,21,1997,1.0,1,1,1,0,0,0,0,,0,1,0,1,0,1,2,0,Matches
1964,Paul Pogba,fr FRA,MF,Manchester Utd,eng Premier League,25,1993,33.4,47,30,21,21,5,17,43,39.5,26,30,9,21,18,65,39,0,Matches
1965,Denis-Will Poha,fr FRA,MF,Rennes,fr Ligue 1,21,1997,0.3,0,0,0,0,0,0,1,0.0,1,0,0,0,1,1,1,0,Matches
1966,Andrea Poli,it ITA,MF,Bologna,it Serie A,28,1989,21.5,65,47,30,28,7,24,67,35.8,43,36,5,31,35,100,13,2,Matches
1967,Matteo Politano,it ITA,FW,Inter,it Serie A,24,1993,28.3,18,7,9,4,5,8,30,26.7,22,18,0,18,14,32,10,1,Matches
1968,Pierre-Yves Polomat,fr FRA,DF,Saint-Étienne,fr Ligue 1,24,1993,10.6,18,13,11,6,1,10,18,55.6,8,4,2,2,21,39,27,0,Matches
1969,Giacomo Poluzzi,it ITA,GK,SPAL,it Serie A,30,1988,0.1,0,0,0,0,0,0,0,,0,0,0,0,0,0,0,0,Matches
1970,Pere Pons,es ESP,MF,Girona,es La Liga,25,1993,31.0,83,46,34,38,11,30,82,36.6,52,48,12,36,35,118,39,0,Matches
1971,Pedro Porro,es ESP,DF,Girona,es La Liga,18,1999,24.6,51,31,28,16,7,32,80,40.0,48,36,2,34,39,90,60,1,Matches
1972,Manolo Portanova,it ITA,MF,Juventus,it Serie A,18,2000,0.4,1,1,0,1,0,0,1,0.0,1,2,0,2,1,2,2,0,Matches
1973,Francisco Portillo,es ESP,MF,Getafe,es La Liga,28,1990,22.2,26,16,6,15,5,9,29,31.0,20,14,0,14,17,43,9,0,Matches
1974,Portu,es ESP,"FW,MF",Girona,es La Liga,26,1992,31.3,33,24,8,15,10,12,43,27.9,31,16,1,15,8,41,5,0,Matches
1975,Stefan Posch,at AUT,DF,Hoffenheim,de Bundesliga,21,1997,15.6,45,32,28,15,2,17,28,60.7,11,26,11,15,21,66,58,0,Matches
1976,Sergio Postigo,es ESP,DF,Levante,es La Liga,29,1988,16.1,25,15,22,3,0,15,19,78.9,4,21,12,9,20,45,77,0,Matches
1977,Yussuf Poulsen,dk DEN,FW,RB Leipzig,de Bundesliga,24,1994,27.2,20,10,5,10,5,3,25,12.0,22,33,2,31,7,27,28,0,Matches
1978,Maxime Poundjé,fr FRA,DF,Bordeaux,fr Ligue 1,25,1992,28.2,48,35,34,12,2,31,62,50.0,31,24,5,19,29,77,79,0,Matches
1979,Gaëtan Poussin,fr FRA,GK,Bordeaux,fr Ligue 1,19,1999,1.0,0,0,0,0,0,0,0,,0,0,0,0,0,0,0,0,Matches
1980,José Pozo,es ESP,MF,Rayo Vallecano,es La Liga,22,1996,18.0,13,10,4,5,4,4,25,16.0,21,7,1,6,4,17,6,0,Matches
1981,Dennis Praet,be BEL,MF,Sampdoria,it Serie A,24,1994,32.1,62,44,30,25,7,27,51,52.9,24,33,4,29,36,98,31,0,Matches
1982,Sanjin Prcić,ba BIH,MF,Levante,es La Liga,24,1993,5.9,18,13,7,9,2,5,11,45.5,6,11,7,4,11,29,11,1,Matches
1983,Sanjin Prcić,ba BIH,MF,Strasbourg,fr Ligue 1,24,1993,11.7,19,14,11,7,1,8,18,44.4,10,22,8,14,18,37,7,1,Matches
1984,Nicolas de Préville,fr FRA,"FW,MF",Bordeaux,fr Ligue 1,27,1991,14.1,28,19,10,15,3,8,29,27.6,21,23,1,22,10,38,21,1,Matches
1985,Edgar Prib,de GER,MF,Hannover 96,de Bundesliga,28,1989,2.2,10,9,3,5,2,2,4,50.0,2,4,0,4,2,12,1,0,Matches
1986,Alex Pritchard,eng ENG,"MF,FW",Huddersfield,eng Premier League,25,1993,23.1,36,24,10,18,8,10,35,28.6,25,26,2,24,17,53,9,0,Matches
1987,Sebastian Prödl,at AUT,DF,Watford,eng Premier League,31,1987,0.1,0,0,0,0,0,0,0,,0,0,0,0,0,0,0,0,Matches
1988,Quincy Promes,nl NED,"FW,DF",Sevilla,es La Liga,26,1992,17.6,35,25,23,9,3,15,22,68.2,7,19,3,16,25,60,22,1,Matches
1989,Davy Pröpper,nl NED,MF,Brighton,eng Premier League,26,1991,28.3,50,28,23,21,6,16,52,30.8,36,21,6,15,53,103,37,0,Matches
1990,Silvio Proto,be BEL,GK,Lazio,it Serie A,35,1983,2.0,0,0,0,0,0,0,1,0.0,1,0,0,0,0,0,1,0,Matches
1991,Ivan Provedel,it ITA,GK,Empoli,it Serie A,24,1994,16.0,0,0,0,0,0,0,1,0.0,1,0,0,0,0,0,4,0,Matches
1992,Javi Puado,es ESP,"FW,MF",Espanyol,es La Liga,20,1998,4.0,2,1,0,2,0,0,7,0.0,7,5,1,4,6,8,4,0,Matches
1993,Manuel Pucciarelli,it ITA,FW,Chievo,it Serie A,27,1991,3.4,4,2,2,1,1,2,5,40.0,3,5,0,5,3,7,4,0,Matches
1994,Riqui Puig,es ESP,MF,Barcelona,es La Liga,18,1999,1.7,3,3,0,2,1,2,3,66.7,1,0,0,0,0,3,1,0,Matches
1995,Erick Pulgar,cl CHI,MF,Bologna,it Serie A,24,1994,26.2,65,36,35,23,7,22,73,30.1,51,35,5,30,50,115,54,1,Matches
1996,Jorge Pulido,es ESP,DF,Huesca,es La Liga,27,1991,30.9,63,42,40,19,4,32,51,62.7,19,39,18,21,50,113,158,0,Matches
1997,Christian Pulisic,us USA,FW,Dortmund,de Bundesliga,19,1998,10.4,10,6,2,6,2,2,6,33.3,4,12,2,10,6,16,10,0,Matches
1998,Jason Puncheon,eng ENG,MF,Crystal Palace,eng Premier League,32,1986,0.1,1,1,1,0,0,0,0,,0,0,0,0,0,1,0,0,Matches
1999,Jason Puncheon,eng ENG,MF,Huddersfield,eng Premier League,32,1986,4.2,7,4,1,5,1,1,7,14.3,6,3,1,2,3,10,8,0,Matches
2000,Ignacio Pussetto,ar ARG,"FW,MF",Udinese,it Serie A,22,1995,24.2,65,40,25,30,10,15,43,34.9,28,28,3,25,29,94,34,0,Matches
2001,Fabio Quagliarella,it ITA,FW,Sampdoria,it Serie A,35,1983,35.5,14,8,6,4,4,2,15,13.3,13,32,1,31,8,22,17,0,Matches
2002,Robin Quaison,se SWE,"FW,MF",Mainz 05,de Bundesliga,24,1993,24.4,19,12,3,10,6,5,12,41.7,7,9,1,8,7,26,4,0,Matches
2003,Collin Quaner,de GER,FW,Huddersfield,eng Premier League,27,1991,0.4,0,0,0,0,0,0,1,0.0,1,0,0,0,0,0,0,0,Matches
2004,Domingos Quina,pt POR,MF,Watford,eng Premier League,18,1999,3.8,9,7,3,5,1,3,11,27.3,8,6,0,6,3,12,1,0,Matches
2005,Xavi Quintillà,es ESP,DF,Villarreal,es La Liga,21,1996,7.0,10,4,5,4,1,6,12,50.0,6,5,2,3,8,18,17,0,Matches
2006,Dani Raba,es ESP,"MF,FW",Villarreal,es La Liga,22,1995,2.1,6,5,1,2,3,1,5,20.0,4,1,0,1,1,7,0,0,Matches
2007,Adrien Rabiot,fr FRA,MF,Paris S-G,fr Ligue 1,23,1995,11.8,35,20,13,17,5,9,12,75.0,3,9,2,7,10,45,20,0,Matches
2008,Nemanja Radonjić,rs SRB,"FW,MF",Marseille,fr Ligue 1,22,1996,7.6,8,5,1,5,2,5,16,31.3,11,3,0,3,5,13,4,0,Matches
2009,Ivan Radovanović,rs SRB,MF,Genoa,it Serie A,29,1988,14.2,20,12,11,8,1,8,17,47.1,9,12,4,8,13,33,20,1,Matches
2010,Ivan Radovanović,rs SRB,MF,Chievo,it Serie A,29,1988,19.0,27,22,20,7,0,11,31,35.5,20,19,7,12,26,53,36,0,Matches
2011,Ionuț Radu,ro ROU,GK,Genoa,it Serie A,21,1997,33.0,0,0,0,0,0,0,1,0.0,1,0,0,0,1,1,11,4,Matches
2012,Ștefan Radu,ro ROU,DF,Lazio,it Serie A,31,1986,24.9,43,27,24,15,4,25,38,65.8,13,20,14,6,42,85,85,1,Matches
2013,Rafael,br BRA,DF,Lyon,fr Ligue 1,28,1990,11.4,31,19,14,12,5,17,24,70.8,7,19,2,17,15,46,30,2,Matches
2014,Raffael,br BRA,FW,M'Gladbach,de Bundesliga,33,1985,6.0,8,4,2,4,2,2,7,28.6,5,5,0,5,1,9,0,0,Matches
2015,Rafinha,br BRA,"FW,MF",Barcelona,es La Liga,25,1993,2.5,8,6,2,3,3,2,2,100.0,0,5,1,4,1,9,2,0,Matches
2016,Rafinha,br BRA,DF,Bayern Munich,de Bundesliga,32,1985,10.0,15,7,6,6,3,6,14,42.9,8,8,3,5,19,34,11,0,Matches
2017,Andrea Raggi,it ITA,DF,Monaco,fr Ligue 1,34,1984,5.5,7,5,7,0,0,6,6,100.0,0,1,0,1,7,14,21,0,Matches
2018,Baba Rahman,gh GHA,DF,Reims,fr Ligue 1,24,1994,10.7,26,20,17,8,1,18,21,85.7,3,21,3,18,16,42,37,2,Matches
2019,Baba Rahman,gh GHA,DF,Schalke 04,de Bundesliga,24,1994,1.8,3,1,1,1,1,1,1,100.0,0,3,0,3,2,5,2,0,Matches
2020,Ivan Rakitić,hr CRO,MF,Barcelona,es La Liga,30,1988,29.4,30,24,10,14,6,12,37,32.4,25,32,8,24,51,81,33,0,Matches
2021,Joe Ralls,eng ENG,MF,Cardiff City,eng Premier League,24,1993,21.8,45,23,21,21,3,10,33,30.3,23,21,6,15,29,74,30,0,Matches
2022,Jonás Ramalho,es ESP,DF,Girona,es La Liga,25,1993,18.0,13,6,12,1,0,8,14,57.1,6,24,11,13,16,29,80,1,Matches
2023,Benito Raman,be BEL,"MF,FW",Düsseldorf,de Bundesliga,23,1994,18.7,35,20,14,16,5,11,53,20.8,42,30,2,28,15,50,8,0,Matches
2024,Adil Rami,fr FRA,DF,Marseille,fr Ligue 1,32,1985,15.7,14,9,12,2,0,8,12,66.7,4,14,14,0,18,32,52,3,Matches
2025,Gastón Ramírez,uy URU,MF,Sampdoria,it Serie A,27,1990,17.5,38,22,12,18,8,11,31,35.5,20,28,4,24,8,46,27,0,Matches
2026,Sandro Ramírez,es ESP,"FW,MF",Real Sociedad,es La Liga,23,1995,11.7,19,10,7,10,2,4,11,36.4,7,12,1,11,9,28,3,0,Matches
2027,Iván Ramis,es ESP,DF,Eibar,es La Liga,33,1984,18.6,23,13,10,11,2,17,23,73.9,6,10,5,5,18,41,65,2,Matches
2028,Chris Ramos,es ESP,FW,Valladolid,es La Liga,21,1997,0.7,1,1,0,0,1,1,1,100.0,0,0,0,0,0,1,1,0,Matches
2029,Sergio Ramos,es ESP,DF,Real Madrid,es La Liga,32,1986,27.5,41,32,25,12,4,22,39,56.4,17,29,15,14,37,78,90,2,Matches
2030,Aaron Ramsey,wls WAL,MF,Arsenal,eng Premier League,27,1990,14.8,34,18,11,15,8,7,25,28.0,18,7,1,6,9,43,3,0,Matches
2031,Kayne Ramsey,eng ENG,DF,Southampton,eng Premier League,17,2000,1.0,0,0,0,0,0,0,0,,0,0,0,0,0,0,7,0,Matches
2032,Andrea Ranocchia,it ITA,"DF,FW",Inter,it Serie A,30,1988,0.7,2,2,1,1,0,0,1,0.0,1,1,0,1,0,2,3,0,Matches
2033,Marcus Rashford,eng ENG,FW,Manchester Utd,eng Premier League,20,1997,25.9,24,12,4,12,8,7,29,24.1,22,27,0,27,3,27,24,0,Matches
2034,Milot Rashica,xk KVX,"FW,MF",Werder Bremen,de Bundesliga,22,1996,17.2,24,16,8,11,5,9,24,37.5,15,16,2,14,6,30,6,1,Matches
2035,Jacob Rasmussen,dk DEN,"DF,MF",Empoli,it Serie A,21,1997,11.3,18,12,10,6,2,5,14,35.7,9,18,13,5,12,30,55,1,Matches
2036,Giacomo Raspadori,it ITA,DF,Sassuolo,it Serie A,18,2000,0.0,0,0,0,0,0,0,0,,0,0,0,0,0,0,0,0,Matches
2037,Yoric Ravet,fr FRA,"FW,MF",Freiburg,de Bundesliga,28,1989,0.8,2,1,1,0,1,1,2,50.0,1,2,1,1,0,2,1,0,Matches
2038,Tim Ream,us USA,DF,Fulham,eng Premier League,30,1987,22.7,23,14,16,7,0,14,28,50.0,14,19,10,9,25,48,80,2,Matches
2039,Ante Rebić,hr CRO,"FW,MF",Eint Frankfurt,de Bundesliga,24,1993,22.0,22,9,5,12,5,5,12,41.7,7,18,1,17,8,30,3,0,Matches
2040,Pedro Rebocho,pt POR,DF,Guingamp,fr Ligue 1,23,1995,36.0,61,35,31,22,8,29,54,53.7,25,48,13,35,40,101,92,1,Matches
2041,Arkadiusz Reca,pl POL,DF,Atalanta,it Serie A,23,1995,0.5,2,0,1,0,1,0,1,0.0,1,0,0,0,3,5,0,0,Matches
2042,Recio,es ESP,MF,Leganés,es La Liga,27,1991,14.3,30,21,14,13,3,6,24,25.0,18,14,2,12,14,44,14,0,Matches
2043,Nathan Redmond,eng ENG,"MF,FW",Southampton,eng Premier League,24,1994,36.3,45,22,14,19,12,14,41,34.1,27,54,2,52,20,65,23,1,Matches
2044,Vasco Regini,it ITA,"DF,FW",SPAL,it Serie A,27,1990,0.9,1,0,0,1,0,1,3,33.3,2,2,1,1,0,1,4,0,Matches
2045,Sergio Reguilón,es ESP,DF,Real Madrid,es La Liga,21,1996,12.4,25,14,15,9,1,10,21,47.6,11,13,3,10,20,45,41,1,Matches
2046,Bobby Reid,jm JAM,"FW,MF",Cardiff City,eng Premier League,25,1993,15.8,16,9,6,7,3,3,8,37.5,5,13,0,13,3,19,12,0,Matches
2047,Pepe Reina,es ESP,GK,Milan,it Serie A,35,1982,3.7,0,0,0,0,0,0,0,,0,0,0,0,0,0,1,0,Matches
2048,Jeff Reine-Adélaïde,fr FRA,"FW,MF",Angers,fr Ligue 1,20,1998,28.4,40,22,18,19,3,17,40,42.5,23,20,0,20,19,59,10,0,Matches
2049,Karim Rekik,nl NED,DF,Hertha BSC,de Bundesliga,23,1994,23.0,36,22,23,12,1,12,18,66.7,6,24,16,8,34,70,88,0,Matches
2050,Loïc Rémy,fr FRA,FW,Lille,fr Ligue 1,31,1987,13.4,2,1,0,2,0,0,3,0.0,3,3,1,2,2,4,17,1,Matches
2051,Michael Rensing,de GER,GK,Düsseldorf,de Bundesliga,34,1984,32.0,2,1,2,0,0,1,5,20.0,4,1,0,1,2,4,13,2,Matches
2052,Marco Reus,de GER,"MF,FW",Dortmund,de Bundesliga,29,1989,25.7,33,22,11,16,6,6,31,19.4,25,28,1,27,8,41,32,0,Matches
2053,Elvis Rexhbeçaj,de GER,MF,Wolfsburg,de Bundesliga,20,1997,12.7,28,18,11,12,5,12,24,50.0,12,18,2,16,14,42,21,0,Matches
2054,Diego Reyes,mx MEX,DF,Leganés,es La Liga,25,1992,3.6,7,4,4,3,0,3,4,75.0,1,4,4,0,7,14,17,1,Matches
2055,Baptiste Reynet,fr FRA,GK,Toulouse,fr Ligue 1,27,1990,30.0,0,0,0,0,0,0,3,0.0,3,0,0,0,1,1,14,2,Matches
2056,Simon Rhein,de GER,MF,Nürnberg,de Bundesliga,20,1998,5.5,7,4,7,0,0,2,7,28.6,5,6,1,5,7,14,6,0,Matches
2057,Franck Ribéry,fr FRA,"MF,FW",Bayern Munich,de Bundesliga,35,1983,13.0,15,7,7,6,2,4,10,40.0,6,9,0,9,7,22,1,0,Matches
2058,Declan Rice,eng ENG,MF,West Ham,eng Premier League,19,1999,33.4,98,60,35,58,5,38,88,43.2,50,51,12,39,52,150,56,0,Matches
2059,Jazz Richards,wls WAL,"DF,MF",Cardiff City,eng Premier League,27,1991,1.5,0,0,0,0,0,0,1,0.0,1,2,1,1,2,2,5,0,Matches
2060,Richarlison,br BRA,"FW,MF",Everton,eng Premier League,21,1997,29.6,49,34,19,20,10,8,24,33.3,16,30,2,28,16,65,39,0,Matches
2061,Marco Richter,de GER,"MF,FW",Augsburg,de Bundesliga,20,1997,15.8,13,8,4,5,4,7,20,35.0,13,16,1,15,13,26,9,1,Matches
2062,Diego Rico,es ESP,"DF,MF",Bournemouth,eng Premier League,25,1993,6.8,14,9,8,2,4,4,12,33.3,8,13,2,11,14,28,20,0,Matches
2063,Mikel Rico,es ESP,MF,Athletic Club,es La Liga,33,1984,2.7,5,2,1,4,0,2,7,28.6,5,3,2,1,2,7,3,0,Matches
2064,Sergio Rico,es ESP,GK,Fulham,eng Premier League,24,1993,29.0,1,1,1,0,0,1,1,100.0,0,0,0,0,1,2,13,5,Matches
2065,Asier Riesgo,es ESP,GK,Eibar,es La Liga,34,1983,14.0,1,1,1,0,0,1,3,33.3,2,0,0,0,0,1,8,1,Matches
2066,Sascha Riether,de GER,FW,Schalke 04,de Bundesliga,35,1983,0.0,0,0,0,0,0,0,0,,0,0,0,0,0,0,0,0,Matches
2067,Emiliano Rigoni,ar ARG,"FW,MF",Atalanta,it Serie A,25,1993,5.8,6,1,2,2,2,2,6,33.3,4,3,0,3,3,9,3,0,Matches
2068,Luca Rigoni,it ITA,MF,Parma,it Serie A,33,1984,19.6,42,25,25,15,2,9,26,34.6,17,19,2,17,18,60,39,0,Matches
2069,Nicola Rigoni,it ITA,MF,Chievo,it Serie A,27,1990,21.7,43,25,22,15,6,22,51,43.1,29,20,5,15,23,66,45,1,Matches
2070,Kévin Rimane,gf GUF,MF,Paris S-G,fr Ligue 1,27,1991,0.1,0,0,0,0,0,0,0,,0,0,0,0,0,0,0,0,Matches
2071,Tomás Rincón,ve VEN,MF,Torino,it Serie A,30,1988,31.1,75,44,25,41,9,31,68,45.6,37,35,5,30,42,117,71,1,Matches
2072,Renaud Ripart,fr FRA,"FW,DF",Nîmes,fr Ligue 1,25,1993,33.4,76,49,41,22,13,32,76,42.1,44,43,7,36,27,103,79,0,Matches
2073,Mihailo Ristić,rs SRB,"DF,MF",Montpellier,fr Ligue 1,22,1995,3.6,14,9,8,5,1,6,10,60.0,4,11,3,8,9,23,6,0,Matches
2074,Matt Ritchie,sct SCO,"DF,MF",Newcastle Utd,eng Premier League,28,1989,32.5,70,44,35,27,8,19,47,40.4,28,34,11,23,51,121,76,1,Matches
2075,Cristian Rivera,es ESP,MF,Huesca,es La Liga,21,1997,18.8,38,25,18,19,1,11,25,44.0,14,21,4,17,31,69,31,0,Matches
2076,Arjen Robben,nl NED,"FW,MF",Bayern Munich,de Bundesliga,34,1984,6.3,3,1,0,3,0,0,1,0.0,1,6,1,5,3,6,0,0,Matches
2077,Rober,es ESP,DF,Levante,es La Liga,23,1995,31.7,41,29,33,6,2,24,48,50.0,24,52,36,16,51,92,129,2,Matches
2078,Sergi Roberto,es ESP,"DF,MF",Barcelona,es La Liga,26,1992,23.2,28,20,15,9,4,16,24,66.7,8,18,3,15,43,71,31,0,Matches
2079,Patrick Roberts,eng ENG,"MF,FW",Girona,es La Liga,21,1997,6.7,7,6,5,2,0,3,15,20.0,12,5,0,5,3,10,2,1,Matches
2080,Andrew Robertson,sct SCO,DF,Liverpool,eng Premier League,24,1994,35.7,80,49,41,31,8,39,70,55.7,31,33,6,27,29,109,57,3,Matches
2081,Joel Robles,es ESP,GK,Betis,es La Liga,28,1990,5.0,1,0,1,0,0,1,1,100.0,0,0,0,0,0,1,5,1,Matches
2082,Marc Roca,es ESP,MF,Espanyol,es La Liga,21,1996,34.6,71,45,36,26,9,28,70,40.0,42,43,21,22,36,107,60,3,Matches
2083,Christopher Rocchia,fr FRA,DF,Marseille,fr Ligue 1,20,1998,0.0,0,0,0,0,0,0,0,,0,0,0,0,0,0,1,0,Matches
2084,Kenny Rocha Santos,cv CPV,MF,Saint-Étienne,fr Ligue 1,18,2000,0.0,0,0,0,0,0,0,0,,0,0,0,0,0,0,0,0,Matches
2085,Rubén Rochina,es ESP,MF,Levante,es La Liga,27,1991,20.0,51,33,26,16,9,23,81,28.4,58,29,0,29,21,72,19,1,Matches
2086,Sebastian Rode,de GER,MF,Eint Frankfurt,de Bundesliga,27,1990,10.3,31,19,17,9,5,16,35,45.7,19,17,0,17,19,50,14,0,Matches
2087,Ronny Rodelin,fr FRA,"MF,FW",Guingamp,fr Ligue 1,28,1989,8.8,13,5,2,7,4,3,8,37.5,5,8,1,7,8,21,13,0,Matches
2088,Rodri,es ESP,MF,Atlético Madrid,es La Liga,22,1996,30.4,103,70,45,50,8,39,75,52.0,36,35,11,24,41,144,68,0,Matches
2089,Rodrigo,es ESP,FW,Valencia,es La Liga,27,1991,28.1,21,10,6,9,6,3,17,17.6,14,17,1,16,3,24,18,0,Matches
2090,Kévin Rodrigues,pt POR,DF,Real Sociedad,es La Liga,24,1994,5.4,21,11,14,6,1,9,17,52.9,8,13,3,10,8,29,15,0,Matches
2091,Alejandro Rodríguez,es ESP,MF,Empoli,it Serie A,27,1991,0.3,0,0,0,0,0,0,0,,0,0,0,0,0,0,1,0,Matches
2092,Ángel Rodríguez,es ESP,FW,Getafe,es La Liga,31,1987,20.2,16,7,1,6,9,6,26,23.1,20,15,1,14,8,24,8,0,Matches
2093,Óscar Rodríguez Arnaiz,es ESP,MF,Leganés,es La Liga,20,1998,27.8,46,25,26,15,5,16,58,27.6,42,12,2,10,16,62,16,0,Matches
2094,James Rodríguez,co COL,MF,Bayern Munich,de Bundesliga,27,1991,12.6,12,8,3,4,5,5,19,26.3,14,9,0,9,4,16,1,0,Matches
2095,Ricardo Rodríguez,ch SUI,DF,Milan,it Serie A,25,1992,33.9,57,32,34,21,2,32,39,82.1,7,25,5,20,38,95,98,0,Matches
2096,Marko Rog,hr CRO,MF,Napoli,it Serie A,23,1995,3.7,12,9,3,7,2,5,11,45.5,6,8,2,6,5,17,1,0,Matches
2097,Marko Rog,hr CRO,MF,Sevilla,es La Liga,23,1995,4.0,12,11,4,8,0,5,9,55.6,4,4,0,4,8,20,1,0,Matches
2098,Rogério,br BRA,"DF,MF",Sassuolo,it Serie A,20,1998,29.7,55,38,35,13,7,30,55,54.5,25,32,7,25,37,92,109,1,Matches
2099,Marcos Rojo,ar ARG,DF,Manchester Utd,eng Premier League,28,1990,2.4,5,3,3,2,0,1,6,16.7,5,3,2,1,6,11,9,1,Matches
2100,Diego Rolán,uy URU,"MF,FW",Leganés,es La Liga,25,1993,2.4,6,4,3,3,0,2,9,22.2,7,2,0,2,3,9,3,0,Matches
2101,Diego Rolán,uy URU,"MF,FW",Alavés,es La Liga,25,1993,3.3,7,4,3,1,3,0,2,0.0,2,1,0,1,1,8,4,0,Matches
2102,Rolando,pt POR,DF,Marseille,fr Ligue 1,32,1985,8.9,18,7,15,3,0,8,10,80.0,2,8,6,2,11,29,25,0,Matches
2103,Esteban Rolón,ar ARG,MF,Genoa,it Serie A,23,1995,11.6,46,29,14,20,12,20,44,45.5,24,18,2,16,16,62,12,0,Matches
2104,Filippo Romagna,it ITA,DF,Cagliari,it Serie A,21,1997,16.4,14,9,10,4,0,4,8,50.0,4,20,12,8,19,33,68,0,Matches
2105,Alessio Romagnoli,it ITA,DF,Milan,it Serie A,23,1995,31.6,34,19,26,6,2,16,19,84.2,3,48,32,16,37,71,173,1,Matches
2106,Alaixys Romao,tg TOG,MF,Reims,fr Ligue 1,34,1984,35.1,118,71,61,50,7,43,102,42.2,59,44,16,28,58,176,65,1,Matches
2107,Cristian Romero,ar ARG,DF,Genoa,it Serie A,20,1998,26.0,61,35,38,18,5,27,40,67.5,13,49,27,22,37,98,128,1,Matches
2108,Oriol Romeu,es ESP,MF,Southampton,eng Premier League,26,1991,23.7,81,46,39,38,4,32,77,41.6,45,43,17,26,52,133,44,1,Matches
2109,Rômulo,it ITA,"MF,FW",Genoa,it Serie A,31,1987,15.0,26,18,9,10,7,7,17,41.2,10,16,3,13,18,44,20,0,Matches
2110,Rômulo,it ITA,DF,Lazio,it Serie A,31,1987,8.6,10,5,8,2,0,5,7,71.4,2,10,2,8,5,15,13,0,Matches
2111,Cristiano Ronaldo,pt POR,FW,Juventus,it Serie A,33,1985,29.9,10,7,5,4,1,1,11,9.1,10,7,2,5,6,16,32,0,Matches
2112,Facundo Roncaglia,ar ARG,DF,Valencia,es La Liga,31,1987,6.7,13,10,8,5,0,4,6,66.7,2,4,2,2,10,23,22,0,Matches
2113,Facundo Roncaglia,ar ARG,DF,Celta Vigo,es La Liga,31,1987,11.9,34,22,26,8,0,17,24,70.8,7,12,5,7,20,54,51,2,Matches
2114,Salomón Rondón,ve VEN,FW,Newcastle Utd,eng Premier League,28,1989,28.9,8,3,2,4,2,4,24,16.7,20,14,3,11,5,13,39,0,Matches
2115,Valentin Rongier,fr FRA,MF,Nantes,fr Ligue 1,23,1994,35.8,86,54,24,46,16,26,65,40.0,39,46,6,40,33,119,19,0,Matches
2116,Marten de Roon,nl NED,MF,Atalanta,it Serie A,27,1991,33.1,102,57,32,61,9,34,94,36.2,60,48,9,39,53,155,49,1,Matches
2117,Roberto Rosales,ve VEN,DF,Espanyol,es La Liga,29,1988,19.4,48,31,22,16,10,21,44,47.7,23,19,7,12,22,70,68,0,Matches
2118,Danny Rose,eng ENG,DF,Tottenham,eng Premier League,28,1990,20.0,49,31,26,16,7,20,32,62.5,12,24,4,20,24,73,28,3,Matches
2119,Valentin Rosier,fr FRA,"DF,MF",Dijon,fr Ligue 1,21,1996,16.2,44,25,22,19,3,16,31,51.6,15,25,4,21,32,76,45,1,Matches
2120,Luca Rossettini,it ITA,DF,Chievo,it Serie A,33,1985,20.3,26,17,18,8,0,15,20,75.0,5,23,15,8,35,61,114,0,Matches
2121,Francesco Rossi,it ITA,GK,Atalanta,it Serie A,27,1991,0.0,0,0,0,0,0,0,0,,0,0,0,0,0,0,0,0,Matches
2122,Jérôme Roussillon,fr FRA,DF,Wolfsburg,de Bundesliga,25,1993,27.3,42,29,25,15,2,20,30,66.7,10,50,7,43,31,73,54,0,Matches
2123,Nolan Roux,fr FRA,FW,Guingamp,fr Ligue 1,30,1988,17.1,11,9,0,6,5,4,14,28.6,10,6,2,4,4,15,21,0,Matches
2124,Aaron Rowe,eng ENG,FW,Huddersfield,eng Premier League,17,2000,0.8,1,0,1,0,0,0,0,,0,0,0,0,1,2,1,0,Matches
2125,Waldo Rubio,es ESP,MF,Valladolid,es La Liga,22,1995,5.5,4,2,3,1,0,1,6,16.7,5,2,0,2,1,5,8,1,Matches
2126,John Ruddy,eng ENG,GK,Wolves,eng Premier League,31,1986,1.0,0,0,0,0,0,0,0,,0,0,0,0,0,0,0,0,Matches
2127,Antonio Rüdiger,de GER,DF,Chelsea,eng Premier League,25,1993,31.9,34,16,27,6,1,15,27,55.6,12,15,8,7,32,66,96,1,Matches
2128,Sebastian Rudy,de GER,MF,Schalke 04,de Bundesliga,28,1990,15.1,44,24,11,27,6,11,41,26.8,30,23,2,21,15,59,15,0,Matches
2129,Stéphane Ruffier,fr FRA,GK,Saint-Étienne,fr Ligue 1,31,1986,37.0,2,2,2,0,0,2,4,50.0,2,0,0,0,0,2,18,3,Matches
2130,Daniele Rugani,it ITA,DF,Juventus,it Serie A,24,1994,15.0,8,5,5,3,0,2,5,40.0,3,19,14,5,16,24,51,1,Matches
2131,Mário Rui,pt POR,DF,Napoli,it Serie A,27,1991,15.7,24,18,9,12,3,14,25,56.0,11,15,3,12,21,45,38,0,Matches
2132,Abel Ruiz,es ESP,FW,Barcelona,es La Liga,18,2000,0.2,1,1,1,0,0,1,1,100.0,0,0,0,0,0,1,0,0,Matches
2133,Fabián Ruiz Peña,es ESP,MF,Napoli,it Serie A,22,1996,22.1,54,33,22,25,7,20,46,43.5,26,23,4,19,21,75,29,2,Matches
2134,Víctor Ruiz,es ESP,DF,Villarreal,es La Liga,29,1989,21.9,28,19,20,6,2,13,18,72.2,5,28,16,12,38,66,67,1,Matches
2135,Gerónimo Rulli,ar ARG,GK,Real Sociedad,es La Liga,26,1992,27.0,2,1,2,0,0,1,3,33.3,2,1,0,1,1,3,12,6,Matches
2136,Lukas Rupp,de GER,"MF,DF",Hoffenheim,de Bundesliga,27,1991,0.3,1,1,0,0,1,0,0,,0,0,0,0,0,1,0,0,Matches
2137,Marco Russ,de GER,DF,Eint Frankfurt,de Bundesliga,32,1985,4.2,7,2,5,2,0,4,6,66.7,2,2,2,0,7,14,8,0,Matches
2138,Mathew Ryan,au AUS,GK,Brighton,eng Premier League,26,1992,34.0,1,0,1,0,0,1,2,50.0,1,0,0,0,0,1,13,1,Matches
2139,Frederik Rønnow,dk DEN,GK,Eint Frankfurt,de Bundesliga,25,1992,1.4,0,0,0,0,0,0,0,,0,0,0,0,0,0,1,0,Matches
2140,Idriss Saadi,dz ALG,"FW,MF",Strasbourg,fr Ligue 1,26,1992,0.1,0,0,0,0,0,0,0,,0,0,0,0,0,0,0,0,Matches
2141,Youssouf Sabaly,sn SEN,DF,Bordeaux,fr Ligue 1,25,1993,21.2,46,32,32,12,2,25,46,54.3,21,19,2,17,26,72,42,0,Matches
2142,Abdelhamid Sabiri,ma MAR,FW,Huddersfield,eng Premier League,21,1996,0.5,2,1,1,1,0,0,0,,0,1,0,1,1,3,0,0,Matches
2143,Marcel Sabitzer,at AUT,MF,RB Leipzig,de Bundesliga,24,1994,26.1,45,28,17,21,7,18,46,39.1,28,21,2,19,33,78,31,0,Matches
2144,Ihsan Sacko,fr FRA,FW,Nice,fr Ligue 1,21,1997,4.9,7,2,2,5,0,2,5,40.0,3,5,0,5,2,9,2,0,Matches
2145,Nuri Şahin,tr TUR,MF,Werder Bremen,de Bundesliga,29,1988,16.4,60,33,22,33,5,23,59,39.0,36,30,3,27,37,97,39,1,Matches
2146,Samuel Şahin-Radlinger,at AUT,GK,Hannover 96,de Bundesliga,25,1992,1.0,0,0,0,0,0,0,0,,0,1,0,1,0,0,2,0,Matches
2147,Wesley Saïd,fr FRA,"FW,MF",Dijon,fr Ligue 1,23,1995,25.0,25,18,6,11,8,5,20,25.0,15,9,0,9,9,34,9,0,Matches
2148,Allan Saint-Maximin,fr FRA,FW,Nice,fr Ligue 1,21,1997,32.2,12,6,1,7,4,2,14,14.3,12,11,0,11,4,16,3,0,Matches
2149,Théo Sainte-Luce,fr FRA,MF,Nîmes,fr Ligue 1,19,1998,0.0,0,0,0,0,0,0,0,,0,0,0,0,0,0,0,0,Matches
2150,Romain Saïss,ma MAR,"MF,DF",Wolves,eng Premier League,28,1990,12.8,39,26,23,14,2,20,37,54.1,17,25,12,13,26,65,61,0,Matches
2151,Samuel Sáiz,es ESP,MF,Getafe,es La Liga,27,1991,3.4,4,3,0,3,1,2,5,40.0,3,1,0,1,0,4,2,0,Matches
2152,Bukayo Saka,eng ENG,FW,Arsenal,eng Premier League,16,2001,0.1,0,0,0,0,0,0,0,,0,0,0,0,0,0,0,0,Matches
2153,Hiroki Sakai,jp JPN,DF,Marseille,fr Ligue 1,28,1990,26.4,59,41,30,23,6,29,54,53.7,25,25,10,15,37,96,77,0,Matches
2154,Diafra Sakho,sn SEN,FW,Rennes,fr Ligue 1,28,1989,1.6,2,1,0,0,2,0,0,,0,0,0,0,0,2,0,0,Matches
2155,Mamadou Sakho,fr FRA,DF,Crystal Palace,eng Premier League,28,1990,26.8,25,16,22,3,0,11,18,61.1,7,26,16,10,41,66,136,2,Matches
2156,Bakary Sako,ml MLI,FW,Crystal Palace,eng Premier League,30,1988,0.3,2,1,2,0,0,1,1,100.0,0,0,0,0,0,2,0,0,Matches
2157,Emiliano Sala,ar ARG,FW,Nantes,fr Ligue 1,27,1990,15.2,7,5,0,2,5,1,8,12.5,7,8,1,7,2,9,20,0,Matches
2158,Jacopo Sala,it ITA,DF,Sampdoria,it Serie A,26,1991,16.9,38,23,20,14,4,23,41,56.1,18,11,3,8,20,58,47,2,Matches
2159,Mohamed Salah,eg EGY,FW,Liverpool,eng Premier League,26,1992,36.1,21,9,3,11,7,5,16,31.3,11,9,0,9,5,26,6,0,Matches
2160,Bartosz Salamon,pl POL,DF,Frosinone,it Serie A,27,1991,19.2,17,10,12,5,0,6,14,42.9,8,27,19,8,27,44,143,1,Matches
2161,Carlos Salcedo,mx MEX,DF,Eint Frankfurt,de Bundesliga,24,1993,5.1,7,3,4,3,0,4,7,57.1,3,7,3,4,9,16,22,0,Matches
2162,William Saliba,fr FRA,DF,Saint-Étienne,fr Ligue 1,17,2001,14.2,32,20,28,4,0,16,24,66.7,8,11,10,1,28,60,44,2,Matches
2163,Yannis Salibur,fr FRA,"FW,MF",Saint-Étienne,fr Ligue 1,27,1991,9.8,9,5,1,7,1,1,7,14.3,6,6,0,6,8,17,4,0,Matches
2164,Yannis Salibur,fr FRA,MF,Guingamp,fr Ligue 1,27,1991,0.2,0,0,0,0,0,0,0,,0,0,0,0,0,0,0,0,Matches
2165,Roland Sallai,hu HUN,MF,Freiburg,de Bundesliga,21,1997,5.9,12,7,5,5,2,5,13,38.5,8,3,0,3,3,15,8,0,Matches
2166,Edgar Salli,cm CMR,"FW,MF",Nürnberg,de Bundesliga,25,1992,1.3,2,1,1,1,0,0,1,0.0,1,0,0,0,1,3,1,0,Matches
2167,Brice Samba,fr FRA,GK,Caen,fr Ligue 1,24,1994,38.0,1,0,1,0,0,0,1,0.0,1,0,0,0,1,2,12,4,Matches
2168,Junior Sambia,fr FRA,"MF,FW",Montpellier,fr Ligue 1,21,1996,10.3,15,7,7,7,1,6,15,40.0,9,14,2,12,5,20,3,0,Matches
2169,Paolo Sammarco,it ITA,MF,Frosinone,it Serie A,35,1983,6.1,16,7,7,6,3,6,9,66.7,3,5,0,5,3,19,1,2,Matches
2170,Frédéric Sammaritano,fr FRA,"FW,MF",Dijon,fr Ligue 1,32,1986,6.0,11,5,5,5,1,5,13,38.5,8,8,1,7,8,19,2,1,Matches
2171,Mikel San José,es ESP,MF,Athletic Club,es La Liga,29,1989,19.3,43,25,19,19,5,15,48,31.3,33,27,6,21,21,64,35,0,Matches
2172,Antonio Sanabria,py PAR,FW,Genoa,it Serie A,22,1996,8.5,6,3,1,1,4,0,1,0.0,1,8,0,8,4,10,3,0,Matches
2173,Antonio Sanabria,py PAR,FW,Betis,es La Liga,22,1996,9.0,8,6,0,5,3,1,6,16.7,5,8,2,6,3,11,4,0,Matches
2174,Renato Sanches,pt POR,MF,Bayern Munich,de Bundesliga,20,1997,6.4,5,5,2,1,2,3,10,30.0,7,7,0,7,4,9,2,0,Matches
2175,Alexis Sánchez,cl CHI,"FW,MF",Manchester Utd,eng Premier League,29,1988,9.8,17,10,5,9,3,5,13,38.5,8,7,0,7,9,26,2,0,Matches
2176,Carlos Sánchez,co COL,MF,West Ham,eng Premier League,32,1986,2.7,4,3,4,0,0,3,8,37.5,5,1,0,1,1,5,5,2,Matches
2177,Davinson Sánchez,co COL,DF,Tottenham,eng Premier League,22,1996,21.6,37,20,28,9,0,20,37,54.1,17,17,9,8,30,67,103,2,Matches
2178,Javi Sánchez,es ESP,DF,Real Madrid,es La Liga,21,1997,0.5,1,0,1,0,0,0,0,,0,0,0,0,0,1,4,0,Matches
2179,Víctor Sánchez,es ESP,MF,Espanyol,es La Liga,30,1987,14.1,45,30,21,17,7,14,67,20.9,53,17,2,15,25,70,25,0,Matches
2180,Jadon Sancho,eng ENG,"FW,MF",Dortmund,de Bundesliga,18,2000,27.3,19,10,7,6,6,10,31,32.3,21,21,1,20,14,33,12,1,Matches
2181,Sandro,br BRA,MF,Udinese,it Serie A,29,1989,6.6,18,10,10,8,0,7,13,53.8,6,14,5,9,11,29,16,0,Matches
2182,Sandro,br BRA,MF,Genoa,it Serie A,29,1989,7.9,27,17,12,11,4,9,17,52.9,8,9,4,5,20,47,25,0,Matches
2183,Alex Sandro,br BRA,DF,Juventus,it Serie A,27,1991,26.5,68,45,28,33,7,21,36,58.3,15,32,8,24,38,106,71,0,Matches
2184,Leroy Sané,de GER,FW,Manchester City,eng Premier League,22,1996,20.7,24,15,8,7,9,2,23,8.7,21,21,2,19,8,32,2,0,Matches
2185,Salif Sané,sn SEN,DF,Schalke 04,de Bundesliga,27,1990,29.0,54,37,34,19,1,27,46,58.7,19,44,29,15,68,122,146,3,Matches
2186,Luca Sangalli,es ESP,"MF,FW",Real Sociedad,es La Liga,23,1995,11.1,19,13,6,11,2,5,22,22.7,17,9,1,8,5,24,5,0,Matches
2187,Ibrahim Sangaré,ci CIV,MF,Toulouse,fr Ligue 1,20,1997,27.4,102,66,50,44,8,32,63,50.8,31,52,20,32,29,131,49,2,Matches
2188,Younousse Sankharé,sn SEN,MF,Bordeaux,fr Ligue 1,28,1989,16.4,25,12,2,19,4,6,19,31.6,13,14,0,14,9,34,4,0,Matches
2189,Baissama Sankoh,gn GUI,"MF,FW",Caen,fr Ligue 1,26,1992,7.2,4,1,4,0,0,1,4,25.0,3,8,1,7,5,9,16,0,Matches
2190,Yaya Sanogo,fr FRA,FW,Toulouse,fr Ligue 1,25,1993,13.8,4,2,0,2,2,2,4,50.0,2,3,0,3,3,7,15,0,Matches
2191,Morgan Sanson,fr FRA,MF,Marseille,fr Ligue 1,23,1994,26.7,70,47,27,35,8,21,77,27.3,56,40,1,39,42,112,8,1,Matches
2192,Nicola Sansone,it ITA,FW,Bologna,it Serie A,26,1991,12.7,29,17,9,14,6,9,27,33.3,18,13,1,12,9,38,4,0,Matches
2193,Nicola Sansone,it ITA,"FW,MF",Villarreal,es La Liga,26,1991,0.4,0,0,0,0,0,0,0,,0,0,0,0,0,0,0,0,Matches
2194,Baptiste Santamaria,fr FRA,MF,Angers,fr Ligue 1,23,1995,36.1,118,60,48,63,7,51,106,48.1,55,41,4,37,57,175,57,2,Matches
2195,Roberto Santamaría,es ESP,GK,Huesca,es La Liga,33,1985,20.0,0,0,0,0,0,0,0,,0,0,0,0,1,1,12,1,Matches
2196,Federico Santander,py PAR,FW,Bologna,it Serie A,27,1991,22.9,18,10,6,8,4,2,23,8.7,21,20,2,18,9,27,30,0,Matches
2197,Davide Santon,it ITA,DF,Roma,it Serie A,27,1991,11.2,14,6,8,6,0,8,12,66.7,4,11,7,4,15,29,27,0,Matches
2198,Michael Santos,uy URU,"FW,MF",Leganés,es La Liga,25,1993,6.2,12,5,1,7,4,2,7,28.6,5,7,1,6,1,13,1,0,Matches
2199,Samir Santos,br BRA,DF,Udinese,it Serie A,23,1994,20.0,47,33,27,18,2,19,25,76.0,6,18,9,9,34,81,96,0,Matches
2200,Riccardo Saponara,it ITA,MF,Sampdoria,it Serie A,26,1991,10.1,12,6,2,6,4,3,12,25.0,9,5,1,4,4,16,10,0,Matches
2201,Pablo Sarabia,es ESP,"MF,FW",Sevilla,es La Liga,26,1992,30.3,30,15,6,15,9,6,47,12.8,41,30,3,27,22,52,20,0,Matches
2202,Marcelo Saracchi,uy URU,DF,RB Leipzig,de Bundesliga,20,1998,7.3,17,11,12,4,1,8,13,61.5,5,12,1,11,11,28,14,0,Matches
2203,Josh Sargent,us USA,FW,Werder Bremen,de Bundesliga,18,2000,2.4,2,1,1,0,1,2,2,100.0,0,2,0,2,0,2,3,0,Matches
2204,Bouna Sarr,sn SEN,"DF,MF",Marseille,fr Ligue 1,26,1992,24.9,67,48,27,27,13,26,42,61.9,16,28,3,25,39,106,56,1,Matches
2205,Ismaila Sarr,sn SEN,"FW,MF",Rennes,fr Ligue 1,20,1998,31.0,35,24,16,15,4,17,34,50.0,17,17,2,15,14,49,4,0,Matches
2206,Malang Sarr,fr FRA,DF,Nice,fr Ligue 1,19,1999,33.3,59,36,38,17,4,31,57,54.4,26,29,12,17,68,127,107,2,Matches
2207,Lluís Sastre,es ESP,MF,Huesca,es La Liga,32,1986,1.3,5,3,0,5,0,0,1,0.0,1,0,0,0,1,6,0,0,Matches
2208,Marco Sau,it ITA,"MF,FW",Sampdoria,it Serie A,30,1987,0.6,0,0,0,0,0,0,0,,0,1,0,1,0,0,0,0,Matches
2209,Marco Sau,it ITA,"FW,MF",Cagliari,it Serie A,30,1987,6.2,4,2,0,2,2,0,3,0.0,3,5,0,5,1,5,4,0,Matches
2210,Téji Savanier,fr FRA,MF,Nîmes,fr Ligue 1,26,1991,31.8,95,58,35,52,8,43,116,37.1,73,32,15,17,64,159,53,2,Matches
2211,Stefan Savić,me MNE,DF,Atlético Madrid,es La Liga,27,1991,15.5,11,10,9,2,0,7,12,58.3,5,13,9,4,22,33,67,0,Matches
2212,Fabian Schär,ch SUI,DF,Newcastle Utd,eng Premier League,26,1991,22.2,60,39,37,19,4,24,50,48.0,26,40,16,24,67,127,145,2,Matches
2213,Ezequiel Schelotto,it ITA,DF,Chievo,it Serie A,29,1989,1.6,3,0,3,0,0,2,3,66.7,1,1,0,1,2,5,8,0,Matches
2214,Nicolás Schiappacasse,uy URU,"FW,MF",Parma,it Serie A,19,1999,0.9,0,0,0,0,0,0,0,,0,2,0,2,0,0,0,0,Matches
2215,Pasquale Schiattarella,it ITA,MF,SPAL,it Serie A,31,1987,20.5,43,27,18,21,4,13,38,34.2,25,17,5,12,22,65,25,1,Matches
2216,Patrik Schick,cz CZE,"FW,MF",Roma,it Serie A,22,1996,14.6,11,5,3,5,3,1,19,5.3,18,19,2,17,3,14,15,1,Matches
2217,Julian Schieber,de GER,FW,Augsburg,de Bundesliga,29,1989,2.9,3,2,1,2,0,0,1,0.0,1,1,0,1,1,4,3,0,Matches
2218,Christopher Schindler,de GER,DF,Huddersfield,eng Premier League,28,1990,36.2,61,36,46,14,1,27,47,57.4,20,69,34,35,70,131,138,4,Matches
2219,Keven Schlotterbeck,de GER,DF,Freiburg,de Bundesliga,21,1997,8.6,22,16,19,2,1,8,12,66.7,4,17,11,6,13,35,26,0,Matches
2220,Nico Schlotterbeck,de GER,DF,Freiburg,de Bundesliga,18,1999,2.5,6,6,6,0,0,2,2,100.0,0,3,1,2,5,11,10,0,Matches
2221,Jeffrey Schlupp,gh GHA,"MF,FW",Crystal Palace,eng Premier League,25,1992,18.6,41,20,18,18,5,10,27,37.0,17,30,8,22,19,60,27,1,Matches
2222,Kasper Schmeichel,dk DEN,GK,Leicester City,eng Premier League,31,1986,38.0,1,1,1,0,0,1,1,100.0,0,0,0,0,3,4,14,3,Matches
2223,Marcel Schmelzer,de GER,DF,Dortmund,de Bundesliga,30,1988,6.3,10,5,7,2,1,5,9,55.6,4,7,1,6,9,19,14,0,Matches
2224,Jonathan Schmid,fr FRA,DF,Augsburg,de Bundesliga,28,1990,28.0,44,22,23,19,2,16,28,57.1,12,22,8,14,43,87,70,2,Matches
2225,Morgan Schneiderlin,fr FRA,MF,Everton,eng Premier League,28,1989,9.3,24,16,11,11,2,6,14,42.9,8,16,3,13,15,39,16,0,Matches
2226,Alessandro Schöpf,at AUT,"MF,DF",Schalke 04,de Bundesliga,24,1994,11.2,26,16,12,13,1,12,29,41.4,17,14,0,14,9,35,12,0,Matches
2227,Nico Schulz,de GER,DF,Hoffenheim,de Bundesliga,25,1993,28.2,34,20,19,12,3,15,36,41.7,21,32,4,28,24,58,36,0,Matches
2228,André Schürrle,de GER,"FW,MF",Fulham,eng Premier League,27,1990,18.2,30,19,14,10,6,12,42,28.6,30,16,1,15,8,38,17,1,Matches
2229,Pirmin Schwegler,ch SUI,MF,Hannover 96,de Bundesliga,31,1987,23.1,63,34,30,29,4,34,60,56.7,26,21,5,16,41,104,54,0,Matches
2230,Alexander Schwolow,de GER,GK,Freiburg,de Bundesliga,26,1992,33.0,0,0,0,0,0,0,1,0.0,1,0,0,0,0,0,13,2,Matches
2231,Matteo Scozzarella,it ITA,MF,Parma,it Serie A,30,1988,16.2,18,13,9,8,1,9,33,27.3,24,22,10,12,23,41,33,0,Matches
2232,Simone Scuffet,it ITA,GK,Udinese,it Serie A,22,1996,9.0,0,0,0,0,0,0,1,0.0,1,0,0,0,0,0,4,2,Matches
2233,Andrea Seculin,it ITA,GK,Chievo,it Serie A,28,1990,1.0,0,0,0,0,0,0,0,,0,0,0,0,0,0,1,0,Matches
2234,Stanley Segarel,fr FRA,FW,Amiens,fr Ligue 1,24,1994,0.2,0,0,0,0,0,0,0,,0,0,0,0,0,0,0,0,Matches
2235,Davie Selke,de GER,FW,Hertha BSC,de Bundesliga,23,1995,19.3,5,2,1,4,0,2,9,22.2,7,11,0,11,1,6,7,0,Matches
2236,Ole Selnæs,no NOR,MF,Saint-Étienne,fr Ligue 1,24,1994,18.5,44,26,12,23,9,13,35,37.1,22,24,7,17,19,63,29,0,Matches
2237,Matz Sels,be BEL,GK,Strasbourg,fr Ligue 1,26,1992,37.0,0,0,0,0,0,0,1,0.0,1,0,0,0,1,1,24,1,Matches
2238,Ken Sema,se SWE,"MF,FW",Watford,eng Premier League,24,1993,8.4,15,7,7,5,3,9,21,42.9,12,7,0,7,8,23,5,0,Matches
2239,Alfa Semedo,gw GNB,MF,Espanyol,es La Liga,20,1997,0.5,0,0,0,0,0,0,3,0.0,3,1,1,0,2,2,0,0,Matches
2240,Nélson Semedo,pt POR,DF,Barcelona,es La Liga,24,1993,17.8,38,27,23,12,3,12,18,66.7,6,23,7,16,22,60,26,0,Matches
2241,Rúben Semedo,pt POR,DF,Huesca,es La Liga,24,1994,9.4,20,16,14,6,0,12,16,75.0,4,15,9,6,16,36,35,2,Matches
2242,Adrian Šemper,hr CRO,GK,Chievo,it Serie A,20,1998,6.0,0,0,0,0,0,0,0,,0,0,0,0,1,1,3,0,Matches
2243,Stefano Sensi,it ITA,MF,Sassuolo,it Serie A,22,1995,21.9,36,20,15,18,3,6,30,20.0,24,36,7,29,33,69,17,0,Matches
2244,Luigi Sepe,it ITA,GK,Parma,it Serie A,27,1991,37.0,1,1,1,0,0,1,2,50.0,1,0,0,0,3,4,21,3,Matches
2245,Suat Serdar,de GER,MF,Schalke 04,de Bundesliga,21,1997,19.2,51,32,20,26,5,14,49,28.6,35,37,6,31,23,74,5,1,Matches
2246,Jean Seri,ci CIV,MF,Fulham,eng Premier League,27,1991,24.9,41,28,20,20,1,13,45,28.9,32,40,9,31,32,73,17,4,Matches
2247,Leonardo Sernicola,it ITA,FW,Sassuolo,it Serie A,21,1997,0.1,0,0,0,0,0,0,0,,0,0,0,0,0,0,0,0,Matches
2248,Julien Serrano,fr FRA,"MF,DF",Monaco,fr Ligue 1,20,1998,1.3,5,4,3,2,0,3,6,50.0,3,1,0,1,3,8,3,0,Matches
2249,Grégory Sertic,fr FRA,MF,Marseille,fr Ligue 1,28,1989,1.2,2,0,1,1,0,0,1,0.0,1,2,1,1,1,3,2,0,Matches
2250,Ryan Sessegnon,eng ENG,"FW,DF",Fulham,eng Premier League,18,2000,25.6,22,14,8,8,6,6,22,27.3,16,25,2,23,19,41,49,1,Matches
2251,Paik Seung-ho,kr KOR,"FW,MF",Girona,es La Liga,21,1997,0.7,0,0,0,0,0,0,1,0.0,1,1,0,1,3,3,1,0,Matches
2252,Stephan El Shaarawy,it ITA,"FW,MF",Roma,it Serie A,25,1992,23.4,27,14,14,8,5,9,24,37.5,15,11,2,9,20,47,9,0,Matches
2253,Meritan Shabani,al ALB,MF,Bayern Munich,de Bundesliga,19,1999,0.0,0,0,0,0,0,0,0,,0,0,0,0,0,0,0,0,Matches
2254,Xherdan Shaqiri,ch SUI,"FW,MF",Liverpool,eng Premier League,26,1991,11.8,14,4,3,9,2,9,19,47.4,10,6,1,5,6,20,6,0,Matches
2255,Luke Shaw,eng ENG,DF,Manchester Utd,eng Premier League,23,1995,28.8,55,29,17,31,7,28,47,59.6,19,42,12,30,21,76,93,2,Matches
2256,Jonjo Shelvey,eng ENG,MF,Newcastle Utd,eng Premier League,26,1992,10.5,22,12,10,9,3,8,17,47.1,9,10,3,7,7,29,15,0,Matches
2257,Gaku Shibasaki,jp JPN,"MF,FW",Getafe,es La Liga,26,1992,4.3,7,3,2,4,1,3,6,50.0,3,2,0,2,3,10,4,0,Matches
2258,Gen Shoji,jp JPN,DF,Toulouse,fr Ligue 1,25,1992,18.0,24,13,16,8,0,11,24,45.8,13,22,14,8,21,45,56,0,Matches
2259,Djibril Sidibé,fr FRA,"DF,MF",Monaco,fr Ligue 1,26,1992,23.1,50,34,27,12,11,26,48,54.2,22,25,9,16,30,80,51,0,Matches
2260,Kalidou Sidibé,fr FRA,MF,Toulouse,fr Ligue 1,19,1999,14.0,24,12,11,12,1,7,15,46.7,8,16,3,13,17,41,26,1,Matches
2261,Sidnei,br BRA,DF,Betis,es La Liga,28,1989,19.4,48,29,33,12,3,18,34,52.9,16,21,8,13,41,89,57,0,Matches
2262,Francisco Sierralta,cl CHI,DF,Parma,it Serie A,21,1997,3.0,11,8,8,3,0,4,6,66.7,2,1,1,0,4,15,27,0,Matches
2263,Gylfi Sigurðsson,is ISL,MF,Everton,eng Premier League,28,1989,34.6,56,36,20,25,11,16,47,34.0,31,38,4,34,28,84,24,0,Matches
2264,Luca Siligardi,it ITA,FW,Parma,it Serie A,30,1988,18.2,30,20,10,13,7,8,23,34.8,15,19,3,16,15,45,11,0,Matches
2265,Adrien Silva,pt POR,MF,Leicester City,eng Premier League,29,1989,1.0,2,2,0,1,1,0,2,0.0,2,1,0,1,1,3,1,0,Matches
2266,Adrien Silva,pt POR,MF,Monaco,fr Ligue 1,29,1989,13.2,50,31,19,26,5,30,62,48.4,32,15,2,13,16,66,23,0,Matches
2267,André Silva,pt POR,FW,Sevilla,es La Liga,22,1995,24.0,8,5,1,4,3,1,11,9.1,10,17,1,16,3,11,32,0,Matches
2268,Bernardo Silva,pt POR,"MF,FW",Manchester City,eng Premier League,23,1994,31.7,52,39,18,21,13,16,67,23.9,51,47,3,44,25,77,26,1,Matches
2269,David Silva,es ESP,MF,Manchester City,eng Premier League,32,1986,26.7,30,18,12,11,7,1,20,5.0,19,18,1,17,22,52,15,0,Matches
2270,Gabriel Silva,br BRA,DF,Saint-Étienne,fr Ligue 1,27,1991,15.9,19,10,13,6,0,6,17,35.3,11,15,3,12,14,33,60,1,Matches
2271,Jonathan Silva,ar ARG,"DF,FW",Leganés,es La Liga,24,1994,30.0,51,38,30,17,4,23,52,44.2,29,23,2,21,29,80,86,0,Matches
2272,Matheus Pereira da Silva,br BRA,MF,Juventus,it Serie A,20,1998,1.0,3,2,0,2,1,2,4,50.0,2,1,0,1,0,3,1,0,Matches
2273,Thiago Silva,br BRA,DF,Paris S-G,fr Ligue 1,33,1984,23.1,16,13,7,8,1,6,11,54.5,5,28,20,8,32,48,99,1,Matches
2274,Xande Silva,pt POR,FW,West Ham,eng Premier League,21,1997,0.2,0,0,0,0,0,0,0,,0,1,0,1,0,0,0,0,Matches
2275,Matías Silvestre,ar ARG,DF,Empoli,it Serie A,33,1984,34.0,31,17,22,5,4,17,26,65.4,9,29,24,5,21,52,165,0,Matches
2276,Giovanni Simeone,ar ARG,FW,Fiorentina,it Serie A,23,1995,27.3,43,27,10,23,10,7,29,24.1,22,26,2,24,4,47,14,0,Matches
2277,Lorenco Šimić,hr CRO,DF,SPAL,it Serie A,22,1996,2.6,6,3,5,1,0,2,4,50.0,2,2,1,1,12,18,19,1,Matches
2278,Moses Simon,ng NGA,"DF,MF",Levante,es La Liga,23,1995,8.7,14,8,10,2,2,5,9,55.6,4,10,1,9,12,26,14,0,Matches
2279,Unai Simón,es ESP,GK,Athletic Club,es La Liga,21,1997,7.0,0,0,0,0,0,0,1,0.0,1,0,0,0,1,1,1,1,Matches
2280,Danny Simpson,eng ENG,DF,Leicester City,eng Premier League,31,1987,3.2,11,3,8,3,0,3,5,60.0,2,7,3,4,6,17,20,0,Matches
2281,Jack Simpson,eng ENG,DF,Bournemouth,eng Premier League,21,1996,4.5,9,5,8,1,0,6,9,66.7,3,5,4,1,9,18,25,2,Matches
2282,Josh Sims,eng ENG,MF,Southampton,eng Premier League,21,1997,2.4,1,0,1,0,0,1,3,33.3,2,2,0,2,1,2,1,0,Matches
2283,Giovanni Sio,ci CIV,FW,Montpellier,fr Ligue 1,29,1989,0.7,0,0,0,0,0,0,0,,0,0,0,0,0,0,0,0,Matches
2284,Dimitris Siovas,gr GRE,DF,Leganés,es La Liga,29,1988,32.9,57,32,38,18,1,27,47,57.4,20,32,15,17,65,122,155,1,Matches
2285,Salvatore Sirigu,it ITA,GK,Torino,it Serie A,31,1987,35.2,0,0,0,0,0,0,2,0.0,2,0,0,0,2,2,21,1,Matches
2286,Ibrahima Sissoko,fr FRA,MF,Strasbourg,fr Ligue 1,20,1997,29.6,60,41,23,34,3,23,55,41.8,32,37,3,34,34,94,39,1,Matches
2287,Moussa Sissoko,fr FRA,"MF,FW",Tottenham,eng Premier League,28,1989,25.9,36,25,18,14,4,15,29,51.7,14,31,4,27,16,52,25,2,Matches
2288,Pione Sisto,dk DEN,"FW,MF",Celta Vigo,es La Liga,23,1995,9.4,4,3,4,0,0,0,9,0.0,9,5,0,5,3,7,3,0,Matches
2289,Antonio Sivera,es ESP,GK,Alavés,es La Liga,21,1996,3.0,0,0,0,0,0,0,0,,0,0,0,0,0,0,4,1,Matches
2290,Ellyes Skhiri,tn TUN,MF,Montpellier,fr Ligue 1,23,1995,34.3,105,58,31,64,10,43,91,47.3,48,60,7,53,60,165,41,0,Matches
2291,Oliver Skipp,eng ENG,MF,Tottenham,eng Premier League,17,2000,2.4,7,3,4,3,0,4,6,66.7,2,2,1,1,1,8,7,0,Matches
2292,Łukasz Skorupski,pl POL,GK,Bologna,it Serie A,27,1991,38.0,0,0,0,0,0,0,0,,0,0,0,0,3,3,12,4,Matches
2293,Milan Škriniar,sk SVK,DF,Inter,it Serie A,23,1995,35.0,64,37,46,17,1,38,60,63.3,22,48,29,19,27,91,138,0,Matches
2294,Steven Skrzybski,de GER,"FW,MF",Schalke 04,de Bundesliga,25,1992,7.4,9,3,0,6,3,3,11,27.3,8,8,1,7,3,12,2,0,Matches
2295,Petar Škuletić,rs SRB,FW,Montpellier,fr Ligue 1,28,1990,6.7,9,5,4,2,3,1,15,6.7,14,7,1,6,3,12,14,1,Matches
2296,Callum Slattery,eng ENG,MF,Southampton,eng Premier League,19,1999,1.2,4,3,0,4,0,3,7,42.9,4,1,1,0,2,6,1,0,Matches
2297,Naïm Sliti,tn TUN,"MF,FW",Dijon,fr Ligue 1,26,1992,25.4,56,33,24,19,13,15,46,32.6,31,18,0,18,11,67,9,0,Matches
2298,Chris Smalling,eng ENG,DF,Manchester Utd,eng Premier League,28,1989,23.6,30,17,21,9,0,11,17,64.7,6,37,25,12,26,56,109,1,Matches
2299,Adam Smith,eng ENG,"DF,MF",Bournemouth,eng Premier League,27,1991,23.0,46,32,26,14,6,19,41,46.3,22,26,7,19,31,77,68,1,Matches
2300,Emile Smith Rowe,eng ENG,MF,RB Leipzig,de Bundesliga,18,2000,0.3,1,0,0,1,0,1,1,100.0,0,0,0,0,1,2,0,0,Matches
2301,Tommy Smith,eng ENG,DF,Huddersfield,eng Premier League,26,1992,12.7,26,13,14,11,1,10,25,40.0,15,12,4,8,18,44,25,0,Matches
2302,Robert Snodgrass,sct SCO,MF,West Ham,eng Premier League,30,1987,24.7,44,27,18,24,2,13,46,28.3,33,24,4,20,11,55,23,0,Matches
2303,Cédric Soares,pt POR,DF,Southampton,eng Premier League,26,1991,16.6,22,16,15,6,1,9,15,60.0,6,21,5,16,22,44,60,2,Matches
2304,Cédric Soares,pt POR,DF,Inter,it Serie A,26,1991,2.9,8,6,2,4,2,4,7,57.1,3,4,1,3,2,10,3,0,Matches
2305,Ramadan Sobhi,eg EGY,"FW,MF",Huddersfield,eng Premier League,21,1997,0.9,1,1,0,1,0,0,0,,0,2,0,2,1,2,0,0,Matches
2306,Marcel Sobottka,de GER,MF,Düsseldorf,de Bundesliga,24,1994,10.5,30,20,12,18,0,10,19,52.6,9,13,5,8,24,54,17,0,Matches
2307,Rubén Sobrino,es ESP,"FW,MF",Alavés,es La Liga,26,1992,10.7,16,11,7,6,3,5,13,38.5,8,16,1,15,2,18,13,0,Matches
2308,Rubén Sobrino,es ESP,"FW,MF",Valencia,es La Liga,26,1992,2.1,6,3,1,4,1,1,1,100.0,0,1,1,0,1,7,1,0,Matches
2309,Danilo Soddimo,it ITA,"MF,FW",Frosinone,it Serie A,30,1987,2.8,11,9,3,6,2,3,6,50.0,3,2,1,1,7,18,3,0,Matches
2310,Alex Sola,es ESP,DF,Real Sociedad,es La Liga,19,1999,1.0,4,3,0,3,1,3,4,75.0,1,0,0,0,1,5,2,0,Matches
2311,Dominic Solanke,eng ENG,"FW,MF",Bournemouth,eng Premier League,20,1997,3.9,8,3,1,4,3,1,8,12.5,7,4,1,3,2,10,9,0,Matches
2312,Andrés Solano,co COL,DF,Atlético Madrid,es La Liga,20,1998,0.5,4,3,2,2,0,2,2,100.0,0,1,0,1,0,4,1,0,Matches
2313,Carlos Soler,es ESP,MF,Valencia,es La Liga,21,1997,27.3,41,28,15,23,3,16,65,24.6,49,46,6,40,19,60,37,0,Matches
2314,Oumar Solet,fr FRA,DF,Lyon,fr Ligue 1,18,2000,0.7,1,0,1,0,0,1,1,100.0,0,1,0,1,0,1,0,0,Matches
2315,Yann Sommer,ch SUI,GK,M'Gladbach,de Bundesliga,29,1988,34.0,2,2,2,0,0,2,2,100.0,0,1,0,1,1,3,12,5,Matches
2316,Kévin Soni,cm CMR,"FW,DF",Girona,es La Liga,20,1998,0.9,3,2,0,2,1,2,4,50.0,2,3,0,3,1,4,0,0,Matches
2317,Jérémy Sorbon,fr FRA,DF,Guingamp,fr Ligue 1,34,1983,29.4,33,20,23,10,0,14,22,63.6,8,33,23,10,34,67,105,2,Matches
2318,Oliver Sorg,de GER,DF,Hannover 96,de Bundesliga,28,1990,17.6,42,28,26,16,0,20,43,46.5,23,16,9,7,46,88,47,0,Matches
2319,David Soria,es ESP,GK,Getafe,es La Liga,25,1993,37.0,1,0,1,0,0,1,2,50.0,1,2,0,2,1,2,15,6,Matches
2320,Juan Soriano,es ESP,GK,Sevilla,es La Liga,20,1997,4.0,0,0,0,0,0,0,0,,0,0,0,0,1,1,1,0,Matches
2321,Roberto Soriano,it ITA,MF,Torino,it Serie A,27,1991,5.2,9,5,0,5,4,1,8,12.5,7,9,0,9,6,15,1,0,Matches
2322,Roberto Soriano,it ITA,MF,Bologna,it Serie A,27,1991,16.5,27,18,14,10,3,8,24,33.3,16,21,2,19,3,30,11,0,Matches
2323,Stefano Sorrentino,it ITA,GK,Chievo,it Serie A,39,1979,31.0,1,1,1,0,0,1,2,50.0,1,0,0,0,3,4,10,1,Matches
2324,Borna Sosa,hr CRO,"DF,MF",Stuttgart,de Bundesliga,20,1998,6.8,13,7,8,4,1,4,9,44.4,5,5,1,4,6,19,34,0,Matches
2325,Sebastian Soto,us USA,"MF,FW",Hannover 96,de Bundesliga,18,2000,0.3,0,0,0,0,0,0,0,,0,0,0,0,0,0,0,0,Matches
2326,Riccardo Sottil,it ITA,"FW,MF",Fiorentina,it Serie A,19,1999,0.2,1,1,0,1,0,1,1,100.0,0,0,0,0,0,1,0,0,Matches
2327,Pape Souaré,sn SEN,DF,Crystal Palace,eng Premier League,28,1990,0.0,0,0,0,0,0,0,0,,0,0,0,0,1,1,0,0,Matches
2328,Adama Soumaoro,fr FRA,DF,Lille,fr Ligue 1,26,1992,19.1,14,11,12,2,0,4,6,66.7,2,21,18,3,21,35,92,1,Matches
2329,Boubakary Soumaré,fr FRA,MF,Lille,fr Ligue 1,19,1999,6.3,20,15,9,11,0,10,18,55.6,8,9,3,6,7,27,5,0,Matches
2330,Çağlar Söyüncü,tr TUR,DF,Leicester City,eng Premier League,22,1996,4.1,5,2,4,1,0,3,6,50.0,3,8,5,3,7,12,22,3,Matches
2331,Julián Speroni,ar ARG,GK,Crystal Palace,eng Premier League,39,1979,1.0,0,0,0,0,0,0,0,,0,0,0,0,0,0,1,2,Matches
2332,Leonardo Spinazzola,it ITA,DF,Juventus,it Serie A,25,1993,6.7,9,4,4,2,3,4,8,50.0,4,5,0,5,3,12,7,0,Matches
2333,Nicolás Spolli,ar ARG,DF,Genoa,it Serie A,35,1983,6.0,7,6,3,4,0,0,2,0.0,2,8,6,2,7,14,39,1,Matches
2334,Marco Sportiello,it ITA,GK,Frosinone,it Serie A,26,1992,35.0,1,0,1,0,0,1,1,100.0,0,1,0,1,0,1,8,2,Matches
2335,Mattia Sprocati,it ITA,"FW,MF",Parma,it Serie A,25,1993,7.2,10,4,5,5,0,5,11,45.5,6,6,0,6,7,17,6,0,Matches
2336,Bassem Srarfi,tn TUN,"FW,MF",Nice,fr Ligue 1,21,1997,9.1,20,11,8,8,4,6,17,35.3,11,8,0,8,5,25,5,0,Matches
2337,Darijo Srna,hr CRO,DF,Cagliari,it Serie A,36,1982,23.2,24,16,6,13,5,9,14,64.3,5,24,5,19,18,42,66,0,Matches
2338,Kostas Stafylidis,gr GRE,DF,Augsburg,de Bundesliga,24,1993,10.2,22,14,17,4,1,10,19,52.6,9,13,2,11,15,37,31,0,Matches
2339,Benjamin Stambouli,fr FRA,"DF,MF",Schalke 04,de Bundesliga,27,1990,19.6,51,31,24,24,3,25,46,54.3,21,41,9,32,32,83,65,2,Matches
2340,Jozo Stanić,hr CRO,MF,Augsburg,de Bundesliga,19,1999,0.0,0,0,0,0,0,0,0,,0,0,0,0,0,0,0,0,Matches
2341,Junior Stanislas,eng ENG,"MF,FW",Bournemouth,eng Premier League,28,1989,11.5,12,6,5,4,3,3,7,42.9,4,8,1,7,2,14,15,0,Matches
2342,Niklas Stark,de GER,DF,Hertha BSC,de Bundesliga,23,1995,20.8,34,19,23,11,0,9,24,37.5,15,45,26,19,37,71,141,1,Matches
2343,Timo Stavitski,fi FIN,"MF,FW",Caen,fr Ligue 1,19,1999,0.2,0,0,0,0,0,0,1,0.0,1,0,0,0,0,0,0,0,Matches
2344,Renato Steffen,ch SUI,"FW,MF",Wolfsburg,de Bundesliga,26,1991,16.7,26,17,5,17,4,7,17,41.2,10,13,2,11,16,42,14,0,Matches
2345,Marc Stendera,de GER,MF,Eint Frankfurt,de Bundesliga,22,1995,1.2,6,1,2,4,0,2,4,50.0,2,4,1,3,0,6,0,0,Matches
2346,Pascal Stenzel,de GER,"DF,MF",Freiburg,de Bundesliga,22,1996,16.1,42,26,26,14,2,24,43,55.8,19,16,3,13,30,72,48,1,Matches
2347,Dale Stephens,eng ENG,MF,Brighton,eng Premier League,29,1989,27.6,83,57,37,41,5,28,74,37.8,46,33,13,20,46,129,47,0,Matches
2348,Jack Stephens,eng ENG,DF,Southampton,eng Premier League,24,1994,18.9,25,13,17,7,1,16,28,57.1,12,25,13,12,37,62,96,2,Matches
2349,Mariusz Stępiński,pl POL,FW,Chievo,it Serie A,23,1995,27.5,18,13,1,11,6,1,17,5.9,16,10,2,8,5,23,20,0,Matches
2350,Raheem Sterling,eng ENG,FW,Manchester City,eng Premier League,23,1994,30.8,32,16,11,12,9,9,25,36.0,16,28,3,25,17,49,4,0,Matches
2351,Lars Stindl,de GER,"FW,MF",M'Gladbach,de Bundesliga,29,1988,16.8,21,14,8,11,2,3,15,20.0,12,22,2,20,14,35,13,0,Matches
2352,Kevin Stöger,at AUT,MF,Düsseldorf,de Bundesliga,24,1993,23.5,63,35,28,27,8,30,67,44.8,37,32,5,27,31,94,19,1,Matches
2353,John Stones,eng ENG,DF,Manchester City,eng Premier League,24,1994,19.6,16,11,9,5,2,4,9,44.4,5,15,9,6,14,30,64,1,Matches
2354,Thomas Strakosha,al ALB,GK,Lazio,it Serie A,23,1995,35.0,1,1,1,0,0,1,1,100.0,0,0,0,0,1,2,8,1,Matches
2355,Tobias Strobl,de GER,"MF,DF",M'Gladbach,de Bundesliga,28,1990,25.5,31,17,17,13,1,9,29,31.0,20,36,14,22,29,60,35,1,Matches
2356,Kevin Strootman,nl NED,MF,Roma,it Serie A,28,1990,1.0,2,2,1,0,1,0,1,0.0,1,5,0,5,2,4,2,0,Matches
2357,Kevin Strootman,nl NED,MF,Marseille,fr Ligue 1,28,1990,21.6,76,40,21,47,8,20,52,38.5,32,24,6,18,24,100,26,0,Matches
2358,Jens Stryger Larsen,dk DEN,DF,Udinese,it Serie A,27,1991,35.9,42,20,24,14,4,22,44,50.0,22,27,8,19,26,68,98,1,Matches
2359,Cristhian Stuani,uy URU,FW,Girona,es La Liga,31,1986,30.3,23,13,7,13,3,5,20,25.0,15,13,1,12,4,27,39,0,Matches
2360,Leo Štulac,si SVN,MF,Parma,it Serie A,23,1994,16.1,21,13,10,10,1,4,17,23.5,13,29,13,16,34,55,31,1,Matches
2361,Stefano Sturaro,it ITA,"MF,FW",Genoa,it Serie A,25,1993,2.4,4,3,0,3,1,2,9,22.2,7,3,1,2,3,7,2,0,Matches
2362,Daniel Sturridge,eng ENG,"FW,MF",Liverpool,eng Premier League,28,1989,5.7,3,3,1,1,1,2,3,66.7,1,4,0,4,1,4,0,0,Matches
2363,Damián Suárez,uy URU,DF,Getafe,es La Liga,30,1988,36.0,96,62,43,41,12,53,120,44.2,67,47,6,41,46,142,57,2,Matches
2364,Denis Suárez,es ESP,"MF,FW",Arsenal,eng Premier League,24,1994,0.8,1,1,0,1,0,0,5,0.0,5,0,0,0,1,2,0,0,Matches
2365,Denis Suárez,es ESP,"MF,DF",Barcelona,es La Liga,24,1994,0.2,0,0,0,0,0,0,0,,0,1,0,1,0,0,0,0,Matches
2366,Leonardo Suárez,ar ARG,"FW,MF",Valladolid,es La Liga,22,1996,5.7,3,3,2,0,1,2,4,50.0,2,7,1,6,1,4,4,0,Matches
2367,Luis Suárez,uy URU,FW,Barcelona,es La Liga,31,1987,31.4,18,11,1,6,11,4,10,40.0,6,12,4,8,8,26,24,0,Matches
2368,Mario Suárez,es ESP,MF,Rayo Vallecano,es La Liga,31,1987,11.4,37,23,17,17,3,15,28,53.6,13,10,3,7,14,51,17,2,Matches
2369,Mathías Suárez,uy URU,DF,Montpellier,fr Ligue 1,22,1996,6.1,20,11,7,10,3,10,23,43.5,13,11,0,11,9,29,18,0,Matches
2370,Danijel Subašić,hr CRO,GK,Monaco,fr Ligue 1,33,1984,12.6,0,0,0,0,0,0,1,0.0,1,0,0,0,0,0,6,2,Matches
2371,Neven Subotić,rs SRB,DF,Saint-Étienne,fr Ligue 1,29,1988,23.9,44,23,36,7,1,20,39,51.3,19,14,6,8,38,82,107,3,Matches
2372,Isaac Success,ng NGA,"FW,MF",Watford,eng Premier League,22,1996,11.7,15,12,4,8,3,2,5,40.0,3,6,0,6,2,17,11,0,Matches
2373,Niklas Süle,de GER,DF,Bayern Munich,de Bundesliga,22,1995,29.5,28,23,17,10,1,18,25,72.0,7,23,13,10,40,68,83,0,Matches
2374,Ki Sung-yueng,kr KOR,MF,Newcastle Utd,eng Premier League,29,1989,14.5,14,10,5,8,1,3,12,25.0,9,11,1,10,19,33,20,0,Matches
2375,Andrew Surman,eng ENG,MF,Bournemouth,eng Premier League,31,1986,16.0,11,6,6,5,0,3,13,23.1,10,20,7,13,10,21,34,1,Matches
2376,Sam Surridge,eng ENG,"MF,FW",Bournemouth,eng Premier League,20,1998,0.1,1,0,0,0,1,0,0,,0,0,0,0,0,1,0,0,Matches
2377,Markel Susaeta,es ESP,"FW,MF",Athletic Club,es La Liga,30,1987,15.3,17,10,4,6,7,3,23,13.0,20,10,1,9,12,29,5,0,Matches
2378,Suso,es ESP,"FW,MF",Milan,it Serie A,24,1993,33.5,28,18,10,14,4,10,41,24.4,31,26,1,25,16,44,3,0,Matches
2379,Markus Suttner,at AUT,"DF,MF",Düsseldorf,de Bundesliga,31,1987,5.4,10,7,5,4,1,4,8,50.0,4,8,3,5,8,18,10,0,Matches
2380,Mattias Svanberg,se SWE,MF,Bologna,it Serie A,19,1999,13.1,22,11,14,7,1,11,25,44.0,14,25,6,19,11,33,16,2,Matches
2381,Sanasi Sy,fr FRA,MF,Amiens,fr Ligue 1,19,1999,0.0,0,0,0,0,0,0,0,,0,0,0,0,0,0,0,0,Matches
2382,Seydou Sy,sn SEN,GK,Monaco,fr Ligue 1,22,1995,2.5,0,0,0,0,0,0,0,,0,0,0,0,0,0,0,1,Matches
2383,Issiaga Sylla,gn GUI,"DF,MF",Toulouse,fr Ligue 1,24,1994,22.2,54,36,30,24,0,28,53,52.8,25,36,10,26,39,93,77,0,Matches
2384,Moussa Sylla,fr FRA,"FW,MF",Monaco,fr Ligue 1,18,1999,8.5,6,4,4,1,1,2,6,33.3,4,5,2,3,2,8,5,0,Matches
2385,Eddy Sylvestre,fr FRA,"FW,MF",Nice,fr Ligue 1,18,1999,3.0,3,2,0,3,0,3,9,33.3,6,1,0,1,0,3,0,0,Matches
2386,Ádám Szalai,hu HUN,FW,Hoffenheim,de Bundesliga,30,1987,18.1,19,13,3,12,4,4,11,36.4,7,8,1,7,4,23,8,0,Matches
2387,Wojciech Szczęsny,pl POL,GK,Juventus,it Serie A,28,1990,28.0,2,1,2,0,0,1,1,100.0,0,0,0,0,1,3,8,2,Matches
2388,Alexander Sørloth,no NOR,FW,Crystal Palace,eng Premier League,22,1995,2.1,2,1,0,0,2,1,2,50.0,1,0,0,0,0,2,3,0,Matches
2389,Franck Tabanou,fr FRA,DF,Guingamp,fr Ligue 1,29,1989,2.0,4,3,4,0,0,1,2,50.0,1,0,0,0,6,10,15,0,Matches
2390,Jonathan Tah,de GER,DF,Leverkusen,de Bundesliga,22,1996,32.6,44,30,30,10,4,17,32,53.1,15,39,26,13,45,89,142,1,Matches
2391,Flavien Tait,fr FRA,"MF,FW",Angers,fr Ligue 1,25,1993,33.2,58,35,33,16,9,23,59,39.0,36,29,2,27,28,86,15,0,Matches
2392,Adrien Tameze,cm CMR,MF,Nice,fr Ligue 1,24,1994,32.7,74,44,32,31,11,39,92,42.4,53,53,12,41,56,130,59,1,Matches
2393,Strahinja Tanasijević,rs SRB,"DF,MF",Chievo,it Serie A,21,1997,0.2,0,0,0,0,0,0,0,,0,0,0,0,0,0,0,0,Matches
2394,Matt Targett,eng ENG,DF,Southampton,eng Premier League,22,1995,13.2,27,19,15,7,5,12,26,46.2,14,19,3,16,27,54,42,0,Matches
2395,Rodrigo Tarín,es ESP,DF,Leganés,es La Liga,22,1996,15.9,22,14,15,5,2,7,10,70.0,3,11,5,6,31,53,79,0,Matches
2396,James Tarkowski,eng ENG,DF,Burnley,eng Premier League,25,1992,34.3,71,36,52,18,1,29,50,58.0,21,72,56,16,42,113,240,2,Matches
2397,Ciprian Tătărușanu,ro ROU,GK,Nantes,fr Ligue 1,32,1986,26.6,0,0,0,0,0,0,0,,0,0,0,0,2,2,20,0,Matches
2398,Júlio Tavares,cv CPV,FW,Dijon,fr Ligue 1,29,1988,31.2,15,9,1,7,7,3,9,33.3,6,17,3,14,13,28,51,0,Matches
2399,Júnior Tavares,br BRA,DF,Sampdoria,it Serie A,21,1996,2.0,2,1,1,1,0,2,4,50.0,2,0,0,0,2,4,1,0,Matches
2400,Taleb Tawatha,il ISR,"FW,DF",Eint Frankfurt,de Bundesliga,26,1992,1.4,1,1,1,0,0,1,2,50.0,1,0,0,0,0,1,1,0,Matches
2401,Charlie Taylor,eng ENG,DF,Burnley,eng Premier League,24,1993,36.0,55,26,37,15,3,24,50,48.0,26,74,35,39,40,95,120,0,Matches
2402,Malik Tchokounté,fr FRA,"FW,MF",Caen,fr Ligue 1,29,1988,16.4,21,13,6,12,3,5,10,50.0,5,11,0,11,6,27,26,0,Matches
2403,Aurélien Tchouaméni,fr FRA,MF,Bordeaux,fr Ligue 1,18,2000,7.8,24,12,10,14,0,7,18,38.9,11,11,5,6,21,45,14,0,Matches
2404,Georg Teigl,at AUT,"MF,FW",Augsburg,de Bundesliga,27,1991,3.3,5,3,4,0,1,2,2,100.0,0,1,0,1,7,12,5,1,Matches
2405,Cristian Tello,es ESP,"DF,FW",Betis,es La Liga,26,1991,17.5,32,20,18,9,5,17,35,48.6,18,19,0,19,16,48,17,1,Matches
2406,Łukasz Teodorczyk,pl POL,FW,Udinese,it Serie A,27,1991,4.4,4,2,2,2,0,2,8,25.0,6,8,2,6,1,5,4,0,Matches
2407,Hidde ter Avest,nl NED,"DF,FW",Udinese,it Serie A,21,1997,10.8,26,14,17,6,3,14,20,70.0,6,14,3,11,10,36,39,1,Matches
2408,Marc-André ter Stegen,de GER,GK,Barcelona,es La Liga,26,1992,35.0,0,0,0,0,0,0,3,0.0,3,0,0,0,2,2,5,2,Matches
2409,Pietro Terracciano,it ITA,GK,Fiorentina,it Serie A,28,1990,2.0,0,0,0,0,0,0,0,,0,0,0,0,0,0,1,1,Matches
2410,Pietro Terracciano,it ITA,GK,Empoli,it Serie A,28,1990,8.0,0,0,0,0,0,0,0,,0,0,0,0,1,1,4,0,Matches
2411,Marco Terrazzino,de GER,"MF,FW",Freiburg,de Bundesliga,27,1991,5.7,6,3,4,2,0,1,7,14.3,6,5,2,3,3,9,2,0,Matches
2412,Martin Terrier,fr FRA,FW,Lyon,fr Ligue 1,21,1997,16.5,23,13,5,13,5,9,23,39.1,14,17,2,15,6,29,14,0,Matches
2413,Kenny Tete,nl NED,DF,Lyon,fr Ligue 1,22,1995,11.6,30,23,11,16,3,13,19,68.4,6,13,5,8,18,48,29,0,Matches
2414,Cedric Teuchert,de GER,"FW,MF",Schalke 04,de Bundesliga,21,1997,1.8,0,0,0,0,0,0,0,,0,2,0,2,1,1,0,0,Matches
2415,Florian Thauvin,fr FRA,"FW,MF",Marseille,fr Ligue 1,25,1993,29.0,42,23,10,21,11,16,35,45.7,19,19,1,18,8,50,4,0,Matches
2416,Cyril Théréau,fr FRA,"FW,MF",Fiorentina,it Serie A,35,1983,0.3,0,0,0,0,0,0,0,,0,0,0,0,0,0,1,0,Matches
2417,Cyril Théréau,fr FRA,FW,Cagliari,it Serie A,35,1983,1.5,1,1,0,1,0,1,1,100.0,0,0,0,0,0,1,2,0,Matches
2418,Sada Thioub,sn SEN,"MF,FW",Nîmes,fr Ligue 1,23,1995,27.5,30,19,13,10,7,20,45,44.4,25,29,1,28,16,46,11,0,Matches
2419,Romain Thomas,fr FRA,DF,Angers,fr Ligue 1,30,1988,26.6,35,26,25,10,0,14,19,73.7,5,31,24,7,29,64,133,1,Matches
2420,Adrien Thomasson,fr FRA,"MF,FW",Strasbourg,fr Ligue 1,24,1993,27.5,54,27,18,23,13,21,66,31.8,45,29,5,24,18,72,12,1,Matches
2421,Erik Thommy,de GER,"MF,FW",Stuttgart,de Bundesliga,23,1994,8.8,5,3,3,1,1,1,7,14.3,6,16,1,15,14,19,4,0,Matches
2422,Marcus Thuram,fr FRA,"FW,MF",Guingamp,fr Ligue 1,20,1997,28.6,45,28,23,15,7,20,43,46.5,23,24,1,23,10,55,14,0,Matches
2423,Youri Tielemans,be BEL,MF,Leicester City,eng Premier League,21,1997,12.1,17,8,5,9,3,5,17,29.4,12,13,2,11,5,22,13,1,Matches
2424,Youri Tielemans,be BEL,MF,Monaco,fr Ligue 1,21,1997,18.7,45,24,17,23,5,24,47,51.1,23,20,3,17,18,63,22,0,Matches
2425,Timothy Tillman,de GER,"FW,MF",Nürnberg,de Bundesliga,19,1999,2.3,0,0,0,0,0,0,4,0.0,4,3,0,3,3,3,0,2,Matches
2426,Cheick Timite,ci CIV,"FW,MF",Amiens,fr Ligue 1,20,1997,16.2,18,13,5,7,6,3,16,18.8,13,14,2,12,12,30,13,0,Matches
2427,David Timor,es ESP,MF,Girona,es La Liga,28,1989,1.8,2,2,1,1,0,0,1,0.0,1,1,1,0,3,5,3,0,Matches
2428,George Timotheou,au AUS,DF,Schalke 04,de Bundesliga,21,1997,1.0,3,3,3,0,0,0,0,,0,1,1,0,1,4,4,0,Matches
2429,Marcel Tisserand,cd COD,DF,Wolfsburg,de Bundesliga,25,1993,9.8,14,9,9,5,0,10,13,76.9,3,12,5,7,20,34,42,1,Matches
2430,Tito,es ESP,DF,Rayo Vallecano,es La Liga,33,1985,12.2,14,9,12,2,0,7,22,31.8,15,22,2,20,17,31,41,0,Matches
2431,Jean-Clair Todibo,fr FRA,DF,Barcelona,es La Liga,18,1999,1.7,7,2,4,3,0,5,6,83.3,1,1,0,1,3,10,8,0,Matches
2432,Jean-Clair Todibo,fr FRA,DF,Toulouse,fr Ligue 1,18,1999,9.3,21,18,19,2,0,11,13,84.6,2,14,5,9,14,35,62,2,Matches
2433,Karl Toko Ekambi,cm CMR,"FW,MF",Villarreal,es La Liga,25,1992,23.8,11,8,1,6,4,2,14,14.3,12,8,0,8,11,22,9,1,Matches
2434,Corentin Tolisso,fr FRA,MF,Bayern Munich,de Bundesliga,23,1994,0.6,0,0,0,0,0,0,2,0.0,2,1,1,0,0,0,0,0,Matches
2435,Rafael Tolói,it ITA,DF,Atalanta,it Serie A,27,1990,19.4,27,17,15,9,3,16,24,66.7,8,28,10,18,33,60,54,1,Matches
2436,Raúl de Tomás,es ESP,FW,Rayo Vallecano,es La Liga,23,1994,31.3,8,3,0,7,1,0,12,0.0,12,18,4,14,9,17,45,0,Matches
2437,James Tomkins,eng ENG,DF,Crystal Palace,eng Premier League,29,1989,28.4,34,20,27,7,0,15,28,53.6,13,23,10,13,34,68,184,3,Matches
2438,Nenad Tomović,rs SRB,DF,Chievo,it Serie A,30,1987,8.2,9,7,5,4,0,7,10,70.0,3,5,1,4,13,22,34,0,Matches
2439,Lorenzo Tonelli,it ITA,DF,Sampdoria,it Serie A,28,1990,18.4,31,22,19,9,3,15,19,78.9,4,27,21,6,24,55,92,0,Matches
2440,Toño,es ESP,"DF,FW",Levante,es La Liga,28,1989,19.6,17,13,12,3,2,10,21,47.6,11,20,5,15,14,31,42,0,Matches
2441,Ömer Toprak,tr TUR,DF,Dortmund,de Bundesliga,29,1989,2.6,1,1,0,1,0,0,1,0.0,1,1,1,0,0,1,7,0,Matches
2442,Lucas Torreira,uy URU,MF,Arsenal,eng Premier League,22,1996,26.5,65,39,24,32,9,25,57,43.9,32,34,7,27,41,106,33,2,Matches
2443,Daniel Torres,co COL,MF,Alavés,es La Liga,28,1989,0.8,2,1,2,0,0,0,3,0.0,3,0,0,0,2,4,0,0,Matches
2444,Ferrán Torres,es ESP,MF,Valencia,es La Liga,18,2000,9.4,15,8,4,8,3,5,11,45.5,6,10,1,9,10,25,9,0,Matches
2445,Lucas Torró,es ESP,MF,Eint Frankfurt,de Bundesliga,24,1994,6.2,14,7,5,7,2,5,11,45.5,6,12,1,11,14,28,13,0,Matches
2446,Jordan Torunarigha,de GER,DF,Hertha BSC,de Bundesliga,20,1997,12.9,34,30,23,10,1,18,28,64.3,10,19,7,12,29,63,55,0,Matches
2447,Cenk Tosun,tr TUR,FW,Everton,eng Premier League,27,1991,11.8,13,9,3,6,4,4,13,30.8,9,12,0,12,5,18,3,0,Matches
2448,Abdoulaye Touré,fr FRA,MF,Nantes,fr Ligue 1,24,1994,30.5,48,31,14,28,6,19,56,33.9,37,25,10,15,47,95,29,1,Matches
2449,Almamy Touré,ml MLI,DF,Monaco,fr Ligue 1,22,1996,3.8,13,6,6,7,0,3,10,30.0,7,3,1,2,11,24,12,0,Matches
2450,Almamy Touré,ml MLI,"DF,MF",Eint Frankfurt,de Bundesliga,22,1996,5.8,18,11,7,11,0,5,8,62.5,3,4,1,3,9,27,25,0,Matches
2451,Lucas Tousart,fr FRA,MF,Lyon,fr Ligue 1,21,1997,19.2,74,38,33,34,7,25,59,42.4,34,30,13,17,26,100,27,0,Matches
2452,Andros Townsend,eng ENG,"FW,MF",Crystal Palace,eng Premier League,27,1991,33.4,62,35,38,16,8,35,89,39.3,54,48,5,43,38,100,28,0,Matches
2453,Adama Traoré,es ESP,"FW,MF",Wolves,eng Premier League,22,1996,10.0,16,13,11,3,2,4,9,44.4,5,11,0,11,6,22,7,0,Matches
2454,Adama Traoré,ml MLI,MF,Monaco,fr Ligue 1,23,1995,2.7,2,1,1,0,1,1,4,25.0,3,4,0,4,3,5,1,0,Matches
2455,Bertrand Traoré,bf BFA,FW,Lyon,fr Ligue 1,22,1995,23.5,36,22,19,13,4,12,26,46.2,14,23,5,18,15,51,18,0,Matches
2456,Charles Traore,ml MLI,"DF,FW",Nantes,fr Ligue 1,26,1992,12.9,40,20,22,16,2,23,34,67.6,11,16,3,13,19,59,46,0,Matches
2457,Cheick Traoré,ml MLI,DF,Guingamp,fr Ligue 1,23,1995,16.8,37,21,23,11,3,15,25,60.0,10,13,3,10,23,60,46,1,Matches
2458,Gaoussou Traoré,ml MLI,MF,Amiens,fr Ligue 1,18,1999,1.2,10,5,6,4,0,4,8,50.0,4,1,0,1,0,10,0,0,Matches
2459,Hamari Traoré,ml MLI,DF,Rennes,fr Ligue 1,26,1992,33.0,61,33,32,27,2,36,71,50.7,35,39,11,28,44,105,82,0,Matches
2460,Ibrahima Traoré,gn GUI,"FW,MF",M'Gladbach,de Bundesliga,30,1988,6.1,12,6,8,2,2,3,11,27.3,8,3,1,2,3,15,1,0,Matches
2461,Ismaël Traoré,ci CIV,DF,Angers,fr Ligue 1,31,1986,29.3,27,11,19,8,0,9,24,37.5,15,27,16,11,42,69,120,2,Matches
2462,Kevin Trapp,de GER,GK,Eint Frankfurt,de Bundesliga,28,1990,32.6,0,0,0,0,0,0,2,0.0,2,0,0,0,0,0,17,1,Matches
2463,Mark Travers,ie IRL,GK,Bournemouth,eng Premier League,19,1999,2.0,0,0,0,0,0,0,0,,0,0,0,0,0,0,2,0,Matches
2464,Óscar Trejo,ar ARG,"MF,FW",Rayo Vallecano,es La Liga,30,1988,19.6,57,41,21,25,11,8,33,24.2,25,24,2,22,18,75,15,0,Matches
2465,Driss Trichard,fr FRA,DF,Bordeaux,fr Ligue 1,23,1995,1.0,2,2,2,0,0,1,1,100.0,0,1,0,1,1,3,4,0,Matches
2466,Manu Trigueros,es ESP,MF,Villarreal,es La Liga,26,1991,17.2,46,35,18,23,5,20,57,35.1,37,17,6,11,16,62,17,0,Matches
2467,Kieran Trippier,eng ENG,DF,Tottenham,eng Premier League,27,1990,25.3,67,37,43,16,8,37,62,59.7,25,38,5,33,23,90,77,2,Matches
2468,William Troost-Ekong,ng NGA,DF,Udinese,it Serie A,24,1993,34.0,31,15,21,9,1,13,24,54.2,11,53,41,12,40,71,200,2,Matches
2469,Marcello Trotta,it ITA,FW,Frosinone,it Serie A,25,1992,4.4,7,6,2,4,1,1,3,33.3,2,2,1,1,3,10,3,0,Matches
2470,Marcello Trotta,it ITA,MF,Sassuolo,it Serie A,25,1992,0.1,0,0,0,0,0,0,1,0.0,1,0,0,0,0,0,0,0,Matches
2471,Philipp Tschauner,de GER,GK,Hannover 96,de Bundesliga,32,1985,1.0,0,0,0,0,0,0,0,,0,0,0,0,0,0,0,0,Matches
2472,Marco Tumminello,it ITA,"FW,DF",Atalanta,it Serie A,19,1998,0.1,0,0,0,0,0,0,0,,0,0,0,0,0,0,0,0,Matches
2473,Patrick Twumasi,gh GHA,"MF,FW",Alavés,es La Liga,24,1994,1.9,3,3,2,0,1,0,4,0.0,4,2,0,2,1,4,1,0,Matches
2474,Salih Uçan,tr TUR,MF,Empoli,it Serie A,24,1994,2.9,10,4,3,5,2,3,10,30.0,7,4,0,4,6,16,2,0,Matches
2475,Anthony Ujah,ng NGA,FW,Mainz 05,de Bundesliga,27,1990,8.2,2,0,0,1,1,1,2,50.0,1,7,2,5,1,3,10,0,Matches
2476,Sven Ulreich,de GER,GK,Bayern Munich,de Bundesliga,29,1988,8.4,0,0,0,0,0,0,0,,0,0,0,0,0,0,2,1,Matches
2477,Samuel Umtiti,fr FRA,DF,Barcelona,es La Liga,24,1993,13.2,8,5,3,4,1,4,6,66.7,2,10,8,2,18,26,28,2,Matches
2478,Enes Ünal,tr TUR,FW,Valladolid,es La Liga,21,1997,23.9,17,10,3,4,10,4,24,16.7,20,17,4,13,2,19,18,0,Matches
2479,Cengiz Ünder,tr TUR,FW,Roma,it Serie A,21,1997,15.3,6,3,3,3,0,2,11,18.2,9,7,0,7,13,19,5,0,Matches
2480,Joel Untersee,ch SUI,DF,Empoli,it Serie A,24,1994,1.4,3,2,1,2,0,2,3,66.7,1,2,1,1,1,4,5,1,Matches
2481,Dayot Upamecano,fr FRA,DF,RB Leipzig,de Bundesliga,19,1998,14.4,22,16,14,8,0,15,18,83.3,3,19,5,14,33,55,47,0,Matches
2482,Takashi Usami,jp JPN,"MF,FW",Düsseldorf,de Bundesliga,26,1992,9.8,18,12,7,11,0,9,26,34.6,17,15,2,13,8,26,13,1,Matches
2483,Mark Uth,de GER,"FW,MF",Schalke 04,de Bundesliga,26,1991,15.6,20,11,8,8,4,4,23,17.4,19,19,2,17,8,28,12,0,Matches
2484,Tomáš Vaclík,cz CZE,GK,Sevilla,es La Liga,29,1989,33.0,0,0,0,0,0,0,1,0.0,1,0,0,0,0,0,9,6,Matches
2485,Valentín Vada,ar ARG,MF,Bordeaux,fr Ligue 1,22,1996,0.4,2,1,0,2,0,1,1,100.0,0,0,0,0,0,2,0,0,Matches
2486,Valentín Vada,ar ARG,MF,Saint-Étienne,fr Ligue 1,22,1996,4.5,7,4,4,3,0,3,12,25.0,9,4,1,3,7,14,4,0,Matches
2487,William Vainqueur,fr FRA,MF,Monaco,fr Ligue 1,29,1988,0.9,6,3,4,2,0,1,1,100.0,0,1,0,1,0,6,0,0,Matches
2488,Mirko Valdifiori,it ITA,MF,SPAL,it Serie A,32,1986,7.4,20,15,12,7,1,8,14,57.1,6,4,2,2,5,25,9,0,Matches
2489,Pierrick Valdivia,fr FRA,MF,Nîmes,fr Ligue 1,30,1988,0.3,1,1,0,1,0,1,2,50.0,1,1,0,1,1,2,0,0,Matches
2490,Antonio Valencia,ec ECU,DF,Manchester Utd,eng Premier League,32,1985,5.2,8,6,2,4,2,3,4,75.0,1,9,0,9,5,13,10,0,Matches
2491,Enrico Valentini,it ITA,DF,Nürnberg,de Bundesliga,29,1989,14.4,44,27,31,10,3,22,40,55.0,18,17,3,14,13,57,58,0,Matches
2492,Borja Valero,es ESP,MF,Inter,it Serie A,33,1985,13.7,22,19,9,10,3,8,30,26.7,22,11,1,10,16,38,27,2,Matches
2493,Valery,es ESP,"DF,MF",Southampton,eng Premier League,18,1999,19.0,,35,,,,,,,,,,,20,,,,Matches
2494,Valery,es ESP,"DF,FW",Girona,es La Liga,18,1999,9.9,20,15,13,6,1,10,17,58.8,7,15,1,14,8,28,10,0,Matches
2495,Jesús Vallejo,es ESP,DF,Real Madrid,es La Liga,21,1997,3.5,6,5,4,2,0,5,6,83.3,1,4,4,0,7,13,12,0,Matches
2496,Theo Valls,fr FRA,MF,Nîmes,fr Ligue 1,22,1995,19.7,37,21,16,19,2,15,43,34.9,28,17,4,13,22,59,15,0,Matches
2497,Mattia Valoti,it ITA,MF,SPAL,it Serie A,24,1993,13.6,33,19,13,14,6,13,29,44.8,16,23,0,23,19,52,17,1,Matches
2498,Federico Valverde,uy URU,MF,Real Madrid,es La Liga,20,1998,7.3,12,8,3,7,2,5,11,45.5,6,10,2,8,21,33,10,0,Matches
2499,Luca Valzania,it ITA,MF,Frosinone,it Serie A,22,1996,10.0,21,12,7,10,4,13,33,39.4,20,18,0,18,16,37,8,1,Matches
2500,Luca Valzania,it ITA,MF,Atalanta,it Serie A,22,1996,0.8,5,4,2,3,0,3,5,60.0,2,0,0,0,1,6,0,0,Matches
2501,Virgil van Dijk,nl NED,DF,Liverpool,eng Premier League,27,1991,37.6,38,28,26,11,1,14,14,100.0,0,29,18,11,40,78,201,1,Matches
2502,Raphaël Varane,fr FRA,DF,Real Madrid,es La Liga,25,1993,30.6,33,18,25,7,1,15,19,78.9,4,21,9,12,32,65,141,1,Matches
2503,Jamie Vardy,eng ENG,FW,Leicester City,eng Premier League,31,1987,30.3,14,8,3,6,5,4,17,23.5,13,16,1,15,6,20,28,0,Matches
2504,Franco Vázquez,ar ARG,MF,Sevilla,es La Liga,29,1989,25.3,51,37,21,21,9,23,66,34.8,43,25,2,23,23,74,27,1,Matches
2505,Kevin Vázquez,es ESP,DF,Celta Vigo,es La Liga,25,1993,2.4,6,5,5,0,1,4,7,57.1,3,8,3,5,2,8,9,0,Matches
2506,Lucas Vázquez,es ESP,"FW,MF",Real Madrid,es La Liga,27,1991,16.8,43,26,11,21,11,15,41,36.6,26,16,1,15,12,55,11,0,Matches
2507,Matías Vecino,uy URU,MF,Inter,it Serie A,26,1991,22.4,50,39,18,23,9,26,53,49.1,27,38,9,29,17,67,22,0,Matches
2508,Koke Vegas,es ESP,GK,Levante,es La Liga,22,1995,1.0,0,0,0,0,0,0,0,,0,0,0,0,0,0,0,0,Matches
2509,Emiliano Velázquez,uy URU,DF,Rayo Vallecano,es La Liga,24,1994,14.2,49,32,38,9,2,20,34,58.8,14,29,7,22,47,96,106,1,Matches
2510,Miloš Veljković,rs SRB,DF,Werder Bremen,de Bundesliga,22,1995,20.9,36,24,29,6,1,22,37,59.5,15,27,13,14,27,63,111,0,Matches
2511,Miguel Veloso,pt POR,MF,Genoa,it Serie A,32,1986,14.0,31,20,14,13,4,9,26,34.6,17,12,1,11,13,44,21,0,Matches
2512,Daniele Verde,it ITA,"MF,FW",Valladolid,es La Liga,22,1996,7.3,6,3,2,2,2,1,6,16.7,5,3,0,3,7,13,3,1,Matches
2513,Francesco Verde,it ITA,FW,Cagliari,it Serie A,19,1999,0.1,1,0,0,1,0,0,0,,0,0,0,0,0,1,0,0,Matches
2514,Simone Verdi,it ITA,"MF,FW",Napoli,it Serie A,26,1992,7.8,16,11,5,9,2,8,16,50.0,8,6,0,6,4,20,3,0,Matches
2515,Jordan Veretout,fr FRA,MF,Fiorentina,it Serie A,25,1993,32.7,64,40,22,31,11,21,52,40.4,31,33,7,26,46,110,54,2,Matches
2516,Paul Verhaegh,nl NED,DF,Wolfsburg,de Bundesliga,34,1983,2.0,1,0,0,0,1,1,2,50.0,1,5,0,5,1,2,7,1,Matches
2517,Thomas Vermaelen,be BEL,DF,Barcelona,es La Liga,32,1985,6.5,6,4,3,3,0,3,7,42.9,4,4,2,2,6,12,21,0,Matches
2518,Marco Verratti,it ITA,MF,Paris S-G,fr Ligue 1,25,1992,20.9,72,42,25,39,8,36,81,44.4,45,26,1,25,18,90,8,2,Matches
2519,Jan Vertonghen,be BEL,DF,Tottenham,eng Premier League,31,1987,21.2,39,24,17,20,2,14,24,58.3,10,18,11,7,32,71,81,0,Matches
2520,Freddie Veseli,al ALB,DF,Empoli,it Serie A,25,1992,28.2,34,21,16,15,3,19,27,70.4,8,28,17,11,30,64,99,1,Matches
2521,Mikel Vesga,es ESP,MF,Leganés,es La Liga,25,1993,23.0,50,32,27,15,8,20,82,24.4,62,42,4,38,39,89,26,0,Matches
2522,Jannik Vestergaard,dk DEN,DF,Southampton,eng Premier League,25,1992,22.5,53,33,37,13,3,28,45,62.2,17,35,20,15,35,88,174,1,Matches
2523,Rúben Vezo,pt POR,DF,Levante,es La Liga,24,1994,14.9,26,17,17,8,1,14,22,63.6,8,23,20,3,19,45,88,0,Matches
2524,Rúben Vezo,pt POR,DF,Valencia,es La Liga,24,1994,2.2,2,1,2,0,0,2,4,50.0,2,2,1,1,2,4,10,0,Matches
2525,Francesco Vicari,it ITA,DF,SPAL,it Serie A,23,1994,25.9,28,24,21,7,0,18,28,64.3,10,31,24,7,34,62,139,1,Matches
2526,Aleix Vidal,es ESP,"DF,MF",Sevilla,es La Liga,28,1989,5.9,13,11,5,5,3,5,14,35.7,9,5,0,5,4,17,12,0,Matches
2527,Arturo Vidal,cl CHI,MF,Barcelona,es La Liga,31,1987,21.4,78,44,32,37,9,30,69,43.5,39,46,5,41,29,107,23,1,Matches
2528,Ronaldo Vieira,gw GNB,MF,Sampdoria,it Serie A,20,1998,6.7,,10,,,,,,,,,,,7,,,,Matches
2529,Luciano Vietto,ar ARG,"FW,MF",Fulham,eng Premier League,24,1993,11.0,15,11,5,5,5,4,19,21.1,15,9,0,9,6,21,5,0,Matches
2530,Carlos Vigaray,es ESP,DF,Alavés,es La Liga,23,1994,7.2,15,8,10,4,1,9,15,60.0,6,6,1,5,6,21,24,1,Matches
2531,Emanuel Vignato,it ITA,"MF,FW",Chievo,it Serie A,17,2000,7.3,8,4,4,3,1,0,6,0.0,6,4,0,4,10,18,0,0,Matches
2532,Dídac Vilà,es ESP,DF,Espanyol,es La Liga,29,1989,26.2,67,31,33,26,8,31,58,53.4,27,41,12,29,53,120,94,1,Matches
2533,Toni Villa,es ESP,"MF,FW",Valladolid,es La Liga,23,1995,19.6,51,32,24,18,9,20,47,42.6,27,15,0,15,12,63,10,0,Matches
2534,Rúben Vinagre,pt POR,"DF,MF",Wolves,eng Premier League,19,1999,7.9,14,9,7,7,0,2,5,40.0,3,10,2,8,14,28,16,1,Matches
2535,Carlos Vinícius,br BRA,"FW,MF",Monaco,fr Ligue 1,23,1995,5.8,4,1,1,2,1,0,1,0.0,1,7,0,7,1,5,2,0,Matches
2536,Vitolo,es ESP,"MF,FW",Atlético Madrid,es La Liga,28,1989,8.4,17,13,8,6,3,6,19,31.6,13,8,1,7,10,27,6,0,Matches
2537,Federico Viviani,it ITA,MF,Frosinone,it Serie A,26,1992,3.7,6,5,2,3,1,3,8,37.5,5,6,3,3,8,14,2,0,Matches
2538,Emiliano Viviano,it ITA,GK,SPAL,it Serie A,32,1985,16.9,0,0,0,0,0,0,0,,0,0,0,0,0,0,5,2,Matches
2539,Felipe Vizeu,br BRA,"FW,DF",Udinese,it Serie A,21,1997,0.4,0,0,0,0,0,0,0,,0,0,0,0,0,0,0,0,Matches
2540,Dušan Vlahović,rs SRB,FW,Fiorentina,it Serie A,18,2000,1.8,0,0,0,0,0,0,0,,0,2,0,2,0,0,4,0,Matches
2541,Rai Vloet,nl NED,MF,Frosinone,it Serie A,23,1995,1.4,4,2,1,2,1,0,3,0.0,3,4,0,4,0,4,1,0,Matches
2542,Kevin Vogt,de GER,DF,Hoffenheim,de Bundesliga,26,1991,26.6,24,15,20,4,0,12,32,37.5,20,28,11,17,33,57,103,3,Matches
2543,Sam Vokes,wls WAL,FW,Burnley,eng Premier League,28,1989,10.2,4,2,1,2,1,0,0,,0,2,1,1,0,4,17,0,Matches
2544,Kevin Volland,de GER,FW,Leverkusen,de Bundesliga,26,1992,31.3,33,20,7,14,12,13,27,48.1,14,17,1,16,6,39,33,0,Matches
2545,Michel Vorm,nl NED,GK,Tottenham,eng Premier League,34,1983,2.0,0,0,0,0,0,0,0,,0,0,0,0,0,0,1,0,Matches
2546,Stefan de Vrij,nl NED,DF,Inter,it Serie A,26,1992,28.0,25,16,14,10,1,8,15,53.3,7,32,23,9,25,50,95,1,Matches
2547,Šime Vrsaljko,hr CRO,DF,Inter,it Serie A,26,1992,8.1,20,14,8,6,6,9,14,64.3,5,5,1,4,11,31,27,1,Matches
2548,Nikola Vukčević,me MNE,MF,Levante,es La Liga,26,1991,7.4,25,18,12,9,4,9,24,37.5,15,15,5,10,10,35,17,0,Matches
2549,Matěj Vydra,cz CZE,FW,Burnley,eng Premier League,26,1992,3.5,2,1,0,1,1,0,3,0.0,3,4,1,3,1,3,6,0,Matches
2550,Paul Wade,fr FRA,MF,Nice,fr Ligue 1,18,2000,0.1,0,0,0,0,0,0,3,0.0,3,0,0,0,0,0,1,0,Matches
2551,Sandro Wagner,de GER,FW,Bayern Munich,de Bundesliga,30,1987,1.6,3,2,0,2,1,0,1,0.0,1,0,0,0,0,3,2,0,Matches
2552,Molla Wagué,ml MLI,DF,Udinese,it Serie A,27,1991,1.1,1,1,1,0,0,0,1,0.0,1,1,0,1,4,5,5,0,Matches
2553,Moussa Wagué,sn SEN,"DF,FW",Barcelona,es La Liga,19,1998,2.5,6,5,1,4,1,3,7,42.9,4,1,0,1,4,10,3,0,Matches
2554,Wakaso,gh GHA,MF,Alavés,es La Liga,28,1990,18.5,46,30,23,19,4,12,36,33.3,24,37,9,28,16,62,19,2,Matches
2555,Walace,br BRA,MF,Hannover 96,de Bundesliga,23,1995,22.2,52,22,17,28,7,27,61,44.3,34,30,4,26,45,97,36,1,Matches
2556,Theo Walcott,eng ENG,"FW,MF",Everton,eng Premier League,29,1989,23.5,27,17,11,9,7,10,22,45.5,12,17,1,16,22,49,8,0,Matches
2557,Luca Waldschmidt,de GER,"FW,MF",Freiburg,de Bundesliga,22,1996,19.1,20,13,7,10,3,2,20,10.0,18,20,3,17,13,33,8,1,Matches
2558,Kyle Walker,eng ENG,DF,Manchester City,eng Premier League,28,1990,30.9,40,26,20,20,0,24,38,63.2,14,19,5,14,36,76,58,2,Matches
2559,Kyle Walker-Peters,eng ENG,DF,Tottenham,eng Premier League,21,1997,4.2,7,4,4,2,1,3,4,75.0,1,5,1,4,4,11,6,0,Matches
2560,Wallace,br BRA,DF,Lazio,it Serie A,23,1994,13.7,17,13,11,6,0,8,17,47.1,9,13,7,6,30,47,60,2,Matches
2561,Anthony Walongwa,cd COD,DF,Nantes,fr Ligue 1,24,1993,1.0,0,0,0,0,0,0,0,,0,3,2,1,1,1,2,0,Matches
2562,Rémi Walter,fr FRA,MF,Nice,fr Ligue 1,23,1995,9.3,20,12,7,10,3,5,15,33.3,10,9,1,8,6,26,11,0,Matches
2563,Aaron Wan-Bissaka,eng ENG,DF,Crystal Palace,eng Premier League,20,1997,34.8,129,90,90,33,6,55,65,84.6,10,49,16,33,84,213,161,0,Matches
2564,Victor Wanyama,ke KEN,MF,Tottenham,eng Premier League,27,1991,5.7,13,13,8,5,0,6,12,50.0,6,9,3,6,7,20,11,0,Matches
2565,Danny Ward,eng ENG,FW,Cardiff City,eng Premier League,26,1991,4.9,2,1,0,1,1,0,3,0.0,3,3,1,2,0,2,9,0,Matches
2566,Joel Ward,eng ENG,DF,Crystal Palace,eng Premier League,28,1989,6.1,12,7,7,4,1,3,10,30.0,7,2,0,2,10,22,35,0,Matches
2567,Stephen Ward,ie IRL,DF,Burnley,eng Premier League,32,1985,2.5,4,2,1,2,1,1,4,25.0,3,3,1,2,4,8,14,0,Matches
2568,James Ward-Prowse,eng ENG,"MF,DF",Southampton,eng Premier League,23,1994,21.6,36,17,19,13,4,14,43,32.6,29,30,6,24,27,63,59,0,Matches
2569,Daniel Wass,dk DEN,"DF,MF",Valencia,es La Liga,29,1989,26.2,35,25,9,19,7,20,42,47.6,22,23,4,19,34,69,49,0,Matches
2570,Timothy Weah,us USA,FW,Paris S-G,fr Ligue 1,18,2000,0.6,0,0,0,0,0,0,0,,0,0,0,0,0,0,0,0,Matches
2571,Wout Weghorst,nl NED,FW,Wolfsburg,de Bundesliga,25,1992,32.5,30,23,10,12,8,7,35,20.0,28,27,3,24,9,39,33,0,Matches
2572,Julian Weigl,de GER,"DF,MF",Dortmund,de Bundesliga,22,1995,16.2,32,18,19,12,1,24,41,58.5,17,18,10,8,16,48,56,2,Matches
2573,Mitchell Weiser,de GER,DF,Leverkusen,de Bundesliga,24,1994,23.5,63,37,34,22,7,26,50,52.0,24,31,3,28,27,90,48,0,Matches
2574,Danny Welbeck,eng ENG,"FW,MF",Arsenal,eng Premier League,27,1990,1.7,3,2,0,2,1,0,0,,0,2,0,2,1,4,2,0,Matches
2575,Wendell,br BRA,DF,Leverkusen,de Bundesliga,25,1993,25.3,75,48,47,24,4,34,57,59.6,23,49,13,36,29,104,66,0,Matches
2576,Oscar Wendt,se SWE,DF,M'Gladbach,de Bundesliga,32,1985,30.3,45,34,34,8,3,31,53,58.5,22,37,11,26,19,64,90,0,Matches
2577,Axel Werner,ar ARG,GK,Huesca,es La Liga,22,1996,6.0,0,0,0,0,0,0,0,,0,0,0,0,0,0,2,0,Matches
2578,Timo Werner,de GER,FW,RB Leipzig,de Bundesliga,22,1996,27.9,18,12,6,8,4,3,16,18.8,13,18,2,16,3,21,7,0,Matches
2579,Ashley Westwood,eng ENG,MF,Burnley,eng Premier League,28,1990,31.4,58,30,24,27,7,14,39,35.9,25,38,9,29,47,105,42,2,Matches
2580,Hendrik Weydandt,de GER,FW,Hannover 96,de Bundesliga,23,1995,19.1,18,12,7,8,3,3,24,12.5,21,14,4,10,5,23,44,0,Matches
2581,Connor Wickham,eng ENG,"FW,MF",Crystal Palace,eng Premier League,25,1993,0.7,0,0,0,0,0,0,0,,0,0,0,0,0,0,2,0,Matches
2582,Georginio Wijnaldum,nl NED,MF,Liverpool,eng Premier League,27,1990,30.3,41,28,14,20,7,14,27,51.9,13,21,7,14,21,62,24,0,Matches
2583,Jetro Willems,nl NED,"MF,DF",Eint Frankfurt,de Bundesliga,24,1994,8.1,20,15,10,8,2,9,15,60.0,6,10,4,6,10,30,14,0,Matches
2584,William,br BRA,DF,Wolfsburg,de Bundesliga,23,1995,29.7,82,57,52,21,9,35,75,46.7,40,41,2,39,85,167,127,3,Matches
2585,Danny Williams,us USA,MF,Huddersfield,eng Premier League,29,1989,1.1,0,0,0,0,0,0,0,,0,4,1,3,1,1,2,0,Matches
2586,Iñaki Williams,gh GHA,FW,Athletic Club,es La Liga,24,1994,33.6,27,18,9,7,11,5,22,22.7,17,22,1,21,7,34,33,0,Matches
2587,Willian,br BRA,FW,Chelsea,eng Premier League,29,1988,23.3,35,21,11,15,9,9,25,36.0,16,16,1,15,14,49,12,2,Matches
2588,Joe Willock,eng ENG,"MF,FW",Arsenal,eng Premier League,18,1999,0.7,1,0,0,1,0,0,0,,0,1,0,1,1,2,0,0,Matches
2589,Ben Wilmot,eng ENG,"MF,DF",Watford,eng Premier League,18,1999,0.3,0,0,0,0,0,0,1,0.0,1,2,1,1,0,0,1,0,Matches
2590,Ben Wilmot,eng ENG,"DF,MF",Udinese,it Serie A,18,1999,2.2,0,0,0,0,0,0,2,0.0,2,2,2,0,2,2,11,0,Matches
2591,Jack Wilshere,eng ENG,MF,West Ham,eng Premier League,26,1992,4.4,7,4,1,4,2,2,6,33.3,4,3,1,2,7,14,0,0,Matches
2592,Callum Wilson,eng ENG,FW,Bournemouth,eng Premier League,26,1992,28.1,9,7,4,3,2,0,8,0.0,8,14,4,10,4,13,16,0,Matches
2593,Kevin Wimmer,at AUT,DF,Hannover 96,de Bundesliga,25,1992,18.7,25,17,17,6,2,15,27,55.6,12,30,23,7,41,66,63,0,Matches
2594,Harry Winks,eng ENG,MF,Tottenham,eng Premier League,22,1996,17.7,22,13,12,9,1,5,30,16.7,25,19,3,16,21,43,19,0,Matches
2595,Axel Witsel,be BEL,MF,Dortmund,de Bundesliga,29,1989,31.9,47,33,19,24,4,17,28,60.7,11,33,6,27,47,94,49,0,Matches
2596,Maximilian Wöber,at AUT,DF,Sevilla,es La Liga,20,1998,6.0,12,9,8,2,2,3,6,50.0,3,6,0,6,7,19,16,0,Matches
2597,Marius Wolf,de GER,"DF,FW",Dortmund,de Bundesliga,23,1995,9.2,14,10,11,3,0,5,13,38.5,8,6,0,6,13,27,12,0,Matches
2598,Jeong Woo-yeong,kr KOR,FW,Bayern Munich,de Bundesliga,18,1999,0.1,0,0,0,0,0,0,1,0.0,1,0,0,0,0,0,0,0,Matches
2599,Bobby Wood,us USA,"FW,MF",Hannover 96,de Bundesliga,25,1992,13.1,13,10,2,10,1,5,8,62.5,3,2,0,2,4,17,6,0,Matches
2600,Chris Wood,nz NZL,FW,Burnley,eng Premier League,26,1991,28.8,12,8,0,7,5,5,17,29.4,12,17,4,13,3,15,26,0,Matches
2601,Haji Wright,us USA,FW,Schalke 04,de Bundesliga,20,1998,2.2,3,2,1,1,1,0,1,0.0,1,1,0,1,0,3,1,0,Matches
2602,Xeka,pt POR,MF,Lille,fr Ligue 1,23,1994,25.1,59,31,25,27,7,18,57,31.6,39,20,2,18,21,80,30,4,Matches
2603,Granit Xhaka,ch SUI,"MF,DF",Arsenal,eng Premier League,25,1992,27.8,52,29,29,20,3,24,59,40.7,35,35,9,26,36,88,56,3,Matches
2604,Cédric Yamberé,cf CTA,DF,Dijon,fr Ligue 1,27,1990,31.2,47,31,36,11,0,21,39,53.8,18,45,32,13,52,99,136,4,Matches
2605,Andriy Yarmolenko,ua UKR,"MF,FW",West Ham,eng Premier League,28,1989,5.1,4,1,2,1,1,4,6,66.7,2,4,1,3,2,6,4,2,Matches
2606,John Yeboah,de GER,"MF,FW",Wolfsburg,de Bundesliga,18,2000,0.6,0,0,0,0,0,0,3,0.0,3,1,0,1,1,1,0,0,Matches
2607,DeAndre Yedlin,us USA,DF,Newcastle Utd,eng Premier League,25,1993,27.5,54,32,36,14,4,19,41,46.3,22,36,10,26,28,82,88,0,Matches
2608,Yoel,es ESP,GK,Valladolid,es La Liga,29,1988,3.0,0,0,0,0,0,0,0,,0,0,0,0,0,0,0,1,Matches
2609,Okay Yokuşlu,tr TUR,MF,Celta Vigo,es La Liga,24,1994,24.4,61,39,31,28,2,28,45,62.2,17,32,11,21,37,98,53,2,Matches
2610,Maya Yoshida,jp JPN,DF,Southampton,eng Premier League,29,1988,16.9,16,12,5,10,1,4,13,30.8,9,24,20,4,42,58,103,1,Matches
2611,Elie Youan,fr FRA,FW,Nantes,fr Ligue 1,19,1999,0.2,1,0,0,1,0,0,0,,0,0,0,0,0,1,0,0,Matches
2612,Amin Younes,de GER,"MF,FW",Napoli,it Serie A,24,1993,5.5,11,6,3,6,2,3,6,50.0,3,7,0,7,2,13,0,0,Matches
2613,Ashley Young,eng ENG,DF,Manchester Utd,eng Premier League,33,1985,28.5,52,32,34,16,2,20,39,51.3,19,36,10,26,55,107,74,0,Matches
2614,Zaydou Youssouf,fr FRA,"MF,FW",Bordeaux,fr Ligue 1,19,1999,4.7,7,5,3,4,0,3,7,42.9,4,5,1,4,5,12,0,0,Matches
2615,Pablo Zabaleta,ar ARG,DF,West Ham,eng Premier League,33,1985,23.2,47,24,26,15,6,17,44,38.6,27,39,15,24,48,95,96,3,Matches
2616,Dan-Axel Zagadou,fr FRA,DF,Dortmund,de Bundesliga,19,1999,14.1,13,10,10,2,1,4,6,66.7,2,17,11,6,25,38,70,2,Matches
2617,Wilfried Zaha,ci CIV,FW,Crystal Palace,eng Premier League,25,1992,33.7,39,20,11,23,5,12,34,35.3,22,19,0,19,10,49,4,0,Matches
2618,Younn Zahary,km COM,DF,Caen,fr Ligue 1,19,1998,8.2,16,9,7,6,3,8,14,57.1,6,13,8,5,16,32,35,0,Matches
2619,Miha Zajc,si SVN,"MF,FW",Empoli,it Serie A,24,1994,13.0,6,4,1,1,4,2,11,18.2,9,15,4,11,5,11,8,0,Matches
2620,Denis Zakaria,ch SUI,MF,M'Gladbach,de Bundesliga,21,1996,21.8,40,21,15,24,1,12,30,40.0,18,38,9,29,26,66,20,0,Matches
2621,Joseba Zaldúa,es ESP,DF,Real Sociedad,es La Liga,26,1992,23.8,36,27,23,10,3,15,32,46.9,17,19,3,16,38,74,72,0,Matches
2622,Andre-Frank Zambo Anguissa,cm CMR,MF,Fulham,eng Premier League,22,1995,16.9,48,29,23,20,5,18,52,34.6,34,25,6,19,34,82,32,0,Matches
2623,Francesco Zampano,it ITA,"DF,MF",Frosinone,it Serie A,24,1993,23.4,35,25,23,9,3,15,31,48.4,16,24,4,20,13,48,48,0,Matches
2624,Nicolò Zaniolo,it ITA,"MF,FW",Roma,it Serie A,19,1999,19.6,35,21,7,18,10,7,37,18.9,30,14,0,14,13,48,8,0,Matches
2625,Cristián Zapata,co COL,DF,Milan,it Serie A,31,1986,11.4,23,16,15,7,1,9,10,90.0,1,18,15,3,8,31,59,0,Matches
2626,Duván Zapata,co COL,FW,Atalanta,it Serie A,27,1991,32.2,9,5,3,2,4,1,9,11.1,8,26,6,20,4,13,25,0,Matches
2627,Davide Zappacosta,it ITA,DF,Chelsea,eng Premier League,26,1992,1.4,0,0,0,0,0,0,1,0.0,1,0,0,0,3,3,5,0,Matches
2628,Simone Zaza,it ITA,"FW,MF",Torino,it Serie A,27,1991,16.0,20,9,3,12,5,1,8,12.5,7,12,1,11,4,24,9,0,Matches
2629,Marvin Zeegelaar,nl NED,DF,Udinese,it Serie A,27,1990,10.6,30,23,21,6,3,16,24,66.7,8,11,2,9,17,47,38,0,Matches
2630,Mehdi Zeffane,dz ALG,"DF,MF",Rennes,fr Ligue 1,26,1992,13.5,19,13,12,7,0,10,26,38.5,16,14,5,9,18,37,35,1,Matches
2631,Arton Zekaj,xk KVX,FW,Lille,fr Ligue 1,18,2000,0.0,0,0,0,0,0,0,0,,0,0,0,0,0,0,0,0,Matches
2632,Mootaz Zemzemi,tn TUN,"FW,MF",Strasbourg,fr Ligue 1,18,1999,0.0,1,0,0,0,1,0,0,,0,0,0,0,0,1,0,0,Matches
2633,Arber Zeneli,xk KVX,FW,Reims,fr Ligue 1,23,1995,9.0,8,6,3,2,3,0,10,0.0,10,3,0,3,2,10,3,1,Matches
2634,Robin Zentner,de GER,GK,Mainz 05,de Bundesliga,23,1994,10.0,0,0,0,0,0,0,1,0.0,1,0,0,0,1,1,3,0,Matches
2635,Nabil El Zhar,ma MAR,"MF,FW",Leganés,es La Liga,31,1986,10.7,8,4,2,4,2,0,5,0.0,5,4,0,4,4,12,1,0,Matches
2636,Luca Zidane,fr FRA,GK,Real Madrid,es La Liga,20,1998,1.0,0,0,0,0,0,0,0,,0,0,0,0,0,0,0,0,Matches
2637,Ron-Robert Zieler,de GER,GK,Stuttgart,de Bundesliga,29,1989,34.0,2,1,2,0,0,1,4,25.0,3,1,0,1,1,3,19,3,Matches
2638,Piotr Zieliński,pl POL,MF,Napoli,it Serie A,24,1994,31.9,41,25,11,20,10,13,34,38.2,21,30,4,26,20,61,18,0,Matches
2639,Jean Zimmer,de GER,"DF,FW",Düsseldorf,de Bundesliga,24,1993,15.9,17,11,11,5,1,6,16,37.5,10,13,2,11,11,28,32,1,Matches
2640,Matthias Zimmermann,de GER,"DF,MF",Düsseldorf,de Bundesliga,26,1992,33.9,97,64,69,24,4,45,90,50.0,45,51,18,33,67,164,90,2,Matches
2641,Oleksandr Zinchenko,ua UKR,DF,Manchester City,eng Premier League,21,1996,12.8,34,20,13,15,6,14,33,42.4,19,14,3,11,20,54,19,1,Matches
2642,Kévin Zohi,ml MLI,"FW,MF",Strasbourg,fr Ligue 1,21,1996,7.0,14,10,6,6,2,5,9,55.6,4,8,0,8,7,21,5,0,Matches
2643,Kenneth Zohore,dk DEN,FW,Cardiff City,eng Premier League,24,1994,8.4,3,2,0,3,0,1,3,33.3,2,4,2,2,2,5,5,0,Matches
2644,Kurt Zouma,fr FRA,DF,Everton,eng Premier League,23,1994,29.0,32,21,16,14,2,4,11,36.4,7,27,12,15,54,86,126,2,Matches
2645,Adam Zreľák,sk SVK,FW,Nürnberg,de Bundesliga,24,1994,10.5,14,9,2,11,1,5,9,55.6,4,14,2,12,2,16,13,0,Matches
2646,Igor Zubeldia,es ESP,MF,Real Sociedad,es La Liga,21,1997,28.3,61,35,32,24,5,22,54,40.7,32,30,6,24,45,106,60,0,Matches
2647,Steven Zuber,ch SUI,"MF,FW",Hoffenheim,de Bundesliga,26,1991,6.3,12,9,5,6,1,6,13,46.2,7,5,1,4,5,17,4,0,Matches
2648,Steven Zuber,ch SUI,"MF,FW",Stuttgart,de Bundesliga,26,1991,11.7,6,3,2,2,2,1,13,7.7,12,14,2,12,6,12,6,0,Matches
2649,Martín Zubimendi,es ESP,MF,Real Sociedad,es La Liga,19,1999,0.1,1,0,0,1,0,0,1,0.0,1,0,0,0,0,1,0,0,Matches
2650,Ervin Zukanović,ba BIH,DF,Genoa,it Serie A,31,1987,21.8,28,16,20,7,1,17,30,56.7,13,17,9,8,19,47,96,0,Matches
2651,Bongani Zungu,za RSA,MF,Amiens,fr Ligue 1,25,1992,2.6,3,2,0,1,2,2,8,25.0,6,0,0,0,2,5,5,0,Matches
2652,David Zurutuza,es ESP,MF,Real Sociedad,es La Liga,32,1986,13.6,27,16,9,15,3,8,22,36.4,14,19,4,15,24,51,26,1,Matches
2653,Filip Đorđević,rs SRB,FW,Chievo,it Serie A,30,1987,7.0,11,6,3,6,2,3,12,25.0,9,7,1,6,2,13,8,1,Matches
2654,Filip Đuričić,rs SRB,"FW,MF",Sassuolo,it Serie A,26,1992,13.9,17,13,2,11,4,5,22,22.7,17,20,1,19,8,25,8,1,Matches
2655,이강인,kr KOR,"FW,MF",Valencia,es La Liga,17,2001,0.3,,0,,,,,,,,,,,1,,,,Matches
