,Player,Nation,Pos,Squad,Comp,Age,Born,90s,Tackles,Tackles_Won,Tackles_Def_3rd,Tackles_Mid_3rd,Tackles_Att_3rd,Dribblers_Tackled,Dribblers_Challenged,Dribblers_Tackle_W%,Dribblers_Tackle_Lost,Blocks,Shots_Blocked,Passes_Blocked,Interceptions,Tackles+Interceptions,Clearances,Errors_Shots,Matches
0,Max Aarons,eng ENG,DF,Norwich City,eng Premier League,21,2000,32.0,64,44,49,15,0,37,55,67.3,18,39,19,20,28,92,96,1,Matches
1,Yunis Abdelhamid,ma MAR,DF,Reims,fr Ligue 1,33,1987,33.1,48,27,34,14,0,16,32,50.0,16,50,25,25,68,116,104,0,Matches
2,Salis Abdul Samed,gh GHA,MF,Clermont Foot,fr Ligue 1,21,2000,27.4,43,23,25,16,2,20,57,35.1,37,18,1,17,42,85,15,0,Matches
3,Laurent Abergel,fr FRA,MF,Lorient,fr Ligue 1,28,1993,32.8,110,60,44,53,13,71,166,42.8,95,58,1,57,55,165,13,0,Matches
4,Charles Abi,fr FRA,FW,Saint-Étienne,fr Ligue 1,21,2000,0.5,0,0,0,0,0,0,1,0.0,1,2,0,2,0,0,0,0,Matches
5,Dickson Abiama,ng NGA,FW,Greuther Fürth,de Bundesliga,22,1998,8.1,11,7,4,5,2,2,10,20.0,8,12,1,11,4,15,8,0,Matches
6,Matthis Abline,fr FRA,FW,Rennes,fr Ligue 1,18,2003,1.1,0,0,0,0,0,0,0,,0,2,0,2,0,0,1,0,Matches
7,Tammy Abraham,eng ENG,FW,Roma,it Serie A,23,1997,34.3,27,13,7,14,6,9,22,40.9,13,17,3,14,5,32,27,0,Matches
8,Luis Abram,pe PER,DF,Granada,es La Liga,25,1996,6.2,6,3,3,3,0,2,4,50.0,2,6,5,1,5,11,37,1,Matches
9,Francesco Acerbi,it ITA,DF,Lazio,it Serie A,33,1988,28.2,25,12,15,9,1,12,19,63.2,7,37,28,9,34,59,92,0,Matches
10,Ragnar Ache,de GER,"MF,FW",Eint Frankfurt,de Bundesliga,23,1998,2.9,2,0,0,1,1,1,4,25.0,3,3,0,3,0,2,1,0,Matches
11,Mohamed Achi,fr FRA,MF,Nantes,fr Ligue 1,19,2002,0.1,0,0,0,0,0,0,0,,0,0,0,0,0,0,0,0,Matches
12,Marcos Acuña,ar ARG,DF,Sevilla,es La Liga,29,1991,25.1,50,29,27,14,9,30,46,65.2,16,22,5,17,14,64,25,1,Matches
13,Che Adams,sct SCO,FW,Southampton,eng Premier League,25,1996,22.7,13,6,5,5,3,2,16,12.5,14,18,2,16,8,21,18,0,Matches
14,Tyler Adams,us USA,MF,RB Leipzig,de Bundesliga,22,1999,15.0,23,7,5,16,2,7,25,28.0,18,24,1,23,16,39,19,2,Matches
15,Sargis Adamyan,am ARM,"FW,MF",Hoffenheim,de Bundesliga,28,1993,3.7,8,6,3,4,1,3,11,27.3,8,4,0,4,1,9,2,0,Matches
16,Martin Adeline,fr FRA,"MF,FW",Reims,fr Ligue 1,17,2003,3.9,15,11,5,8,2,8,16,50.0,8,0,0,0,11,26,6,0,Matches
17,Amine Adli,ma MAR,"FW,MF",Leverkusen,de Bundesliga,21,2000,14.0,27,14,10,14,3,8,15,53.3,7,26,2,24,11,38,12,0,Matches
18,Yacine Adli,fr FRA,"MF,FW",Bordeaux,fr Ligue 1,21,2000,25.1,43,27,22,14,7,19,68,27.9,49,33,3,30,37,80,11,2,Matches
19,Michel Aebischer,ch SUI,MF,Bologna,it Serie A,24,1997,4.9,14,5,5,8,1,6,11,54.5,5,4,1,3,6,20,3,0,Matches
20,Felix Afena-Gyan,gh GHA,"FW,MF",Roma,it Serie A,18,2003,7.4,10,3,1,6,3,4,7,57.1,3,4,0,4,3,13,0,0,Matches
21,Martin Agirregabiria,es ESP,DF,Alavés,es La Liga,25,1996,18.0,34,22,17,11,6,18,37,48.6,19,20,3,17,25,59,38,0,Matches
22,Julen Agirrezabala,es ESP,GK,Athletic Club,es La Liga,20,2000,4.0,0,0,0,0,0,0,0,,0,0,0,0,0,0,2,0,Matches
23,Lucien Agoume,fr FRA,MF,Brest,fr Ligue 1,19,2002,20.8,51,31,24,20,7,23,45,51.1,22,30,9,21,52,103,27,1,Matches
24,Kevin Agudelo,co COL,"MF,FW",Spezia,it Serie A,22,1998,13.7,44,26,13,26,5,7,20,35.0,13,22,0,22,8,52,6,0,Matches
25,Nayef Aguerd,ma MAR,DF,Rennes,fr Ligue 1,25,1996,30.4,27,18,16,11,0,14,24,58.3,10,24,14,10,24,51,127,1,Matches
26,Sergio Agüero,ar ARG,FW,Barcelona,es La Liga,33,1988,1.7,1,1,0,0,1,0,2,0.0,2,0,0,0,0,1,0,0,Matches
27,Ruben Aguilar,fr FRA,DF,Monaco,fr Ligue 1,28,1993,23.8,78,53,39,32,7,43,68,63.2,25,19,4,15,44,122,57,0,Matches
28,Álvaro Aguirre,es ESP,FW,Rayo Vallecano,es La Liga,21,2000,0.1,0,0,0,0,0,0,0,,0,0,0,0,0,0,0,0,Matches
29,Naouirou Ahamada,fr FRA,"MF,DF",Stuttgart,de Bundesliga,19,2002,0.7,1,0,1,0,0,1,3,33.3,2,0,0,0,0,1,0,0,Matches
30,Anel Ahmedhodžić,ba BIH,DF,Bordeaux,fr Ligue 1,22,1999,15.0,38,26,27,9,2,20,31,64.5,11,16,8,8,22,60,44,0,Matches
31,Jean-Eudes Aholou,ci CIV,MF,Strasbourg,fr Ligue 1,27,1994,11.2,16,9,4,9,3,5,19,26.3,14,8,1,7,19,35,7,0,Matches
32,Joseph Aidoo,gh GHA,DF,Celta Vigo,es La Liga,25,1995,29.3,39,26,28,10,1,17,31,54.8,14,23,13,10,38,77,96,3,Matches
33,Ola Aina,ng NGA,DF,Torino,it Serie A,24,1996,16.0,27,19,11,10,6,15,23,65.2,8,17,3,14,28,55,30,0,Matches
34,Rayan Aït-Nouri,dz ALG,"DF,MF",Wolves,eng Premier League,20,2001,20.3,64,36,46,15,3,22,44,50.0,22,24,2,22,22,86,39,1,Matches
35,Kristoffer Ajer,no NOR,DF,Brentford,eng Premier League,23,1998,22.2,29,18,21,6,2,13,21,61.9,8,19,11,8,26,55,74,0,Matches
36,Ludovic Ajorque,fr FRA,FW,Strasbourg,fr Ligue 1,27,1994,30.4,36,25,5,19,12,7,40,17.5,33,28,3,25,8,44,31,1,Matches
37,Manuel Akanji,ch SUI,DF,Dortmund,de Bundesliga,26,1995,25.1,33,23,20,11,2,22,32,68.8,10,26,15,11,35,68,58,0,Matches
38,Carlos Akapo,gq EQG,DF,Cádiz,es La Liga,28,1993,20.5,43,31,26,15,2,21,37,56.8,16,26,7,19,51,94,61,0,Matches
39,Marley Aké,fr FRA,"FW,MF",Juventus,it Serie A,20,2001,0.9,0,0,0,0,0,0,2,0.0,2,0,0,0,1,1,0,0,Matches
40,Nathan Aké,nl NED,DF,Manchester City,eng Premier League,26,1995,10.3,16,9,7,8,1,6,8,75.0,2,7,5,2,8,24,23,0,Matches
41,Ilias Akhomach,ma MAR,FW,Barcelona,es La Liga,17,2004,1.4,2,0,0,1,1,0,0,,0,0,0,0,0,2,0,0,Matches
42,Maghnes Akliouche,fr FRA,"MF,FW",Monaco,fr Ligue 1,19,2002,0.6,2,0,0,2,0,0,1,0.0,1,2,0,2,0,2,0,0,Matches
43,Paul Akouokou,ci CIV,MF,Betis,es La Liga,23,1997,5.7,14,9,5,7,2,8,12,66.7,4,6,0,6,11,25,6,0,Matches
44,Jean-Daniel Akpa-Akpro,ci CIV,MF,Lazio,it Serie A,28,1992,3.5,17,10,7,9,1,7,12,58.3,5,4,2,2,2,19,6,0,Matches
45,Kevin Akpoguma,ng NGA,"DF,FW",Hoffenheim,de Bundesliga,26,1995,17.0,33,19,16,11,6,16,28,57.1,12,32,2,30,20,53,29,2,Matches
46,David Alaba,at AUT,DF,Real Madrid,es La Liga,29,1992,29.4,23,13,15,6,2,9,19,47.4,10,26,15,11,22,45,70,1,Matches
47,Sofiane Alakouch,ma MAR,"DF,MF",Metz,fr Ligue 1,23,1998,1.8,7,4,3,4,0,2,5,40.0,3,4,0,4,1,8,4,0,Matches
48,Tomás Alarcón,cl CHI,MF,Cádiz,es La Liga,22,1999,15.8,31,20,17,10,4,10,31,32.3,21,19,7,12,30,61,31,0,Matches
49,Lucas Alario,ar ARG,FW,Leverkusen,de Bundesliga,28,1992,7.3,6,5,0,2,4,2,5,40.0,3,5,0,5,1,7,6,0,Matches
50,Jordi Alba,es ESP,DF,Barcelona,es La Liga,32,1989,29.4,47,34,12,26,9,27,47,57.4,20,26,6,20,33,80,41,1,Matches
51,Josué Albert,fr FRA,DF,Clermont Foot,fr Ligue 1,29,1992,0.2,0,0,0,0,0,0,0,,0,0,0,0,1,1,2,0,Matches
52,Luis Alberto,es ESP,MF,Lazio,it Serie A,28,1992,26.1,29,17,8,11,10,8,52,15.4,44,32,4,28,13,42,7,0,Matches
53,Raúl Albiol,es ESP,DF,Villarreal,es La Liga,35,1985,27.4,26,15,20,5,1,14,18,77.8,4,24,15,9,21,47,126,1,Matches
54,Marc Albrighton,eng ENG,"FW,DF",Leicester City,eng Premier League,31,1989,12.6,31,19,16,9,6,10,47,21.3,37,15,3,12,14,45,20,0,Matches
55,Paco Alcácer,es ESP,FW,Villarreal,es La Liga,27,1993,8.7,9,3,2,4,3,1,5,20.0,4,7,0,7,6,15,1,0,Matches
56,Thiago Alcántara,es ESP,MF,Liverpool,eng Premier League,30,1991,17.0,48,29,14,24,10,10,42,23.8,32,22,2,20,26,74,13,2,Matches
57,Rubén Alcaraz,es ESP,MF,Cádiz,es La Liga,30,1991,12.3,41,20,14,24,3,22,45,48.9,23,10,2,8,13,54,14,0,Matches
58,Omar Alderete,py PAR,DF,Valencia,es La Liga,24,1996,26.7,53,34,34,17,2,34,53,64.2,19,30,18,12,35,88,153,0,Matches
59,Iván Alejo,es ESP,"MF,FW",Cádiz,es La Liga,26,1995,11.8,33,15,21,10,2,15,44,34.1,29,12,0,12,8,41,17,0,Matches
60,Doğan Alemdar,tr TUR,GK,Rennes,fr Ligue 1,18,2002,12.0,0,0,0,0,0,0,0,,0,0,0,0,0,0,9,1,Matches
61,Carles Aleñá,es ESP,MF,Getafe,es La Liga,23,1998,25.8,27,19,11,13,3,9,48,18.8,39,21,2,19,15,42,16,0,Matches
62,Trent Alexander-Arnold,eng ENG,DF,Liverpool,eng Premier League,22,1998,31.7,40,23,19,13,8,27,60,45.0,33,22,4,18,43,83,40,0,Matches
63,Mohamed Ali Cho,fr FRA,FW,Angers,fr Ligue 1,17,2004,20.4,10,5,1,4,5,5,17,29.4,12,17,1,16,8,18,0,1,Matches
64,Alisson,br BRA,GK,Liverpool,eng Premier League,28,1992,36.0,3,1,3,0,0,3,5,60.0,2,1,0,1,0,3,28,1,Matches
65,Allan,br BRA,MF,Everton,eng Premier League,30,1991,24.3,74,44,28,39,7,34,105,32.4,71,40,9,31,23,97,39,1,Matches
66,Jim Allevinah,ga GAB,FW,Clermont Foot,fr Ligue 1,26,1995,16.5,18,13,8,8,2,5,18,27.8,13,11,0,11,6,24,4,0,Matches
67,Dele Alli,eng ENG,MF,Tottenham,eng Premier League,25,1996,7.3,14,8,10,3,1,5,17,29.4,12,22,5,17,6,20,16,0,Matches
68,Dele Alli,eng ENG,"MF,FW",Everton,eng Premier League,25,1996,3.8,7,2,3,4,0,0,4,0.0,4,7,2,5,6,13,10,0,Matches
69,Miguel Almirón,py PAR,"MF,FW",Newcastle Utd,eng Premier League,27,1994,19.1,47,29,23,17,7,11,44,25.0,33,14,1,13,20,67,13,0,Matches
70,Marcos Alonso,es ESP,DF,Chelsea,eng Premier League,30,1990,24.1,41,29,20,12,9,17,36,47.2,19,29,5,24,43,84,53,0,Matches
71,Giorgio Altare,it ITA,DF,Cagliari,it Serie A,22,1998,16.3,39,28,18,18,3,21,26,80.8,5,17,5,12,30,69,70,0,Matches
72,Hugo Álvarez,es ESP,FW,Celta Vigo,es La Liga,18,2003,0.1,1,0,1,0,0,0,0,,0,0,0,0,0,1,1,0,Matches
73,Yeray Álvarez,es ESP,DF,Athletic Club,es La Liga,26,1995,20.7,24,14,15,8,1,10,18,55.6,8,21,16,5,45,69,97,0,Matches
74,Dani Alves,br BRA,DF,Barcelona,es La Liga,38,1983,12.2,30,19,13,13,4,14,26,53.8,12,10,3,7,11,41,10,2,Matches
75,Steven Alzate,co COL,MF,Brighton,eng Premier League,22,1998,4.5,10,4,4,5,1,4,7,57.1,3,2,1,1,10,20,10,0,Matches
76,Ibrahim Amadou,fr FRA,"DF,MF",Metz,fr Ligue 1,28,1993,9.0,16,8,10,6,0,8,15,53.3,7,4,2,2,14,30,26,0,Matches
77,Emmanuel Amankwaa Akurugu,gh GHA,DF,Getafe,es La Liga,19,2001,0.9,0,0,0,0,0,0,2,0.0,2,1,0,1,0,0,0,0,Matches
78,Daniel Amartey,gh GHA,DF,Leicester City,eng Premier League,26,1994,23.6,26,13,19,7,0,19,29,65.5,10,30,22,8,21,47,93,4,Matches
79,Amath,sn SEN,"FW,MF",Mallorca,es La Liga,25,1996,9.8,21,11,11,6,4,7,17,41.2,10,12,0,12,7,28,7,0,Matches
80,Jordan Amavi,fr FRA,DF,Nice,fr Ligue 1,27,1994,4.6,16,10,8,7,1,10,17,58.8,7,3,1,2,15,31,7,0,Matches
81,Jordan Amavi,fr FRA,"DF,FW",Marseille,fr Ligue 1,27,1994,1.4,6,5,3,1,2,5,10,50.0,5,1,0,1,1,7,3,0,Matches
82,Wisdom Amey,it ITA,DF,Bologna,it Serie A,15,2005,0.8,3,2,1,1,1,2,3,66.7,1,2,0,2,3,6,1,0,Matches
83,Kelvin Amian,fr FRA,DF,Spezia,it Serie A,23,1998,29.4,66,42,43,18,5,30,41,73.2,11,39,21,18,32,98,75,0,Matches
84,Nadiem Amiri,de GER,"MF,FW",Genoa,it Serie A,24,1996,7.6,6,4,2,2,2,2,9,22.2,7,7,0,7,0,6,0,0,Matches
85,Nadiem Amiri,de GER,"MF,FW",Leverkusen,de Bundesliga,24,1996,4.1,8,4,3,2,3,4,8,50.0,4,4,2,2,5,13,0,0,Matches
86,Ethan Ampadu,wls WAL,"MF,DF",Venezia,it Serie A,20,2000,25.4,67,43,37,27,3,24,58,41.4,34,49,19,30,51,118,76,0,Matches
87,Sofyan Amrabat,ma MAR,MF,Fiorentina,it Serie A,24,1996,10.5,24,13,9,13,2,11,19,57.9,8,25,8,17,5,29,6,1,Matches
88,Joachim Andersen,dk DEN,DF,Crystal Palace,eng Premier League,25,1996,32.4,30,23,21,9,0,16,27,59.3,11,29,19,10,37,67,125,3,Matches
89,Felipe Anderson,br BRA,FW,Lazio,it Serie A,28,1993,32.1,71,45,30,33,8,27,99,27.3,72,65,6,59,20,91,16,0,Matches
90,Sebastian Andersson,se SWE,FW,Köln,de Bundesliga,30,1991,14.0,11,7,0,3,8,3,9,33.3,6,8,0,8,3,14,14,0,Matches
91,Florin Andone,ro ROU,FW,Cádiz,es La Liga,28,1993,2.0,1,1,1,0,0,0,1,0.0,1,2,0,2,0,1,1,0,Matches
92,Andrés Andrade Cedeño,pa PAN,DF,Arminia,de Bundesliga,22,1998,11.6,27,16,18,8,1,17,35,48.6,18,16,7,9,19,46,44,0,Matches
93,Benjamin André,fr FRA,MF,Lille,fr Ligue 1,30,1990,30.6,123,69,49,65,9,51,113,45.1,62,49,11,38,50,173,56,0,Matches
94,Fredrik André Bjørkan,no NOR,DF,Hertha BSC,de Bundesliga,22,1998,3.9,12,10,7,4,1,7,9,77.8,2,6,2,4,6,18,8,0,Matches
95,Marcos André,br BRA,"FW,MF",Valencia,es La Liga,24,1996,10.8,15,11,4,6,5,5,16,31.3,11,15,0,15,7,22,13,0,Matches
96,Robert Andrich,de GER,MF,Leverkusen,de Bundesliga,26,1994,20.2,33,17,18,14,1,14,28,50.0,14,19,7,12,31,64,46,0,Matches
97,José Ángel,es ESP,DF,Osasuna,es La Liga,31,1989,12.0,20,13,9,9,2,9,14,64.3,5,6,1,5,10,30,21,0,Matches
98,Angeliño,es ESP,DF,RB Leipzig,de Bundesliga,24,1997,25.5,28,21,14,13,1,14,30,46.7,16,24,3,21,29,57,40,0,Matches
99,Ebenezer Annan,gh GHA,DF,Bologna,it Serie A,18,2002,0.3,1,1,1,0,0,0,0,,0,0,0,0,1,2,1,0,Matches
100,Cristian Ansaldi,ar ARG,DF,Torino,it Serie A,34,1986,7.7,20,9,11,7,2,10,13,76.9,3,9,1,8,6,26,10,0,Matches
101,Janis Antiste,fr FRA,FW,Spezia,it Serie A,18,2002,8.8,18,11,6,6,6,5,13,38.5,8,7,1,6,4,22,6,0,Matches
102,Waldemar Anton,de GER,DF,Stuttgart,de Bundesliga,25,1996,28.8,40,26,22,15,3,19,32,59.4,13,27,16,11,32,72,116,1,Matches
103,Josep Antoni Gayá,es ESP,DF,Mallorca,es La Liga,21,2000,0.6,0,0,0,0,0,0,0,,0,1,0,1,1,1,3,1,Matches
104,Michail Antonio,jm JAM,FW,West Ham,eng Premier League,31,1990,33.0,23,17,5,9,9,7,18,38.9,11,19,1,18,3,26,13,0,Matches
105,Christopher Antwi-Adjei,gh GHA,"FW,MF",Bochum,de Bundesliga,27,1994,12.6,21,18,7,8,6,6,26,23.1,20,12,0,12,1,22,8,0,Matches
106,Houssem Aouar,dz ALG,"MF,FW",Lyon,fr Ligue 1,23,1998,27.8,46,30,9,25,12,27,54,50.0,27,26,1,25,20,66,5,0,Matches
107,Adil Aouchiche,fr FRA,"MF,FW",Saint-Étienne,fr Ligue 1,19,2002,12.0,13,6,5,5,3,5,33,15.2,28,18,1,17,17,30,4,0,Matches
108,Dennis Appiah,fr FRA,DF,Nantes,fr Ligue 1,29,1992,23.3,55,34,35,18,2,28,48,58.3,20,30,13,17,27,82,74,0,Matches
109,Mauro Arambarri,uy URU,MF,Getafe,es La Liga,25,1995,29.6,62,37,19,32,11,20,68,29.4,48,35,5,30,32,94,18,0,Matches
110,Mattia Aramu,it ITA,"MF,FW",Venezia,it Serie A,26,1995,23.3,20,15,5,9,6,8,33,24.2,25,20,2,18,8,28,19,0,Matches
111,Charles Aránguiz,cl CHI,MF,Leverkusen,de Bundesliga,32,1989,17.5,45,25,18,21,6,22,52,42.3,30,24,4,20,33,78,21,0,Matches
112,Néstor Araujo,mx MEX,DF,Celta Vigo,es La Liga,29,1991,29.1,22,14,17,5,0,9,21,42.9,12,17,10,7,27,49,105,2,Matches
113,Ronald Araújo,uy URU,DF,Barcelona,es La Liga,22,1999,25.2,41,23,29,12,0,21,25,84.0,4,37,20,17,23,64,66,1,Matches
114,Cameron Archer,eng ENG,"FW,MF",Aston Villa,eng Premier League,20,2001,0.3,0,0,0,0,0,0,0,,0,0,0,0,0,0,0,0,Matches
115,Alphonse Areola,fr FRA,GK,West Ham,eng Premier League,28,1993,1.0,0,0,0,0,0,0,0,,0,0,0,0,0,0,1,0,Matches
116,Jesús Areso,es ESP,DF,Osasuna,es La Liga,22,1999,2.1,3,3,2,1,0,0,2,0.0,2,0,0,0,0,3,2,1,Matches
117,Matias Arezo,uy URU,"FW,MF",Granada,es La Liga,18,2002,1.8,5,3,2,1,2,4,9,44.4,5,1,0,1,1,6,1,0,Matches
118,Santiago Arias,co COL,DF,Granada,es La Liga,29,1992,4.9,12,5,8,3,1,4,9,44.4,5,8,4,4,5,17,10,0,Matches
119,Adam Armstrong,eng ENG,FW,Southampton,eng Premier League,24,1997,15.7,10,4,2,2,6,0,6,0.0,6,13,1,12,3,13,6,0,Matches
120,Stuart Armstrong,sct SCO,MF,Southampton,eng Premier League,29,1992,16.4,27,19,15,6,6,9,23,39.1,14,10,1,9,8,35,15,0,Matches
121,Marko Arnautović,at AUT,FW,Bologna,it Serie A,32,1989,29.9,17,9,1,11,5,7,30,23.3,23,13,2,11,7,24,17,0,Matches
122,Maximilian Arnold,de GER,MF,Wolfsburg,de Bundesliga,27,1994,33.3,37,20,19,16,2,20,50,40.0,30,43,15,28,37,74,55,0,Matches
123,Kepa Arrizabalaga,es ESP,GK,Chelsea,eng Premier League,26,1994,4.0,0,0,0,0,0,0,0,,0,0,0,0,0,0,4,0,Matches
124,Tolgay Arslan,de GER,MF,Udinese,it Serie A,30,1990,18.4,35,20,15,16,4,19,50,38.0,31,17,4,13,13,48,23,1,Matches
125,Santiago Arzamendia,py PAR,MF,Cádiz,es La Liga,23,1998,5.2,14,6,6,5,3,6,13,46.2,7,6,0,6,4,18,7,0,Matches
126,Takuma Asano,jp JPN,"FW,MF",Bochum,de Bundesliga,26,1994,17.9,11,6,3,6,2,5,19,26.3,14,14,1,13,7,18,7,0,Matches
127,Santiago Ascacíbar,ar ARG,MF,Hertha BSC,de Bundesliga,24,1997,26.4,93,54,50,37,6,38,89,42.7,51,31,6,25,41,134,42,0,Matches
128,Sergio Asenjo,es ESP,GK,Villarreal,es La Liga,32,1989,6.0,0,0,0,0,0,0,1,0.0,1,0,0,0,1,1,6,0,Matches
129,Alejandro Asensio,es ESP,FW,Rayo Vallecano,es La Liga,20,2000,0.1,0,0,0,0,0,0,0,,0,0,0,0,0,0,0,0,Matches
130,Marco Asensio,es ESP,"FW,MF",Real Madrid,es La Liga,25,1996,19.2,12,8,6,4,2,4,18,22.2,14,8,1,7,12,24,6,1,Matches
131,Harrison Ashby,sct SCO,DF,West Ham,eng Premier League,19,2001,0.1,0,0,0,0,0,0,0,,0,1,0,1,1,1,1,0,Matches
132,Kristoffer Askildsen,no NOR,MF,Sampdoria,it Serie A,20,2001,8.4,18,6,7,11,0,9,19,47.4,10,14,7,7,15,33,15,0,Matches
133,Fisnik Asllani,xk KVX,"MF,FW",Hoffenheim,de Bundesliga,18,2002,0.1,0,0,0,0,0,0,1,0.0,1,0,0,0,0,0,0,0,Matches
134,Kristjan Asllani,al ALB,MF,Empoli,it Serie A,19,2002,15.0,18,9,9,8,1,11,29,37.9,18,16,7,9,19,37,15,1,Matches
135,Iago Aspas,es ESP,FW,Celta Vigo,es La Liga,33,1987,34.3,14,7,1,5,8,4,24,16.7,20,23,2,21,11,25,19,0,Matches
136,Lorenz Assignon,tg TOG,DF,Rennes,fr Ligue 1,21,2000,6.8,15,10,11,3,1,5,9,55.6,4,3,1,2,11,26,19,0,Matches
137,Simon Asta,de GER,DF,Greuther Fürth,de Bundesliga,20,2001,8.7,13,6,4,5,4,4,8,50.0,4,14,2,12,8,21,16,0,Matches
138,Youcef Atal,dz ALG,DF,Nice,fr Ligue 1,25,1996,12.7,29,19,17,10,2,14,25,56.0,11,13,2,11,32,61,21,0,Matches
139,Pierre-Emerick Aubameyang,ga GAB,FW,Arsenal,eng Premier League,32,1989,11.5,11,5,6,4,1,3,10,30.0,7,12,1,11,0,11,4,0,Matches
140,Pierre-Emerick Aubameyang,ga GAB,FW,Barcelona,es La Liga,32,1989,12.0,2,2,0,1,1,0,5,0.0,5,9,1,8,2,4,4,0,Matches
141,Emil Audero,it ITA,GK,Sampdoria,it Serie A,24,1997,28.4,3,1,3,0,0,3,5,60.0,2,0,0,0,2,5,17,2,Matches
142,Tommaso Augello,it ITA,DF,Sampdoria,it Serie A,26,1994,26.6,36,20,22,8,6,17,29,58.6,12,19,4,15,29,65,68,1,Matches
143,Jean-Kévin Augustin,fr FRA,"FW,MF",Nantes,fr Ligue 1,24,1997,0.9,1,0,0,0,1,0,3,0.0,3,1,0,1,0,1,0,0,Matches
144,Ludwig Augustinsson,se SWE,"DF,FW",Sevilla,es La Liga,27,1994,8.8,18,14,11,3,4,8,13,61.5,5,10,3,7,5,23,21,0,Matches
145,Serge Aurier,ci CIV,DF,Villarreal,es La Liga,28,1992,11.2,14,9,11,2,1,4,7,57.1,3,14,7,7,11,25,25,0,Matches
146,Ezequiel Ávila,ar ARG,"FW,MF",Osasuna,es La Liga,27,1994,20.8,17,7,6,7,4,7,21,33.3,14,14,2,12,13,30,15,1,Matches
147,Taiwo Awoniyi,ng NGA,FW,Union Berlin,de Bundesliga,23,1997,24.2,11,7,3,6,2,1,9,11.1,8,11,2,9,2,13,29,0,Matches
148,Ramzi Aya,it ITA,DF,Salernitana,it Serie A,30,1990,1.5,1,1,1,0,0,1,1,100.0,0,0,0,0,0,1,4,0,Matches
149,Jordan Ayew,gh GHA,FW,Crystal Palace,eng Premier League,29,1991,22.4,47,30,20,20,7,17,31,54.8,14,33,3,30,15,62,15,0,Matches
150,Kaan Ayhan,tr TUR,DF,Sassuolo,it Serie A,26,1994,15.0,20,12,14,6,0,7,15,46.7,8,20,14,6,13,33,57,0,Matches
151,Luke Ayling,eng ENG,DF,Leeds United,eng Premier League,29,1991,25.2,74,42,46,23,5,51,97,52.6,46,46,25,21,28,102,52,1,Matches
152,Karim Azamoum,fr FRA,DF,Troyes,fr Ligue 1,31,1990,4.3,6,5,4,2,0,3,5,60.0,2,4,2,2,1,7,10,0,Matches
153,Sardar Azmoun,ir IRN,"FW,MF",Leverkusen,de Bundesliga,26,1995,4.0,3,1,0,2,1,0,5,0.0,5,2,0,2,0,3,8,0,Matches
154,César Azpilicueta,es ESP,DF,Chelsea,eng Premier League,31,1989,23.0,51,28,18,27,6,16,35,45.7,19,32,9,23,23,74,65,1,Matches
155,Iddrisu Baba,gh GHA,MF,Mallorca,es La Liga,25,1996,21.5,57,30,31,23,3,25,43,58.1,18,19,5,14,24,81,34,1,Matches
156,Carlos Bacca,co COL,FW,Granada,es La Liga,34,1986,5.7,4,4,2,0,2,0,3,0.0,3,5,0,5,1,5,5,0,Matches
157,Daniel Bachmann,at AUT,GK,Watford,eng Premier League,27,1994,12.0,0,0,0,0,0,0,0,,0,0,0,0,1,1,5,0,Matches
158,Loïc Bade,fr FRA,DF,Rennes,fr Ligue 1,21,2000,10.9,6,5,4,2,0,3,5,60.0,2,12,10,2,12,18,48,0,Matches
159,Milan Badelj,hr CRO,MF,Genoa,it Serie A,32,1989,31.6,64,37,25,30,9,34,80,42.5,46,39,7,32,85,149,43,0,Matches
160,Édgar Badía,es ESP,GK,Elche,es La Liga,29,1992,24.0,0,0,0,0,0,0,0,,0,0,0,0,0,0,16,2,Matches
161,Benoît Badiashile,fr FRA,DF,Monaco,fr Ligue 1,20,2001,20.4,36,19,21,15,0,14,23,60.9,9,18,12,6,28,64,68,1,Matches
162,Youssouph Badji,sn SEN,"FW,MF",Brest,fr Ligue 1,19,2001,1.5,1,0,0,1,0,0,1,0.0,1,0,0,0,0,1,0,0,Matches
163,Miguel Baeza,es ESP,DF,Celta Vigo,es La Liga,21,2000,0.0,0,0,0,0,0,0,0,,0,0,0,0,0,0,0,0,Matches
164,Nicola Bagnolini,it ITA,GK,Bologna,it Serie A,17,2004,0.0,0,0,0,0,0,0,0,,0,0,0,0,0,0,0,0,Matches
165,Issa Bah,lu LUX,FW,Venezia,it Serie A,19,2002,0.1,0,0,0,0,0,0,0,,0,0,0,0,0,0,0,0,Matches
166,Stéphane Bahoken,cm CMR,FW,Angers,fr Ligue 1,29,1992,12.2,13,8,2,7,4,1,9,11.1,8,15,0,15,3,16,3,0,Matches
167,Leon Bailey,jm JAM,"FW,MF",Aston Villa,eng Premier League,23,1997,8.5,17,11,6,8,3,6,13,46.2,7,10,1,9,1,18,2,0,Matches
168,Eric Bailly,ci CIV,DF,Manchester Utd,eng Premier League,27,1994,2.4,5,4,4,0,1,3,4,75.0,1,4,2,2,3,8,11,0,Matches
169,Dénys Bain,fr FRA,DF,Brest,fr Ligue 1,28,1993,2.0,3,3,1,2,0,1,1,100.0,0,3,1,2,3,6,5,0,Matches
170,Stefan Bajic,fr FRA,GK,Saint-Étienne,fr Ligue 1,19,2001,5.7,0,0,0,0,0,0,0,,0,0,0,0,0,0,4,0,Matches
171,Nedim Bajrami,al ALB,"MF,FW",Empoli,it Serie A,22,1999,22.8,21,14,5,13,3,4,14,28.6,10,11,0,11,3,24,8,0,Matches
172,Cédric Bakambu,cd COD,FW,Marseille,fr Ligue 1,30,1991,4.0,2,0,1,0,1,0,3,0.0,3,2,0,2,0,2,1,0,Matches
173,Abdoulaye Bakayoko,fr FRA,DF,Saint-Étienne,fr Ligue 1,18,2002,3.4,15,9,13,2,0,8,12,66.7,4,5,4,1,12,27,15,0,Matches
174,Tiemoué Bakayoko,fr FRA,MF,Milan,it Serie A,26,1994,5.6,19,13,9,7,3,5,16,31.3,11,8,1,7,9,28,10,2,Matches
175,Mitchel Bakker,nl NED,DF,Leverkusen,de Bundesliga,21,2000,20.2,33,22,16,12,5,20,34,58.8,14,13,2,11,23,56,42,3,Matches
176,Ridle Baku,de GER,"DF,FW",Wolfsburg,de Bundesliga,23,1998,27.2,62,37,30,24,8,25,65,38.5,40,43,1,42,21,83,52,1,Matches
177,Dilane Bakwa,fr FRA,"FW,MF",Bordeaux,fr Ligue 1,18,2002,0.5,1,1,0,1,0,1,2,50.0,1,0,0,0,0,1,1,0,Matches
178,Tommaso Baldanzi,it ITA,FW,Empoli,it Serie A,18,2003,0.2,0,0,0,0,0,0,0,,0,1,0,1,0,0,0,0,Matches
179,Alejandro Balde,es ESP,"DF,FW",Barcelona,es La Liga,17,2003,2.1,2,1,1,0,1,0,0,,0,2,2,0,1,3,1,0,Matches
180,Ibrahima Baldé,fr FRA,"FW,MF",Lens,fr Ligue 1,18,2003,0.6,0,0,0,0,0,0,0,,0,0,0,0,0,0,0,0,Matches
181,Keita Baldé,sn SEN,FW,Cagliari,it Serie A,26,1995,13.7,8,4,1,5,2,1,10,10.0,9,6,0,6,4,12,6,0,Matches
182,Gareth Bale,wls WAL,FW,Real Madrid,es La Liga,32,1989,3.1,2,1,1,0,1,1,4,25.0,3,2,0,2,2,4,1,0,Matches
183,Mikel Balenziaga,es ESP,DF,Athletic Club,es La Liga,33,1988,22.5,33,24,15,15,3,25,43,58.1,18,27,4,23,21,54,79,0,Matches
184,Leonardo Balerdi,ar ARG,DF,Marseille,fr Ligue 1,22,1999,10.6,9,6,9,0,0,5,14,35.7,9,11,4,7,19,28,30,0,Matches
185,Iván Balliu,al ALB,DF,Rayo Vallecano,es La Liga,29,1992,35.0,45,22,25,11,9,19,31,61.3,12,24,5,19,39,84,64,0,Matches
186,Fodé Ballo-Touré,sn SEN,DF,Milan,it Serie A,24,1997,5.0,18,14,5,13,0,4,9,44.4,5,6,2,4,3,21,5,0,Matches
187,Folarin Balogun,us USA,FW,Arsenal,eng Premier League,20,2001,0.8,1,1,0,0,1,0,0,,0,1,0,1,0,1,1,0,Matches
188,Abdoulaye Bamba,ci CIV,"DF,FW",Angers,fr Ligue 1,31,1990,5.1,6,5,6,0,0,4,11,36.4,7,5,1,4,9,15,13,0,Matches
189,Jonathan Bamba,ci CIV,"MF,FW",Lille,fr Ligue 1,25,1996,27.0,30,12,13,9,8,13,36,36.1,23,24,1,23,21,51,10,0,Matches
190,Patrick Bamford,eng ENG,FW,Leeds United,eng Premier League,27,1993,6.2,1,0,0,1,0,0,3,0.0,3,8,2,6,2,3,8,0,Matches
191,Filippo Bandinelli,it ITA,MF,Empoli,it Serie A,26,1995,21.7,33,20,10,17,6,15,31,48.4,16,22,5,17,10,43,37,2,Matches
192,Mattia Bani,it ITA,DF,Genoa,it Serie A,27,1993,13.5,23,13,17,6,0,14,18,77.8,4,19,11,8,20,43,76,0,Matches
193,Simon Banza,cd COD,FW,Lens,fr Ligue 1,24,1996,1.4,2,1,0,0,2,0,2,0.0,2,1,0,1,1,3,2,0,Matches
194,Shandon Baptiste,gd GRN,MF,Brentford,eng Premier League,23,1998,10.1,14,4,9,4,1,6,15,40.0,9,10,0,10,11,25,12,0,Matches
195,Antonín Barák,cz CZE,"MF,FW",Hellas Verona,it Serie A,26,1994,26.0,18,8,9,8,1,5,17,29.4,12,32,5,27,6,24,26,0,Matches
196,Barbero,es ESP,"FW,MF",Osasuna,es La Liga,22,1998,0.2,0,0,0,0,0,0,0,,0,0,0,0,0,0,1,0,Matches
197,Danilo Barbosa,br BRA,DF,Nice,fr Ligue 1,25,1996,1.0,0,0,0,0,0,0,0,,0,1,1,0,2,2,10,0,Matches
198,Barcia,es ESP,DF,Granada,es La Liga,20,2000,0.8,0,0,0,0,0,0,0,,0,1,1,0,1,1,0,1,Matches
199,Bradley Barcola,fr FRA,"FW,MF",Lyon,fr Ligue 1,18,2002,2.9,7,4,2,3,2,1,8,12.5,7,7,1,6,2,9,1,0,Matches
200,Melvin Bard,fr FRA,DF,Nice,fr Ligue 1,20,2000,28.8,59,37,38,17,4,41,63,65.1,22,33,10,23,51,110,56,0,Matches
201,Enis Bardhi,mk MKD,"MF,FW",Levante,es La Liga,26,1995,18.9,29,12,12,14,3,12,35,34.3,23,13,2,11,10,39,7,0,Matches
202,Francesco Bardi,it ITA,GK,Bologna,it Serie A,29,1992,2.0,0,0,0,0,0,0,0,,0,0,0,0,0,0,0,0,Matches
203,Keidi Bare,al ALB,MF,Espanyol,es La Liga,23,1997,16.5,27,17,14,12,1,11,31,35.5,20,20,10,10,15,42,26,1,Matches
204,Nicolò Barella,it ITA,MF,Inter,it Serie A,24,1997,32.4,63,42,17,35,11,29,55,52.7,26,26,2,24,21,84,8,2,Matches
205,Kike Barja,es ESP,"MF,FW",Osasuna,es La Liga,24,1997,9.6,15,11,4,7,4,8,22,36.4,14,10,1,9,9,24,4,0,Matches
206,Ross Barkley,eng ENG,"MF,FW",Chelsea,eng Premier League,27,1993,2.0,0,0,0,0,0,0,1,0.0,1,1,0,1,1,1,0,0,Matches
207,Aymen Barkok,ma MAR,"MF,DF",Eint Frankfurt,de Bundesliga,23,1998,1.8,6,2,2,3,1,2,7,28.6,5,4,1,3,5,11,6,0,Matches
208,Ashley Barnes,eng ENG,FW,Burnley,eng Premier League,31,1989,9.0,11,2,2,7,2,2,9,22.2,7,8,1,7,2,13,5,0,Matches
209,Harvey Barnes,eng ENG,"FW,MF",Leicester City,eng Premier League,23,1997,23.3,31,16,9,11,11,7,23,30.4,16,24,1,23,5,36,7,0,Matches
210,Antonio Barragán,es ESP,DF,Elche,es La Liga,34,1987,11.3,21,14,13,7,1,11,17,64.7,6,5,3,2,17,38,34,0,Matches
211,Leandro Barreiro Martins,lu LUX,MF,Mainz 05,de Bundesliga,21,2000,19.9,63,32,23,27,13,29,50,58.0,21,23,6,17,32,95,23,0,Matches
212,Ander Barrenetxea,es ESP,"FW,MF",Real Sociedad,es La Liga,19,2001,6.1,15,10,9,6,0,8,18,44.4,10,7,0,7,2,17,2,0,Matches
213,Jacob Barrett Laursen,dk DEN,DF,Arminia,de Bundesliga,26,1994,18.1,16,12,10,6,0,8,21,38.1,13,19,7,12,28,44,43,0,Matches
214,Musa Barrow,gm GAM,"FW,MF",Bologna,it Serie A,22,1998,23.7,12,4,4,4,4,6,20,30.0,14,20,1,19,6,18,8,0,Matches
215,Abdourahmane Barry,gn GUI,DF,Greuther Fürth,de Bundesliga,21,2000,2.3,6,4,3,3,0,5,7,71.4,2,5,2,3,4,10,1,0,Matches
216,Marc Bartra,es ESP,DF,Betis,es La Liga,30,1991,22.1,39,14,18,17,4,19,35,54.3,16,39,22,17,33,72,105,1,Matches
217,Daniele Baselli,it ITA,"MF,FW",Torino,it Serie A,29,1992,1.7,3,3,2,0,1,2,6,33.3,4,0,0,0,1,4,2,0,Matches
218,Daniele Baselli,it ITA,MF,Cagliari,it Serie A,29,1992,3.2,6,5,3,1,2,1,5,20.0,4,2,0,2,2,8,5,0,Matches
219,Toma Bašić,hr CRO,MF,Lazio,it Serie A,24,1996,10.9,12,8,3,9,0,5,17,29.4,12,13,4,9,4,16,21,0,Matches
220,Toma Bašić,hr CRO,MF,Bordeaux,fr Ligue 1,24,1996,2.3,2,2,1,0,1,0,4,0.0,4,4,1,3,2,4,0,0,Matches
221,Amine Bassi,fr FRA,"MF,FW",Metz,fr Ligue 1,23,1997,2.0,6,3,2,3,1,1,3,33.3,2,5,0,5,0,6,0,0,Matches
222,Álvaro Bastida,es ESP,MF,Cádiz,es La Liga,17,2004,2.2,7,4,2,4,1,4,5,80.0,1,1,0,1,3,10,1,0,Matches
223,Alessandro Bastoni,it ITA,DF,Inter,it Serie A,22,1999,25.7,44,25,28,13,3,17,34,50.0,17,22,12,10,35,79,59,1,Matches
224,Simone Bastoni,it ITA,"MF,DF",Spezia,it Serie A,24,1996,25.4,52,34,28,17,7,21,65,32.3,44,38,11,27,30,82,31,0,Matches
225,Lewis Bate,eng ENG,MF,Leeds United,eng Premier League,18,2002,1.6,1,0,0,0,1,0,8,0.0,8,1,0,1,1,2,1,0,Matches
226,Rodrigo Battaglia,ar ARG,MF,Mallorca,es La Liga,30,1991,13.1,32,16,13,19,0,15,30,50.0,15,21,10,11,10,42,36,0,Matches
227,Maximilian Bauer,de GER,DF,Greuther Fürth,de Bundesliga,21,2000,18.8,28,15,17,10,1,11,28,39.3,17,24,14,10,29,57,99,0,Matches
228,Oliver Baumann,de GER,GK,Hoffenheim,de Bundesliga,31,1990,33.0,0,0,0,0,0,0,3,0.0,3,0,0,0,0,0,19,1,Matches
229,Timo Baumgartl,de GER,DF,Union Berlin,de Bundesliga,25,1996,24.1,59,28,34,21,4,31,47,66.0,16,27,11,16,37,96,58,0,Matches
230,Julian Baumgartlinger,at AUT,"MF,FW",Leverkusen,de Bundesliga,33,1988,1.0,3,1,2,1,0,1,2,50.0,1,1,0,1,2,5,0,0,Matches
231,Christoph Baumgartner,at AUT,"MF,FW",Hoffenheim,de Bundesliga,21,1999,21.0,28,15,14,7,7,13,32,40.6,19,24,3,21,8,36,16,0,Matches
232,Jon Bautista,es ESP,MF,Real Sociedad,es La Liga,26,1995,0.5,3,0,0,3,0,0,1,0.0,1,1,0,1,1,4,1,0,Matches
233,Paul Baysse,fr FRA,"MF,DF",Bordeaux,fr Ligue 1,33,1988,0.1,1,1,0,1,0,0,0,,0,0,0,0,0,1,1,0,Matches
234,Noah Joel Sarenren Bazee,ng NGA,"MF,FW",Augsburg,de Bundesliga,24,1996,2.7,5,2,2,2,1,3,4,75.0,1,8,2,6,1,6,4,0,Matches
235,Bebé,cv CPV,FW,Rayo Vallecano,es La Liga,31,1990,9.6,6,5,1,3,2,4,16,25.0,12,18,0,18,3,9,6,0,Matches
236,Ihlas Bebou,tg TOG,"FW,DF",Hoffenheim,de Bundesliga,27,1994,23.2,22,14,5,12,5,7,21,33.3,14,20,3,17,12,34,25,0,Matches
237,Rodrigo Becão,br BRA,DF,Udinese,it Serie A,25,1996,34.8,81,46,49,30,2,34,60,56.7,26,45,20,25,42,123,89,3,Matches
238,Mads Bech Sørensen,dk DEN,DF,Brentford,eng Premier League,22,1999,9.3,8,7,6,2,0,6,7,85.7,1,9,6,3,6,14,25,0,Matches
239,Sheraldo Becker,sr SUR,"FW,MF",Union Berlin,de Bundesliga,26,1995,19.5,9,6,3,4,2,6,18,33.3,12,11,0,11,2,11,4,0,Matches
240,Jan Bednarek,pl POL,DF,Southampton,eng Premier League,25,1996,29.2,32,15,18,13,1,19,33,57.6,14,48,27,21,72,104,141,0,Matches
241,Donny van de Beek,nl NED,MF,Manchester Utd,eng Premier League,24,1997,0.8,6,4,4,1,1,1,2,50.0,1,5,1,4,2,8,1,0,Matches
242,Donny van de Beek,nl NED,MF,Everton,eng Premier League,24,1997,5.4,15,7,8,6,1,6,13,46.2,7,6,2,4,6,21,4,0,Matches
243,Asmir Begović,ba BIH,GK,Everton,eng Premier League,34,1987,3.0,0,0,0,0,0,0,0,,0,0,0,0,0,0,3,0,Matches
244,Valon Behrami,ch SUI,"MF,FW",Genoa,it Serie A,36,1985,3.5,3,1,0,2,1,0,7,0.0,7,4,1,3,1,4,4,0,Matches
245,Kevin Behrens,de GER,FW,Union Berlin,de Bundesliga,30,1991,5.5,3,2,1,1,1,0,4,0.0,4,3,0,3,3,6,7,0,Matches
246,Youcef Belaïli,dz ALG,"MF,FW",Brest,fr Ligue 1,29,1992,9.2,2,1,0,0,2,2,9,22.2,7,5,1,4,7,9,4,0,Matches
247,Vid Belec,si SVN,GK,Salernitana,it Serie A,31,1990,21.5,0,0,0,0,0,0,0,,0,0,0,0,0,0,9,1,Matches
248,Ishak Belfodil,dz ALG,FW,Hertha BSC,de Bundesliga,29,1992,18.2,9,6,4,4,1,4,8,50.0,4,9,1,8,5,14,16,0,Matches
249,Haris Belkebla,dz ALG,MF,Brest,fr Ligue 1,27,1994,25.7,46,23,21,21,4,18,39,46.2,21,26,6,20,48,94,30,1,Matches
250,Stefan Bell,de GER,DF,Mainz 05,de Bundesliga,29,1991,31.8,54,23,37,16,1,30,63,47.6,33,26,15,11,41,95,112,1,Matches
251,Armel Bella Kotchap,de GER,DF,Bochum,de Bundesliga,19,2001,19.6,34,20,25,9,0,18,28,64.3,10,21,16,5,42,76,84,2,Matches
252,Raoul Bellanova,it ITA,"DF,FW",Cagliari,it Serie A,21,2000,27.7,29,15,14,12,3,6,27,22.2,21,39,8,31,21,50,51,0,Matches
253,Karim Bellarabi,de GER,"FW,MF",Leverkusen,de Bundesliga,31,1990,7.6,9,4,4,4,1,3,13,23.1,10,5,0,5,9,18,4,0,Matches
254,Jean-Ricner Bellegarde,fr FRA,MF,Strasbourg,fr Ligue 1,23,1998,25.9,51,32,21,21,9,17,41,41.5,24,29,4,25,27,78,19,0,Matches
255,Héctor Bellerín,es ESP,DF,Betis,es La Liga,26,1995,22.0,52,32,29,20,3,31,44,70.5,13,11,2,9,23,75,57,1,Matches
256,Jude Bellingham,eng ENG,MF,Dortmund,de Bundesliga,18,2003,31.0,52,34,15,31,6,21,53,39.6,32,50,4,46,42,94,32,0,Matches
257,George Bello,us USA,DF,Arminia,de Bundesliga,19,2002,4.8,7,7,7,0,0,4,4,100.0,0,5,4,1,6,13,11,0,Matches
258,Jeanuël Belocian,fr FRA,DF,Rennes,fr Ligue 1,16,2005,0.1,0,0,0,0,0,0,0,,0,0,0,0,0,0,0,0,Matches
259,Andrea Belotti,it ITA,FW,Torino,it Serie A,27,1993,15.2,7,3,2,2,3,3,12,25.0,9,12,4,8,2,9,9,0,Matches
260,Fran Beltrán,es ESP,MF,Celta Vigo,es La Liga,22,1999,28.9,56,41,27,23,6,28,68,41.2,40,29,5,24,32,88,39,0,Matches
261,Hatem Ben Arfa,fr FRA,"FW,MF",Lille,fr Ligue 1,34,1987,3.5,4,2,2,1,1,2,4,50.0,2,3,0,3,0,4,1,0,Matches
262,Salim Ben Seghir,fr FRA,MF,Marseille,fr Ligue 1,18,2003,0.0,0,0,0,0,0,0,0,,0,0,0,0,0,0,0,0,Matches
263,Wissam Ben Yedder,fr FRA,FW,Monaco,fr Ligue 1,30,1990,28.1,18,8,1,11,6,6,15,40.0,9,12,1,11,0,18,1,0,Matches
264,Marco Benassi,it ITA,"DF,MF",Fiorentina,it Serie A,26,1994,1.8,1,0,1,0,0,1,2,50.0,1,3,0,3,3,4,3,0,Matches
265,Marco Benassi,it ITA,MF,Empoli,it Serie A,26,1994,4.2,6,3,3,2,1,1,10,10.0,9,4,0,4,3,9,6,0,Matches
266,Darío Benedetto,ar ARG,"FW,MF",Elche,es La Liga,31,1990,6.6,5,1,2,2,1,3,6,50.0,3,4,0,4,1,6,1,0,Matches
267,Darío Benedetto,ar ARG,"FW,MF",Marseille,fr Ligue 1,31,1990,0.6,0,0,0,0,0,0,0,,0,2,0,2,0,0,0,0,Matches
268,László Bénes,sk SVK,MF,Gladbach,de Bundesliga,23,1997,2.7,5,3,1,3,1,1,6,16.7,5,5,2,3,2,7,5,0,Matches
269,Walter Benítez,ar ARG,GK,Nice,fr Ligue 1,28,1993,37.0,0,0,0,0,0,0,2,0.0,2,1,0,1,0,0,12,2,Matches
270,Iker Benito,es ESP,"FW,MF",Osasuna,es La Liga,18,2002,1.3,2,1,1,0,1,0,1,0.0,1,2,0,2,0,2,2,0,Matches
271,Loris Benito,ch SUI,DF,Bordeaux,fr Ligue 1,29,1992,0.7,0,0,0,0,0,0,0,,0,0,0,0,1,1,3,1,Matches
272,Pedro Benito,es ESP,FW,Cádiz,es La Liga,21,2000,0.3,0,0,0,0,0,0,1,0.0,1,0,0,0,0,0,0,0,Matches
273,Filip Benković,hr CRO,"DF,FW",Udinese,it Serie A,24,1997,0.1,0,0,0,0,0,0,0,,0,0,0,0,0,0,0,0,Matches
274,Ismaël Bennacer,dz ALG,MF,Milan,it Serie A,23,1997,16.9,44,30,22,15,7,21,50,42.0,29,20,4,16,25,69,15,0,Matches
275,Keanan Bennetts,eng ENG,"FW,DF",Gladbach,de Bundesliga,22,1999,0.6,2,0,1,1,0,1,1,100.0,0,1,0,1,0,2,0,0,Matches
276,Saïd Benrahma,dz ALG,"FW,MF",West Ham,eng Premier League,25,1995,24.1,28,17,16,9,3,15,38,39.5,23,17,1,16,9,37,8,0,Matches
277,Ramy Bensebaini,dz ALG,DF,Gladbach,de Bundesliga,26,1995,22.4,42,30,24,15,3,27,44,61.4,17,33,7,26,39,81,77,1,Matches
278,Nabil Bentaleb,dz ALG,MF,Angers,fr Ligue 1,26,1994,16.8,42,24,15,20,7,16,29,55.2,13,24,9,15,28,70,13,0,Matches
279,Rodrigo Bentancur,uy URU,MF,Tottenham,eng Premier League,24,1997,15.1,36,18,14,14,8,16,32,50.0,16,24,9,15,20,56,35,0,Matches
280,Rodrigo Bentancur,uy URU,MF,Juventus,it Serie A,24,1997,12.8,32,18,11,18,3,7,20,35.0,13,15,2,13,26,58,15,1,Matches
281,Christian Benteke,be BEL,FW,Crystal Palace,eng Premier League,30,1990,12.7,3,2,1,2,0,2,6,33.3,4,7,3,4,2,5,33,0,Matches
282,Karim Benzema,fr FRA,FW,Real Madrid,es La Liga,33,1987,28.8,11,9,5,3,3,2,9,22.2,7,10,0,10,4,15,13,0,Matches
283,Alessandro Berardi,it ITA,GK,Hellas Verona,it Serie A,30,1991,1.0,0,0,0,0,0,0,0,,0,0,0,0,0,0,0,0,Matches
284,Domenico Berardi,it ITA,FW,Sassuolo,it Serie A,26,1994,31.3,32,19,9,16,7,15,57,26.3,42,39,2,37,31,63,23,0,Matches
285,Yuri Berchiche,es ESP,DF,Athletic Club,es La Liga,31,1990,11.3,25,11,10,11,4,7,14,50.0,7,19,6,13,13,38,25,0,Matches
286,Álex Berenguer,es ESP,MF,Athletic Club,es La Liga,26,1995,24.1,45,26,23,14,8,11,51,21.6,40,40,2,38,16,61,20,0,Matches
287,Bartosz Bereszyński,pl POL,DF,Sampdoria,it Serie A,29,1992,32.7,64,38,34,25,5,37,80,46.3,43,38,12,26,42,106,73,1,Matches
288,Jóhann Berg Guðmundsson,is ISL,MF,Burnley,eng Premier League,30,1990,12.2,16,6,7,7,2,5,20,25.0,15,11,2,9,12,28,22,0,Matches
289,Patrick Berg,no NOR,MF,Lens,fr Ligue 1,23,1997,3.4,14,6,6,8,0,0,4,0.0,4,2,1,1,4,18,3,0,Matches
290,Mitchell van Bergen,nl NED,"FW,MF",Reims,fr Ligue 1,21,1999,10.9,8,5,7,0,1,6,15,40.0,9,9,0,9,4,12,7,0,Matches
291,Steven Bergwijn,nl NED,"FW,MF",Tottenham,eng Premier League,23,1997,6.3,3,2,2,1,0,1,10,10.0,9,3,0,3,1,4,8,0,Matches
292,Etrit Berisha,al ALB,GK,Torino,it Serie A,32,1989,10.0,0,0,0,0,0,0,0,,0,0,0,0,0,0,4,0,Matches
293,Valon Berisha,xk KVX,"MF,FW",Reims,fr Ligue 1,28,1993,5.1,10,7,2,5,3,2,10,20.0,8,9,0,9,4,14,3,0,Matches
294,Federico Bernardeschi,it ITA,"MF,FW",Juventus,it Serie A,27,1994,16.4,16,10,7,4,5,6,13,46.2,7,12,4,8,5,21,15,0,Matches
295,Paul Bernardoni,fr FRA,GK,Angers,fr Ligue 1,24,1997,13.0,3,2,3,0,0,3,4,75.0,1,0,0,0,0,3,8,1,Matches
296,Paul Bernardoni,fr FRA,GK,Saint-Étienne,fr Ligue 1,24,1997,19.0,0,0,0,0,0,0,0,,0,0,0,0,0,0,14,2,Matches
297,Juan Bernat,es ESP,"DF,MF",Paris S-G,fr Ligue 1,28,1993,10.6,24,14,10,10,4,13,18,72.2,5,8,0,8,8,32,16,0,Matches
298,Dimitry Bertaud,cd COD,GK,Montpellier,fr Ligue 1,23,1998,9.3,0,0,0,0,0,0,1,0.0,1,0,0,0,0,0,5,1,Matches
299,Jason Berthomier,fr FRA,MF,Clermont Foot,fr Ligue 1,31,1990,19.2,29,14,5,17,7,12,34,35.3,22,14,2,12,8,37,4,1,Matches
300,Nicolò Bertola,it ITA,"MF,DF",Spezia,it Serie A,18,2003,0.4,3,2,3,0,0,3,4,75.0,1,0,0,0,3,6,1,0,Matches
301,Ryan Bertrand,eng ENG,DF,Leicester City,eng Premier League,31,1989,3.7,8,5,3,4,1,2,5,40.0,3,8,3,5,1,9,7,0,Matches
302,Daniel Bessa,it ITA,MF,Hellas Verona,it Serie A,28,1993,8.5,7,2,3,3,1,4,15,26.7,11,13,3,10,5,12,11,0,Matches
303,Beto,gw GNB,FW,Udinese,it Serie A,23,1998,24.1,21,6,2,14,5,9,19,47.4,10,16,1,15,5,26,25,1,Matches
304,Jordan Beyer,de GER,DF,Gladbach,de Bundesliga,21,2000,15.4,46,27,32,13,1,23,39,59.0,16,18,5,13,15,61,52,2,Matches
305,Giulian Biancone,fr FRA,"DF,MF",Troyes,fr Ligue 1,21,2000,25.5,70,42,44,22,4,40,69,58.0,29,23,8,15,53,123,71,1,Matches
306,Bartosz Białek,pl POL,"FW,DF",Wolfsburg,de Bundesliga,19,2001,2.0,0,0,0,0,0,0,1,0.0,1,1,0,1,0,0,2,0,Matches
307,Ermin Bičakčić,ba BIH,DF,Hoffenheim,de Bundesliga,31,1990,0.1,0,0,0,0,0,0,0,,0,0,0,0,0,0,0,0,Matches
308,Mads Bidstrup,dk DEN,MF,Brentford,eng Premier League,20,2001,0.5,1,0,0,1,0,0,3,0.0,3,0,0,0,1,2,2,0,Matches
309,Pedro Bigas,es ESP,DF,Elche,es La Liga,30,1990,17.2,24,10,16,8,0,9,20,45.0,11,21,16,5,18,42,77,1,Matches
310,El Bilal Touré,ml MLI,FW,Reims,fr Ligue 1,19,2001,13.3,13,6,4,6,3,2,7,28.6,5,10,3,7,6,19,19,0,Matches
311,Jean-Claude Billong,cm CMR,DF,Clermont Foot,fr Ligue 1,27,1993,10.9,17,8,14,1,2,8,11,72.7,3,9,1,8,10,27,35,0,Matches
312,Luis Binks,eng ENG,DF,Bologna,it Serie A,19,2001,7.2,8,4,7,1,0,4,6,66.7,2,6,5,1,17,25,33,1,Matches
313,Cristiano Biraghi,it ITA,DF,Fiorentina,it Serie A,28,1992,35.0,37,24,17,15,5,22,53,41.5,31,28,10,18,19,56,31,1,Matches
314,Davide Biraschi,it ITA,DF,Genoa,it Serie A,27,1994,10.3,31,16,19,9,3,17,24,70.8,7,16,9,7,16,47,26,0,Matches
315,Tom Bischof,de GER,MF,Hoffenheim,de Bundesliga,16,2005,0.2,0,0,0,0,0,0,0,,0,1,0,1,0,0,1,0,Matches
316,Yves Bissouma,ml MLI,MF,Brighton,eng Premier League,24,1996,23.5,76,49,35,37,4,21,37,56.8,16,33,3,30,50,126,49,0,Matches
317,Nathan Bitu Mazala,fr FRA,DF,Paris S-G,fr Ligue 1,18,2002,0.1,0,0,0,0,0,0,0,,0,1,0,1,0,0,0,0,Matches
318,Marco Bizot,nl NED,GK,Brest,fr Ligue 1,30,1991,38.0,3,1,3,0,0,3,5,60.0,2,1,0,1,0,3,24,1,Matches
319,Bjarki Bjarkason,is ISL,MF,Venezia,it Serie A,21,2000,0.0,0,0,0,0,0,0,0,,0,0,0,0,0,0,0,0,Matches
320,Antonio Blanco,es ESP,MF,Real Madrid,es La Liga,21,2000,0.3,2,0,1,1,0,0,0,,0,1,1,0,1,3,0,0,Matches
321,Ludovic Blas,fr FRA,"MF,FW",Nantes,fr Ligue 1,23,1997,32.9,33,18,7,20,6,15,44,34.1,29,33,3,30,31,64,6,1,Matches
322,Danny Blum,de GER,FW,Bochum,de Bundesliga,30,1991,3.8,2,1,0,0,2,0,2,0.0,2,4,0,4,2,4,1,0,Matches
323,Myron Boadu,nl NED,FW,Monaco,fr Ligue 1,20,2001,10.7,9,7,2,3,4,1,5,20.0,4,6,0,6,2,11,1,0,Matches
324,Jérôme Boateng,de GER,DF,Lyon,fr Ligue 1,32,1988,18.0,20,15,11,9,0,9,17,52.9,8,20,10,10,20,40,73,0,Matches
325,Kevin-Prince Boateng,gh GHA,"MF,FW",Hertha BSC,de Bundesliga,34,1987,7.7,6,5,1,4,1,3,9,33.3,6,7,2,5,6,12,11,0,Matches
326,Antonin Bobichon,fr FRA,"MF,FW",Angers,fr Ligue 1,25,1995,0.4,1,0,0,1,0,0,0,,0,0,0,0,1,2,0,0,Matches
327,Herbert Bockhorn,de GER,DF,Bochum,de Bundesliga,26,1995,9.4,20,14,13,4,3,12,20,60.0,8,10,1,9,14,34,18,0,Matches
328,Jean-Paul Boëtius,nl NED,MF,Mainz 05,de Bundesliga,27,1994,20.0,40,23,18,17,5,22,53,41.5,31,41,3,38,25,65,11,0,Matches
329,Jeremie Boga,ci CIV,"FW,MF",Atalanta,it Serie A,24,1997,8.5,7,3,0,4,3,4,6,66.7,2,6,0,6,1,8,3,1,Matches
330,Jeremie Boga,ci CIV,"FW,MF",Sassuolo,it Serie A,24,1997,7.4,7,4,1,2,4,2,3,66.7,1,3,0,3,2,9,1,1,Matches
331,Luka Bogdan,hr CRO,DF,Salernitana,it Serie A,25,1996,4.4,6,3,6,0,0,4,8,50.0,4,3,2,1,6,12,21,0,Matches
332,Emil Bohinen,no NOR,MF,Salernitana,it Serie A,22,1999,7.8,15,9,4,9,2,10,20,50.0,10,17,3,14,12,27,14,0,Matches
333,Quentin Boisgard,fr FRA,"MF,FW",Lorient,fr Ligue 1,24,1997,10.6,19,11,6,10,3,8,17,47.1,9,15,0,15,6,25,5,0,Matches
334,Charles Boli,fr FRA,"MF,DF",Lens,fr Ligue 1,22,1998,0.4,2,1,0,2,0,0,0,,0,0,0,0,0,2,0,0,Matches
335,Willy Boly,ci CIV,DF,Wolves,eng Premier League,30,1991,10.0,25,19,18,7,0,8,15,53.3,7,14,6,8,14,39,35,0,Matches
336,Giacomo Bonaventura,it ITA,MF,Fiorentina,it Serie A,31,1989,25.2,33,17,12,16,5,21,46,45.7,25,20,2,18,14,47,9,1,Matches
337,Federico Bonazzoli,it ITA,"FW,MF",Salernitana,it Serie A,24,1997,20.7,24,12,9,8,7,6,25,24.0,19,17,1,16,6,30,7,0,Matches
338,Tarsis Bonga,de GER,"MF,FW",Bochum,de Bundesliga,24,1997,0.2,0,0,0,0,0,0,0,,0,0,0,0,0,0,0,0,Matches
339,Kevin Bonifazi,it ITA,DF,Bologna,it Serie A,25,1996,13.4,25,16,16,7,2,13,14,92.9,1,22,7,15,16,41,35,0,Matches
340,Solomon Bonnah,nl NED,DF,RB Leipzig,de Bundesliga,17,2003,0.1,0,0,0,0,0,0,0,,0,1,0,1,1,1,0,0,Matches
341,Leonardo Bonucci,it ITA,DF,Juventus,it Serie A,34,1987,22.3,14,5,4,10,0,8,13,61.5,5,22,17,5,26,40,82,0,Matches
342,Sebastiaan Bornauw,be BEL,DF,Wolfsburg,de Bundesliga,22,1999,22.3,30,19,23,5,2,16,25,64.0,9,29,8,21,42,72,97,1,Matches
343,Rafael Borré,co COL,FW,Eint Frankfurt,de Bundesliga,25,1995,26.4,31,22,4,13,14,7,33,21.2,26,24,4,20,5,36,9,0,Matches
344,Sven Botman,nl NED,DF,Lille,fr Ligue 1,21,2000,25.0,24,11,13,11,0,12,18,66.7,6,32,21,11,26,50,116,0,Matches
345,Denis Bouanga,ga GAB,"FW,MF",Saint-Étienne,fr Ligue 1,26,1994,27.1,46,25,14,13,19,22,63,34.9,41,30,0,30,8,54,34,1,Matches
346,Hicham Boudaoui,dz ALG,MF,Nice,fr Ligue 1,21,1999,18.0,31,18,15,10,6,13,36,36.1,23,17,4,13,18,49,15,0,Matches
347,Ryad Boudebouz,dz ALG,"MF,FW",Saint-Étienne,fr Ligue 1,31,1990,25.0,27,15,11,12,4,12,29,41.4,17,17,2,15,10,37,5,0,Matches
348,Sofiane Boufal,ma MAR,"FW,MF",Angers,fr Ligue 1,27,1993,25.9,44,29,19,16,9,18,38,47.4,20,19,2,17,7,51,1,0,Matches
349,Farid Boulaya,dz ALG,"MF,FW",Metz,fr Ligue 1,28,1993,17.0,18,10,7,9,2,14,38,36.8,24,8,2,6,12,30,5,0,Matches
350,Yassine Bounou,ma MAR,GK,Sevilla,es La Liga,30,1991,31.0,0,0,0,0,0,0,0,,0,0,0,0,0,0,11,1,Matches
351,Ismaëlben Boura,km COM,DF,Lens,fr Ligue 1,20,2000,1.1,2,2,1,1,0,0,0,,0,1,1,0,2,4,5,0,Matches
352,Mehdi Bourabia,ma MAR,MF,Spezia,it Serie A,29,1991,3.1,5,1,2,3,0,3,11,27.3,8,7,6,1,3,8,10,0,Matches
353,Benjamin Bourigeaud,fr FRA,"FW,MF",Rennes,fr Ligue 1,27,1994,35.5,46,24,16,18,12,24,67,35.8,43,33,3,30,30,76,44,0,Matches
354,Redwan Bourles,fr FRA,"MF,FW",Lorient,fr Ligue 1,18,2003,0.2,0,0,0,0,0,0,0,,0,0,0,0,0,0,0,0,Matches
355,Edoardo Bove,it ITA,"MF,DF",Roma,it Serie A,19,2002,0.8,1,1,1,0,0,0,2,0.0,2,1,0,1,1,2,0,0,Matches
356,Jarrod Bowen,eng ENG,FW,West Ham,eng Premier League,24,1996,33.1,36,20,20,11,5,17,44,38.6,27,29,2,27,21,57,14,0,Matches
357,Dedryck Boyata,be BEL,DF,Hertha BSC,de Bundesliga,30,1990,21.1,15,13,11,3,1,8,11,72.7,3,17,13,4,17,32,134,1,Matches
358,Lucas Boyé,ar ARG,FW,Elche,es La Liga,25,1996,19.0,27,13,5,15,7,9,24,37.5,15,24,1,23,2,29,23,0,Matches
359,Domagoj Bradarić,hr CRO,DF,Lille,fr Ligue 1,21,1999,4.6,11,9,8,2,1,7,12,58.3,5,5,2,3,10,21,7,1,Matches
360,Bilal Brahimi,dz ALG,MF,Nice,fr Ligue 1,21,2000,4.2,1,1,0,1,0,0,2,0.0,2,1,0,1,2,3,1,0,Matches
361,Bilal Brahimi,dz ALG,FW,Angers,fr Ligue 1,21,2000,3.8,1,1,0,1,0,0,3,0.0,3,0,0,0,1,2,1,0,Matches
362,Martin Braithwaite,dk DEN,FW,Barcelona,es La Liga,30,1991,2.6,1,1,0,0,1,0,0,,0,2,0,2,1,2,1,0,Matches
363,Julian Brandt,de GER,"MF,FW",Dortmund,de Bundesliga,25,1996,23.1,37,19,13,20,4,17,54,31.5,37,19,2,17,24,61,14,1,Matches
364,Jarrad Branthwaite,eng ENG,DF,Everton,eng Premier League,19,2002,4.3,4,1,3,1,0,3,8,37.5,5,3,2,1,1,5,20,0,Matches
365,Darko Brašanac,rs SRB,MF,Osasuna,es La Liga,29,1992,26.7,35,22,19,14,2,14,40,35.0,26,25,8,17,25,60,15,0,Matches
366,Lilian Brassier,fr FRA,DF,Brest,fr Ligue 1,21,1999,25.1,40,24,23,13,4,10,21,47.6,11,31,21,10,32,72,86,0,Matches
367,Claudio Bravo,cl CHI,GK,Betis,es La Liga,38,1983,16.2,0,0,0,0,0,0,0,,0,0,0,0,0,0,6,2,Matches
368,Iker Bravo,es ESP,FW,Leverkusen,de Bundesliga,16,2005,0.1,1,1,0,1,0,0,0,,0,0,0,0,0,1,0,0,Matches
369,Fabian Bredlow,de GER,GK,Stuttgart,de Bundesliga,26,1995,4.0,0,0,0,0,0,0,0,,0,0,0,0,0,0,1,0,Matches
370,Josip Brekalo,hr CRO,MF,Torino,it Serie A,23,1998,25.4,9,5,5,1,3,3,21,14.3,18,16,1,15,4,13,7,1,Matches
371,Josip Brekalo,hr CRO,FW,Wolfsburg,de Bundesliga,23,1998,0.2,0,0,0,0,0,0,0,,0,0,0,0,0,0,0,0,Matches
372,Gleison Bremer,br BRA,DF,Torino,it Serie A,24,1997,32.1,49,24,27,22,0,18,28,64.3,10,54,23,31,105,154,137,0,Matches
373,Jimmy Briand,fr FRA,"FW,MF",Bordeaux,fr Ligue 1,35,1985,2.5,2,0,2,0,0,0,2,0.0,2,0,0,0,1,3,2,0,Matches
374,Yan Brice Eteki,cm CMR,MF,Granada,es La Liga,23,1997,3.8,6,3,3,2,1,3,7,42.9,4,7,3,4,4,10,6,1,Matches
375,Brian Brobbey,nl NED,"FW,MF",RB Leipzig,de Bundesliga,19,2002,1.5,1,0,0,1,0,1,1,100.0,0,1,0,1,0,1,0,0,Matches
376,Armando Broja,al ALB,FW,Southampton,eng Premier League,19,2001,21.9,12,5,2,7,3,2,9,22.2,7,17,1,16,3,15,11,0,Matches
377,Dylan Bronn,tn TUN,DF,Metz,fr Ligue 1,26,1995,28.3,47,29,33,13,1,20,31,64.5,11,32,19,13,40,87,78,1,Matches
378,John Brooks,us USA,DF,Wolfsburg,de Bundesliga,28,1993,29.1,47,25,25,18,4,36,60,60.0,24,33,19,14,41,88,125,1,Matches
379,Daniel Brosinski,de GER,DF,Mainz 05,de Bundesliga,33,1988,4.3,2,1,1,1,0,1,1,100.0,0,6,0,6,3,5,9,0,Matches
380,Josh Brownhill,eng ENG,MF,Burnley,eng Premier League,25,1995,32.8,73,37,25,42,6,21,53,39.6,32,37,12,25,68,141,42,1,Matches
381,Marcelo Brozović,hr CRO,MF,Inter,it Serie A,28,1992,32.6,77,45,34,35,8,34,68,50.0,34,28,10,18,37,114,36,2,Matches
382,Cédric Brunner,ch SUI,DF,Arminia,de Bundesliga,27,1994,24.3,51,35,29,20,2,25,49,51.0,24,27,10,17,43,94,84,0,Matches
383,Lewis Brunt,eng ENG,MF,Leicester City,eng Premier League,20,2000,0.3,0,0,0,0,0,0,0,,0,1,0,1,0,0,0,0,Matches
384,Jacob Bruun Larsen,dk DEN,"FW,MF",Hoffenheim,de Bundesliga,22,1998,9.0,2,1,1,1,0,0,5,0.0,5,14,3,11,5,7,5,2,Matches
385,Ante Budimir,hr CRO,FW,Osasuna,es La Liga,30,1991,19.3,24,10,3,15,6,6,19,31.6,13,22,4,18,3,27,16,0,Matches
386,Emi Buendía,ar ARG,"MF,FW",Aston Villa,eng Premier League,24,1996,21.1,38,18,16,13,9,21,51,41.2,30,21,3,18,9,47,11,0,Matches
387,Osman Bukari,gh GHA,"FW,MF",Nantes,fr Ligue 1,22,1998,11.2,18,8,7,6,5,8,22,36.4,14,8,0,8,8,26,1,0,Matches
388,Aleksander Buksa,pl POL,FW,Genoa,it Serie A,18,2003,0.7,0,0,0,0,0,0,1,0.0,1,0,0,0,0,0,1,0,Matches
389,Alessandro Buongiorno,it ITA,DF,Torino,it Serie A,22,1999,13.1,20,9,9,8,3,9,13,69.2,4,12,6,6,31,51,44,0,Matches
390,Sascha Burchert,de GER,GK,Greuther Fürth,de Bundesliga,31,1989,14.0,1,1,1,0,0,1,2,50.0,1,0,0,0,0,1,11,1,Matches
391,Delano Burgzorg,nl NED,MF,Mainz 05,de Bundesliga,22,1998,0.3,1,1,1,0,0,0,1,0.0,1,0,0,0,0,1,0,0,Matches
392,Jonathan Burkardt,de GER,"FW,MF",Mainz 05,de Bundesliga,21,2000,29.0,17,8,0,10,7,6,25,24.0,19,31,5,26,8,25,16,0,Matches
393,Roman Bürki,ch SUI,GK,Dortmund,de Bundesliga,30,1990,1.0,0,0,0,0,0,0,0,,0,0,0,0,0,0,0,0,Matches
394,Dan Burn,eng ENG,DF,Newcastle Utd,eng Premier League,29,1992,16.0,16,11,11,4,1,7,11,63.6,4,22,14,8,20,36,101,0,Matches
395,Dan Burn,eng ENG,DF,Brighton,eng Premier League,29,1992,11.4,22,12,13,8,1,6,15,40.0,9,14,10,4,24,46,51,0,Matches
396,Maxime Busi,be BEL,DF,Reims,fr Ligue 1,21,1999,14.4,26,15,20,5,1,19,36,52.8,17,19,5,14,17,43,28,0,Matches
397,Gianluca Busio,us USA,MF,Venezia,it Serie A,19,2002,21.7,53,28,27,20,6,28,63,44.4,35,45,13,32,21,74,30,1,Matches
398,Oriol Busquets,es ESP,MF,Clermont Foot,fr Ligue 1,22,1999,2.2,3,3,0,3,0,2,6,33.3,4,7,4,3,1,4,2,0,Matches
399,Sergio Busquets,es ESP,MF,Barcelona,es La Liga,33,1988,35.5,93,49,31,48,14,46,83,55.4,37,44,8,36,45,138,31,0,Matches
400,Jack Butland,eng ENG,GK,Crystal Palace,eng Premier League,28,1993,8.5,0,0,0,0,0,0,0,,0,0,0,0,0,0,1,0,Matches
401,Adrián Butzke,es ESP,FW,Granada,es La Liga,22,1999,0.0,0,0,0,0,0,0,0,,0,0,0,0,0,0,0,0,Matches
402,Marcin Bułka,pl POL,GK,Nice,fr Ligue 1,21,1999,1.0,0,0,0,0,0,0,0,,0,0,0,0,0,0,0,0,Matches
403,Jamie Bynoe-Gittens,eng ENG,FW,Dortmund,de Bundesliga,16,2004,1.5,3,2,0,2,1,2,5,40.0,3,4,1,3,1,4,1,0,Matches
404,Sam Byram,eng ENG,DF,Norwich City,eng Premier League,27,1993,11.4,24,15,17,6,1,19,27,70.4,8,21,11,10,22,46,48,0,Matches
405,Erick Cabaco,uy URU,DF,Getafe,es La Liga,26,1995,4.5,2,1,1,1,0,2,5,40.0,3,5,2,3,4,6,10,0,Matches
406,Willy Caballero,ar ARG,GK,Southampton,eng Premier League,39,1981,2.0,0,0,0,0,0,0,0,,0,0,0,0,0,0,2,1,Matches
407,Rémy Cabella,fr FRA,"MF,FW",Montpellier,fr Ligue 1,31,1990,3.5,15,7,4,8,3,5,15,33.3,10,7,0,7,5,20,1,0,Matches
408,Jimmy Cabot,fr FRA,DF,Angers,fr Ligue 1,27,1994,22.3,81,44,59,15,7,47,83,56.6,36,29,0,29,32,113,30,0,Matches
409,Arthur Cabral,br BRA,FW,Fiorentina,it Serie A,23,1998,8.3,9,5,2,5,2,4,7,57.1,3,4,1,3,1,10,8,0,Matches
410,Jovane Cabral,cv CPV,FW,Lazio,it Serie A,23,1998,2.1,2,1,1,0,1,0,0,,0,1,1,0,1,3,1,0,Matches
411,Leandro Cabrera,uy URU,DF,Espanyol,es La Liga,30,1991,37.0,37,24,27,10,0,21,34,61.8,13,32,23,9,44,81,222,2,Matches
412,Liberato Cacace,nz NZL,DF,Empoli,it Serie A,20,2000,5.2,15,6,8,4,3,8,8,100.0,0,7,2,5,8,23,9,0,Matches
413,Martín Cáceres,uy URU,DF,Cagliari,it Serie A,34,1987,9.2,13,7,5,5,3,4,12,33.3,8,12,3,9,14,27,21,0,Matches
414,Martín Cáceres,uy URU,DF,Levante,es La Liga,34,1987,7.4,2,2,2,0,0,1,5,20.0,4,2,2,0,11,13,16,1,Matches
415,Anthony Caci,fr FRA,DF,Strasbourg,fr Ligue 1,24,1997,26.6,65,34,35,24,6,33,55,60.0,22,22,3,19,33,98,49,1,Matches
416,Mathieu Cafaro,fr FRA,"MF,FW",Reims,fr Ligue 1,24,1997,2.1,4,2,3,1,0,0,7,0.0,7,2,0,2,3,7,1,0,Matches
417,Yannick Cahuzac,fr FRA,MF,Lens,fr Ligue 1,36,1985,6.9,5,2,2,3,0,0,5,0.0,5,8,2,6,9,14,12,0,Matches
418,Felipe Caicedo,ec ECU,FW,Genoa,it Serie A,32,1988,3.2,3,3,0,2,1,0,1,0.0,1,1,0,1,0,3,4,0,Matches
419,Felipe Caicedo,ec ECU,"FW,DF",Inter,it Serie A,32,1988,0.3,0,0,0,0,0,0,0,,0,1,0,1,0,0,0,0,Matches
420,Moisés Caicedo,ec ECU,MF,Brighton,eng Premier League,19,2001,7.3,16,10,7,7,2,5,12,41.7,7,18,4,14,10,26,7,0,Matches
421,Marc-Aurèle Caillard,fr FRA,GK,Metz,fr Ligue 1,27,1994,17.1,0,0,0,0,0,0,2,0.0,2,0,0,0,2,2,9,1,Matches
422,Jens Cajuste,se SWE,"MF,FW",Reims,fr Ligue 1,21,1999,4.0,10,6,6,2,2,6,17,35.3,11,7,2,5,5,15,6,0,Matches
423,Cala,es ESP,DF,Cádiz,es La Liga,31,1989,10.5,9,4,9,0,0,8,17,47.1,9,12,6,6,12,21,56,0,Matches
424,Davide Calabria,it ITA,DF,Milan,it Serie A,24,1996,23.5,62,37,31,23,8,37,72,51.4,35,25,5,20,23,85,40,1,Matches
425,Riccardo Calafiori,it ITA,DF,Genoa,it Serie A,19,2002,0.9,1,0,0,0,1,1,2,50.0,1,2,1,1,2,3,4,0,Matches
426,Riccardo Calafiori,it ITA,DF,Roma,it Serie A,19,2002,1.9,5,4,2,2,1,1,5,20.0,4,3,0,3,3,8,1,0,Matches
427,Mattia Caldara,it ITA,DF,Venezia,it Serie A,27,1994,30.0,48,28,30,15,3,20,34,58.8,14,49,37,12,62,110,147,1,Matches
428,Calderón,es ESP,DF,Betis,es La Liga,21,2000,0.7,2,0,1,0,1,1,3,33.3,2,0,0,0,0,2,2,0,Matches
429,Fernando Calero,es ESP,DF,Espanyol,es La Liga,25,1995,12.1,17,10,12,5,0,8,13,61.5,5,7,2,5,16,33,63,1,Matches
430,Duje Ćaleta-Car,hr CRO,DF,Marseille,fr Ligue 1,24,1996,22.9,21,8,15,6,0,11,14,78.6,3,11,7,4,24,45,55,2,Matches
431,Hakan Çalhanoğlu,tr TUR,MF,Inter,it Serie A,27,1994,27.6,41,23,16,19,6,11,40,27.5,29,29,5,24,25,66,12,0,Matches
432,Daniel Caligiuri,it ITA,"DF,MF",Augsburg,de Bundesliga,33,1988,22.3,46,30,17,26,3,27,72,37.5,45,36,5,31,18,64,33,0,Matches
433,José Callejón,es ESP,FW,Fiorentina,it Serie A,34,1987,14.4,15,6,6,6,3,13,31,41.9,18,6,0,6,3,18,1,1,Matches
434,Lucas Calodat,fr FRA,DF,Saint-Étienne,fr Ligue 1,19,2002,0.0,0,0,0,0,0,0,0,,0,0,0,0,0,0,0,0,Matches
435,Dominic Calvert-Lewin,eng ENG,FW,Everton,eng Premier League,24,1997,14.3,11,8,1,6,4,3,8,37.5,5,5,2,3,3,14,12,0,Matches
436,Mahdi Camara,fr FRA,"MF,DF",Saint-Étienne,fr Ligue 1,23,1998,34.1,101,57,39,50,12,39,70,55.7,31,44,8,36,57,158,35,1,Matches
437,Mamadou Camara,ml MLI,FW,Troyes,fr Ligue 1,20,2001,0.4,1,1,1,0,0,0,0,,0,0,0,0,0,1,0,0,Matches
438,Víctor Camarasa,es ESP,"MF,FW",Betis,es La Liga,27,1994,1.2,2,1,1,1,0,0,1,0.0,1,2,1,1,2,4,2,0,Matches
439,Eduardo Camavinga,fr FRA,MF,Real Madrid,es La Liga,18,2002,13.7,52,35,22,20,10,20,38,52.6,18,20,2,18,17,69,14,1,Matches
440,Eduardo Camavinga,fr FRA,MF,Rennes,fr Ligue 1,18,2002,1.6,4,1,2,1,1,2,5,40.0,3,1,1,0,1,5,3,0,Matches
441,Andrea Cambiaso,it ITA,DF,Genoa,it Serie A,21,2000,19.9,46,20,28,14,4,18,32,56.3,14,33,8,25,23,69,37,1,Matches
442,José Campaña,es ESP,MF,Levante,es La Liga,28,1993,15.8,27,16,13,10,4,12,32,37.5,20,13,2,11,21,48,19,1,Matches
443,Chem Campbell,wls WAL,MF,Wolves,eng Premier League,18,2002,0.1,1,1,0,1,0,0,0,,0,0,0,0,0,1,0,0,Matches
444,Emre Can,de GER,"DF,MF",Dortmund,de Bundesliga,27,1994,18.8,36,22,20,16,0,15,30,50.0,15,26,10,16,36,72,40,2,Matches
445,Sergio Canales,es ESP,"FW,MF",Betis,es La Liga,30,1991,31.0,24,14,8,12,4,10,35,28.6,25,16,1,15,10,34,12,0,Matches
446,Matteo Cancellieri,it ITA,"MF,DF",Hellas Verona,it Serie A,19,2002,2.5,4,4,2,2,0,0,5,0.0,5,2,0,2,1,5,0,0,Matches
447,João Cancelo,pt POR,DF,Manchester City,eng Premier League,27,1994,35.9,83,54,33,35,15,46,91,50.5,45,25,3,22,59,142,45,1,Matches
448,Fali Candé,gw GNB,DF,Metz,fr Ligue 1,23,1998,10.8,30,18,13,15,2,13,31,41.9,18,11,2,9,6,36,21,0,Matches
449,Antonio Candreva,it ITA,"MF,FW",Sampdoria,it Serie A,34,1987,34.7,27,16,9,11,7,19,55,34.5,36,23,2,21,33,60,19,0,Matches
450,Sergi Canós,es ESP,"DF,FW",Brentford,eng Premier League,24,1997,23.1,56,25,32,15,9,33,60,55.0,27,32,3,29,22,78,38,0,Matches
451,Álex Cantero,es ESP,"FW,MF",Levante,es La Liga,21,2000,6.8,6,4,2,3,1,1,8,12.5,7,2,0,2,1,7,0,0,Matches
452,Todd Cantwell,eng ENG,"FW,MF",Norwich City,eng Premier League,23,1998,4.9,15,13,8,6,1,6,17,35.3,11,2,0,2,3,18,2,0,Matches
453,Ander Capa,es ESP,DF,Athletic Club,es La Liga,29,1992,0.0,0,0,0,0,0,0,0,,0,0,0,0,0,0,0,0,Matches
454,Pierrick Capelle,fr FRA,"MF,DF",Angers,fr Ligue 1,34,1987,13.3,36,24,16,17,3,18,52,34.6,34,12,1,11,16,52,20,0,Matches
455,Leonardo Capezzi,it ITA,MF,Salernitana,it Serie A,26,1995,1.9,3,1,0,3,0,1,4,25.0,3,8,4,4,0,3,2,0,Matches
456,Étienne Capoue,fr FRA,MF,Villarreal,es La Liga,33,1988,25.4,44,26,18,23,3,15,28,53.6,13,17,5,12,35,79,51,0,Matches
457,Gianluca Caprari,it ITA,"MF,FW",Hellas Verona,it Serie A,28,1993,30.4,43,25,10,22,11,17,51,33.3,34,32,0,32,4,47,7,0,Matches
458,Francesco Caputo,it ITA,FW,Sampdoria,it Serie A,33,1987,31.0,5,2,1,3,1,1,6,16.7,5,5,0,5,2,7,10,0,Matches
459,Francesco Caputo,it ITA,FW,Sassuolo,it Serie A,33,1987,1.7,0,0,0,0,0,0,0,,0,0,0,0,0,0,0,0,Matches
460,Maxence Caqueret,fr FRA,MF,Lyon,fr Ligue 1,21,2000,25.9,73,40,29,36,8,30,80,37.5,50,38,10,28,43,116,26,2,Matches
461,Andrea Carboni,it ITA,DF,Cagliari,it Serie A,20,2001,24.6,53,24,33,16,4,19,42,45.2,23,42,15,27,27,80,87,0,Matches
462,Isaac Carcelen,es ESP,"DF,MF",Cádiz,es La Liga,28,1993,17.2,43,29,29,12,2,28,56,50.0,28,25,6,19,34,77,42,0,Matches
463,Cárdenas,es ESP,GK,Levante,es La Liga,24,1997,24.0,1,1,1,0,0,0,3,0.0,3,0,0,0,1,2,19,0,Matches
464,Irvin Cardona,fr FRA,"FW,MF",Brest,fr Ligue 1,23,1997,14.8,13,7,5,4,4,3,16,18.8,13,10,0,10,5,18,17,0,Matches
465,Igor Carioca,br BRA,DF,Lorient,fr Ligue 1,24,1996,17.5,27,16,16,8,3,15,43,34.9,28,17,2,15,25,52,28,0,Matches
466,Carlo,es ESP,MF,Villarreal,es La Liga,20,2001,0.1,0,0,0,0,0,0,0,,0,0,0,0,0,0,0,0,Matches
467,Diego Carlos,br BRA,DF,Sevilla,es La Liga,28,1993,32.9,35,24,20,13,2,16,24,66.7,8,48,33,15,24,59,120,5,Matches
468,Carmona,es ESP,DF,Sevilla,es La Liga,19,2002,0.3,0,0,0,0,0,0,0,,0,0,0,0,1,1,0,0,Matches
469,Yannick Carrasco,be BEL,"FW,MF",Atlético Madrid,es La Liga,27,1993,28.7,34,19,16,12,6,19,44,43.2,25,26,5,21,19,53,12,2,Matches
470,Guido Carrillo,ar ARG,FW,Elche,es La Liga,30,1991,13.0,7,4,2,4,1,3,13,23.1,10,9,2,7,1,8,27,0,Matches
471,Dani Carvajal,es ESP,DF,Real Madrid,es La Liga,29,1992,17.2,43,28,21,15,7,15,26,57.7,11,22,8,14,20,63,38,2,Matches
472,William Carvalho,pt POR,MF,Betis,es La Liga,29,1992,20.1,49,33,20,25,4,15,40,37.5,25,18,7,11,16,65,20,0,Matches
473,Nicolò Casale,it ITA,DF,Hellas Verona,it Serie A,23,1998,28.7,46,30,25,19,2,21,37,56.8,16,31,12,19,49,95,95,0,Matches
474,Casemiro,br BRA,MF,Real Madrid,es La Liga,29,1992,28.5,79,51,45,30,4,30,67,44.8,37,65,19,46,38,117,65,3,Matches
475,Matty Cash,pl POL,DF,Aston Villa,eng Premier League,23,1997,37.5,89,50,52,34,3,47,78,60.3,31,54,16,38,49,138,100,2,Matches
476,Kiko Casilla,es ESP,GK,Elche,es La Liga,34,1986,14.0,0,0,0,0,0,0,1,0.0,1,0,0,0,1,1,2,2,Matches
477,Moreto Cassamã,gw GNB,MF,Reims,fr Ligue 1,23,1998,8.9,12,6,7,4,1,3,19,15.8,16,10,5,5,9,21,5,0,Matches
478,Francesco Cassata,it ITA,MF,Genoa,it Serie A,24,1997,0.1,0,0,0,0,0,0,0,,0,0,0,0,0,0,0,0,Matches
479,Timothy Castagne,be BEL,DF,Leicester City,eng Premier League,25,1995,23.6,67,31,38,22,7,27,43,62.8,16,28,9,19,29,96,54,1,Matches
480,Koen Casteels,be BEL,GK,Wolfsburg,de Bundesliga,29,1992,28.0,0,0,0,0,0,0,1,0.0,1,0,0,0,0,0,9,2,Matches
481,Jean-Charles Castelletto,cm CMR,DF,Nantes,fr Ligue 1,26,1995,27.9,45,24,27,17,1,25,35,71.4,10,38,27,11,30,75,73,0,Matches
482,Samu Castillejo,es ESP,"FW,MF",Milan,it Serie A,26,1995,1.4,4,2,0,2,2,1,8,12.5,7,4,1,3,2,6,1,0,Matches
483,Gonzalo Castro,de GER,"MF,FW",Arminia,de Bundesliga,34,1987,4.8,8,3,4,4,0,1,5,20.0,4,3,0,3,3,11,3,0,Matches
484,Jonny Castro,es ESP,DF,Wolves,eng Premier League,27,1994,11.4,25,15,13,11,1,11,20,55.0,9,14,3,11,13,38,11,0,Matches
485,Gaetano Castrovilli,it ITA,MF,Fiorentina,it Serie A,24,1997,15.5,25,17,15,6,4,12,23,52.2,11,18,4,14,11,36,6,0,Matches
486,Danilo Cataldi,it ITA,MF,Lazio,it Serie A,26,1994,19.0,36,17,15,17,4,12,38,31.6,26,24,12,12,17,53,19,1,Matches
487,Catena,es ESP,DF,Rayo Vallecano,es La Liga,26,1994,36.0,39,23,24,15,0,25,42,59.5,17,26,19,7,30,69,168,3,Matches
488,Craig Cathcart,nir NIR,DF,Watford,eng Premier League,32,1989,26.6,32,15,25,6,1,16,30,53.3,14,39,29,10,28,60,132,3,Matches
489,Edinson Cavani,uy URU,FW,Manchester Utd,eng Premier League,34,1987,8.5,4,1,0,3,1,2,8,25.0,6,6,0,6,2,6,8,0,Matches
490,Dani Ceballos,es ESP,MF,Real Madrid,es La Liga,24,1996,3.1,7,5,4,3,0,1,5,20.0,4,8,2,6,4,11,2,0,Matches
491,Pietro Ceccaroni,it ITA,DF,Venezia,it Serie A,25,1995,34.7,55,31,33,18,4,25,36,69.4,11,45,32,13,30,85,143,0,Matches
492,Federico Ceccherini,it ITA,DF,Hellas Verona,it Serie A,29,1992,26.2,32,16,19,10,3,19,33,57.6,14,13,8,5,50,82,76,1,Matches
493,Emil Ceide,no NOR,"FW,MF",Sassuolo,it Serie A,19,2001,0.6,1,1,0,1,0,1,2,50.0,1,1,0,1,0,1,0,0,Matches
494,Zeki Çelik,tr TUR,DF,Lille,fr Ligue 1,24,1997,30.0,64,37,43,17,4,36,63,57.1,27,32,9,23,43,107,62,2,Matches
495,Fabien Centonze,fr FRA,DF,Metz,fr Ligue 1,25,1996,17.6,33,21,22,9,2,13,32,40.6,19,37,8,29,32,65,51,0,Matches
496,Luca Ceppitelli,it ITA,DF,Cagliari,it Serie A,31,1989,16.1,23,12,13,10,0,16,27,59.3,11,21,14,7,25,48,54,0,Matches
497,Franco Cervi,ar ARG,MF,Celta Vigo,es La Liga,27,1994,20.0,73,41,35,22,16,33,77,42.9,44,38,2,36,21,94,19,0,Matches
498,Damir Ceter,co COL,FW,Cagliari,it Serie A,23,1997,0.1,0,0,0,0,0,0,0,,0,0,0,0,0,0,0,0,Matches
499,Julian Chabot,de GER,DF,Sampdoria,it Serie A,23,1998,5.4,12,10,8,4,0,8,10,80.0,2,7,4,3,9,21,28,1,Matches
500,Julian Chabot,de GER,DF,Köln,de Bundesliga,23,1998,2.3,8,3,4,4,0,2,5,40.0,3,4,2,2,3,11,5,1,Matches
501,El Chadaille Bitshiabu,fr FRA,DF,Paris S-G,fr Ligue 1,16,2005,0.1,0,0,0,0,0,0,0,,0,0,0,0,0,0,2,0,Matches
502,Nassim Chadli,fr FRA,"MF,DF",Troyes,fr Ligue 1,20,2001,1.1,5,3,3,0,2,2,4,50.0,2,1,0,1,0,5,0,0,Matches
503,Kayky Chagas,br BRA,FW,Manchester City,eng Premier League,18,2003,0.1,0,0,0,0,0,0,0,,0,0,0,0,0,0,0,0,Matches
504,Mehdi Chahiri,ma MAR,DF,Strasbourg,fr Ligue 1,25,1996,0.2,1,1,1,0,0,1,1,100.0,0,0,0,0,0,1,0,0,Matches
505,Trevoh Chalobah,eng ENG,DF,Chelsea,eng Premier League,22,1999,16.1,40,27,22,18,0,24,31,77.4,7,16,6,10,19,59,43,2,Matches
506,Calum Chambers,eng ENG,DF,Arsenal,eng Premier League,26,1995,1.9,5,3,3,1,1,3,4,75.0,1,6,3,3,0,5,10,0,Matches
507,Calum Chambers,eng ENG,DF,Aston Villa,eng Premier League,26,1995,9.2,16,8,10,6,0,4,6,66.7,2,14,8,6,5,21,42,0,Matches
508,Dylan Chambost,fr FRA,"MF,FW",Troyes,fr Ligue 1,23,1997,8.4,16,11,6,9,1,4,25,16.0,21,9,2,7,8,24,4,0,Matches
509,Timothy Chandler,us USA,DF,Eint Frankfurt,de Bundesliga,31,1990,13.5,18,12,10,8,0,11,24,45.8,13,10,3,7,19,37,28,1,Matches
510,Chapela,es ESP,"MF,FW",Cádiz,es La Liga,22,1999,4.4,4,2,1,0,3,2,4,50.0,2,6,1,5,4,8,5,0,Matches
511,Brendan Chardonnet,fr FRA,DF,Brest,fr Ligue 1,26,1994,29.8,44,25,32,11,1,29,40,72.5,11,42,29,13,55,99,141,0,Matches
512,Xavier Chavalerin,fr FRA,MF,Troyes,fr Ligue 1,30,1991,30.2,49,26,19,25,5,12,55,21.8,43,32,5,27,39,88,36,0,Matches
513,Xavier Chavalerin,fr FRA,MF,Reims,fr Ligue 1,30,1991,2.4,4,4,2,1,1,1,3,33.3,2,2,0,2,5,9,2,1,Matches
514,Justin Che,us USA,"FW,DF",Hoffenheim,de Bundesliga,17,2003,0.5,2,0,1,0,1,1,2,50.0,1,0,0,0,1,3,0,0,Matches
515,Chema,es ESP,MF,Getafe,es La Liga,29,1992,0.5,0,0,0,0,0,0,1,0.0,1,0,0,0,0,0,0,0,Matches
516,Rayan Cherki,fr FRA,"FW,MF",Lyon,fr Ligue 1,17,2003,4.9,6,2,1,3,2,4,9,44.4,5,2,0,2,1,7,0,0,Matches
517,Denis Cheryshev,ru RUS,"MF,FW",Valencia,es La Liga,30,1990,6.3,14,5,6,1,7,6,15,40.0,9,9,1,8,9,23,9,0,Matches
518,Daniel Chesters,eng ENG,MF,West Ham,eng Premier League,19,2002,0.0,0,0,0,0,0,0,0,,0,0,0,0,0,0,0,0,Matches
519,Giorgio Chiellini,it ITA,DF,Juventus,it Serie A,36,1984,15.0,22,13,17,4,1,7,13,53.8,6,24,18,6,22,44,59,0,Matches
520,Federico Chiesa,it ITA,"MF,FW",Juventus,it Serie A,23,1997,9.6,26,19,9,9,8,12,26,46.2,14,7,0,7,4,30,3,0,Matches
521,Ben Chilwell,eng ENG,DF,Chelsea,eng Premier League,24,1996,6.0,8,3,2,6,0,2,5,40.0,3,7,0,7,4,12,14,1,Matches
522,Chiquinho,pt POR,"DF,FW",Wolves,eng Premier League,21,2000,2.3,9,6,4,5,0,4,5,80.0,1,5,0,5,2,11,1,0,Matches
523,Vlad Chiricheș,ro ROU,DF,Sassuolo,it Serie A,31,1989,25.6,28,15,19,9,0,10,21,47.6,11,34,21,13,41,69,71,4,Matches
524,Pedro Chirivella,es ESP,MF,Nantes,fr Ligue 1,24,1997,29.3,49,31,14,26,9,25,70,35.7,45,23,2,21,37,86,11,0,Matches
525,Joris Chotard,fr FRA,MF,Montpellier,fr Ligue 1,19,2001,32.6,59,30,33,23,3,36,78,46.2,42,27,15,12,42,101,56,0,Matches
526,Hamza Choudhury,eng ENG,"DF,MF",Leicester City,eng Premier League,23,1997,3.2,9,3,4,4,1,3,5,60.0,2,0,0,0,12,21,10,0,Matches
527,Andreas Christensen,dk DEN,DF,Chelsea,eng Premier League,25,1996,16.6,14,8,9,4,1,4,7,57.1,3,14,6,8,29,43,57,1,Matches
528,Max Christiansen,de GER,MF,Greuther Fürth,de Bundesliga,24,1996,22.8,46,25,19,22,5,18,43,41.9,25,52,16,36,68,114,56,0,Matches
529,Carney Chukwuemeka,eng ENG,"MF,FW",Aston Villa,eng Premier League,17,2003,3.3,7,1,2,5,0,3,5,60.0,2,3,0,3,1,8,2,1,Matches
530,Samuel Chukwueze,ng NGA,"MF,FW",Villarreal,es La Liga,22,1999,14.8,13,9,6,5,2,3,6,50.0,3,7,0,7,5,18,4,0,Matches
531,Víctor Chust,es ESP,DF,Cádiz,es La Liga,21,2000,20.3,19,10,14,4,1,11,17,64.7,6,20,8,12,16,35,87,0,Matches
532,Riccardo Ciervo,it ITA,"MF,DF",Sampdoria,it Serie A,19,2002,2.5,8,3,4,3,1,2,6,33.3,4,1,0,1,2,10,2,0,Matches
533,Jasper Cillessen,nl NED,GK,Valencia,es La Liga,32,1989,16.2,0,0,0,0,0,0,1,0.0,1,0,0,0,1,1,6,0,Matches
534,Pathé Ciss,sn SEN,MF,Rayo Vallecano,es La Liga,27,1994,12.2,31,15,20,8,3,12,26,46.2,14,16,6,10,30,61,27,0,Matches
535,Moustapha Cissé,gn GUI,FW,Atalanta,it Serie A,17,2003,0.4,1,0,0,1,0,0,3,0.0,3,0,0,0,0,1,0,0,Matches
536,Giorgio Cittadini,it ITA,DF,Atalanta,it Serie A,19,2002,0.0,0,0,0,0,0,0,0,,0,0,0,0,1,1,0,0,Matches
537,Ciaran Clark,ie IRL,DF,Newcastle Utd,eng Premier League,31,1989,11.3,13,10,4,7,2,9,14,64.3,5,14,11,3,13,26,43,1,Matches
538,Alexis Claude-Maurice,fr FRA,MF,Nice,fr Ligue 1,23,1998,2.3,2,0,1,0,1,1,4,25.0,3,7,0,7,3,5,1,0,Matches
539,Jonathan Clauss,fr FRA,DF,Lens,fr Ligue 1,28,1992,33.8,63,34,33,20,10,22,55,40.0,33,43,1,42,73,136,51,0,Matches
540,Carlos Clerc,es ESP,DF,Levante,es La Liga,29,1992,16.8,35,17,21,10,4,7,19,36.8,12,8,3,5,26,61,32,1,Matches
541,Tom Cleverley,eng ENG,MF,Watford,eng Premier League,31,1989,18.0,37,20,19,17,1,18,33,54.5,15,23,6,17,18,55,19,3,Matches
542,Nathaniel Clyne,eng ENG,DF,Crystal Palace,eng Premier League,30,1991,15.0,21,10,11,9,1,10,20,50.0,10,7,2,5,15,36,32,0,Matches
543,Conor Coady,eng ENG,DF,Wolves,eng Premier League,28,1993,37.3,31,14,23,7,1,16,28,57.1,12,46,40,6,28,59,140,0,Matches
544,Marcus Coco,fr FRA,"MF,FW",Nantes,fr Ligue 1,25,1996,10.3,34,14,17,11,6,8,18,44.4,10,11,1,10,10,44,15,0,Matches
545,Coke,es ESP,DF,Levante,es La Liga,34,1987,1.3,3,2,1,1,1,3,4,75.0,1,1,0,1,2,5,7,0,Matches
546,Séamus Coleman,ie IRL,DF,Everton,eng Premier League,32,1988,29.5,61,36,35,16,10,33,51,64.7,18,30,11,19,32,93,80,2,Matches
547,Álex Collado,es ESP,"MF,FW",Granada,es La Liga,22,1999,11.3,27,12,6,16,5,12,31,38.7,19,28,2,26,6,33,11,0,Matches
548,Ebrima Colley,gm GAM,"FW,MF",Spezia,it Serie A,21,2000,4.4,6,1,3,2,1,1,7,14.3,6,8,0,8,3,9,2,0,Matches
549,Omar Colley,gm GAM,DF,Sampdoria,it Serie A,28,1992,30.5,47,36,32,14,1,22,32,68.8,10,31,19,12,80,127,135,2,Matches
550,Nathan Collins,ie IRL,DF,Burnley,eng Premier League,20,2001,18.6,37,15,27,8,2,17,27,63.0,10,38,25,13,24,61,83,2,Matches
551,Kingsley Coman,fr FRA,"FW,DF",Bayern Munich,de Bundesliga,25,1996,15.1,14,8,1,9,4,5,16,31.3,11,14,0,14,8,22,5,0,Matches
552,Eray Cömert,ch SUI,DF,Valencia,es La Liga,23,1998,4.5,5,3,4,1,0,3,6,50.0,3,3,2,1,2,7,6,0,Matches
553,Santi Comesaña,es ESP,MF,Rayo Vallecano,es La Liga,24,1996,29.8,87,56,45,33,9,40,104,38.5,64,46,6,40,33,120,30,0,Matches
554,Diego Conde,es ESP,GK,Getafe,es La Liga,22,1998,0.1,0,0,0,0,0,0,0,,0,0,0,0,0,0,0,0,Matches
555,Aaron Connolly,ie IRL,"FW,MF",Brighton,eng Premier League,21,2000,1.7,0,0,0,0,0,0,1,0.0,1,2,0,2,0,0,0,0,Matches
556,Andrea Consigli,it ITA,GK,Sassuolo,it Serie A,34,1987,36.9,0,0,0,0,0,0,2,0.0,2,0,0,0,0,0,23,3,Matches
557,Abdu Conté,pt POR,DF,Troyes,fr Ligue 1,23,1998,15.0,22,12,16,5,1,12,24,50.0,12,12,2,10,4,26,10,0,Matches
558,Andrea Conti,it ITA,"DF,MF",Sampdoria,it Serie A,27,1994,2.6,4,2,2,1,1,3,6,50.0,3,4,0,4,7,11,4,0,Matches
559,Andrea Conti,it ITA,DF,Milan,it Serie A,27,1994,0.1,0,0,0,0,0,0,0,,0,0,0,0,0,0,0,0,Matches
560,Liam Cooper,sct SCO,DF,Leeds United,eng Premier League,29,1991,20.2,41,23,27,13,1,23,33,69.7,10,29,18,11,43,84,72,2,Matches
561,Lucas Copado,de GER,FW,Bayern Munich,de Bundesliga,17,2004,0.2,1,0,1,0,0,1,1,100.0,0,0,0,0,0,1,0,0,Matches
562,Diego Coppola,it ITA,DF,Hellas Verona,it Serie A,17,2003,2.8,8,4,4,4,0,3,3,100.0,0,5,1,4,4,12,5,0,Matches
563,Francis Coquelin,fr FRA,MF,Villarreal,es La Liga,30,1991,9.2,26,17,9,11,6,11,20,55.0,9,15,5,10,19,45,11,0,Matches
564,Sébastien Corchia,fr FRA,DF,Nantes,fr Ligue 1,30,1990,14.7,33,20,17,11,5,24,42,57.1,18,24,3,21,13,46,36,0,Matches
565,Sergio Córdova,ve VEN,"FW,MF",Augsburg,de Bundesliga,23,1997,3.6,4,3,2,2,0,1,2,50.0,1,4,0,4,0,4,4,0,Matches
566,Jack Cork,eng ENG,MF,Burnley,eng Premier League,32,1989,18.6,20,6,6,11,3,7,20,35.0,13,17,4,13,17,37,29,1,Matches
567,Maxwel Cornet,ci CIV,"FW,MF",Burnley,eng Premier League,24,1996,19.6,16,9,7,5,4,7,15,46.7,8,13,4,9,10,26,14,0,Matches
568,Maxwel Cornet,ci CIV,DF,Lyon,fr Ligue 1,24,1996,0.7,3,1,1,0,2,3,4,75.0,1,0,0,0,1,4,1,0,Matches
569,Jesús Corona,mx MEX,"FW,DF",Sevilla,es La Liga,28,1993,12.9,12,7,7,5,0,3,6,50.0,3,4,0,4,8,20,6,0,Matches
570,Ángel Correa,ar ARG,"FW,MF",Atlético Madrid,es La Liga,26,1995,20.6,16,8,5,10,1,7,29,24.1,22,25,2,23,10,26,4,0,Matches
571,Joaquín Correa,ar ARG,FW,Inter,it Serie A,26,1994,11.4,11,5,2,6,3,1,13,7.7,12,8,1,7,3,14,2,0,Matches
572,Thierry Correia,pt POR,DF,Valencia,es La Liga,22,1999,15.7,35,23,26,6,3,14,29,48.3,15,20,5,15,19,54,27,0,Matches
573,Danny da Costa,de GER,"DF,MF",Eint Frankfurt,de Bundesliga,28,1993,8.1,15,4,6,7,2,6,18,33.3,12,14,1,13,11,26,18,1,Matches
574,David Pereira da Costa,pt POR,"MF,FW",Lens,fr Ligue 1,20,2001,16.3,22,12,9,6,7,11,26,42.3,15,12,0,12,13,35,5,0,Matches
575,Hélder Costa,ao ANG,MF,Leeds United,eng Premier League,27,1994,0.2,0,0,0,0,0,0,0,,0,1,0,1,0,0,0,0,Matches
576,Hélder Costa,ao ANG,"MF,FW",Valencia,es La Liga,27,1994,12.4,27,16,11,9,7,14,41,34.1,27,12,1,11,3,30,9,0,Matches
577,Jaume Costa,es ESP,DF,Mallorca,es La Liga,33,1988,20.3,35,26,23,7,5,23,31,74.2,8,22,7,15,23,58,55,0,Matches
578,Benoît Costil,fr FRA,GK,Bordeaux,fr Ligue 1,34,1987,25.0,1,0,1,0,0,1,2,50.0,1,0,0,0,0,1,6,3,Matches
579,Vladimír Coufal,cz CZE,DF,West Ham,eng Premier League,28,1992,24.5,45,25,24,14,7,18,36,50.0,18,31,9,22,22,67,64,1,Matches
580,Kalifa Coulibaly,ml MLI,FW,Nantes,fr Ligue 1,29,1991,9.4,5,1,1,1,3,0,4,0.0,4,2,2,0,0,5,11,0,Matches
581,Lassana Coulibaly,ml MLI,MF,Salernitana,it Serie A,25,1996,25.9,58,32,29,26,3,24,62,38.7,38,40,13,27,22,80,27,0,Matches
582,Mamadou Coulibaly,sn SEN,MF,Salernitana,it Serie A,22,1999,9.0,15,12,8,5,2,7,20,35.0,13,9,0,9,11,26,9,0,Matches
583,Tanguy Coulibaly,fr FRA,"FW,MF",Stuttgart,de Bundesliga,20,2001,12.0,27,15,14,11,2,9,19,47.4,10,14,2,12,4,31,10,0,Matches
584,Thibaut Courtois,be BEL,GK,Real Madrid,es La Liga,29,1992,36.0,1,0,1,0,0,1,2,50.0,1,0,0,0,0,1,9,1,Matches
585,Philippe Coutinho,br BRA,"MF,FW",Aston Villa,eng Premier League,29,1992,14.8,17,12,4,11,2,6,21,28.6,15,11,1,10,7,24,4,0,Matches
586,Philippe Coutinho,br BRA,"MF,FW",Barcelona,es La Liga,29,1992,5.6,6,3,3,3,0,3,11,27.3,8,3,0,3,4,10,3,0,Matches
587,Nicolas Cozza,fr FRA,DF,Montpellier,fr Ligue 1,22,1999,30.8,80,47,50,23,7,35,65,53.8,30,35,19,16,38,118,82,1,Matches
588,Alessio Cragno,it ITA,GK,Cagliari,it Serie A,27,1994,35.0,3,3,2,1,0,3,3,100.0,0,0,0,0,1,4,14,1,Matches
589,Aaron Cresswell,eng ENG,DF,West Ham,eng Premier League,31,1989,30.3,28,18,18,6,4,13,25,52.0,12,31,18,13,35,63,66,0,Matches
590,Charlie Cresswell,eng ENG,DF,Leeds United,eng Premier League,18,2002,1.6,5,2,1,4,0,3,3,100.0,0,1,1,0,2,7,6,0,Matches
591,Domenico Criscito,it ITA,DF,Genoa,it Serie A,34,1986,18.0,37,21,19,14,4,16,25,64.0,9,22,12,10,39,76,57,0,Matches
592,Bryan Cristante,it ITA,MF,Roma,it Serie A,26,1995,29.8,79,39,31,39,9,37,69,53.6,32,31,5,26,40,119,45,0,Matches
593,Cristo,es ESP,DF,Real Sociedad,es La Liga,21,2000,0.2,0,0,0,0,0,0,0,,0,0,0,0,0,0,0,0,Matches
594,Enzo Crivelli,fr FRA,"FW,MF",Saint-Étienne,fr Ligue 1,26,1995,1.1,1,0,0,0,1,0,0,,0,0,0,0,0,1,1,0,Matches
595,Domen Črnigoj,si SVN,MF,Venezia,it Serie A,25,1995,20.9,21,13,7,11,3,11,29,37.9,18,27,8,19,24,45,42,0,Matches
596,Giovanni Crociata,it ITA,FW,Empoli,it Serie A,23,1997,0.2,0,0,0,0,0,0,1,0.0,1,0,0,0,0,0,0,0,Matches
597,Juan Cruz Armada,es ESP,DF,Osasuna,es La Liga,29,1992,21.5,28,21,15,12,1,8,16,50.0,8,15,12,3,16,44,58,1,Matches
598,Juan Cuadrado,co COL,"DF,MF",Juventus,it Serie A,33,1988,27.6,48,23,30,13,5,30,55,54.5,25,23,5,18,29,77,34,0,Matches
599,Cucho,co COL,"FW,MF",Watford,eng Premier League,22,1999,12.7,13,5,5,5,3,5,27,18.5,22,13,1,12,5,18,9,0,Matches
600,Marc Cucurella,es ESP,DF,Brighton,eng Premier League,23,1998,34.3,93,62,43,32,18,44,71,62.0,27,42,14,28,30,123,74,0,Matches
601,Marc Cucurella,es ESP,"MF,DF",Getafe,es La Liga,23,1998,0.3,0,0,0,0,0,0,0,,0,0,0,0,0,0,0,0,Matches
602,Jorge Cuenca,es ESP,DF,Getafe,es La Liga,21,1999,29.8,46,32,30,15,1,21,28,75.0,7,29,14,15,39,85,155,0,Matches
603,Mickaël Cuisance,fr FRA,MF,Venezia,it Serie A,21,1999,10.2,23,9,7,12,4,10,28,35.7,18,14,0,14,12,35,5,0,Matches
604,Mickaël Cuisance,fr FRA,MF,Bayern Munich,de Bundesliga,21,1999,0.1,1,1,0,1,0,0,0,,0,0,0,0,0,1,0,0,Matches
605,Luke Cundle,eng ENG,MF,Wolves,eng Premier League,19,2002,2.0,4,3,0,4,0,1,1,100.0,0,0,0,0,1,5,1,0,Matches
606,Matheus Cunha,br BRA,FW,Atlético Madrid,es La Liga,22,1999,11.8,19,12,3,11,5,5,20,25.0,15,18,2,16,6,25,9,0,Matches
607,Matheus Cunha,br BRA,FW,Hertha BSC,de Bundesliga,22,1999,0.7,0,0,0,0,0,0,0,,0,0,0,0,0,0,0,0,Matches
608,Patrick Cutrone,it ITA,FW,Empoli,it Serie A,23,1998,15.6,5,2,0,3,2,1,9,11.1,8,11,1,10,5,10,1,0,Matches
609,Wylan Cyprien,fr FRA,MF,Nantes,fr Ligue 1,26,1995,16.6,33,17,12,18,3,13,32,40.6,19,16,6,10,10,43,14,2,Matches
610,Rafael Czichos,de GER,DF,Köln,de Bundesliga,31,1990,15.6,29,18,18,9,2,14,28,50.0,14,23,13,10,19,48,53,2,Matches
611,Lennart-Marten Czyborra,de GER,DF,Arminia,de Bundesliga,22,1999,1.5,0,0,0,0,0,0,2,0.0,2,0,0,0,3,3,3,1,Matches
612,Danilo D'Ambrosio,it ITA,DF,Inter,it Serie A,32,1988,11.1,30,15,21,8,1,11,22,50.0,11,21,10,11,8,38,20,0,Matches
613,Lucas Da Cunha,fr FRA,MF,Nice,fr Ligue 1,20,2001,4.4,13,7,2,7,4,6,11,54.5,5,2,0,2,1,14,2,0,Matches
614,Lucas Da Cunha,fr FRA,"FW,MF",Clermont Foot,fr Ligue 1,20,2001,9.3,17,11,5,8,4,9,18,50.0,9,13,0,13,1,18,3,0,Matches
615,Damien Da Silva,fr FRA,DF,Lyon,fr Ligue 1,33,1988,12.5,13,9,7,5,1,5,9,55.6,4,15,10,5,22,35,53,1,Matches
616,Moanes Dabbur,il ISR,"FW,MF",Hoffenheim,de Bundesliga,29,1992,14.6,18,10,3,5,10,4,17,23.5,13,10,0,10,5,23,4,0,Matches
617,Colin Dagba,fr FRA,DF,Paris S-G,fr Ligue 1,22,1998,1.8,4,2,2,2,0,3,6,50.0,3,4,2,2,2,6,1,0,Matches
618,Finn Dahmen,de GER,GK,Mainz 05,de Bundesliga,23,1998,2.0,0,0,0,0,0,0,0,,0,0,0,0,0,0,2,0,Matches
619,Mahmoud Dahoud,de GER,MF,Dortmund,de Bundesliga,25,1996,18.4,42,19,10,24,8,20,46,43.5,26,18,3,15,17,59,16,0,Matches
620,Patson Daka,zm ZAM,FW,Leicester City,eng Premier League,22,1998,12.9,15,10,2,8,5,2,19,10.5,17,7,0,7,2,17,8,0,Matches
621,Stuart Dallas,nir NIR,"DF,MF",Leeds United,eng Premier League,30,1991,32.4,93,55,58,31,4,56,105,53.3,49,45,14,31,57,150,63,2,Matches
622,Diogo Dalot,pt POR,DF,Manchester Utd,eng Premier League,22,1999,20.0,55,41,35,12,8,31,57,54.4,26,24,13,11,29,84,59,0,Matches
623,Mikkel Damsgaard,dk DEN,"MF,FW",Sampdoria,it Serie A,21,2000,6.4,27,13,12,11,4,20,36,55.6,16,16,1,15,7,34,7,0,Matches
624,Flavius Daniliuc,at AUT,DF,Nice,fr Ligue 1,20,2001,14.4,46,31,26,17,3,34,43,79.1,9,13,7,6,14,60,34,1,Matches
625,Danilo,br BRA,"DF,MF",Juventus,it Serie A,30,1991,21.0,37,26,20,13,4,18,28,64.3,10,21,12,9,32,69,53,1,Matches
626,Arnaut Danjuma,nl NED,FW,Villarreal,es La Liga,24,1997,16.4,7,6,3,0,4,2,4,50.0,2,5,0,5,2,9,3,0,Matches
627,Kevin Danso,at AUT,DF,Lens,fr Ligue 1,22,1998,31.0,41,29,29,12,0,23,34,67.6,11,38,25,13,40,81,111,0,Matches
628,Dante,br BRA,DF,Nice,fr Ligue 1,37,1983,31.9,42,29,30,12,0,23,33,69.7,10,43,27,16,49,91,96,1,Matches
629,Ebrima Darboe,gm GAM,MF,Roma,it Serie A,20,2001,0.7,1,1,0,1,0,0,0,,0,0,0,0,1,2,0,1,Matches
630,Márton Dárdai,hu HUN,DF,Hertha BSC,de Bundesliga,19,2002,8.4,10,4,8,2,0,8,18,44.4,10,16,6,10,20,30,33,2,Matches
631,Sergi Darder,es ESP,MF,Espanyol,es La Liga,27,1993,34.7,45,22,16,19,10,18,54,33.3,36,16,1,15,26,71,32,1,Matches
632,Vladimír Darida,cz CZE,MF,Hertha BSC,de Bundesliga,30,1990,19.8,32,18,15,13,4,13,32,40.6,19,22,3,19,20,52,17,2,Matches
633,Karl Darlow,eng ENG,GK,Newcastle Utd,eng Premier League,30,1990,8.0,0,0,0,0,0,0,0,,0,0,0,0,0,0,5,1,Matches
634,Matteo Darmian,it ITA,DF,Inter,it Serie A,31,1989,16.7,32,16,17,9,6,16,41,39.0,25,16,1,15,19,51,25,0,Matches
635,Josh Dasilva,eng ENG,"MF,FW",Brentford,eng Premier League,22,1998,2.9,2,1,0,1,1,1,2,50.0,1,3,0,3,1,3,7,0,Matches
636,Jonathan David,ca CAN,FW,Lille,fr Ligue 1,21,2000,31.2,24,9,7,11,6,9,30,30.0,21,14,4,10,5,29,15,0,Matches
637,Alphonso Davies,ca CAN,DF,Bayern Munich,de Bundesliga,20,2000,19.3,34,17,17,8,9,13,31,41.9,18,27,1,26,23,57,26,1,Matches
638,Ben Davies,wls WAL,DF,Tottenham,eng Premier League,28,1993,28.2,36,21,20,12,4,13,26,50.0,13,32,19,13,30,66,75,1,Matches
639,Tom Davies,eng ENG,MF,Everton,eng Premier League,23,1998,2.6,3,1,1,1,1,2,5,40.0,3,2,1,1,2,5,9,0,Matches
640,Keinan Davis,eng ENG,FW,Aston Villa,eng Premier League,23,1998,0.1,0,0,0,0,0,0,0,,0,0,0,0,0,0,0,0,Matches
641,Paweł Dawidowicz,pl POL,DF,Hellas Verona,it Serie A,26,1995,13.3,30,18,16,10,4,16,25,64.0,9,14,11,3,21,51,53,0,Matches
642,Craig Dawson,eng ENG,DF,West Ham,eng Premier League,31,1990,30.6,29,17,20,8,1,14,25,56.0,11,59,52,7,29,58,139,0,Matches
643,Kevin De Bruyne,be BEL,MF,Manchester City,eng Premier League,30,1991,24.5,32,16,4,15,13,12,37,32.4,25,32,2,30,6,38,16,0,Matches
644,Konrad De La Fuente,us USA,"FW,MF",Marseille,fr Ligue 1,20,2001,8.7,11,7,8,2,1,7,11,63.6,4,5,0,5,2,13,4,0,Matches
645,Sebastien De Maio,fr FRA,DF,Udinese,it Serie A,34,1987,2.0,5,1,4,1,0,1,9,11.1,8,6,5,1,1,6,9,0,Matches
646,Tommaso De Nipoti,it ITA,FW,Atalanta,it Serie A,18,2003,0.1,0,0,0,0,0,0,0,,0,0,0,0,0,0,0,0,Matches
647,Rodrigo De Paul,ar ARG,MF,Atlético Madrid,es La Liga,27,1994,23.9,55,30,22,25,8,30,60,50.0,30,24,3,21,21,76,17,2,Matches
648,Mattia De Sciglio,it ITA,DF,Juventus,it Serie A,28,1992,13.0,24,12,7,9,8,11,24,45.8,13,10,0,10,10,34,30,0,Matches
649,Lorenzo De Silvestri,it ITA,DF,Bologna,it Serie A,33,1988,25.5,23,14,13,8,2,9,31,29.0,22,25,7,18,26,49,52,0,Matches
650,Saulo Decarli,ch SUI,DF,Bochum,de Bundesliga,29,1992,0.1,0,0,0,0,0,0,0,,0,0,0,0,0,0,0,0,Matches
651,Troy Deeney,eng ENG,FW,Watford,eng Premier League,33,1988,0.3,0,0,0,0,0,0,1,0.0,1,0,0,0,0,0,2,0,Matches
652,Grégoire Defrel,mq MTQ,FW,Sassuolo,it Serie A,30,1991,15.1,15,9,4,8,3,6,16,37.5,10,11,1,10,4,19,11,0,Matches
653,Alessandro Deiola,it ITA,MF,Cagliari,it Serie A,25,1995,23.7,47,22,15,25,7,23,58,39.7,35,28,10,18,26,73,45,0,Matches
654,Romain Del Castillo,fr FRA,"MF,FW",Rennes,fr Ligue 1,25,1996,0.3,2,1,0,1,1,2,2,100.0,0,0,0,0,1,3,0,0,Matches
655,Romain Del Castillo,fr FRA,"MF,FW",Brest,fr Ligue 1,25,1996,10.8,27,16,3,17,7,12,31,38.7,19,12,0,12,7,34,3,0,Matches
656,Thomas Delaine,fr FRA,DF,Metz,fr Ligue 1,29,1992,25.7,48,35,34,12,2,22,42,52.4,20,20,7,13,27,75,31,0,Matches
657,Thomas Delaney,dk DEN,MF,Sevilla,es La Liga,29,1991,17.2,41,24,17,21,3,16,30,53.3,14,19,10,9,13,54,35,0,Matches
658,Thomas Delaney,dk DEN,MF,Dortmund,de Bundesliga,29,1991,0.2,0,0,0,0,0,0,0,,0,0,0,0,0,0,0,0,Matches
659,Liam Delap,eng ENG,FW,Manchester City,eng Premier League,18,2003,0.1,0,0,0,0,0,0,0,,0,0,0,0,0,0,0,0,Matches
660,Sacha Delaye,fr FRA,"MF,FW",Montpellier,fr Ligue 1,19,2002,2.9,8,6,3,2,3,2,8,25.0,6,1,0,1,1,9,1,1,Matches
661,Filippo Delli Carri,it ITA,DF,Salernitana,it Serie A,22,1999,3.7,6,4,4,2,0,5,14,35.7,9,6,2,4,4,10,14,0,Matches
662,Andy Delort,dz ALG,FW,Nice,fr Ligue 1,29,1991,27.2,15,9,3,5,7,7,12,58.3,5,13,4,9,9,24,14,0,Matches
663,Andy Delort,dz ALG,FW,Montpellier,fr Ligue 1,29,1991,3.0,2,0,0,1,1,0,1,0.0,1,1,0,1,0,2,4,0,Matches
664,Fabian Delph,eng ENG,MF,Everton,eng Premier League,31,1989,7.4,18,15,10,7,1,8,21,38.1,13,12,5,7,14,32,10,0,Matches
665,Moussa Dembélé,fr FRA,FW,Lyon,fr Ligue 1,25,1996,24.5,18,9,5,5,8,6,15,40.0,9,13,0,13,8,26,30,1,Matches
666,Ousmane Dembélé,fr FRA,FW,Barcelona,es La Liga,24,1997,15.7,24,16,6,10,8,7,23,30.4,16,8,0,8,8,32,3,0,Matches
667,Yusuf Demir,at AUT,FW,Barcelona,es La Liga,18,2003,2.1,3,1,1,1,1,2,5,40.0,3,1,0,1,2,5,1,0,Matches
668,Merih Demiral,tr TUR,DF,Atalanta,it Serie A,23,1998,21.3,31,17,18,12,1,15,28,53.6,13,26,14,12,58,89,68,1,Matches
669,Kerem Demirbay,de GER,MF,Leverkusen,de Bundesliga,28,1993,22.8,52,31,19,30,3,16,41,39.0,25,32,9,23,33,85,21,0,Matches
670,Ermedin Demirović,ba BIH,FW,Freiburg,de Bundesliga,23,1998,9.7,12,6,4,4,4,1,10,10.0,9,14,1,13,1,13,7,0,Matches
671,Diego Demme,de GER,MF,Napoli,it Serie A,29,1991,7.7,21,12,4,13,4,10,21,47.6,11,11,2,9,9,30,2,0,Matches
672,Jason Denayer,be BEL,DF,Lyon,fr Ligue 1,26,1995,11.1,11,4,8,3,0,6,7,85.7,1,8,7,1,16,27,52,0,Matches
673,Leander Dendoncker,be BEL,MF,Wolves,eng Premier League,26,1995,21.7,42,17,25,14,3,22,50,44.0,28,37,10,27,9,51,38,1,Matches
674,Emmanuel Dennis,ng NGA,"FW,MF",Watford,eng Premier League,23,1997,28.7,51,35,20,22,9,17,52,32.7,35,36,2,34,15,66,13,0,Matches
675,Fabio Depaoli,it ITA,DF,Hellas Verona,it Serie A,24,1997,7.8,12,7,6,4,2,1,7,14.3,6,9,2,7,8,20,14,0,Matches
676,Fabio Depaoli,it ITA,"MF,DF",Sampdoria,it Serie A,24,1997,1.2,3,1,1,2,0,0,2,0.0,2,2,1,1,1,4,2,0,Matches
677,Mike van der Hoorn,nl NED,DF,Arminia,de Bundesliga,28,1992,0.2,1,0,1,0,0,0,0,,0,0,0,0,1,2,2,0,Matches
678,Arthur Desmas,fr FRA,GK,Clermont Foot,fr Ligue 1,27,1994,14.5,0,0,0,0,0,0,3,0.0,3,0,0,0,0,0,1,3,Matches
679,Sergiño Dest,us USA,"DF,FW",Barcelona,es La Liga,20,2000,16.8,32,15,21,10,1,13,18,72.2,5,22,4,18,2,34,18,0,Matches
680,Mattia Destro,it ITA,FW,Genoa,it Serie A,30,1991,19.4,9,4,1,4,4,1,6,16.7,5,14,1,13,2,11,16,0,Matches
681,Gerard Deulofeu,es ESP,"FW,MF",Udinese,it Serie A,27,1994,29.1,11,6,2,3,6,7,29,24.1,22,14,0,14,9,20,4,0,Matches
682,Kiernan Dewsbury-Hall,eng ENG,MF,Leicester City,eng Premier League,22,1998,23.4,39,24,20,14,5,19,40,47.5,21,37,8,29,21,60,26,1,Matches
683,Jacopo Dezi,it ITA,MF,Venezia,it Serie A,29,1992,0.2,0,0,0,0,0,0,1,0.0,1,0,0,0,1,1,0,0,Matches
684,Samuel Di Carmine,it ITA,FW,Hellas Verona,it Serie A,32,1988,0.4,0,0,0,0,0,0,0,,0,0,0,0,0,0,0,0,Matches
685,Federico Di Francesco,it ITA,"FW,MF",Empoli,it Serie A,27,1994,15.2,16,5,2,8,6,9,23,39.1,14,17,1,16,9,25,11,0,Matches
686,Giovanni Di Lorenzo,it ITA,DF,Napoli,it Serie A,27,1993,31.9,58,36,30,20,8,33,58,56.9,25,28,10,18,38,96,46,1,Matches
687,Ángel Di María,ar ARG,FW,Paris S-G,fr Ligue 1,33,1988,18.3,29,18,6,13,10,14,37,37.8,23,17,0,17,6,35,3,0,Matches
688,Francesco Di Mariano,it ITA,FW,Venezia,it Serie A,25,1996,0.7,1,1,0,1,0,0,0,,0,2,1,1,0,1,0,0,Matches
689,Francesco Di Tacchio,it ITA,MF,Salernitana,it Serie A,31,1990,13.9,17,7,5,10,2,9,25,36.0,16,16,8,8,22,39,25,0,Matches
690,Boulaye Dia,sn SEN,FW,Villarreal,es La Liga,24,1996,14.1,8,6,3,4,1,2,5,40.0,3,6,1,5,5,13,4,0,Matches
691,Moussa Diaby,fr FRA,"FW,MF",Leverkusen,de Bundesliga,22,1999,30.7,20,11,8,9,3,5,38,13.2,33,11,0,11,8,28,2,0,Matches
692,Yadaly Diaby,gn GUI,"FW,MF",Clermont Foot,fr Ligue 1,20,2000,0.7,0,0,0,0,0,0,1,0.0,1,0,0,0,2,2,2,0,Matches
693,Mouctar Diakhaby,gn GUI,DF,Valencia,es La Liga,24,1996,21.6,35,24,18,15,2,13,23,56.5,10,29,17,12,30,65,87,3,Matches
694,Ibrahim Diakité,gn GUI,MF,Reims,fr Ligue 1,17,2003,0.0,0,0,0,0,0,0,1,0.0,1,0,0,0,0,0,0,0,Matches
695,Abdou Diallo,sn SEN,DF,Paris S-G,fr Ligue 1,25,1996,9.7,22,14,10,9,3,8,14,57.1,6,6,2,4,10,32,19,1,Matches
696,Habib Diallo,sn SEN,FW,Strasbourg,fr Ligue 1,26,1995,17.1,9,5,0,8,1,0,8,0.0,8,13,4,9,4,13,11,0,Matches
697,Ibrahima Diallo,fr FRA,MF,Southampton,eng Premier League,22,1999,11.4,22,11,10,9,3,10,24,41.7,14,7,0,7,9,31,10,0,Matches
698,Habib Diarra,sn SEN,MF,Strasbourg,fr Ligue 1,17,2004,1.2,2,1,1,1,0,1,1,100.0,0,0,0,0,0,2,0,0,Matches
699,Stéphane Diarra,fr FRA,"MF,FW",Lorient,fr Ligue 1,22,1998,5.8,11,9,7,3,1,5,10,50.0,5,4,0,4,7,18,1,0,Matches
700,Rúben Dias,pt POR,DF,Manchester City,eng Premier League,24,1997,26.7,26,19,11,12,3,8,15,53.3,7,19,13,6,23,49,66,0,Matches
701,Krépin Diatta,sn SEN,"MF,DF",Monaco,fr Ligue 1,22,1999,3.2,3,2,1,0,2,1,3,33.3,2,2,0,2,1,4,0,0,Matches
702,Amadou Diawara,gn GUI,MF,Roma,it Serie A,24,1997,1.9,7,2,5,2,0,1,3,33.3,2,2,0,2,0,7,1,0,Matches
703,Brahim Díaz,ma MAR,MF,Milan,it Serie A,21,1999,20.6,23,17,3,11,9,8,22,36.4,14,11,0,11,8,31,4,0,Matches
704,Javier Díaz,es ESP,GK,Sevilla,es La Liga,24,1997,1.0,0,0,0,0,0,0,0,,0,0,0,0,0,0,0,0,Matches
705,Luis Díaz,co COL,FW,Liverpool,eng Premier League,24,1997,10.6,9,7,3,5,1,2,8,25.0,6,7,0,7,4,13,2,0,Matches
706,Víctor Díaz,es ESP,DF,Granada,es La Liga,33,1988,16.7,23,15,14,9,0,12,25,48.0,13,19,11,8,17,40,71,1,Matches
707,Daniel Didavi,de GER,"MF,FW",Stuttgart,de Bundesliga,31,1990,3.1,6,2,0,4,2,4,7,57.1,3,4,1,3,1,7,1,0,Matches
708,Bamba Dieng,sn SEN,FW,Marseille,fr Ligue 1,21,2000,10.8,17,11,5,5,7,4,14,28.6,10,7,0,7,5,22,8,0,Matches
709,Eric Dier,eng ENG,DF,Tottenham,eng Premier League,27,1994,34.1,15,9,6,8,1,7,14,50.0,7,37,32,5,27,42,142,1,Matches
710,Elhadji Dieye,sn SEN,"FW,MF",Saint-Étienne,fr Ligue 1,19,2002,0.4,3,2,2,1,0,0,1,0.0,1,2,0,2,1,4,0,0,Matches
711,Lucas Digne,fr FRA,DF,Aston Villa,eng Premier League,28,1993,14.1,13,10,8,3,2,9,19,47.4,10,15,8,7,23,36,40,0,Matches
712,Lucas Digne,fr FRA,DF,Everton,eng Premier League,28,1993,13.0,33,19,26,4,3,21,28,75.0,7,16,5,11,14,47,30,0,Matches
713,Mitchell Dijks,nl NED,"DF,FW",Bologna,it Serie A,28,1993,7.7,15,6,6,6,3,5,12,41.7,7,11,2,9,3,18,10,1,Matches
714,Javairô Dilrosun,nl NED,"MF,FW",Bordeaux,fr Ligue 1,23,1998,19.2,13,4,2,8,3,7,24,29.2,17,14,1,13,11,24,5,0,Matches
715,Javairô Dilrosun,nl NED,FW,Hertha BSC,de Bundesliga,23,1998,1.5,3,1,1,2,0,1,1,100.0,0,1,0,1,0,3,0,0,Matches
716,Federico Dimarco,it ITA,DF,Inter,it Serie A,23,1997,15.9,28,15,10,15,3,13,24,54.2,11,6,1,5,19,47,19,0,Matches
717,Landry Dimata,be BEL,"FW,MF",Espanyol,es La Liga,23,1997,6.0,2,2,1,1,0,1,4,25.0,3,0,0,0,1,3,7,0,Matches
718,Stole Dimitrievski,mk MKD,GK,Rayo Vallecano,es La Liga,27,1993,30.8,0,0,0,0,0,0,0,,0,0,0,0,1,1,14,3,Matches
719,Junior Dina Ebimbe,fr FRA,MF,Paris S-G,fr Ligue 1,20,2000,3.5,9,4,3,4,2,2,3,66.7,1,5,3,2,2,11,1,0,Matches
720,Tristan Dingomé,cm CMR,"MF,FW",Troyes,fr Ligue 1,30,1991,12.0,23,11,10,12,1,10,18,55.6,8,7,1,6,9,32,3,0,Matches
721,Sinaly Diomande,ci CIV,DF,Lyon,fr Ligue 1,20,2001,6.4,6,3,4,2,0,5,6,83.3,1,6,6,0,12,18,26,0,Matches
722,Issa Diop,fr FRA,DF,West Ham,eng Premier League,24,1997,10.7,10,8,5,5,0,4,11,36.4,7,14,13,1,7,17,44,0,Matches
723,Sofiane Diop,fr FRA,"MF,FW",Monaco,fr Ligue 1,21,2000,21.6,38,20,12,19,7,15,47,31.9,32,10,0,10,23,61,4,0,Matches
724,Andy Diouf,fr FRA,MF,Rennes,fr Ligue 1,18,2003,0.2,1,1,1,0,0,1,1,100.0,0,1,0,1,0,1,0,0,Matches
725,Assane Dioussé,sn SEN,MF,Saint-Étienne,fr Ligue 1,23,1997,0.3,1,1,1,0,0,1,1,100.0,0,0,0,0,0,1,0,0,Matches
726,Axel Disasi,fr FRA,DF,Monaco,fr Ligue 1,23,1998,30.2,42,27,20,21,1,23,39,59.0,16,40,30,10,26,68,75,0,Matches
727,Filippo Distefano,it ITA,FW,Fiorentina,it Serie A,17,2003,0.0,0,0,0,0,0,0,0,,0,0,0,0,0,0,0,0,Matches
728,Matías Dituro,ar ARG,GK,Celta Vigo,es La Liga,34,1987,38.0,0,0,0,0,0,0,0,,0,0,0,0,0,0,10,5,Matches
729,Tiago Djaló,pt POR,DF,Lille,fr Ligue 1,21,2000,25.9,60,39,39,19,2,26,39,66.7,13,26,10,16,24,84,71,0,Matches
730,Djené,tg TOG,DF,Getafe,es La Liga,29,1991,34.6,44,26,24,16,4,23,34,67.6,11,24,5,19,59,103,109,2,Matches
731,Moussa Djenepo,ml MLI,MF,Southampton,eng Premier League,23,1998,5.1,9,3,3,5,1,3,11,27.3,8,6,1,5,2,11,6,1,Matches
732,Koffi Djidji,ci CIV,DF,Torino,it Serie A,28,1992,19.3,48,29,21,23,4,14,18,77.8,4,20,9,11,34,82,60,0,Matches
733,Alexander Djiku,gh GHA,DF,Strasbourg,fr Ligue 1,26,1994,29.9,50,37,33,13,4,18,35,51.4,17,30,13,17,61,111,90,2,Matches
734,Bryan Djile Nokoué,cm CMR,"DF,MF",Saint-Étienne,fr Ligue 1,19,2002,0.6,3,3,1,2,0,2,2,100.0,0,1,0,1,1,4,2,0,Matches
735,Berat Djimsiti,al ALB,DF,Atalanta,it Serie A,28,1993,25.1,43,24,21,20,2,29,46,63.0,17,21,11,10,31,74,56,0,Matches
736,Ouparine Djoco,gw GNB,GK,Clermont Foot,fr Ligue 1,23,1998,23.5,0,0,0,0,0,0,0,,0,0,0,0,1,1,14,2,Matches
737,Naïs Djouahra,fr FRA,"FW,MF",Real Sociedad,es La Liga,21,1999,2.4,7,3,2,2,3,4,8,50.0,4,3,0,3,2,9,2,0,Matches
738,Marko Dmitrović,rs SRB,GK,Sevilla,es La Liga,29,1992,6.0,0,0,0,0,0,0,0,,0,0,0,0,0,0,3,1,Matches
739,Lewis Dobbin,eng ENG,"FW,MF",Everton,eng Premier League,18,2003,0.4,2,1,0,1,1,1,2,50.0,1,0,0,0,0,2,0,0,Matches
740,Matt Doherty,ie IRL,DF,Tottenham,eng Premier League,29,1992,9.7,18,12,5,11,2,8,14,57.1,6,11,2,9,13,31,20,0,Matches
741,Jeremy Doku,be BEL,"FW,MF",Rennes,fr Ligue 1,19,2002,5.2,10,5,3,5,2,3,6,50.0,3,4,0,4,3,13,0,0,Matches
742,Kasper Dolberg,dk DEN,FW,Nice,fr Ligue 1,23,1997,16.6,9,4,4,3,2,3,9,33.3,6,15,1,14,6,15,17,0,Matches
743,Jaume Doménech,es ESP,GK,Valencia,es La Liga,30,1990,3.8,0,0,0,0,0,0,0,,0,0,0,0,0,0,3,1,Matches
744,Brandon Domingues,fr FRA,"MF,FW",Troyes,fr Ligue 1,21,2000,2.6,6,2,2,4,0,2,3,66.7,1,3,0,3,3,9,0,0,Matches
745,Carlos Dominguez,es ESP,DF,Celta Vigo,es La Liga,20,2001,3.8,4,1,4,0,0,4,6,66.7,2,2,1,1,4,8,21,0,Matches
746,Mario Dominguez,es ESP,FW,Valencia,es La Liga,17,2004,0.3,0,0,0,0,0,0,0,,0,0,0,0,0,0,1,0,Matches
747,Nicolás Domínguez,ar ARG,MF,Bologna,it Serie A,23,1998,22.4,76,45,36,32,8,32,76,42.1,44,38,9,29,32,108,34,1,Matches
748,John Donald,es ESP,DF,Elche,es La Liga,20,2000,2.0,7,4,4,2,1,5,8,62.5,3,5,3,2,3,10,3,0,Matches
749,Lee Dongjun,kr KOR,"MF,FW",Hertha BSC,de Bundesliga,24,1997,1.3,2,1,0,2,0,1,3,33.3,2,2,0,2,2,4,1,0,Matches
750,Anastasios Donis,gr GRE,"FW,MF",Reims,fr Ligue 1,24,1996,4.1,8,7,4,2,2,2,6,33.3,4,3,0,3,0,8,1,0,Matches
751,Gianluigi Donnarumma,it ITA,GK,Paris S-G,fr Ligue 1,22,1999,17.0,0,0,0,0,0,0,0,,0,0,0,0,0,0,9,2,Matches
752,Niklas Dorsch,de GER,MF,Augsburg,de Bundesliga,23,1998,25.8,76,47,47,23,6,30,60,50.0,30,34,12,22,35,111,36,3,Matches
753,Jodel Dossou,bj BEN,FW,Clermont Foot,fr Ligue 1,29,1992,22.3,36,17,15,14,7,15,43,34.9,28,14,0,14,5,41,7,0,Matches
754,Lohann Doucet,fr FRA,"MF,DF",Nantes,fr Ligue 1,18,2002,0.1,0,0,0,0,0,0,0,,0,0,0,0,1,1,0,0,Matches
755,Abdoulaye Doucouré,ml MLI,MF,Everton,eng Premier League,28,1993,28.2,75,43,30,37,8,32,71,45.1,39,33,8,25,28,103,32,0,Matches
756,Cheick Doucouré,ml MLI,MF,Lens,fr Ligue 1,21,2000,32.7,75,43,34,34,7,35,79,44.3,44,30,7,23,68,143,24,0,Matches
757,Fodé Doucouré,ml MLI,"DF,FW",Reims,fr Ligue 1,20,2001,1.7,12,9,9,3,0,9,11,81.8,2,1,0,1,4,16,6,0,Matches
758,Ismaël Doukouré,fr FRA,DF,Strasbourg,fr Ligue 1,18,2003,0.2,0,0,0,0,0,0,0,,0,0,0,0,0,0,1,0,Matches
759,Kamory Doumbia,ml MLI,"MF,FW",Reims,fr Ligue 1,18,2003,3.9,8,2,2,5,1,5,13,38.5,8,9,3,6,3,11,3,0,Matches
760,Moussa Doumbia,ml MLI,FW,Reims,fr Ligue 1,26,1994,1.0,0,0,0,0,0,0,1,0.0,1,0,0,0,0,0,0,0,Matches
761,Souleyman Doumbia,ci CIV,"DF,FW",Angers,fr Ligue 1,24,1996,24.7,30,20,16,9,5,13,27,48.1,14,25,4,21,39,69,51,0,Matches
762,Kieran Dowell,eng ENG,"FW,MF",Norwich City,eng Premier League,23,1997,10.1,18,7,8,7,3,9,32,28.1,23,10,1,9,7,25,4,0,Matches
763,Bartłomiej Drągowski,pl POL,GK,Fiorentina,it Serie A,23,1997,6.2,0,0,0,0,0,0,0,,0,0,0,0,1,1,5,2,Matches
764,Radu Drăgușin,ro ROU,DF,Sampdoria,it Serie A,19,2002,6.9,4,3,2,2,0,2,6,33.3,4,8,4,4,10,14,33,0,Matches
765,Radu Drăgușin,ro ROU,DF,Salernitana,it Serie A,19,2002,5.4,5,4,2,3,0,4,10,40.0,6,7,3,4,13,18,17,0,Matches
766,Cody Drameh,eng ENG,"DF,MF",Leeds United,eng Premier League,19,2001,1.4,4,2,3,1,0,1,3,33.3,2,0,0,0,1,5,4,0,Matches
767,Julian Draxler,de GER,"FW,MF",Paris S-G,fr Ligue 1,27,1993,6.1,3,2,0,3,0,0,4,0.0,4,3,0,3,5,8,3,0,Matches
768,Matthieu Dreyer,fr FRA,GK,Lorient,fr Ligue 1,32,1989,16.0,1,1,1,0,0,1,1,100.0,0,0,0,0,0,1,9,0,Matches
769,Domingos Duarte,pt POR,DF,Granada,es La Liga,26,1995,18.7,18,14,9,9,0,6,11,54.5,5,27,20,7,22,40,82,0,Matches
770,Óscar Duarte,cr CRC,DF,Levante,es La Liga,32,1989,19.7,18,8,12,6,0,8,23,34.8,15,18,9,9,24,42,102,0,Matches
771,Rubén Duarte,es ESP,DF,Alavés,es La Liga,25,1995,29.1,76,47,43,27,6,43,85,50.6,42,40,6,34,57,133,82,0,Matches
772,Leo Dubois,fr FRA,DF,Lyon,fr Ligue 1,26,1994,19.4,43,27,22,14,7,27,46,58.7,19,27,3,24,22,65,35,1,Matches
773,Martin Dúbravka,sk SVK,GK,Newcastle Utd,eng Premier League,32,1989,26.0,1,1,1,0,0,0,1,0.0,1,0,0,0,0,1,8,2,Matches
774,Ondrej Duda,sk SVK,"MF,FW",Köln,de Bundesliga,26,1994,17.9,23,16,4,12,7,6,23,26.1,17,14,2,12,17,40,9,0,Matches
775,Jeremy Dudziak,tn TUN,"MF,FW",Greuther Fürth,de Bundesliga,25,1995,12.6,17,6,5,8,4,3,14,21.4,11,8,0,8,10,27,4,0,Matches
776,Shane Duffy,ie IRL,DF,Brighton,eng Premier League,29,1992,16.0,15,12,12,3,0,8,14,57.1,6,24,18,6,16,31,76,1,Matches
777,Unai Dufur,es ESP,DF,Osasuna,es La Liga,22,1999,1.0,0,0,0,0,0,0,0,,0,1,0,1,4,4,4,0,Matches
778,Denzel Dumfries,nl NED,DF,Inter,it Serie A,25,1996,22.5,32,12,9,14,9,16,32,50.0,16,15,6,9,9,41,26,0,Matches
779,Paul Dummett,wls WAL,DF,Newcastle Utd,eng Premier League,29,1991,2.2,7,3,3,4,0,5,8,62.5,3,5,0,5,3,10,5,0,Matches
780,Alfred Duncan,gh GHA,MF,Fiorentina,it Serie A,28,1993,21.5,34,19,13,16,5,11,32,34.4,21,32,3,29,10,44,7,0,Matches
781,Lewis Dunk,eng ENG,DF,Brighton,eng Premier League,29,1991,28.6,10,8,5,5,0,5,11,45.5,6,32,28,4,27,37,113,3,Matches
782,Erik Durm,de GER,DF,Eint Frankfurt,de Bundesliga,29,1992,5.3,13,7,6,5,2,10,13,76.9,3,8,1,7,10,23,7,0,Matches
783,Hugo Duro,es ESP,"DF,MF",Getafe,es La Liga,21,1999,0.1,0,0,0,0,0,0,0,,0,0,0,0,0,0,0,0,Matches
784,Hugo Duro,es ESP,"FW,MF",Valencia,es La Liga,21,1999,20.4,25,19,11,13,1,15,38,39.5,23,24,2,22,4,29,20,1,Matches
785,Jean-Kevin Duverne,ht HAI,DF,Brest,fr Ligue 1,24,1997,33.4,71,44,43,21,7,42,90,46.7,48,40,5,35,53,124,92,0,Matches
786,Paulo Dybala,ar ARG,"FW,MF",Juventus,it Serie A,27,1993,22.9,30,13,7,14,9,8,35,22.9,27,19,0,19,9,39,4,3,Matches
787,Edin Džeko,ba BIH,FW,Inter,it Serie A,35,1986,27.4,14,8,7,4,3,8,25,32.0,17,22,5,17,4,18,35,0,Matches
788,Enzo Ebosse,cm CMR,DF,Angers,fr Ligue 1,22,1999,21.0,25,14,19,6,0,11,19,57.9,8,19,9,10,15,40,42,0,Matches
789,Tyronne Ebuehi,ng NGA,DF,Venezia,it Serie A,25,1995,12.6,28,12,16,8,4,10,18,55.6,8,13,3,10,16,44,38,1,Matches
790,Ederson,br BRA,GK,Manchester City,eng Premier League,27,1993,37.0,2,1,2,0,0,0,2,0.0,2,0,0,0,0,2,12,0,Matches
791,Éderson,br BRA,MF,Salernitana,it Serie A,22,1999,12.7,29,18,11,14,4,14,26,53.8,12,11,2,9,19,48,8,0,Matches
792,Odsonne Édouard,fr FRA,FW,Crystal Palace,eng Premier League,23,1998,17.4,16,10,2,7,7,7,21,33.3,14,20,5,15,0,16,18,0,Matches
793,CJ Egan-Riley,eng ENG,DF,Manchester City,eng Premier League,18,2003,0.0,1,1,1,0,0,1,1,100.0,0,0,0,0,0,1,0,0,Matches
794,Maximilian Eggestein,de GER,MF,Freiburg,de Bundesliga,24,1996,24.4,48,28,17,25,6,22,50,44.0,28,35,11,24,30,78,32,1,Matches
795,Lilian Egloff,de GER,"MF,DF",Stuttgart,de Bundesliga,18,2002,0.3,1,0,0,1,0,0,0,,0,1,0,1,0,1,0,0,Matches
796,Kingsley Ehizibue,nl NED,DF,Köln,de Bundesliga,26,1995,7.6,32,18,27,5,0,15,24,62.5,9,13,4,9,9,41,26,0,Matches
797,Julian Eitschberger,de GER,DF,Hertha BSC,de Bundesliga,17,2004,0.5,0,0,0,0,0,0,1,0.0,1,1,1,0,2,2,2,0,Matches
798,Albin Ekdal,se SWE,MF,Sampdoria,it Serie A,32,1989,18.2,43,28,17,21,5,26,56,46.4,30,27,7,20,29,72,25,0,Matches
799,Hugo Ekitike,fr FRA,FW,Reims,fr Ligue 1,19,2002,14.1,18,10,8,6,4,4,11,36.4,7,9,2,7,6,24,15,0,Matches
800,Jurgen Ekkelenkamp,nl NED,"MF,FW",Hertha BSC,de Bundesliga,21,2000,8.0,8,3,2,6,0,2,7,28.6,5,9,2,7,4,12,5,0,Matches
801,Caleb Ekuban,gh GHA,"FW,MF",Genoa,it Serie A,27,1994,19.1,19,12,2,12,5,7,23,30.4,16,19,5,14,9,28,6,0,Matches
802,Anthony Elanga,se SWE,FW,Manchester Utd,eng Premier League,19,2002,13.5,26,20,12,12,2,15,29,51.7,14,17,1,16,9,35,7,0,Matches
803,Alberth Elis,hn HON,"FW,MF",Bordeaux,fr Ligue 1,25,1996,15.7,19,10,5,5,9,11,25,44.0,14,9,0,9,7,26,10,0,Matches
804,Harvey Elliott,eng ENG,MF,Liverpool,eng Premier League,18,2003,3.8,3,0,1,1,1,0,6,0.0,6,8,1,7,4,7,2,0,Matches
805,Elif Elmas,mk MKD,"FW,MF",Napoli,it Serie A,21,1999,18.0,25,15,10,10,5,12,28,42.9,16,13,2,11,8,33,17,0,Matches
806,Mohamed Elneny,eg EGY,MF,Arsenal,eng Premier League,29,1992,9.0,16,8,10,5,1,7,12,58.3,5,7,1,6,14,30,13,0,Matches
807,Aritz Elustondo,es ESP,DF,Real Sociedad,es La Liga,27,1994,23.4,21,14,16,5,0,10,20,50.0,10,19,13,6,29,50,86,0,Matches
808,Nico Elvedi,ch SUI,DF,Gladbach,de Bundesliga,24,1996,27.0,40,24,23,17,0,22,36,61.1,14,33,22,11,34,74,83,1,Matches
809,Mohamed Elyounoussi,no NOR,"MF,FW",Southampton,eng Premier League,26,1994,22.7,36,17,14,15,7,11,39,28.2,28,23,2,21,12,48,28,0,Matches
810,Adri Embarba,es ESP,"FW,MF",Espanyol,es La Liga,29,1992,22.1,44,29,22,15,7,26,69,37.7,43,35,3,32,19,63,30,0,Matches
811,Breel Embolo,ch SUI,FW,Gladbach,de Bundesliga,24,1997,24.1,16,11,1,12,3,3,8,37.5,5,14,2,12,6,22,7,0,Matches
812,Emerson,br BRA,"DF,MF",Tottenham,eng Premier League,22,1999,25.4,72,47,50,16,6,36,67,53.7,31,25,2,23,22,94,92,1,Matches
813,Emerson,br BRA,DF,Barcelona,es La Liga,22,1999,1.0,3,3,2,1,0,1,2,50.0,1,1,0,1,2,5,1,0,Matches
814,Renaud Emond,be BEL,"FW,MF",Nantes,fr Ligue 1,29,1991,2.1,1,0,0,1,0,0,4,0.0,4,2,1,1,0,1,1,0,Matches
815,Youssef En-Nesyri,ma MAR,FW,Sevilla,es La Liga,24,1997,14.2,10,5,5,2,3,4,11,36.4,7,9,1,8,4,14,18,0,Matches
816,Keita Endo,jp JPN,MF,Union Berlin,de Bundesliga,23,1997,0.6,1,1,1,0,0,0,0,,0,1,0,1,0,1,0,0,Matches
817,Wataru Endo,jp JPN,MF,Stuttgart,de Bundesliga,28,1993,32.2,73,41,34,34,5,31,72,43.1,41,43,12,31,30,103,64,0,Matches
818,Christian Eriksen,dk DEN,MF,Brentford,eng Premier League,29,1992,10.4,13,6,4,5,4,8,17,47.1,9,9,1,8,9,22,14,0,Matches
819,Martin Erlic,hr CRO,DF,Spezia,it Serie A,23,1998,28.6,28,16,18,10,0,10,18,55.6,8,54,39,15,28,56,122,1,Matches
820,Gonzalo Escalante,ar ARG,MF,Lazio,it Serie A,28,1993,0.1,1,0,1,0,0,1,1,100.0,0,2,1,1,1,2,0,0,Matches
821,Gonzalo Escalante,ar ARG,MF,Alavés,es La Liga,28,1993,14.4,30,14,9,20,1,13,34,38.2,21,27,2,25,21,51,28,0,Matches
822,Aarón Escandell,es ESP,GK,Granada,es La Liga,25,1995,3.2,0,0,0,0,0,0,1,0.0,1,0,0,0,0,0,4,0,Matches
823,Sergio Escudero,es ESP,"DF,MF",Granada,es La Liga,31,1989,15.9,46,24,25,17,4,26,54,48.1,28,18,3,15,26,72,35,0,Matches
824,Alfonso Espino,uy URU,DF,Cádiz,es La Liga,29,1992,37.0,107,63,58,39,10,44,112,39.3,68,45,10,35,54,161,87,1,Matches
825,Michael Esser,de GER,GK,Bochum,de Bundesliga,33,1987,3.0,0,0,0,0,0,0,1,0.0,1,0,0,0,0,0,2,0,Matches
826,Estanis,es ESP,FW,Barcelona,es La Liga,17,2003,0.1,1,1,0,1,0,1,1,100.0,0,0,0,0,0,1,0,0,Matches
827,Maxime Estève,fr FRA,DF,Montpellier,fr Ligue 1,19,2002,20.6,27,18,22,4,1,15,27,55.6,12,31,24,7,22,49,69,1,Matches
828,Pervis Estupiñán,ec ECU,DF,Villarreal,es La Liga,23,1998,17.5,36,22,20,11,5,17,24,70.8,7,13,5,8,25,61,29,2,Matches
829,Oghenekaro Etebo,ng NGA,MF,Watford,eng Premier League,25,1995,4.5,11,8,7,4,0,3,8,37.5,5,3,1,2,5,16,5,0,Matches
830,Jonny Evans,nir NIR,DF,Leicester City,eng Premier League,33,1988,15.0,24,14,14,8,2,14,22,63.6,8,17,13,4,20,44,59,0,Matches
831,Eberechi Eze,eng ENG,"MF,FW",Crystal Palace,eng Premier League,23,1998,6.7,10,6,5,2,3,6,11,54.5,5,4,1,3,5,15,1,0,Matches
832,Abdessamad Ezzalzouli,ma MAR,FW,Barcelona,es La Liga,19,2001,6.4,17,9,9,5,3,5,8,62.5,3,3,0,3,9,26,0,0,Matches
833,Łukasz Fabiański,pl POL,GK,West Ham,eng Premier League,36,1985,37.0,0,0,0,0,0,0,0,,0,0,0,0,0,0,11,0,Matches
834,Fabinho,br BRA,MF,Liverpool,eng Premier League,27,1993,25.7,46,25,17,23,6,24,70,34.3,46,33,10,23,39,85,25,1,Matches
835,Fábio,br BRA,DF,Nantes,fr Ligue 1,31,1990,18.5,61,40,31,23,7,36,74,48.6,38,29,7,22,35,96,31,1,Matches
836,Cesc Fàbregas,es ESP,MF,Monaco,fr Ligue 1,34,1987,0.4,1,0,0,1,0,1,1,100.0,0,0,0,0,1,2,0,0,Matches
837,Wout Faes,be BEL,DF,Reims,fr Ligue 1,23,1998,37.0,40,24,30,9,1,25,33,75.8,8,47,37,10,53,93,169,2,Matches
838,Wahid Faghir,dk DEN,FW,Stuttgart,de Bundesliga,18,2003,1.4,0,0,0,0,0,0,1,0.0,1,2,0,2,0,0,0,0,Matches
839,Romain Faivre,fr FRA,"FW,MF",Lyon,fr Ligue 1,23,1998,9.9,10,4,2,6,2,4,13,30.8,9,4,0,4,3,13,2,0,Matches
840,Romain Faivre,fr FRA,MF,Brest,fr Ligue 1,23,1998,19.9,30,18,12,13,5,12,30,40.0,18,11,0,11,13,43,10,0,Matches
841,Radamel Falcao,co COL,FW,Rayo Vallecano,es La Liga,35,1986,9.3,2,1,0,1,1,1,4,25.0,3,4,1,3,2,4,11,0,Matches
842,Diego Falcinelli,it ITA,FW,Bologna,it Serie A,30,1991,0.7,2,2,2,0,0,0,0,,0,0,0,0,1,3,1,0,Matches
843,Wladimiro Falcone,it ITA,GK,Sampdoria,it Serie A,26,1995,9.5,0,0,0,0,0,0,0,,0,0,0,0,1,1,5,0,Matches
844,Fali,es ESP,"DF,MF",Cádiz,es La Liga,27,1993,20.0,32,19,24,8,0,17,32,53.1,15,26,16,10,24,56,82,0,Matches
845,Paolo Faragò,it ITA,MF,Cagliari,it Serie A,28,1993,0.2,1,1,1,0,0,0,0,,0,2,0,2,0,1,0,0,Matches
846,Omar Faraj,ps PLE,FW,Levante,es La Liga,19,2002,0.0,1,0,1,0,0,1,1,100.0,0,0,0,0,0,1,0,0,Matches
847,Davide Faraoni,it ITA,DF,Hellas Verona,it Serie A,29,1991,28.6,62,40,38,21,3,29,62,46.8,33,38,5,33,23,85,62,1,Matches
848,Mohamed Fares,dz ALG,"DF,FW",Genoa,it Serie A,25,1996,6.5,4,2,1,3,0,0,4,0.0,4,8,3,5,8,12,11,0,Matches
849,Diego Farias,br BRA,"MF,FW",Cagliari,it Serie A,31,1990,0.7,1,1,0,1,0,1,3,33.3,2,0,0,0,0,1,0,0,Matches
850,Wuilker Faríñez,ve VEN,GK,Lens,fr Ligue 1,23,1998,12.3,0,0,0,0,0,0,0,,0,0,0,0,0,0,4,0,Matches
851,Ömer Faruk Beyaz,tr TUR,"DF,MF",Stuttgart,de Bundesliga,17,2003,0.8,4,3,1,3,0,1,5,20.0,4,0,0,0,2,6,0,0,Matches
852,Noah Fatar,fr FRA,"DF,MF",Angers,fr Ligue 1,19,2002,0.1,1,0,0,0,1,0,1,0.0,1,0,0,0,1,2,0,0,Matches
853,Ansu Fati,es ESP,FW,Barcelona,es La Liga,18,2002,3.7,3,2,0,2,1,1,1,100.0,0,4,0,4,1,4,0,0,Matches
854,Julien Faussurier,fr FRA,"MF,DF",Brest,fr Ligue 1,34,1987,5.4,10,6,3,3,4,6,13,46.2,7,12,1,11,5,15,6,0,Matches
855,Andrea Favilli,it ITA,FW,Genoa,it Serie A,24,1997,0.4,1,1,0,0,1,0,0,,0,0,0,0,0,1,2,0,Matches
856,Federico Fazio,ar ARG,DF,Salernitana,it Serie A,34,1987,15.9,17,11,10,6,1,9,12,75.0,3,21,16,5,27,44,67,1,Matches
857,Aleix Febas,es ESP,MF,Mallorca,es La Liga,25,1996,1.3,4,1,0,4,0,2,4,50.0,2,0,0,0,0,4,0,0,Matches
858,Adrian Fein,de GER,MF,Greuther Fürth,de Bundesliga,22,1999,0.4,0,0,0,0,0,0,1,0.0,1,0,0,0,2,2,0,0,Matches
859,Nabil Fekir,fr FRA,MF,Betis,es La Liga,28,1993,31.0,43,29,5,25,13,7,36,19.4,29,14,0,14,7,50,7,0,Matches
860,Felipe,br BRA,DF,Atlético Madrid,es La Liga,32,1989,16.7,20,15,11,8,1,8,18,44.4,10,17,11,6,28,48,77,0,Matches
861,Luiz Felipe,it ITA,DF,Lazio,it Serie A,24,1997,27.7,41,23,21,16,4,20,34,58.8,14,40,33,7,33,74,102,1,Matches
862,João Félix,pt POR,"FW,MF",Atlético Madrid,es La Liga,21,1999,14.0,5,2,1,4,0,1,5,20.0,4,4,1,3,7,12,8,0,Matches
863,Ohis Felix Uduokhai,de GER,DF,Augsburg,de Bundesliga,23,1997,8.7,9,6,6,3,0,6,11,54.5,5,13,8,5,9,18,33,0,Matches
864,Kiko Femenía,es ESP,DF,Watford,eng Premier League,30,1991,23.8,35,22,23,10,2,21,37,56.8,16,24,8,16,37,72,51,0,Matches
865,Evan Ferguson,ie IRL,MF,Brighton,eng Premier League,16,2004,0.3,0,0,0,0,0,0,0,,0,0,0,0,0,0,0,0,Matches
866,Nathan Ferguson,eng ENG,DF,Crystal Palace,eng Premier League,20,2000,0.1,0,0,0,0,0,0,0,,0,0,0,0,0,0,0,0,Matches
867,Bruno Fernandes,pt POR,MF,Manchester Utd,eng Premier League,26,1994,34.6,54,28,26,22,6,26,91,28.6,65,36,0,36,17,71,42,2,Matches
868,Edimilson Fernandes,ch SUI,"MF,FW",Arminia,de Bundesliga,25,1996,3.1,2,0,1,1,0,1,4,25.0,3,2,2,0,2,4,6,0,Matches
869,Aitor Fernández,es ESP,GK,Levante,es La Liga,30,1991,13.0,2,1,2,0,0,2,2,100.0,0,0,0,0,0,2,7,0,Matches
870,Álex Fernández,es ESP,MF,Cádiz,es La Liga,28,1992,22.8,47,31,22,17,8,21,61,34.4,40,30,7,23,30,77,31,0,Matches
871,Álvaro Fernández,es ESP,GK,Brentford,eng Premier League,23,1998,12.0,0,0,0,0,0,0,0,,0,0,0,0,0,0,5,2,Matches
872,Federico Fernández,ar ARG,DF,Newcastle Utd,eng Premier League,32,1989,5.8,3,0,3,0,0,2,5,40.0,3,10,10,0,4,7,28,0,Matches
873,Fernandinho,br BRA,"MF,DF",Manchester City,eng Premier League,36,1985,10.7,21,10,7,10,4,9,27,33.3,18,8,2,6,8,29,13,1,Matches
874,Fernando,br BRA,"MF,DF",Sevilla,es La Liga,34,1987,20.6,24,17,14,9,1,12,33,36.4,21,21,13,8,29,53,32,2,Matches
875,Alex Ferrari,it ITA,DF,Sampdoria,it Serie A,27,1994,18.3,40,22,28,9,3,19,33,57.6,14,31,22,9,39,79,63,1,Matches
876,Salvador Ferrer,es ESP,"DF,MF",Spezia,it Serie A,23,1998,16.6,32,18,15,9,8,12,25,48.0,13,24,12,12,18,50,46,0,Matches
877,Jordan Ferri,fr FRA,MF,Montpellier,fr Ligue 1,29,1992,32.3,55,35,28,23,4,29,87,33.3,58,21,5,16,30,85,35,0,Matches
878,Riccardo Fiamozzi,it ITA,DF,Empoli,it Serie A,28,1993,6.9,7,5,2,2,3,2,4,50.0,2,6,5,1,7,14,12,0,Matches
879,Fidel,es ESP,MF,Elche,es La Liga,31,1989,25.1,44,23,18,17,9,14,57,24.6,43,9,1,8,7,51,20,0,Matches
880,Karol Fila,pl POL,DF,Strasbourg,fr Ligue 1,23,1998,6.2,10,8,5,4,1,4,8,50.0,4,7,2,5,4,14,6,0,Matches
881,Alfreð Finnbogason,is ISL,FW,Augsburg,de Bundesliga,32,1989,3.2,3,1,0,2,1,2,4,50.0,2,5,1,4,2,5,8,0,Matches
882,Luca Fiordilino,it ITA,MF,Venezia,it Serie A,25,1996,7.3,21,13,11,6,4,13,27,48.1,14,14,4,10,11,32,12,0,Matches
883,Vincenzo Fiorillo,it ITA,GK,Salernitana,it Serie A,31,1990,1.0,0,0,0,0,0,0,0,,0,0,0,0,0,0,1,0,Matches
884,Roberto Firmino,br BRA,FW,Liverpool,eng Premier League,29,1991,11.0,23,14,5,8,10,3,16,18.8,13,20,0,20,4,27,3,0,Matches
885,Junior Firpo,do DOM,"DF,MF",Leeds United,eng Premier League,24,1996,19.0,61,29,30,26,5,31,59,52.5,28,22,6,16,24,85,37,0,Matches
886,Mark Flekken,nl NED,GK,Freiburg,de Bundesliga,28,1993,32.0,0,0,0,0,0,0,2,0.0,2,1,0,1,2,2,10,1,Matches
887,Ashley Fletcher,eng ENG,FW,Watford,eng Premier League,25,1995,0.3,2,1,1,1,0,1,1,100.0,0,1,1,0,0,2,0,0,Matches
888,Alexis Flips,fr FRA,"MF,DF",Reims,fr Ligue 1,21,2000,11.7,37,21,21,9,7,22,45,48.9,23,21,0,21,24,61,17,0,Matches
889,Alessandro Florenzi,it ITA,"DF,FW",Milan,it Serie A,30,1991,12.8,28,14,14,7,7,14,32,43.8,18,9,2,7,27,55,10,1,Matches
890,Phil Foden,eng ENG,FW,Manchester City,eng Premier League,21,2000,23.6,16,8,10,4,2,7,17,41.2,10,9,0,9,11,27,5,0,Matches
891,Mamadou Fofana,ml MLI,DF,Metz,fr Ligue 1,23,1998,0.4,1,1,0,1,0,1,2,50.0,1,2,1,1,1,2,2,0,Matches
892,Seko Fofana,ci CIV,MF,Lens,fr Ligue 1,26,1995,37.3,27,19,11,13,3,12,58,20.7,46,24,2,22,26,53,17,1,Matches
893,Wesley Fofana,fr FRA,DF,Leicester City,eng Premier League,20,2000,7.0,12,8,11,1,0,7,11,63.6,4,5,2,3,12,24,26,1,Matches
894,Youssouf Fofana,fr FRA,MF,Monaco,fr Ligue 1,22,1999,24.3,69,43,19,41,9,29,56,51.8,27,29,7,22,32,101,22,2,Matches
895,Thomas Foket,be BEL,"DF,FW",Reims,fr Ligue 1,26,1994,24.8,28,19,12,13,3,18,40,45.0,22,26,4,22,33,61,35,0,Matches
896,Thomas Fontaine,mg MAD,DF,Lorient,fr Ligue 1,30,1991,1.9,2,0,1,0,1,0,1,0.0,1,3,3,0,2,4,4,0,Matches
897,José Fontán,es ESP,DF,Celta Vigo,es La Liga,21,2000,3.1,5,3,3,2,0,1,5,20.0,4,3,1,2,10,15,10,0,Matches
898,José Fonte,pt POR,DF,Lille,fr Ligue 1,37,1983,38.0,23,12,14,7,2,11,25,44.0,14,39,32,7,44,67,159,1,Matches
899,Fernando Forestieri,it ITA,"FW,MF",Udinese,it Serie A,31,1990,0.6,0,0,0,0,0,0,1,0.0,1,1,0,1,0,0,1,0,Matches
900,Pablo Fornals,es ESP,"FW,MF",West Ham,eng Premier League,25,1996,31.1,54,28,21,21,12,22,84,26.2,62,49,2,47,27,81,16,1,Matches
901,Emil Forsberg,se SWE,MF,RB Leipzig,de Bundesliga,29,1991,19.0,21,12,2,11,8,7,22,31.8,15,18,0,18,2,23,2,1,Matches
902,Adam Forshaw,eng ENG,MF,Leeds United,eng Premier League,29,1991,17.0,53,23,21,27,5,21,54,38.9,33,17,1,16,19,72,12,2,Matches
903,Marcus Forss,fi FIN,"FW,MF",Brentford,eng Premier League,22,1999,2.3,3,3,0,2,1,2,4,50.0,2,5,0,5,1,4,0,0,Matches
904,Fraser Forster,eng ENG,GK,Southampton,eng Premier League,33,1988,19.0,1,0,1,0,0,0,1,0.0,1,0,0,0,0,1,23,2,Matches
905,Philipp Förster,de GER,"MF,FW",Stuttgart,de Bundesliga,26,1995,10.7,20,13,4,12,4,11,26,42.3,15,12,1,11,3,23,2,0,Matches
906,Francesco Forte,it ITA,FW,Venezia,it Serie A,28,1993,4.7,3,2,0,2,1,2,5,40.0,3,1,0,1,0,3,2,0,Matches
907,Steven Fortes,cv CPV,DF,Lens,fr Ligue 1,29,1992,1.0,2,0,2,0,0,1,2,50.0,1,2,1,1,0,2,4,0,Matches
908,Ben Foster,eng ENG,GK,Watford,eng Premier League,38,1983,26.0,0,0,0,0,0,0,3,0.0,3,0,0,0,0,0,9,4,Matches
909,Tariqe Fosu,gh GHA,DF,Brentford,eng Premier League,25,1995,0.2,0,0,0,0,0,0,0,,0,1,0,1,0,0,0,0,Matches
910,Timothy Fosu-Mensah,nl NED,DF,Leverkusen,de Bundesliga,23,1998,1.6,5,3,3,1,1,4,4,100.0,0,1,0,1,2,7,2,0,Matches
911,Dimitri Foulquier,fr FRA,DF,Granada,es La Liga,28,1993,2.0,0,0,0,0,0,0,1,0.0,1,2,1,1,1,1,2,0,Matches
912,Dimitri Foulquier,fr FRA,DF,Valencia,es La Liga,28,1993,26.0,36,17,17,15,4,21,34,61.8,13,19,3,16,29,65,49,0,Matches
913,Juan Foyth,ar ARG,DF,Villarreal,es La Liga,23,1998,21.4,69,49,35,28,6,35,47,74.5,12,29,7,22,20,89,50,0,Matches
914,Gianluca Frabotta,it ITA,"DF,MF",Hellas Verona,it Serie A,22,1999,0.2,0,0,0,0,0,0,1,0.0,1,1,0,1,1,1,0,0,Matches
915,Raphael Framberger,de GER,DF,Augsburg,de Bundesliga,25,1995,9.4,26,19,12,10,4,13,27,48.1,14,8,2,6,9,35,25,0,Matches
916,Przemysław Frankowski,pl POL,DF,Lens,fr Ligue 1,26,1995,27.2,57,39,22,27,8,36,74,48.6,38,27,0,27,28,85,52,0,Matches
917,Enric Franquesa,es ESP,"DF,FW",Levante,es La Liga,24,1997,6.9,5,3,4,0,1,0,1,0.0,1,4,0,4,7,12,11,0,Matches
918,Fransérgio,br BRA,MF,Bordeaux,fr Ligue 1,30,1990,14.0,24,10,8,12,4,12,43,27.9,31,18,6,12,23,47,23,0,Matches
919,Ryan Fraser,sct SCO,"FW,MF",Newcastle Utd,eng Premier League,27,1994,16.3,10,3,5,3,2,5,13,38.5,8,11,1,10,11,21,11,0,Matches
920,Davide Frattesi,it ITA,MF,Sassuolo,it Serie A,21,1999,31.7,46,16,26,18,2,26,52,50.0,26,44,12,32,29,75,62,1,Matches
921,Fred,br BRA,MF,Manchester Utd,eng Premier League,28,1993,22.5,63,27,32,24,7,22,79,27.8,57,38,11,27,32,95,24,0,Matches
922,Ryan Fredericks,eng ENG,DF,West Ham,eng Premier League,28,1992,3.4,2,2,2,0,0,0,1,0.0,1,2,1,1,4,6,6,0,Matches
923,Morten Frendrup,dk DEN,"DF,MF",Genoa,it Serie A,20,2001,7.7,40,24,19,13,8,13,29,44.8,16,19,2,17,17,57,7,1,Matches
924,Remo Freuler,ch SUI,MF,Atalanta,it Serie A,29,1992,26.3,69,39,22,33,14,30,70,42.9,40,48,8,40,35,104,26,1,Matches
925,Marvin Friedrich,de GER,DF,Gladbach,de Bundesliga,25,1995,6.7,14,8,10,4,0,9,11,81.8,2,5,3,2,5,19,26,0,Matches
926,Marvin Friedrich,de GER,DF,Union Berlin,de Bundesliga,25,1995,13.0,17,5,14,3,0,10,16,62.5,6,13,7,6,23,40,47,0,Matches
927,Jeremie Frimpong,nl NED,DF,Leverkusen,de Bundesliga,20,2000,22.8,32,18,19,12,1,12,23,52.2,11,24,6,18,17,49,40,2,Matches
928,Christian Früchtl,de GER,GK,Bayern Munich,de Bundesliga,21,2000,0.1,0,0,0,0,0,0,0,,0,0,0,0,0,0,0,0,Matches
929,Jorge de Frutos,es ESP,"MF,FW",Levante,es La Liga,24,1997,19.6,33,15,14,11,8,10,51,19.6,41,11,1,10,12,45,13,0,Matches
930,Leo Fuhr Hjelde,no NOR,"MF,DF",Leeds United,eng Premier League,17,2003,1.7,5,4,3,2,0,3,3,100.0,0,3,3,0,4,9,7,0,Matches
931,Chris Führich,de GER,"FW,MF",Stuttgart,de Bundesliga,23,1998,19.0,28,16,10,10,8,18,39,46.2,21,31,2,29,8,36,9,0,Matches
932,Angelo Fulgini,fr FRA,"MF,FW",Angers,fr Ligue 1,24,1996,32.5,35,25,8,18,9,14,44,31.8,30,21,5,16,22,57,5,1,Matches
933,Marius Funk,de GER,GK,Greuther Fürth,de Bundesliga,25,1996,8.0,0,0,0,0,0,0,0,,0,0,0,0,0,0,8,1,Matches
934,Stephan Fürstner,de GER,MF,Mainz 05,de Bundesliga,33,1987,0.1,0,0,0,0,0,0,2,0.0,2,0,0,0,0,0,1,0,Matches
935,Matteo Gabbia,it ITA,DF,Milan,it Serie A,21,1999,6.0,4,3,1,3,0,0,4,0.0,4,2,2,0,8,12,12,0,Matches
936,Manolo Gabbiadini,it ITA,"FW,MF",Sampdoria,it Serie A,29,1991,12.7,6,4,3,2,1,1,7,14.3,6,5,2,3,3,9,10,0,Matches
937,Mijat Gaćinović,rs SRB,"FW,MF",Hoffenheim,de Bundesliga,26,1995,1.2,3,3,1,1,1,3,3,100.0,0,1,0,1,1,4,2,0,Matches
938,Gianluca Gaetano,it ITA,MF,Napoli,it Serie A,21,2000,0.2,1,1,1,0,0,1,2,50.0,1,0,0,0,2,3,0,0,Matches
939,Luca Gagliano,it ITA,"FW,DF",Cagliari,it Serie A,21,2000,0.1,0,0,0,0,0,0,0,,0,1,0,1,0,0,1,0,Matches
940,Roberto Gagliardini,it ITA,MF,Inter,it Serie A,27,1994,7.2,12,6,7,4,1,1,13,7.7,12,14,5,9,9,21,7,0,Matches
941,Riccardo Gagliolo,se SWE,DF,Salernitana,it Serie A,31,1990,12.6,23,12,16,4,3,16,27,59.3,11,15,8,7,28,51,52,0,Matches
942,Javi Galán,es ESP,DF,Celta Vigo,es La Liga,26,1994,36.6,108,66,60,37,11,42,99,42.4,57,48,8,40,45,153,52,0,Matches
943,Iñigo Ruiz de Galarreta,es ESP,MF,Mallorca,es La Liga,27,1993,15.3,40,21,14,21,5,14,30,46.7,16,16,2,14,20,60,21,0,Matches
944,Nicolas Galazzi,it ITA,MF,Venezia,it Serie A,20,2000,0.2,2,1,1,0,1,0,1,0.0,1,0,0,0,0,2,0,0,Matches
945,Pablo Galdames Millán,cl CHI,MF,Genoa,it Serie A,24,1996,11.4,28,12,6,16,6,12,35,34.3,23,16,2,14,8,36,9,1,Matches
946,Thiago Galhardo,br BRA,"FW,MF",Celta Vigo,es La Liga,32,1989,12.8,12,6,3,3,6,2,12,16.7,10,15,2,13,6,18,9,0,Matches
947,Conor Gallagher,eng ENG,MF,Crystal Palace,eng Premier League,21,2000,31.6,69,38,35,20,14,21,69,30.4,48,58,9,49,29,98,26,0,Matches
948,Gauthier Gallon,fr FRA,GK,Troyes,fr Ligue 1,28,1993,31.0,3,0,3,0,0,1,1,100.0,0,0,0,0,2,5,12,1,Matches
949,Cristian Gamboa,cr CRC,DF,Bochum,de Bundesliga,31,1989,19.1,59,36,40,16,3,30,61,49.2,31,22,7,15,32,91,35,1,Matches
950,Kévin Gameiro,fr FRA,FW,Strasbourg,fr Ligue 1,34,1987,26.5,19,10,5,9,5,6,18,33.3,12,22,1,21,6,25,1,0,Matches
951,Idrissa Gana Gueye,sn SEN,MF,Paris S-G,fr Ligue 1,31,1989,18.2,60,36,24,24,12,18,44,40.9,26,23,4,19,24,84,13,0,Matches
952,Ignatius Ganago,cm CMR,FW,Lens,fr Ligue 1,22,1999,11.4,3,2,1,2,0,2,6,33.3,4,4,0,4,2,5,3,0,Matches
953,Silvère Ganvoula M'Boussy,cg CGO,FW,Bochum,de Bundesliga,25,1996,1.7,0,0,0,0,0,0,1,0.0,1,0,0,0,0,0,1,0,Matches
954,Álvaro García,es ESP,"FW,MF",Rayo Vallecano,es La Liga,28,1992,33.3,42,23,15,18,9,8,35,22.9,27,27,3,24,42,84,24,0,Matches
955,Dani García,es ESP,MF,Athletic Club,es La Liga,31,1990,24.2,36,22,15,17,4,14,47,29.8,33,27,10,17,24,60,41,1,Matches
956,David García,es ESP,DF,Osasuna,es La Liga,27,1994,34.5,28,14,15,11,2,12,22,54.5,10,27,21,6,52,80,168,0,Matches
957,Eric García,es ESP,DF,Barcelona,es La Liga,20,2001,22.7,27,18,13,13,1,11,26,42.3,15,22,12,10,44,71,53,3,Matches
958,Fran Garcia,es ESP,DF,Rayo Vallecano,es La Liga,21,1999,33.6,60,35,44,12,4,39,73,53.4,34,34,8,26,45,105,53,0,Matches
959,Joan García,es ESP,GK,Espanyol,es La Liga,20,2001,1.2,0,0,0,0,0,0,0,,0,0,0,0,1,1,1,2,Matches
960,Manu García,es ESP,MF,Alavés,es La Liga,23,1998,12.0,18,9,6,9,3,9,27,33.3,18,8,2,6,13,31,4,0,Matches
961,Raúl García,es ESP,FW,Athletic Club,es La Liga,35,1986,20.0,27,17,6,11,10,8,36,22.2,28,30,4,26,9,36,21,0,Matches
962,Rubén García,es ESP,"MF,FW",Osasuna,es La Liga,28,1993,26.4,43,26,12,23,8,16,49,32.7,33,31,4,27,24,67,16,0,Matches
963,Saúl García,es ESP,MF,Alavés,es La Liga,26,1994,0.0,1,1,1,0,0,0,0,,0,0,0,0,0,1,0,0,Matches
964,Unai García,es ESP,DF,Osasuna,es La Liga,29,1992,15.6,21,12,14,6,1,14,17,82.4,3,19,11,8,22,43,78,0,Matches
965,Alejandro Garnacho,ar ARG,"FW,MF",Manchester Utd,eng Premier League,17,2004,0.1,0,0,0,0,0,0,1,0.0,1,0,0,0,0,0,0,0,Matches
966,Mario Gaspar,es ESP,DF,Villarreal,es La Liga,30,1990,6.9,10,4,2,5,3,6,10,60.0,4,6,3,3,6,16,15,0,Matches
967,Djeidi Gassama,fr FRA,FW,Paris S-G,fr Ligue 1,17,2003,0.0,0,0,0,0,0,0,0,,0,1,1,0,0,0,0,0,Matches
968,Johan Gastien,fr FRA,MF,Clermont Foot,fr Ligue 1,33,1988,30.5,56,34,26,25,5,27,74,36.5,47,45,11,34,53,109,49,1,Matches
969,Gavi,es ESP,"MF,FW",Barcelona,es La Liga,16,2004,25.7,38,18,13,18,7,9,33,27.3,24,36,0,36,25,63,13,0,Matches
970,Dwight Gayle,eng ENG,"FW,DF",Newcastle Utd,eng Premier League,30,1990,0.4,1,0,0,1,0,0,1,0.0,1,0,0,0,1,2,0,0,Matches
971,Jean-Philippe Gbamin,ci CIV,MF,Everton,eng Premier League,25,1995,0.7,1,1,1,0,0,0,2,0.0,2,0,0,0,1,2,1,0,Matches
972,David de Gea,es ESP,GK,Manchester Utd,eng Premier League,30,1990,38.0,0,0,0,0,0,0,0,,0,0,0,0,0,0,11,2,Matches
973,Linus Gechter,de GER,DF,Hertha BSC,de Bundesliga,17,2004,8.0,15,8,13,2,0,7,14,50.0,7,12,7,5,11,26,29,0,Matches
974,Dennis Geiger,de GER,MF,Hoffenheim,de Bundesliga,23,1998,15.3,34,23,9,20,5,17,30,56.7,13,15,1,14,14,48,7,1,Matches
975,Joe Gelhardt,eng ENG,"FW,MF",Leeds United,eng Premier League,19,2002,8.3,4,3,1,0,3,2,10,20.0,8,9,0,9,0,4,3,0,Matches
976,Luca Gemello,it ITA,GK,Torino,it Serie A,21,2000,1.0,0,0,0,0,0,0,0,,0,0,0,0,0,0,0,0,Matches
977,Yannick Gerhardt,de GER,"MF,DF",Wolfsburg,de Bundesliga,27,1994,17.5,42,20,18,17,7,22,36,61.1,14,24,1,23,25,67,25,1,Matches
978,Valère Germain,fr FRA,FW,Montpellier,fr Ligue 1,31,1990,21.9,23,14,6,11,6,8,31,25.8,23,13,1,12,9,32,27,0,Matches
979,Gerson,br BRA,"MF,FW",Marseille,fr Ligue 1,24,1997,28.3,42,17,16,20,6,8,35,22.9,27,26,4,22,16,58,16,2,Matches
980,Willem Geubbels,fr FRA,"FW,MF",Nantes,fr Ligue 1,19,2001,6.0,8,5,4,2,2,5,12,41.7,7,5,0,5,6,14,5,0,Matches
981,Hamadi Al Ghaddioui,ma MAR,FW,Stuttgart,de Bundesliga,30,1990,5.5,5,4,2,1,2,0,4,0.0,4,3,1,2,0,5,4,0,Matches
982,Ismaël Gharbi,es ESP,FW,Paris S-G,fr Ligue 1,17,2004,0.0,0,0,0,0,0,0,0,,0,0,0,0,0,0,0,0,Matches
983,Anwar El Ghazi,nl NED,"FW,MF",Aston Villa,eng Premier League,26,1995,4.3,4,4,2,2,0,2,7,28.6,5,6,0,6,1,5,2,0,Matches
984,Anwar El Ghazi,nl NED,"FW,MF",Everton,eng Premier League,26,1995,0.1,1,1,1,0,0,1,1,100.0,0,3,0,3,0,1,0,0,Matches
985,Lamine Ghezali,fr FRA,DF,Saint-Étienne,fr Ligue 1,22,1999,0.0,0,0,0,0,0,0,0,,0,1,0,1,0,0,0,0,Matches
986,Paolo Ghiglione,it ITA,DF,Genoa,it Serie A,24,1997,6.7,17,12,8,6,3,9,14,64.3,5,11,5,6,10,27,12,1,Matches
987,Saman Ghoddos,ir IRN,"MF,DF",Brentford,eng Premier League,27,1993,6.0,17,10,8,6,3,9,15,60.0,6,2,0,2,3,20,16,0,Matches
988,Faouzi Ghoulam,dz ALG,DF,Napoli,it Serie A,30,1991,3.7,3,1,1,2,0,0,3,0.0,3,2,1,1,3,6,10,0,Matches
989,Dimitris Giannoulis,gr GRE,DF,Norwich City,eng Premier League,25,1995,13.0,36,21,17,17,2,24,36,66.7,12,22,6,16,19,55,41,1,Matches
990,Morgan Gibbs-White,eng ENG,"DF,FW",Wolves,eng Premier League,21,2000,0.1,0,0,0,0,0,0,0,,0,1,0,1,0,0,0,0,Matches
991,Ben Gibson,eng ENG,DF,Norwich City,eng Premier League,28,1993,27.7,23,16,17,6,0,7,12,58.3,5,36,30,6,27,50,139,2,Matches
992,Niko Gießelmann,de GER,"DF,FW",Union Berlin,de Bundesliga,29,1991,23.1,24,17,10,11,3,15,38,39.5,23,26,4,22,18,42,29,1,Matches
993,Rafał Gikiewicz,pl POL,GK,Augsburg,de Bundesliga,33,1987,34.0,2,0,2,0,0,2,7,28.6,5,0,0,0,3,5,11,5,Matches
994,Bryan Gil,es ESP,"FW,MF",Tottenham,eng Premier League,20,2001,1.0,3,0,1,0,2,1,2,50.0,1,2,0,2,0,3,0,0,Matches
995,Bryan Gil,es ESP,"MF,FW",Valencia,es La Liga,20,2001,8.4,13,8,6,3,4,2,13,15.4,11,13,0,13,1,14,4,0,Matches
996,Óscar Gil,es ESP,DF,Espanyol,es La Liga,24,1997,18.8,52,35,27,20,5,25,46,54.3,21,33,9,24,19,71,33,2,Matches
997,Mario Gila,es ESP,DF,Real Madrid,es La Liga,20,2000,0.3,1,0,1,0,0,0,1,0.0,1,0,0,0,1,2,1,0,Matches
998,Billy Gilmour,sct SCO,MF,Norwich City,eng Premier League,20,2001,20.6,41,21,16,21,4,14,52,26.9,38,21,4,17,17,58,29,0,Matches
999,Daniel Ginczek,de GER,"MF,FW",Wolfsburg,de Bundesliga,30,1991,0.1,0,0,0,0,0,0,0,,0,0,0,0,0,0,0,0,Matches
1000,Matthias Ginter,de GER,DF,Gladbach,de Bundesliga,27,1994,26.2,36,22,20,13,3,27,40,67.5,13,21,10,11,33,69,76,0,Matches
1001,Nicholas Gioacchini,us USA,"FW,MF",Montpellier,fr Ligue 1,21,2000,5.5,7,5,3,2,2,4,10,40.0,6,8,0,8,4,11,5,0,Matches
1002,Sebastian Giovinco,it ITA,MF,Sampdoria,it Serie A,34,1987,0.4,0,0,0,0,0,0,1,0.0,1,0,0,0,0,0,0,0,Matches
1003,Jimmy Giraudon,fr FRA,DF,Troyes,fr Ligue 1,29,1992,18.0,14,6,10,4,0,7,22,31.8,15,24,14,10,37,51,68,1,Matches
1004,Andrei Girotto,br BRA,"DF,MF",Nantes,fr Ligue 1,29,1992,35.0,85,52,49,32,4,52,103,50.5,51,67,33,34,69,154,143,0,Matches
1005,Olivier Giroud,fr FRA,FW,Milan,it Serie A,34,1986,21.0,15,11,4,6,5,3,17,17.6,14,13,4,9,3,18,19,0,Matches
1006,Serge Gnabry,de GER,"FW,DF",Bayern Munich,de Bundesliga,26,1995,24.3,47,31,16,20,11,22,57,38.6,35,26,0,26,14,61,3,0,Matches
1007,Ben Godfrey,eng ENG,DF,Everton,eng Premier League,23,1998,22.5,47,32,29,14,4,24,39,61.5,15,41,19,22,15,62,100,2,Matches
1008,Diego Godín,uy URU,DF,Cagliari,it Serie A,35,1986,9.1,18,7,13,3,2,10,15,66.7,5,7,5,2,13,31,46,0,Matches
1009,Edoardo Goldaniga,it ITA,DF,Cagliari,it Serie A,27,1993,10.4,12,5,7,5,0,4,11,36.4,7,8,5,3,22,34,23,0,Matches
1010,Edoardo Goldaniga,it ITA,"DF,MF",Sassuolo,it Serie A,27,1993,0.0,0,0,0,0,0,0,0,,0,0,0,0,0,0,0,0,Matches
1011,Aleksandr Golovin,ru RUS,"FW,MF",Monaco,fr Ligue 1,25,1996,16.7,40,22,10,18,12,18,41,43.9,23,26,1,25,12,52,8,0,Matches
1012,André Gomes,pt POR,MF,Everton,eng Premier League,28,1993,6.9,16,4,6,6,4,8,32,25.0,24,8,2,6,1,17,7,1,Matches
1013,Angel Gomes,eng ENG,"MF,FW",Lille,fr Ligue 1,20,2000,10.6,23,13,6,12,5,10,15,66.7,5,4,0,4,3,26,4,0,Matches
1014,Toti Gomes,pt POR,DF,Wolves,eng Premier League,22,1999,4.0,11,7,10,1,0,7,9,77.8,2,6,3,3,8,19,15,0,Matches
1015,Dani Gómez,es ESP,FW,Levante,es La Liga,23,1998,11.8,7,4,3,2,2,4,12,33.3,8,3,0,3,3,10,5,0,Matches
1016,Joe Gomez,eng ENG,DF,Liverpool,eng Premier League,24,1997,3.7,10,6,5,2,3,5,9,55.6,4,4,1,3,5,15,6,0,Matches
1017,Maxi Gómez,uy URU,FW,Valencia,es La Liga,24,1996,21.7,5,3,1,2,2,5,8,62.5,3,5,1,4,3,8,22,0,Matches
1018,Moi Gómez,es ESP,"MF,FW",Villarreal,es La Liga,27,1994,14.3,15,7,8,3,4,5,17,29.4,12,5,0,5,6,21,6,0,Matches
1019,Papu Gómez,ar ARG,"FW,MF",Sevilla,es La Liga,33,1988,19.8,19,11,9,5,5,9,35,25.7,26,15,2,13,7,26,12,2,Matches
1020,Sergi Gómez,es ESP,DF,Espanyol,es La Liga,29,1992,30.2,33,24,29,3,1,18,27,66.7,9,33,23,10,40,73,125,2,Matches
1021,Victor Gomez,es ESP,DF,Espanyol,es La Liga,21,2000,0.0,0,0,0,0,0,0,0,,0,0,0,0,0,0,0,0,Matches
1022,Alfred Gomis,sn SEN,GK,Rennes,fr Ligue 1,27,1993,25.0,1,0,1,0,0,1,2,50.0,1,0,0,0,1,2,8,2,Matches
1023,Maxime Gonalons,fr FRA,MF,Granada,es La Liga,32,1989,17.2,43,28,17,22,4,14,39,35.9,25,33,10,23,18,61,29,0,Matches
1024,Vagner Gonçalves,cv CPV,FW,Metz,fr Ligue 1,25,1996,1.0,2,1,0,2,0,1,1,100.0,0,0,0,0,1,3,0,0,Matches
1025,Cedric Gondo,ci CIV,FW,Salernitana,it Serie A,24,1996,7.8,5,2,2,2,1,2,5,40.0,3,2,0,2,3,8,2,0,Matches
1026,Álvaro González,es ESP,DF,Marseille,fr Ligue 1,31,1990,5.0,1,1,1,0,0,1,1,100.0,0,0,0,0,1,2,9,0,Matches
1027,Diego González,es ESP,DF,Elche,es La Liga,26,1995,19.9,25,16,18,7,0,9,16,56.3,7,21,13,8,19,44,87,0,Matches
1028,Édgar González,es ESP,DF,Betis,es La Liga,24,1997,16.3,25,19,15,8,2,17,24,70.8,7,17,11,6,23,48,82,0,Matches
1029,Giovanni González,uy URU,DF,Mallorca,es La Liga,26,1994,4.1,9,3,4,4,1,3,5,60.0,2,7,2,5,4,13,14,0,Matches
1030,Nicolás González,ar ARG,FW,Fiorentina,it Serie A,23,1998,26.2,21,16,6,8,7,9,28,32.1,19,26,2,24,21,42,4,1,Matches
1031,Nicolás González,es ESP,MF,Barcelona,es La Liga,19,2002,12.4,31,20,5,23,3,11,27,40.7,16,12,0,12,6,37,12,0,Matches
1032,Peter González,do DOM,"MF,DF",Real Madrid,es La Liga,19,2002,0.3,0,0,0,0,0,0,0,,0,0,0,0,1,1,0,0,Matches
1033,Roberto González,es ESP,"FW,MF",Betis,es La Liga,20,2001,1.5,5,4,3,2,0,4,6,66.7,2,5,0,5,1,6,1,0,Matches
1034,Charlie Goode,eng ENG,DF,Brentford,eng Premier League,25,1995,5.0,7,5,5,2,0,4,4,100.0,0,4,2,2,2,9,8,0,Matches
1035,Anthony Gordon,eng ENG,"MF,FW",Everton,eng Premier League,20,2001,25.4,54,32,20,30,4,21,59,35.6,38,49,3,46,22,76,17,0,Matches
1036,Kaide Gordon,eng ENG,FW,Liverpool,eng Premier League,16,2004,0.1,1,0,0,0,1,0,0,,0,0,0,0,0,1,0,0,Matches
1037,Leon Goretzka,de GER,MF,Bayern Munich,de Bundesliga,26,1995,15.5,25,15,12,9,4,11,26,42.3,15,11,1,10,17,42,23,2,Matches
1038,Gori,es ESP,MF,Espanyol,es La Liga,19,2002,0.1,0,0,0,0,0,0,0,,0,2,0,2,0,0,0,0,Matches
1039,Andoni Gorosabel,es ESP,DF,Real Sociedad,es La Liga,24,1996,25.4,47,31,32,9,6,25,47,53.2,22,16,3,13,18,65,49,0,Matches
1040,Robin Gosens,de GER,DF,Atalanta,it Serie A,27,1994,5.1,7,3,3,4,0,4,8,50.0,4,4,0,4,9,16,1,0,Matches
1041,Robin Gosens,de GER,DF,Inter,it Serie A,27,1994,1.9,3,1,1,2,0,0,0,,0,5,2,3,3,6,3,0,Matches
1042,Dan Gosling,eng ENG,MF,Watford,eng Premier League,31,1990,1.8,2,1,1,1,0,2,6,33.3,4,2,0,2,0,2,3,0,Matches
1043,Amine Gouiri,dz ALG,"FW,MF",Nice,fr Ligue 1,21,2000,30.6,22,13,2,13,7,10,32,31.3,22,22,5,17,11,33,17,1,Matches
1044,Lucas Gourna-Douath,fr FRA,MF,Saint-Étienne,fr Ligue 1,17,2003,20.0,45,26,22,18,5,21,36,58.3,15,22,3,19,13,58,9,2,Matches
1045,Jeffrey Gouweleeuw,nl NED,DF,Augsburg,de Bundesliga,30,1991,28.6,50,27,33,17,0,22,36,61.1,14,35,18,17,49,99,116,0,Matches
1046,Jonathan Gradit,fr FRA,DF,Lens,fr Ligue 1,28,1992,34.1,60,28,24,28,8,25,45,55.6,20,39,27,12,65,125,106,0,Matches
1047,Jens Grahl,de GER,GK,Eint Frankfurt,de Bundesliga,32,1988,1.0,0,0,0,0,0,0,0,,0,0,0,0,0,0,1,0,Matches
1048,Alberto Grassi,it ITA,MF,Cagliari,it Serie A,26,1995,24.2,47,26,13,30,4,16,38,42.1,22,27,9,18,63,110,33,1,Matches
1049,Jaume Grau,es ESP,MF,Osasuna,es La Liga,24,1997,0.0,1,1,1,0,0,0,1,0.0,1,0,0,0,0,1,0,0,Matches
1050,Andrew Gravillon,gp GLP,DF,Reims,fr Ligue 1,23,1998,23.7,32,24,19,13,0,17,27,63.0,10,25,15,10,33,65,83,1,Matches
1051,Demarai Gray,jm JAM,"MF,FW",Everton,eng Premier League,25,1996,26.0,30,19,13,10,7,10,22,45.5,12,30,2,28,15,45,21,1,Matches
1052,Adrian Grbić,at AUT,"FW,MF",Lorient,fr Ligue 1,24,1996,5.8,2,1,0,2,0,2,6,33.3,4,3,1,2,0,2,7,0,Matches
1053,Ivo Grbić,hr CRO,GK,Lille,fr Ligue 1,25,1996,21.0,0,0,0,0,0,0,0,,0,0,0,0,0,0,14,1,Matches
1054,Jack Grealish,eng ENG,FW,Manchester City,eng Premier League,25,1995,21.3,18,17,4,10,4,5,13,38.5,8,11,1,10,8,26,7,0,Matches
1055,Etienne Green,eng ENG,GK,Saint-Étienne,fr Ligue 1,21,2000,13.3,1,1,1,0,0,0,0,,0,0,0,0,1,2,9,0,Matches
1056,Julian Green,us USA,MF,Greuther Fürth,de Bundesliga,26,1995,11.7,9,5,0,8,1,2,8,25.0,6,10,2,8,7,16,10,0,Matches
1057,Mason Greenwood,eng ENG,"FW,MF",Manchester Utd,eng Premier League,19,2001,14.1,15,9,9,1,5,3,9,33.3,6,5,0,5,1,16,6,0,Matches
1058,Sam Greenwood,eng ENG,"MF,FW",Leeds United,eng Premier League,19,2002,2.6,8,5,0,5,3,4,7,57.1,3,3,0,3,2,10,1,0,Matches
1059,Michael Gregoritsch,at AUT,"FW,MF",Augsburg,de Bundesliga,27,1994,15.5,19,8,4,10,5,2,15,13.3,13,18,2,16,6,25,29,0,Matches
1060,Dominik Greif,sk SVK,GK,Mallorca,es La Liga,24,1997,1.0,0,0,0,0,0,0,0,,0,0,0,0,0,0,0,0,Matches
1061,Clément Grenier,fr FRA,MF,Mallorca,es La Liga,30,1991,0.7,0,0,0,0,0,0,0,,0,1,1,0,0,0,1,0,Matches
1062,Sebastian Griesbeck,de GER,"DF,MF",Greuther Fürth,de Bundesliga,30,1990,27.1,60,31,38,19,3,39,62,62.9,23,38,13,25,43,103,100,1,Matches
1063,Sebastian Griesbeck,de GER,MF,Union Berlin,de Bundesliga,30,1990,0.1,1,1,0,1,0,1,1,100.0,0,0,0,0,0,1,0,0,Matches
1064,Antoine Griezmann,fr FRA,FW,Barcelona,es La Liga,30,1991,2.9,13,5,3,10,0,2,6,33.3,4,4,0,4,3,16,5,0,Matches
1065,Antoine Griezmann,fr FRA,"FW,MF",Atlético Madrid,es La Liga,30,1991,18.8,30,14,11,15,4,12,32,37.5,20,18,1,17,7,37,18,0,Matches
1066,Vincenzo Grifo,it ITA,"MF,FW",Freiburg,de Bundesliga,28,1993,30.8,27,15,9,13,5,9,26,34.6,17,12,2,10,13,40,28,0,Matches
1067,Lennart Grill,de GER,GK,Leverkusen,de Bundesliga,22,1999,1.0,0,0,0,0,0,0,0,,0,0,0,0,0,0,0,0,Matches
1068,Florian Grillitsch,at AUT,"DF,MF",Hoffenheim,de Bundesliga,25,1995,16.6,37,19,15,21,1,17,31,54.8,14,18,7,11,29,66,36,1,Matches
1069,Pascal Groß,de GER,"MF,DF",Brighton,eng Premier League,30,1991,22.6,28,15,15,11,2,12,33,36.4,21,34,8,26,18,46,23,0,Matches
1070,Carlos Gruezo,ec ECU,MF,Augsburg,de Bundesliga,26,1995,10.8,22,11,10,10,2,8,21,38.1,13,11,2,9,9,31,15,0,Matches
1071,Vicente Guaita,es ESP,GK,Crystal Palace,eng Premier League,34,1987,29.5,1,0,1,0,0,1,1,100.0,0,0,0,0,1,2,8,1,Matches
1072,Andrés Guardado,mx MEX,MF,Betis,es La Liga,34,1986,15.5,30,13,12,17,1,13,34,38.2,21,18,4,14,21,51,29,1,Matches
1073,Sergi Guardiola,es ESP,FW,Rayo Vallecano,es La Liga,30,1991,19.0,10,9,3,5,2,1,21,4.8,20,14,2,12,4,14,17,0,Matches
1074,Nemanja Gudelj,rs SRB,"DF,MF",Sevilla,es La Liga,29,1991,11.6,16,7,10,4,2,5,8,62.5,3,14,9,5,22,38,37,0,Matches
1075,Gabriel Gudmundsson,se SWE,"DF,MF",Lille,fr Ligue 1,22,1999,14.9,43,31,24,16,3,17,35,48.6,18,15,3,12,20,63,13,0,Matches
1076,Noah Guede-Nadje,fr FRA,MF,Angers,fr Ligue 1,17,2003,0.0,0,0,0,0,0,0,0,,0,0,0,0,0,0,0,0,Matches
1077,Gonçalo Guedes,pt POR,"FW,MF",Valencia,es La Liga,24,1996,29.0,21,14,6,7,8,2,22,9.1,20,14,0,14,9,30,1,0,Matches
1078,Marc Guéhi,eng ENG,DF,Crystal Palace,eng Premier League,21,2000,35.8,35,17,24,10,1,15,16,93.8,1,34,26,8,30,65,127,0,Matches
1079,Mattéo Guendouzi,fr FRA,MF,Marseille,fr Ligue 1,22,1999,35.0,45,30,10,26,9,13,47,27.7,34,15,1,14,16,61,18,0,Matches
1080,Yanis Guermouche,fr FRA,"MF,FW",Montpellier,fr Ligue 1,20,2001,0.1,2,1,0,1,1,1,1,100.0,0,0,0,0,0,2,0,0,Matches
1081,Raphaël Guerreiro,pt POR,DF,Dortmund,de Bundesliga,27,1993,19.9,35,19,19,12,4,16,31,51.6,15,18,2,16,25,60,14,1,Matches
1082,Evann Guessand,fr FRA,FW,Nice,fr Ligue 1,20,2001,4.9,9,8,2,5,2,3,8,37.5,5,4,0,4,0,9,1,0,Matches
1083,Ander Guevara,es ESP,MF,Real Sociedad,es La Liga,24,1997,9.6,18,13,6,10,2,10,17,58.8,7,12,6,6,12,30,8,0,Matches
1084,Lamine Gueye,sn SEN,"FW,MF",Metz,fr Ligue 1,23,1998,6.2,5,5,1,1,3,3,7,42.9,4,4,0,4,6,11,1,0,Matches
1085,Pape Gueye,sn SEN,MF,Marseille,fr Ligue 1,22,1999,17.0,38,19,15,22,1,16,31,51.6,15,15,3,12,24,62,16,0,Matches
1086,John Guidetti,se SWE,"FW,MF",Alavés,es La Liga,29,1992,3.1,2,1,0,0,2,0,1,0.0,1,1,0,1,0,2,0,0,Matches
1087,Josuha Guilavogui,fr FRA,"MF,DF",Bordeaux,fr Ligue 1,30,1990,14.8,39,16,18,17,4,14,29,48.3,15,16,8,8,36,75,23,0,Matches
1088,Josuha Guilavogui,fr FRA,"MF,DF",Wolfsburg,de Bundesliga,30,1990,10.5,23,14,13,9,1,7,18,38.9,11,11,6,5,25,48,42,0,Matches
1089,Frederic Guilbert,fr FRA,DF,Strasbourg,fr Ligue 1,26,1994,28.0,69,39,33,24,12,32,62,51.6,30,37,11,26,55,124,39,0,Matches
1090,Hugo Guillamón,es ESP,"MF,DF",Valencia,es La Liga,21,2000,26.2,43,27,20,16,7,18,44,40.9,26,26,10,16,30,73,53,1,Matches
1091,Bruno Guimarães,br BRA,MF,Newcastle Utd,eng Premier League,23,1997,11.5,44,23,18,22,4,21,38,55.3,17,25,6,19,9,53,13,0,Matches
1092,Bruno Guimarães,br BRA,MF,Lyon,fr Ligue 1,23,1997,18.2,50,31,20,25,5,23,59,39.0,36,21,4,17,21,71,11,1,Matches
1093,Serhou Guirassy,gn GUI,FW,Rennes,fr Ligue 1,25,1996,11.3,4,2,1,2,1,1,7,14.3,6,4,0,4,1,5,8,0,Matches
1094,Péter Gulácsi,hu HUN,GK,RB Leipzig,de Bundesliga,31,1990,33.0,0,0,0,0,0,0,0,,0,0,0,0,1,1,15,1,Matches
1095,Manuel Gulde,de GER,DF,Freiburg,de Bundesliga,30,1991,13.6,18,10,14,3,1,8,11,72.7,3,16,8,8,17,35,37,0,Matches
1096,Gerard Gumbau,es ESP,MF,Elche,es La Liga,26,1994,21.0,46,19,22,19,5,22,51,43.1,29,18,4,14,23,69,25,0,Matches
1097,Robert Gumny,pl POL,DF,Augsburg,de Bundesliga,23,1998,25.2,48,29,25,20,3,25,43,58.1,18,24,7,17,28,76,57,3,Matches
1098,İlkay Gündoğan,de GER,MF,Manchester City,eng Premier League,30,1990,20.6,23,9,10,12,1,12,31,38.7,19,11,1,10,15,38,10,0,Matches
1099,Angus Gunn,sct SCO,GK,Norwich City,eng Premier League,25,1996,9.0,0,0,0,0,0,0,0,,0,0,0,0,0,0,11,0,Matches
1100,Christian Günter,de GER,"DF,MF",Freiburg,de Bundesliga,28,1993,34.0,34,20,16,15,3,18,50,36.0,32,23,6,17,17,51,49,2,Matches
1101,Koray Günter,de GER,DF,Hellas Verona,it Serie A,26,1994,26.8,32,18,19,11,2,16,32,50.0,16,27,21,6,69,101,110,1,Matches
1102,Lasse Günther,de GER,DF,Augsburg,de Bundesliga,18,2003,1.8,8,5,4,3,1,5,9,55.6,4,0,0,0,2,10,2,0,Matches
1103,Jon Guridi,es ESP,MF,Real Sociedad,es La Liga,26,1995,2.3,5,3,2,3,0,1,4,25.0,3,3,1,2,3,8,4,0,Matches
1104,Malo Gusto,fr FRA,DF,Lyon,fr Ligue 1,18,2003,20.9,55,35,29,21,5,24,40,60.0,16,21,6,15,33,88,41,1,Matches
1105,Raúl Guti,es ESP,MF,Elche,es La Liga,24,1996,18.1,25,15,7,14,4,10,30,33.3,20,9,3,6,25,50,7,0,Matches
1106,Marcos Mauro López Gutiérrez,ar ARG,DF,Cádiz,es La Liga,30,1991,1.5,1,0,0,1,0,0,2,0.0,2,2,1,1,1,2,9,0,Matches
1107,Miguel Gutiérrez,es ESP,DF,Real Madrid,es La Liga,20,2001,2.9,7,5,5,0,2,3,5,60.0,2,0,0,0,2,9,2,0,Matches
1108,Albert Guðmundsson,is ISL,"FW,MF",Genoa,it Serie A,24,1997,6.7,5,3,2,1,2,3,8,37.5,5,2,0,2,5,10,4,0,Matches
1109,Joško Gvardiol,hr CRO,DF,RB Leipzig,de Bundesliga,19,2002,26.8,47,31,28,17,2,22,39,56.4,17,30,11,19,51,98,62,2,Matches
1110,Emmanuel Gyasi,gh GHA,"FW,MF",Spezia,it Serie A,27,1994,33.7,47,30,31,9,7,21,41,51.2,20,22,4,18,16,63,43,1,Matches
1111,Norbert Gyömbér,sk SVK,DF,Salernitana,it Serie A,29,1992,28.5,53,32,40,11,2,33,50,66.0,17,38,24,14,44,97,126,1,Matches
1112,Erling Haaland,no NOR,FW,Dortmund,de Bundesliga,21,2000,21.2,2,1,0,1,1,0,1,0.0,1,8,1,7,1,3,31,0,Matches
1113,Nicolas Haas,ch SUI,MF,Empoli,it Serie A,25,1996,11.1,35,22,15,10,10,17,39,43.6,22,24,4,20,9,44,17,1,Matches
1114,Janik Haberer,de GER,MF,Freiburg,de Bundesliga,27,1994,9.1,14,8,5,6,3,7,19,36.8,12,11,4,7,16,30,11,0,Matches
1115,Alexander Hack,de GER,DF,Mainz 05,de Bundesliga,27,1993,23.0,52,26,35,17,0,29,46,63.0,17,31,14,17,51,103,95,1,Matches
1116,Robin Hack,de GER,"FW,MF",Arminia,de Bundesliga,22,1998,15.2,14,8,6,5,3,3,21,14.3,18,18,1,17,5,19,4,0,Matches
1117,Munir El Haddadi,ma MAR,"FW,MF",Sevilla,es La Liga,25,1995,5.3,8,4,1,6,1,2,8,25.0,6,7,1,6,5,13,2,0,Matches
1118,André Hahn,de GER,"MF,FW",Augsburg,de Bundesliga,30,1990,23.3,36,20,9,15,12,17,50,34.0,33,38,5,33,15,51,43,0,Matches
1119,Amadou Haidara,ml MLI,MF,RB Leipzig,de Bundesliga,23,1998,14.7,30,14,11,19,0,17,37,45.9,20,22,6,16,16,46,8,1,Matches
1120,Massadio Haïdara,ml MLI,DF,Lens,fr Ligue 1,28,1992,12.0,28,21,18,7,3,15,24,62.5,9,18,4,14,22,50,31,0,Matches
1121,Oualid El Hajjam,ma MAR,DF,Troyes,fr Ligue 1,30,1991,11.9,22,11,12,6,4,15,23,65.2,8,12,6,6,22,44,28,0,Matches
1122,Achraf Hakimi,ma MAR,DF,Paris S-G,fr Ligue 1,22,1998,27.5,74,51,38,27,9,40,72,55.6,32,26,5,21,28,102,23,2,Matches
1123,Marcel Halstenberg,de GER,DF,RB Leipzig,de Bundesliga,29,1991,5.6,10,7,6,4,0,6,11,54.5,5,6,0,6,7,17,11,0,Matches
1124,Pierre-Yves Hamel,fr FRA,"FW,MF",Lorient,fr Ligue 1,27,1994,0.3,0,0,0,0,0,0,1,0.0,1,0,0,0,2,2,0,0,Matches
1125,Pierre-Yves Hamel,fr FRA,FW,Clermont Foot,fr Ligue 1,27,1994,5.8,11,6,0,5,6,5,6,83.3,1,2,1,1,0,11,0,0,Matches
1126,Romain Hamouma,fr FRA,"FW,MF",Saint-Étienne,fr Ligue 1,34,1987,9.8,10,7,1,5,4,2,13,15.4,11,8,0,8,4,14,1,0,Matches
1127,Samir Handanović,si SVN,GK,Inter,it Serie A,37,1984,37.0,1,0,1,0,0,1,2,50.0,1,1,0,1,0,1,6,3,Matches
1128,Grant Hanley,sct SCO,DF,Norwich City,eng Premier League,29,1991,32.2,44,25,28,14,2,18,35,51.4,17,56,45,11,56,100,176,2,Matches
1129,Ridgeciano Haps,sr SUR,DF,Venezia,it Serie A,28,1993,22.8,36,20,26,4,6,11,21,52.4,10,34,12,22,29,65,57,1,Matches
1130,Genki Haraguchi,jp JPN,MF,Union Berlin,de Bundesliga,30,1991,19.5,37,20,12,22,3,15,48,31.3,33,25,3,22,26,63,15,0,Matches
1131,Amine Harit,ma MAR,"FW,MF",Marseille,fr Ligue 1,24,1997,12.9,18,11,9,9,0,9,17,52.9,8,10,0,10,4,22,2,0,Matches
1132,Varazdat Haroyan,am ARM,DF,Cádiz,es La Liga,28,1992,16.0,31,21,20,10,1,19,29,65.5,10,22,12,10,15,46,62,0,Matches
1133,Jack Harrison,eng ENG,"FW,MF",Leeds United,eng Premier League,24,1996,29.3,57,37,22,22,13,31,76,40.8,45,35,1,34,21,78,19,0,Matches
1134,Abdou Harroui,nl NED,MF,Sassuolo,it Serie A,23,1998,5.0,11,4,4,7,0,8,11,72.7,3,14,0,14,4,15,5,0,Matches
1135,Luis Hartwig,de GER,FW,Bochum,de Bundesliga,18,2002,0.0,0,0,0,0,0,0,0,,0,0,0,0,0,0,0,0,Matches
1136,Makoto Hasebe,jp JPN,DF,Eint Frankfurt,de Bundesliga,37,1984,13.2,27,12,15,11,1,13,29,44.8,16,24,8,16,22,49,36,0,Matches
1137,Hans Hateboer,nl NED,"DF,MF",Atalanta,it Serie A,27,1994,15.4,22,14,10,8,4,11,26,42.3,15,11,1,10,7,29,20,0,Matches
1138,Kortney Hause,eng ENG,DF,Aston Villa,eng Premier League,26,1995,4.4,3,3,2,0,1,3,4,75.0,1,8,5,3,6,9,13,0,Matches
1139,Kai Havertz,de GER,"FW,MF",Chelsea,eng Premier League,22,1999,20.1,17,8,5,7,5,4,14,28.6,10,28,1,27,4,21,32,1,Matches
1140,Isaac Hayden,eng ENG,"MF,DF",Newcastle Utd,eng Premier League,26,1995,11.1,28,14,11,14,3,12,29,41.4,17,17,8,9,14,42,24,0,Matches
1141,Eden Hazard,be BEL,"FW,MF",Real Madrid,es La Liga,30,1991,8.0,6,3,3,2,1,3,7,42.9,4,3,0,3,2,8,0,0,Matches
1142,Thorgan Hazard,be BEL,"FW,DF",Dortmund,de Bundesliga,28,1993,14.9,23,13,8,10,5,15,40,37.5,25,23,1,22,6,29,4,0,Matches
1143,Jonas Hector,de GER,DF,Köln,de Bundesliga,31,1990,28.4,76,39,36,26,14,29,74,39.2,45,59,8,51,50,126,68,1,Matches
1144,Hwang Hee-chan,kr KOR,"FW,MF",Wolves,eng Premier League,25,1996,20.2,27,13,9,16,2,14,44,31.8,30,10,0,10,13,40,7,1,Matches
1145,Hwang Hee-chan,kr KOR,FW,RB Leipzig,de Bundesliga,25,1996,0.5,0,0,0,0,0,0,0,,0,0,0,0,1,1,0,0,Matches
1146,Silvan Hefti,ch SUI,DF,Genoa,it Serie A,23,1997,14.3,50,30,23,22,5,32,58,55.2,26,20,4,16,20,70,34,1,Matches
1147,Dominique Heintz,de GER,DF,Union Berlin,de Bundesliga,27,1993,5.2,8,5,5,3,0,3,6,50.0,3,7,4,3,7,15,14,0,Matches
1148,Dominique Heintz,de GER,DF,Freiburg,de Bundesliga,27,1993,0.3,0,0,0,0,0,0,0,,0,0,0,0,1,1,0,0,Matches
1149,Jordan Henderson,eng ENG,MF,Liverpool,eng Premier League,31,1990,28.9,36,20,9,25,2,17,44,38.6,27,25,1,24,23,59,14,0,Matches
1150,Liam Henderson,sct SCO,MF,Empoli,it Serie A,25,1996,22.4,22,13,7,8,7,9,31,29.0,22,14,4,10,9,31,13,0,Matches
1151,Jeff Hendrick,ie IRL,MF,Newcastle Utd,eng Premier League,29,1992,0.8,1,1,0,1,0,1,1,100.0,0,0,0,0,0,1,1,0,Matches
1152,Wayne Hennessey,wls WAL,GK,Burnley,eng Premier League,34,1987,2.0,0,0,0,0,0,0,0,,0,0,0,0,1,1,0,1,Matches
1153,Benjamin Henrichs,de GER,DF,RB Leipzig,de Bundesliga,24,1997,12.7,30,21,18,6,6,12,22,54.5,10,16,1,15,19,49,14,0,Matches
1154,Henrique,br BRA,DF,Lyon,fr Ligue 1,27,1994,12.3,13,7,10,1,2,5,16,31.3,11,13,1,12,22,35,14,0,Matches
1155,Dalbert Henrique,br BRA,"DF,MF",Cagliari,it Serie A,27,1993,23.1,43,23,23,16,4,11,35,31.4,24,28,5,23,24,67,34,0,Matches
1156,Luis Henrique,br BRA,"FW,MF",Marseille,fr Ligue 1,19,2001,7.8,4,3,2,1,1,2,5,40.0,3,2,0,2,5,9,1,0,Matches
1157,Matheus Henrique,br BRA,MF,Sassuolo,it Serie A,23,1997,12.0,10,3,6,3,1,6,24,25.0,18,14,2,12,7,17,12,1,Matches
1158,Rico Henry,eng ENG,DF,Brentford,eng Premier League,24,1997,30.8,28,20,18,8,2,12,34,35.3,22,31,10,21,26,54,76,1,Matches
1159,Thomas Henry,fr FRA,FW,Venezia,it Serie A,26,1994,23.5,9,4,2,3,4,5,13,38.5,8,11,5,6,2,11,25,0,Matches
1160,Christophe Hérelle,mq MTQ,DF,Brest,fr Ligue 1,28,1992,21.5,48,28,30,16,2,17,26,65.4,9,20,15,5,44,92,84,1,Matches
1161,Jérôme Hergault,fr FRA,DF,Lorient,fr Ligue 1,35,1986,3.9,3,1,1,2,0,2,5,40.0,3,4,1,3,4,7,7,0,Matches
1162,Kike Hermoso,es ESP,DF,Betis,es La Liga,21,1999,1.0,2,1,2,0,0,2,2,100.0,0,2,1,1,0,2,5,1,Matches
1163,Mario Hermoso,es ESP,DF,Atlético Madrid,es La Liga,26,1995,20.7,30,15,23,4,3,20,38,52.6,18,18,3,15,29,59,49,2,Matches
1164,Aridane Hernández,es ESP,DF,Osasuna,es La Liga,32,1989,12.9,12,9,10,2,0,3,13,23.1,10,11,9,2,20,32,71,0,Matches
1165,Lucas Hernández,fr FRA,DF,Bayern Munich,de Bundesliga,25,1996,22.6,50,31,20,24,6,26,42,61.9,16,22,11,11,28,78,54,1,Matches
1166,Luis Hernández,es ESP,DF,Cádiz,es La Liga,32,1989,15.2,9,5,9,0,0,5,8,62.5,3,5,3,2,16,25,34,0,Matches
1167,Mario Hernández,es ESP,"DF,FW",Rayo Vallecano,es La Liga,22,1999,4.4,10,4,7,3,0,5,9,55.6,4,1,0,1,4,14,7,0,Matches
1168,Theo Hernández,fr FRA,DF,Milan,it Serie A,23,1997,30.1,53,35,34,14,5,29,40,72.5,11,16,3,13,23,76,29,3,Matches
1169,Hernani,br BRA,"MF,FW",Genoa,it Serie A,27,1994,7.6,20,10,8,9,3,13,32,40.6,19,17,4,13,13,33,5,1,Matches
1170,Ander Herrera,es ESP,MF,Paris S-G,fr Ligue 1,31,1989,12.1,29,17,7,16,6,14,39,35.9,25,22,8,14,14,43,8,0,Matches
1171,Héctor Herrera,mx MEX,MF,Atlético Madrid,es La Liga,31,1990,9.5,16,8,11,4,1,7,20,35.0,13,13,2,11,12,28,16,0,Matches
1172,Sergio Herrera,es ESP,GK,Osasuna,es La Liga,28,1993,36.0,3,2,3,0,0,3,6,50.0,3,1,0,1,1,4,18,0,Matches
1173,Yangel Herrera,ve VEN,MF,Espanyol,es La Liga,23,1998,18.3,41,31,19,19,3,18,39,46.2,21,27,5,22,19,60,33,1,Matches
1174,Patrick Herrmann,de GER,"DF,FW",Gladbach,de Bundesliga,30,1991,8.4,15,7,5,6,4,9,24,37.5,15,10,1,9,6,21,8,0,Matches
1175,Son Heung-min,kr KOR,"MF,FW",Tottenham,eng Premier League,29,1992,33.4,15,6,5,7,3,5,23,21.7,18,27,6,21,13,28,8,0,Matches
1176,Daan Heymans,be BEL,"MF,FW",Venezia,it Serie A,22,1999,2.8,3,1,1,2,0,1,5,20.0,4,7,3,4,4,7,3,0,Matches
1177,Aaron Hickey,sct SCO,DF,Bologna,it Serie A,19,2002,31.3,46,29,24,15,7,20,30,66.7,10,36,13,23,29,75,44,0,Matches
1178,Piero Hincapié,ec ECU,DF,Leverkusen,de Bundesliga,19,2002,19.5,33,23,23,8,2,19,25,76.0,6,34,15,19,33,66,56,2,Matches
1179,Martin Hinteregger,at AUT,DF,Eint Frankfurt,de Bundesliga,28,1992,24.7,45,28,28,16,1,28,43,65.1,15,36,16,20,42,87,78,3,Matches
1180,Marwin Hitz,ch SUI,GK,Dortmund,de Bundesliga,33,1987,4.5,0,0,0,0,0,0,0,,0,0,0,0,0,0,2,0,Matches
1181,Ki-Jana Hoever,nl NED,"DF,MF",Wolves,eng Premier League,19,2002,3.4,10,6,5,5,0,7,12,58.3,5,6,0,6,6,16,8,0,Matches
1182,Nicolas Höfler,de GER,MF,Freiburg,de Bundesliga,31,1990,28.9,73,42,37,29,7,28,62,45.2,34,50,21,29,46,119,42,0,Matches
1183,Jonas Hofmann,de GER,"MF,FW",Gladbach,de Bundesliga,29,1992,23.1,30,20,6,17,7,17,42,40.5,25,23,0,23,12,42,10,0,Matches
1184,Rob Holding,eng ENG,DF,Arsenal,eng Premier League,25,1995,9.4,13,9,11,1,1,5,6,83.3,1,23,18,5,10,23,42,1,Matches
1185,Lucas Höler,de GER,FW,Freiburg,de Bundesliga,27,1994,28.7,41,25,10,17,14,13,28,46.4,15,25,4,21,17,58,39,2,Matches
1186,Mason Holgate,eng ENG,DF,Everton,eng Premier League,24,1996,23.7,35,18,26,9,0,11,26,42.3,15,25,17,8,26,61,95,1,Matches
1187,Gerrit Holtmann,ph PHI,"FW,MF",Bochum,de Bundesliga,26,1995,20.4,15,9,5,3,7,6,22,27.3,16,26,2,24,8,23,6,0,Matches
1188,Martin Hongla,cm CMR,MF,Hellas Verona,it Serie A,23,1998,7.2,14,8,5,6,3,4,8,50.0,4,6,2,4,4,18,16,1,Matches
1189,Franck Honorat,fr FRA,"FW,MF",Brest,fr Ligue 1,24,1996,32.2,54,38,25,13,16,27,47,57.4,20,24,2,22,15,69,25,0,Matches
1190,Justin Hoogma,nl NED,DF,Greuther Fürth,de Bundesliga,23,1998,3.0,6,5,4,2,0,4,6,66.7,2,5,5,0,4,10,4,0,Matches
1191,Sydney van Hooijdonk,nl NED,"FW,MF",Bologna,it Serie A,21,2000,0.4,0,0,0,0,0,0,1,0.0,1,1,0,1,0,0,0,0,Matches
1192,Matthew Hoppe,us USA,"FW,MF",Mallorca,es La Liga,20,2001,1.5,1,0,0,0,1,0,3,0.0,3,0,0,0,0,1,0,0,Matches
1193,Jannes Horn,de GER,DF,Köln,de Bundesliga,24,1997,5.3,6,4,4,2,0,4,8,50.0,4,1,1,0,3,9,9,0,Matches
1194,Timo Horn,de GER,GK,Köln,de Bundesliga,28,1993,13.0,0,0,0,0,0,0,1,0.0,1,0,0,0,0,0,5,0,Matches
1195,Fraser Hornby,sct SCO,"FW,MF",Reims,fr Ligue 1,21,1999,3.9,3,1,1,2,0,0,2,0.0,2,3,0,3,4,7,5,0,Matches
1196,Cédric Hountondji,bj BEN,DF,Clermont Foot,fr Ligue 1,27,1994,22.6,33,17,20,12,1,16,24,66.7,8,23,12,11,34,67,76,0,Matches
1197,Lukáš Hrádecký,fi FIN,GK,Leverkusen,de Bundesliga,31,1989,32.0,1,1,1,0,0,1,1,100.0,0,0,0,0,0,1,10,1,Matches
1198,Branimir Hrgota,se SWE,FW,Greuther Fürth,de Bundesliga,28,1993,30.9,46,29,10,31,5,21,72,29.2,51,27,1,26,11,57,3,1,Matches
1199,Petko Hristov,bg BUL,DF,Spezia,it Serie A,22,1999,13.9,17,10,11,6,0,10,16,62.5,6,29,23,6,19,36,47,0,Matches
1200,Ajdin Hrustic,au AUS,MF,Eint Frankfurt,de Bundesliga,25,1996,10.7,16,11,5,7,4,11,32,34.4,21,18,1,17,10,26,7,0,Matches
1201,Timo Hübers,de GER,DF,Köln,de Bundesliga,25,1996,19.3,45,27,28,17,0,27,45,60.0,18,31,19,12,52,97,95,0,Matches
1202,Benjamin Hübner,de GER,DF,Hoffenheim,de Bundesliga,32,1989,4.2,9,5,0,7,2,3,5,60.0,2,2,2,0,9,18,7,0,Matches
1203,Callum Hudson-Odoi,eng ENG,"MF,FW",Chelsea,eng Premier League,20,2000,10.7,14,10,5,6,3,8,23,34.8,15,8,0,8,2,16,6,1,Matches
1204,Will Hughes,eng ENG,MF,Crystal Palace,eng Premier League,26,1995,11.7,29,14,10,16,3,7,16,43.8,9,13,7,6,8,37,10,0,Matches
1205,Mats Hummels,de GER,DF,Dortmund,de Bundesliga,32,1988,19.6,34,22,20,13,1,20,36,55.6,16,18,13,5,32,66,66,1,Matches
1206,Elseid Hysaj,al ALB,DF,Lazio,it Serie A,27,1994,22.5,46,30,25,17,4,29,45,64.4,16,18,6,12,24,70,34,1,Matches
1207,Suk Hyun-jun,kr KOR,"FW,MF",Troyes,fr Ligue 1,30,1991,1.7,0,0,0,0,0,0,0,,0,2,0,2,0,0,2,0,Matches
1208,Pierre Højbjerg,dk DEN,MF,Tottenham,eng Premier League,25,1995,35.5,78,45,31,38,9,38,85,44.7,47,61,13,48,48,126,54,0,Matches
1209,Iago,br BRA,DF,Augsburg,de Bundesliga,24,1997,24.2,49,29,25,19,5,15,34,44.1,19,28,6,22,27,76,62,0,Matches
1210,Robert Ibáñez,es ESP,"MF,FW",Osasuna,es La Liga,28,1993,1.0,3,3,2,0,1,1,2,50.0,1,1,0,1,1,4,1,0,Matches
1211,Roger Ibanez,br BRA,DF,Roma,it Serie A,22,1998,32.1,54,32,31,19,4,26,43,60.5,17,26,7,19,62,116,104,2,Matches
1212,Vicente Iborra,es ESP,MF,Villarreal,es La Liga,33,1988,11.5,19,10,9,7,3,12,24,50.0,12,11,5,6,11,30,27,1,Matches
1213,Zlatan Ibrahimović,se SWE,FW,Milan,it Serie A,39,1981,11.3,0,0,0,0,0,0,2,0.0,2,2,1,1,3,3,9,0,Matches
1214,Mauro Icardi,ar ARG,FW,Paris S-G,fr Ligue 1,28,1993,11.4,5,3,1,3,1,3,7,42.9,4,3,0,3,5,10,12,0,Matches
1215,Adam Idah,ie IRL,"FW,MF",Norwich City,eng Premier League,20,2001,6.9,9,6,2,5,2,2,3,66.7,1,4,2,2,3,12,7,0,Matches
1216,Oussama Idrissi,ma MAR,"MF,FW",Sevilla,es La Liga,25,1996,1.4,1,0,0,1,0,0,1,0.0,1,1,0,1,1,2,1,0,Matches
1217,Oussama Idrissi,ma MAR,MF,Cádiz,es La Liga,25,1996,10.0,8,4,3,4,1,4,15,26.7,11,8,0,8,3,11,5,0,Matches
1218,Iglesias,es ESP,DF,Getafe,es La Liga,23,1998,8.0,19,10,11,8,0,7,17,41.2,10,8,2,6,10,29,28,0,Matches
1219,Borja Iglesias,es ESP,FW,Betis,es La Liga,28,1993,17.5,6,4,1,2,3,0,8,0.0,8,11,1,10,4,10,7,0,Matches
1220,Jonathan Iglesias,uy URU,MF,Clermont Foot,fr Ligue 1,32,1988,6.4,18,11,6,10,2,10,18,55.6,8,8,2,6,5,23,2,1,Matches
1221,Juan Ignacio Ramírez,uy URU,FW,Saint-Étienne,fr Ligue 1,24,1997,1.4,2,1,0,1,1,0,0,,0,0,0,0,0,2,0,0,Matches
1222,Igor,br BRA,DF,Fiorentina,it Serie A,23,1998,24.9,53,31,34,16,3,30,40,75.0,10,37,19,18,31,84,46,4,Matches
1223,Kelechi Iheanacho,ng NGA,FW,Leicester City,eng Premier League,24,1996,14.0,10,7,2,5,3,3,14,21.4,11,19,0,19,4,14,10,0,Matches
1224,Danylo Ihnatenko,ua UKR,MF,Bordeaux,fr Ligue 1,24,1997,7.7,17,9,8,7,2,10,24,41.7,14,9,2,7,6,23,17,1,Matches
1225,Jonathan Ikone,fr FRA,FW,Fiorentina,it Serie A,23,1998,7.2,7,3,2,3,2,3,10,30.0,7,10,2,8,1,8,2,0,Matches
1226,Jonathan Ikone,fr FRA,"MF,FW",Lille,fr Ligue 1,23,1998,11.8,11,3,6,4,1,4,11,36.4,7,13,1,12,5,16,4,0,Matches
1227,Ivan Ilić,rs SRB,MF,Hellas Verona,it Serie A,20,2001,28.1,39,18,16,19,4,20,54,37.0,34,34,12,22,22,61,55,0,Matches
1228,Josip Iličić,si SVN,"MF,FW",Atalanta,it Serie A,33,1988,9.3,7,7,3,2,2,4,17,23.5,13,6,1,5,3,10,1,0,Matches
1229,Asier Illarramendi,es ESP,MF,Real Sociedad,es La Liga,31,1990,4.2,9,5,5,3,1,1,10,10.0,9,5,1,4,4,13,12,0,Matches
1230,Stefan Ilsanker,at AUT,"DF,MF",Eint Frankfurt,de Bundesliga,32,1989,3.0,14,8,7,6,1,5,10,50.0,5,6,2,4,6,20,15,1,Matches
1231,Ciro Immobile,it ITA,FW,Lazio,it Serie A,31,1990,30.1,10,5,4,4,2,1,15,6.7,14,7,1,6,3,13,16,0,Matches
1232,Burak İnce,tr TUR,FW,Arminia,de Bundesliga,17,2004,1.5,1,1,1,0,0,1,2,50.0,1,1,0,1,0,1,0,0,Matches
1233,Danny Ings,eng ENG,FW,Aston Villa,eng Premier League,29,1992,21.1,23,16,2,16,5,13,37,35.1,24,31,2,29,6,29,22,0,Matches
1234,Marcus Ingvartsen,dk DEN,MF,Union Berlin,de Bundesliga,25,1996,1.4,0,0,0,0,0,0,2,0.0,2,0,0,0,2,2,1,0,Matches
1235,Marcus Ingvartsen,dk DEN,"FW,MF",Mainz 05,de Bundesliga,25,1996,7.6,3,2,2,0,1,3,9,33.3,6,6,0,6,6,9,7,1,Matches
1236,Bonke Innocent,ng NGA,MF,Lorient,fr Ligue 1,25,1996,9.7,27,16,10,16,1,11,26,42.3,15,11,3,8,16,43,14,0,Matches
1237,Lorenzo Insigne,it ITA,FW,Napoli,it Serie A,30,1991,25.4,23,14,8,12,3,8,44,18.2,36,30,1,29,20,43,3,1,Matches
1238,Nikita Iosifov,ru RUS,MF,Villarreal,es La Liga,20,2001,0.0,0,0,0,0,0,0,0,,0,0,0,0,0,0,0,0,Matches
1239,Tim Iroegbunam,eng ENG,MF,Aston Villa,eng Premier League,18,2003,1.0,5,4,2,3,0,1,1,100.0,0,0,0,0,2,7,1,0,Matches
1240,Alexander Isak,se SWE,FW,Real Sociedad,es La Liga,21,1999,23.8,7,4,1,3,3,2,12,16.7,10,14,2,12,3,10,10,0,Matches
1241,Isco,es ESP,"MF,FW",Real Madrid,es La Liga,29,1992,3.7,9,5,4,4,1,5,12,41.7,7,1,0,1,2,11,1,0,Matches
1242,Wilson Isidor,fr FRA,"FW,MF",Monaco,fr Ligue 1,20,2000,0.6,0,0,0,0,0,0,4,0.0,4,1,0,1,0,0,0,0,Matches
1243,Ardian Ismajli,al ALB,DF,Empoli,it Serie A,24,1996,14.1,13,9,8,4,1,5,14,35.7,9,21,11,10,24,37,80,0,Matches
1244,Hiroki Ito,jp JPN,DF,Stuttgart,de Bundesliga,22,1999,26.1,43,31,21,19,3,25,43,58.1,18,40,19,21,53,96,95,0,Matches
1245,Cedric Itten,ch SUI,FW,Greuther Fürth,de Bundesliga,24,1996,7.1,5,2,1,2,2,1,6,16.7,5,3,0,3,2,7,4,0,Matches
1246,Gian-Luca Itter,de GER,DF,Greuther Fürth,de Bundesliga,22,1999,16.2,44,26,30,11,3,21,38,55.3,17,24,9,15,13,57,51,0,Matches
1247,Alex Iwobi,ng NGA,"MF,DF",Everton,eng Premier League,25,1996,22.6,40,19,23,12,5,21,52,40.4,31,39,3,36,20,60,25,2,Matches
1248,Armando Izzo,it ITA,DF,Torino,it Serie A,29,1992,5.8,16,9,14,2,0,9,11,81.8,2,5,4,1,17,33,21,0,Matches
1249,Nicolas Jackson,sn SEN,"FW,MF",Villarreal,es La Liga,20,2001,1.8,2,0,1,0,1,0,0,,0,0,0,0,1,3,1,0,Matches
1250,Lee Jae-sung,kr KOR,"MF,FW",Mainz 05,de Bundesliga,28,1992,16.0,30,12,8,14,8,6,27,22.2,21,20,2,18,18,48,18,0,Matches
1251,Paul Jaeckel,de GER,DF,Union Berlin,de Bundesliga,23,1998,22.7,51,29,27,24,0,29,51,56.9,22,34,10,24,57,108,81,0,Matches
1252,Mato Jajalo,ba BIH,MF,Udinese,it Serie A,33,1988,7.0,24,14,14,7,3,11,23,47.8,12,7,0,7,11,35,5,0,Matches
1253,Kristijan Jakić,hr CRO,MF,Eint Frankfurt,de Bundesliga,24,1997,20.9,37,22,10,21,6,15,62,24.2,47,33,3,30,21,58,25,1,Matches
1254,Ismail Jakobs,sn SEN,"DF,FW",Monaco,fr Ligue 1,21,1999,13.4,32,16,14,15,3,16,35,45.7,19,16,1,15,17,49,31,0,Matches
1255,Marin Jakoliš,hr CRO,FW,Angers,fr Ligue 1,24,1996,2.5,2,1,0,1,1,0,6,0.0,6,0,0,0,1,3,0,0,Matches
1256,Abdel Jalil Medioub,dz ALG,DF,Bordeaux,fr Ligue 1,23,1997,6.9,9,5,5,3,1,3,4,75.0,1,8,4,4,12,21,34,0,Matches
1257,Daniel James,wls WAL,FW,Manchester Utd,eng Premier League,23,1997,1.4,2,1,0,2,0,0,0,,0,2,0,2,0,2,1,0,Matches
1258,Daniel James,wls WAL,"FW,MF",Leeds United,eng Premier League,23,1997,26.3,24,14,8,8,8,10,23,43.5,13,18,1,17,8,32,12,0,Matches
1259,Reece James,eng ENG,DF,Chelsea,eng Premier League,21,1999,20.7,33,25,14,18,1,9,22,40.9,13,20,2,18,17,50,22,0,Matches
1260,Vitaly Janelt,de GER,MF,Brentford,eng Premier League,23,1998,25.5,61,32,26,27,8,27,53,50.9,26,23,7,16,28,89,35,0,Matches
1261,Jakub Jankto,cz CZE,"DF,MF",Getafe,es La Liga,25,1996,6.5,11,7,5,5,1,10,17,58.8,7,4,0,4,4,15,7,0,Matches
1262,Pontus Jansson,se SWE,DF,Brentford,eng Premier League,30,1991,36.9,40,21,32,8,0,22,34,64.7,12,37,27,10,52,92,187,0,Matches
1263,Tony Jantschke,de GER,DF,Gladbach,de Bundesliga,31,1990,2.5,6,5,2,4,0,3,6,50.0,3,3,2,1,5,11,8,0,Matches
1264,Adnan Januzaj,be BEL,"FW,MF",Real Sociedad,es La Liga,26,1995,18.1,17,11,5,8,4,9,24,37.5,15,15,3,12,12,29,15,0,Matches
1265,Léo Jardim,br BRA,GK,Lille,fr Ligue 1,26,1995,17.0,0,0,0,0,0,0,0,,0,0,0,0,1,1,10,0,Matches
1266,Paweł Jaroszyński,pl POL,DF,Salernitana,it Serie A,26,1994,5.7,10,5,7,3,0,5,7,71.4,2,4,0,4,10,20,19,0,Matches
1267,Jason,es ESP,"MF,FW",Alavés,es La Liga,27,1994,7.5,11,7,6,4,1,7,20,35.0,13,7,0,7,7,18,5,0,Matches
1268,Jason,es ESP,"MF,DF",Valencia,es La Liga,27,1994,0.8,4,1,2,1,1,0,1,0.0,1,2,0,2,1,5,1,0,Matches
1269,Dennis Jastrzembski,pl POL,"DF,FW",Hertha BSC,de Bundesliga,21,2000,2.5,2,1,1,1,0,2,8,25.0,6,1,0,1,5,7,3,0,Matches
1270,Luis Javier Suárez,co COL,FW,Granada,es La Liga,23,1997,31.6,26,14,9,9,8,8,27,29.6,19,25,3,22,6,32,23,0,Matches
1271,Corentin Jean,fr FRA,"FW,MF",Lens,fr Ligue 1,26,1995,2.8,9,6,4,4,1,3,6,50.0,3,5,0,5,1,10,0,0,Matches
1272,Jemerson,br BRA,DF,Metz,fr Ligue 1,28,1992,13.4,37,25,30,7,0,18,26,69.2,8,23,8,15,25,62,33,1,Matches
1273,Fredrik Jensen,fi FIN,"MF,FW",Augsburg,de Bundesliga,23,1997,4.6,5,4,1,3,1,4,7,57.1,3,5,1,4,2,7,4,0,Matches
1274,Mathias Jensen,dk DEN,MF,Brentford,eng Premier League,25,1996,17.8,33,18,12,16,5,22,63,34.9,41,32,3,29,22,55,13,0,Matches
1275,Moritz Jenz,de GER,DF,Lorient,fr Ligue 1,22,1999,15.3,26,12,18,6,2,11,24,45.8,13,19,11,8,28,54,55,0,Matches
1276,Gabriel Jesus,br BRA,FW,Manchester City,eng Premier League,24,1997,20.9,18,12,2,4,12,6,26,23.1,20,18,0,18,15,33,8,0,Matches
1277,Juan Jesus,br BRA,DF,Napoli,it Serie A,30,1991,14.2,25,17,14,11,0,12,18,66.7,6,21,16,5,9,34,34,0,Matches
1278,Álvaro Jiménez,es ESP,"MF,FW",Cádiz,es La Liga,26,1995,2.6,6,3,3,2,1,4,7,57.1,3,3,0,3,3,9,0,0,Matches
1279,Raúl Jiménez,mx MEX,FW,Wolves,eng Premier League,30,1991,29.2,29,14,6,16,7,6,30,20.0,24,31,5,26,13,42,26,0,Matches
1280,João Pedro,br BRA,"FW,MF",Watford,eng Premier League,19,2001,18.3,20,14,7,8,5,6,23,26.1,17,23,3,20,15,35,17,0,Matches
1281,Joaquín,es ESP,"FW,MF",Betis,es La Liga,40,1981,5.2,6,2,4,2,0,3,8,37.5,5,5,2,3,3,9,10,0,Matches
1282,Joelinton,br BRA,"MF,FW",Newcastle Utd,eng Premier League,24,1996,28.4,72,38,30,33,9,26,61,42.6,35,46,11,35,34,106,50,2,Matches
1283,Jofre,es ESP,"MF,DF",Espanyol,es La Liga,20,2001,0.2,1,1,0,0,1,1,1,100.0,0,0,0,0,0,1,0,0,Matches
1284,Marco John,de GER,DF,Hoffenheim,de Bundesliga,19,2002,0.5,0,0,0,0,0,0,1,0.0,1,1,0,1,1,1,1,0,Matches
1285,Dennis Johnsen,no NOR,"FW,MF",Venezia,it Serie A,23,1998,16.1,14,10,8,4,2,6,18,33.3,12,14,1,13,5,19,3,0,Matches
1286,Ben Johnson,eng ENG,DF,West Ham,eng Premier League,21,2000,15.5,33,16,15,15,3,21,28,75.0,7,16,8,8,22,55,55,0,Matches
1287,Curtis Jones,eng ENG,MF,Liverpool,eng Premier League,20,2001,9.5,11,9,3,6,2,1,10,10.0,9,4,0,4,6,17,4,0,Matches
1288,Phil Jones,eng ENG,DF,Manchester Utd,eng Premier League,29,1992,1.8,5,5,3,1,1,2,3,66.7,1,4,4,0,3,8,8,0,Matches
1289,Frenkie de Jong,nl NED,MF,Barcelona,es La Liga,24,1997,27.5,35,19,12,18,5,12,23,52.2,11,19,5,14,20,55,16,0,Matches
1290,Luuk de Jong,nl NED,FW,Barcelona,es La Liga,30,1990,7.3,9,7,1,5,3,1,2,50.0,1,4,0,4,0,9,12,0,Matches
1291,Joan Jordán,es ESP,MF,Sevilla,es La Liga,27,1994,27.9,61,30,22,31,8,28,65,43.1,37,27,6,21,30,91,18,1,Matches
1292,Kaio Jorge,br BRA,"MF,FW",Juventus,it Serie A,19,2002,1.3,2,1,0,2,0,1,3,33.3,2,1,0,1,0,2,2,0,Matches
1293,Jorginho,it ITA,MF,Chelsea,eng Premier League,29,1991,25.3,64,33,27,31,6,29,83,34.9,54,27,4,23,36,100,21,1,Matches
1294,Josan,es ESP,"DF,MF",Elche,es La Liga,31,1989,13.5,36,22,23,9,4,26,44,59.1,18,11,4,7,10,46,21,0,Matches
1295,Willian José,br BRA,FW,Betis,es La Liga,29,1991,17.8,15,13,2,10,3,2,8,25.0,6,10,2,8,3,18,16,0,Matches
1296,Joselu,es ESP,FW,Alavés,es La Liga,31,1990,34.7,16,11,1,9,6,7,25,28.0,18,21,4,17,7,23,45,0,Matches
1297,Josema,es ESP,DF,Elche,es La Liga,25,1996,2.0,3,2,1,1,1,0,2,0.0,2,1,1,0,0,3,11,0,Matches
1298,Lenny Joseph,fr FRA,"FW,MF",Metz,fr Ligue 1,20,2000,1.7,2,1,1,1,0,0,0,,0,3,0,3,0,2,0,0,Matches
1299,Diogo Jota,pt POR,FW,Liverpool,eng Premier League,24,1996,26.3,39,18,12,18,9,13,55,23.6,42,19,2,17,6,45,6,0,Matches
1300,Stevan Jovetić,me MNE,"FW,MF",Hertha BSC,de Bundesliga,31,1989,11.3,5,2,0,2,3,1,6,16.7,5,3,0,3,1,6,6,0,Matches
1301,Luka Jović,rs SRB,FW,Real Madrid,es La Liga,23,1997,4.1,1,1,0,1,0,0,1,0.0,1,3,0,3,1,2,4,0,Matches
1302,Miguel Juan Llambrich,es ESP,DF,Espanyol,es La Liga,25,1996,0.8,2,2,1,1,0,0,0,,0,1,0,1,0,2,5,0,Matches
1303,José Juan Macías,mx MEX,"FW,MF",Getafe,es La Liga,21,1999,2.2,1,0,0,0,1,0,1,0.0,1,1,0,1,1,2,0,0,Matches
1304,Juanmi,es ESP,FW,Betis,es La Liga,28,1993,23.7,39,25,11,19,9,19,49,38.8,30,24,1,23,9,48,10,1,Matches
1305,Gideon Jung,de GER,DF,Greuther Fürth,de Bundesliga,26,1994,1.6,3,1,1,2,0,2,4,50.0,2,1,1,0,2,5,5,0,Matches
1306,Flavio Junior Bianchi,it ITA,"FW,MF",Genoa,it Serie A,21,2000,3.5,2,2,1,0,1,0,2,0.0,2,0,0,0,0,2,0,0,Matches
1307,Lago Junior,ci CIV,"FW,MF",Mallorca,es La Liga,30,1990,2.0,3,2,3,0,0,3,5,60.0,2,0,0,0,2,5,2,0,Matches
1308,Hamed Junior Traorè,ci CIV,"FW,MF",Sassuolo,it Serie A,21,2000,19.7,32,18,8,14,10,10,46,21.7,36,22,2,20,12,44,6,1,Matches
1309,Vinicius Júnior,br BRA,FW,Real Madrid,es La Liga,21,2000,29.9,46,24,23,19,4,15,50,30.0,35,25,0,25,6,52,6,0,Matches
1310,James Justin,eng ENG,DF,Leicester City,eng Premier League,23,1998,11.1,22,13,11,8,3,7,15,46.7,8,16,4,12,17,39,34,0,Matches
1311,Jutglà,es ESP,FW,Barcelona,es La Liga,22,1999,3.3,2,1,0,1,1,0,1,0.0,1,2,0,2,1,3,1,0,Matches
1312,Jens Jønsson,dk DEN,MF,Cádiz,es La Liga,28,1993,14.5,40,29,22,17,1,17,35,48.6,18,17,7,10,34,74,32,0,Matches
1313,Mathias Jørgensen,dk DEN,DF,Brentford,eng Premier League,31,1990,5.8,10,4,3,5,2,7,10,70.0,3,6,1,5,10,20,13,0,Matches
1314,Ozan Kabak,tr TUR,DF,Norwich City,eng Premier League,21,2000,10.2,10,5,4,6,0,5,9,55.6,4,19,11,8,16,26,26,0,Matches
1315,Christian Kabasele,be BEL,DF,Watford,eng Premier League,30,1991,13.3,11,5,10,1,0,7,10,70.0,3,20,16,4,14,25,67,1,Matches
1316,Issa Kaboré,bf BFA,DF,Troyes,fr Ligue 1,20,2001,25.0,45,22,22,14,9,20,38,52.6,18,27,2,25,20,65,38,1,Matches
1317,Anton Kade,de GER,"FW,MF",Hertha BSC,de Bundesliga,17,2004,0.9,4,2,3,1,0,2,8,25.0,6,3,0,3,3,7,1,0,Matches
1318,Pavel Kadeřábek,cz CZE,"DF,MF",Hoffenheim,de Bundesliga,29,1992,13.3,11,10,6,3,2,5,16,31.3,11,18,6,12,13,24,22,0,Matches
1319,Tino Kadewere,zw ZIM,FW,Lyon,fr Ligue 1,25,1996,5.6,7,5,2,2,3,4,13,30.8,9,7,0,7,4,11,1,1,Matches
1320,Florian Kainz,at AUT,"MF,FW",Köln,de Bundesliga,28,1992,25.8,41,26,9,25,7,23,51,45.1,28,27,3,24,32,73,24,0,Matches
1321,Gaël Kakuta,cd COD,"MF,FW",Lens,fr Ligue 1,30,1991,18.6,22,14,2,13,7,4,20,20.0,16,10,0,10,4,26,3,0,Matches
1322,Sasa Kalajdzic,at AUT,FW,Stuttgart,de Bundesliga,24,1997,13.6,10,6,2,5,3,3,11,27.3,8,5,0,5,2,12,14,0,Matches
1323,Arnaud Kalimuendo,fr FRA,FW,Lens,fr Ligue 1,19,2002,23.9,9,8,1,3,5,2,7,28.6,5,6,1,5,8,17,0,0,Matches
1324,Arnaud Kalimuendo,fr FRA,FW,Paris S-G,fr Ligue 1,19,2002,0.1,0,0,0,0,0,0,0,,0,0,0,0,0,0,0,0,Matches
1325,Nikola Kalinić,hr CRO,FW,Hellas Verona,it Serie A,33,1988,4.5,2,0,0,1,1,1,2,50.0,1,2,0,2,0,2,2,0,Matches
1326,Yayah Kallon,sl SLE,"FW,MF",Genoa,it Serie A,20,2001,7.1,15,11,5,6,4,3,11,27.3,8,7,1,6,1,16,5,0,Matches
1327,Samuel Kalu,ng NGA,FW,Watford,eng Premier League,23,1997,2.5,2,2,0,2,0,1,1,100.0,0,2,0,2,3,5,3,0,Matches
1328,Samuel Kalu,ng NGA,"FW,MF",Bordeaux,fr Ligue 1,23,1997,3.6,8,5,3,4,1,2,5,40.0,3,2,0,2,3,11,1,0,Matches
1329,Pierre Kalulu,fr FRA,DF,Milan,it Serie A,21,2000,21.6,61,36,36,21,4,17,22,77.3,5,36,15,21,26,87,54,0,Matches
1330,Daichi Kamada,jp JPN,MF,Eint Frankfurt,de Bundesliga,24,1996,23.8,40,21,7,26,7,11,40,27.5,29,18,0,18,8,48,10,0,Matches
1331,Boubacar Kamara,fr FRA,"MF,DF",Marseille,fr Ligue 1,21,1999,30.9,68,38,27,36,5,26,47,55.3,21,29,10,19,46,114,44,1,Matches
1332,Hassane Kamara,ci CIV,DF,Watford,eng Premier League,27,1994,18.0,53,34,31,16,6,27,43,62.8,16,20,4,16,69,122,67,0,Matches
1333,Hassane Kamara,ci CIV,"MF,DF",Nice,fr Ligue 1,27,1994,6.0,13,10,4,6,3,5,8,62.5,3,10,2,8,9,22,4,0,Matches
1334,Dimitrije Kamenović,rs SRB,DF,Lazio,it Serie A,21,2000,0.5,1,1,1,0,0,1,1,100.0,0,0,0,0,2,3,1,0,Matches
1335,Kevin Kampl,si SVN,MF,RB Leipzig,de Bundesliga,30,1990,21.1,41,19,16,20,5,10,42,23.8,32,24,5,19,24,65,17,0,Matches
1336,Jean-Armel Kana-Biyik,cm CMR,DF,Metz,fr Ligue 1,32,1989,7.4,10,6,8,2,0,4,9,44.4,5,11,4,7,16,26,22,1,Matches
1337,Nordine Kandil,fr FRA,"MF,FW",Strasbourg,fr Ligue 1,19,2001,1.0,2,1,2,0,0,1,1,100.0,0,1,1,0,0,2,0,0,Matches
1338,Harry Kane,eng ENG,FW,Tottenham,eng Premier League,28,1993,35.9,15,5,2,10,3,7,18,38.9,11,26,8,18,3,18,39,0,Matches
1339,Lee Kang-in,kr KOR,"MF,FW",Mallorca,es La Liga,20,2001,15.7,13,6,2,9,2,5,29,17.2,24,11,1,10,5,18,7,0,Matches
1340,N'Golo Kanté,fr FRA,MF,Chelsea,eng Premier League,30,1991,19.7,59,31,20,27,12,25,40,62.5,15,37,2,35,31,90,8,0,Matches
1341,Stefanos Kapino,gr GRE,GK,Arminia,de Bundesliga,27,1994,1.0,0,0,0,0,0,0,0,,0,0,0,0,0,0,0,0,Matches
1342,Atakan Karazor,de GER,MF,Stuttgart,de Bundesliga,24,1996,21.1,48,24,18,27,3,18,36,50.0,18,37,14,23,34,82,47,0,Matches
1343,Rick Karsdorp,nl NED,"DF,FW",Roma,it Serie A,26,1995,32.0,53,38,33,13,7,28,50,56.0,22,22,5,17,34,87,26,1,Matches
1344,Denso Kasius,nl NED,"DF,FW",Bologna,it Serie A,18,2002,2.0,9,7,5,3,1,2,5,40.0,3,4,0,4,3,12,4,0,Matches
1345,Grigoris Kastanos,cy CYP,"MF,FW",Salernitana,it Serie A,23,1998,15.0,30,19,9,19,2,7,23,30.4,16,21,5,16,22,52,8,0,Matches
1346,Silas Katompa,cd COD,"FW,MF",Stuttgart,de Bundesliga,22,1998,3.1,5,4,4,0,1,3,7,42.9,4,5,0,5,2,7,1,0,Matches
1347,Noah Katterbach,de GER,DF,Köln,de Bundesliga,20,2001,0.2,1,1,1,0,0,1,1,100.0,0,0,0,0,0,1,1,0,Matches
1348,Eiji Kawashima,jp JPN,GK,Strasbourg,fr Ligue 1,38,1983,1.0,0,0,0,0,0,0,0,,0,0,0,0,0,0,0,0,Matches
1349,Edo Kayembe,cd COD,MF,Watford,eng Premier League,23,1998,8.9,21,13,11,9,1,8,16,50.0,8,6,1,5,9,30,13,0,Matches
1350,Moise Kean,it ITA,FW,Everton,eng Premier League,21,2000,0.0,0,0,0,0,0,0,0,,0,0,0,0,0,0,0,0,Matches
1351,Moise Kean,it ITA,FW,Juventus,it Serie A,21,2000,12.2,9,4,2,5,2,6,16,37.5,10,5,0,5,3,12,8,1,Matches
1352,Michael Keane,eng ENG,DF,Everton,eng Premier League,28,1993,31.0,46,25,32,13,1,28,45,62.2,17,33,28,5,62,108,128,2,Matches
1353,Ilan Kebbal,dz ALG,"MF,FW",Reims,fr Ligue 1,23,1998,19.7,31,15,13,10,8,12,44,27.3,32,16,0,16,13,44,3,0,Matches
1354,Wajdi Kechrida,tn TUN,"DF,MF",Salernitana,it Serie A,25,1995,10.6,9,6,6,3,0,8,13,61.5,5,10,2,8,8,17,15,0,Matches
1355,Thilo Kehrer,de GER,DF,Paris S-G,fr Ligue 1,24,1996,16.8,21,14,9,11,1,9,21,42.9,12,19,11,8,24,45,29,0,Matches
1356,Habib Keita,ml MLI,"MF,FW",Lyon,fr Ligue 1,19,2002,0.1,0,0,0,0,0,0,0,,0,0,0,0,0,0,0,0,Matches
1357,Naby Keïta,gn GUI,MF,Liverpool,eng Premier League,26,1995,13.0,46,23,17,19,10,26,42,61.9,16,33,2,31,14,60,8,0,Matches
1358,Yannik Keitel,de GER,MF,Freiburg,de Bundesliga,21,2000,5.6,11,4,5,4,2,5,15,33.3,10,7,1,6,1,12,8,0,Matches
1359,Caoimhín Kelleher,ie IRL,GK,Liverpool,eng Premier League,22,1998,2.0,1,1,1,0,0,1,1,100.0,0,0,0,0,0,1,1,0,Matches
1360,Marc-Oliver Kempf,de GER,DF,Hertha BSC,de Bundesliga,26,1995,11.7,10,9,9,1,0,5,14,35.7,9,14,7,7,25,35,49,1,Matches
1361,Marc-Oliver Kempf,de GER,DF,Stuttgart,de Bundesliga,26,1995,9.3,13,8,7,4,2,3,10,30.0,7,16,14,2,16,29,26,2,Matches
1362,Kenedy,br BRA,DF,Chelsea,eng Premier League,25,1996,0.6,5,2,1,2,2,2,3,66.7,1,0,0,0,0,5,0,0,Matches
1363,Jonjoe Kenny,eng ENG,DF,Everton,eng Premier League,24,1997,11.3,17,7,11,6,0,13,21,61.9,8,8,1,7,20,37,31,0,Matches
1364,Dimitrios Keramitsis,gr GRE,MF,Roma,it Serie A,17,2004,0.0,0,0,0,0,0,0,0,,0,0,0,0,0,0,0,0,Matches
1365,Franck Kessié,ci CIV,MF,Milan,it Serie A,24,1996,25.6,41,23,12,24,5,17,26,65.4,9,39,10,29,23,64,22,0,Matches
1366,Saîf-Eddine Khaoui,tn TUN,"MF,FW",Clermont Foot,fr Ligue 1,26,1995,10.3,19,10,5,10,4,9,18,50.0,9,9,0,9,14,33,5,0,Matches
1367,Wahbi Khazri,tn TUN,"FW,MF",Saint-Étienne,fr Ligue 1,30,1991,24.7,33,18,7,17,9,9,34,26.5,25,21,0,21,12,45,7,0,Matches
1368,Rani Khedira,de GER,MF,Union Berlin,de Bundesliga,27,1994,30.6,75,38,25,42,8,32,66,48.5,34,21,8,13,50,125,27,1,Matches
1369,Kiké,es ESP,FW,Osasuna,es La Liga,31,1989,20.7,11,7,3,4,4,3,23,13.0,20,10,1,9,3,14,12,0,Matches
1370,Luca Kilian,de GER,FW,Mainz 05,de Bundesliga,21,1999,0.0,0,0,0,0,0,0,0,,0,0,0,0,0,0,0,0,Matches
1371,Luca Kilian,de GER,DF,Köln,de Bundesliga,21,1999,25.3,42,24,30,9,3,21,41,51.2,20,31,13,18,46,88,109,3,Matches
1372,Max Kilman,eng ENG,DF,Wolves,eng Premier League,24,1997,29.9,50,26,38,10,2,24,37,64.9,13,36,21,15,45,95,113,3,Matches
1373,Joshua Kimmich,de GER,MF,Bayern Munich,de Bundesliga,26,1995,27.5,39,20,14,17,8,18,58,31.0,40,34,8,26,52,91,29,1,Matches
1374,Presnel Kimpembe,fr FRA,DF,Paris S-G,fr Ligue 1,25,1995,28.6,34,19,18,15,1,14,23,60.9,9,20,14,6,38,72,73,1,Matches
1375,Joshua King,no NOR,FW,Watford,eng Premier League,29,1992,25.0,19,15,7,6,6,4,17,23.5,13,15,4,11,8,27,31,0,Matches
1376,Jakub Kiwior,pl POL,MF,Spezia,it Serie A,21,2000,21.8,50,27,25,19,6,26,57,45.6,31,38,15,23,40,90,53,0,Matches
1377,Sofian Kiyine,ma MAR,"MF,FW",Venezia,it Serie A,23,1997,13.8,24,14,9,11,4,12,32,37.5,20,15,1,14,10,34,9,0,Matches
1378,Simon Kjær,dk DEN,DF,Milan,it Serie A,32,1989,8.9,20,12,9,8,3,6,12,50.0,6,17,13,4,9,29,39,0,Matches
1379,Kristoffer Klaesson,no NOR,GK,Leeds United,eng Premier League,20,2000,0.4,0,0,0,0,0,0,0,,0,0,0,0,0,0,0,0,Matches
1380,Philipp Klement,de GER,MF,Stuttgart,de Bundesliga,28,1992,3.8,7,3,1,4,2,3,3,100.0,0,6,1,5,1,8,0,0,Matches
1381,Mateusz Klich,pl POL,MF,Leeds United,eng Premier League,31,1990,23.0,47,25,18,23,6,25,66,37.9,41,22,4,18,11,58,20,0,Matches
1382,Thibault Klidje,tg TOG,"MF,FW",Bordeaux,fr Ligue 1,20,2001,1.0,0,0,0,0,0,0,1,0.0,1,1,1,0,2,2,0,0,Matches
1383,Mateo Klimowicz,de GER,"MF,FW",Stuttgart,de Bundesliga,21,2000,6.7,13,6,6,7,0,5,16,31.3,11,2,0,2,4,17,3,0,Matches
1384,Fabian Klos,de GER,FW,Arminia,de Bundesliga,33,1987,15.8,7,5,0,5,2,2,10,20.0,8,17,4,13,0,7,31,0,Matches
1385,Lukas Klostermann,de GER,DF,RB Leipzig,de Bundesliga,25,1996,18.3,29,16,11,15,3,13,19,68.4,6,16,3,13,26,55,58,0,Matches
1386,Justin Kluivert,nl NED,MF,Nice,fr Ligue 1,22,1999,20.8,19,9,6,12,1,5,21,23.8,16,13,1,12,14,33,6,0,Matches
1387,Lukas Klünter,de GER,DF,Hertha BSC,de Bundesliga,25,1996,2.2,1,1,1,0,0,1,5,20.0,4,1,0,1,2,3,2,0,Matches
1388,Ansgar Knauff,de GER,"FW,MF",Dortmund,de Bundesliga,19,2002,1.3,3,1,1,1,1,0,4,0.0,4,2,0,2,0,3,4,0,Matches
1389,Ansgar Knauff,de GER,"DF,MF",Eint Frankfurt,de Bundesliga,19,2002,8.4,18,14,8,5,5,8,15,53.3,7,11,1,10,8,26,6,0,Matches
1390,Robin Knoche,de GER,DF,Union Berlin,de Bundesliga,29,1992,33.0,50,24,38,12,0,30,53,56.6,23,45,26,19,49,99,151,1,Matches
1391,Gregor Kobel,ch SUI,GK,Dortmund,de Bundesliga,23,1997,28.5,0,0,0,0,0,0,2,0.0,2,0,0,0,1,1,20,0,Matches
1392,Robin Koch,de GER,"MF,DF",Leeds United,eng Premier League,25,1996,17.5,21,13,9,10,2,9,34,26.5,25,26,10,16,20,41,44,0,Matches
1393,Samuel Koeberlé,fr FRA,FW,Reims,fr Ligue 1,16,2004,0.0,0,0,0,0,0,0,0,,0,0,0,0,0,0,0,0,Matches
1394,Philippe Koffi,ci CIV,FW,Reims,fr Ligue 1,19,2002,4.2,4,0,0,3,1,0,2,0.0,2,2,1,1,3,7,3,0,Matches
1395,Dominik Kohr,de GER,MF,Mainz 05,de Bundesliga,27,1994,17.9,40,20,18,19,3,16,42,38.1,26,21,2,19,35,75,22,0,Matches
1396,Koba Koindredi,fr FRA,MF,Valencia,es La Liga,19,2001,2.0,4,3,2,1,1,2,6,33.3,4,3,0,3,4,8,5,0,Matches
1397,Koke,es ESP,MF,Atlético Madrid,es La Liga,29,1992,27.9,55,30,19,29,7,26,63,41.3,37,21,5,16,24,79,31,1,Matches
1398,Aleksandr Kokorin,ru RUS,"FW,MF",Fiorentina,it Serie A,30,1991,0.6,1,1,1,0,0,0,0,,0,1,0,1,0,1,0,0,Matches
1399,Aleksandar Kolarov,rs SRB,DF,Inter,it Serie A,35,1985,0.5,1,1,1,0,0,1,1,100.0,0,0,0,0,1,2,2,0,Matches
1400,Sead Kolašinac,ba BIH,DF,Arsenal,eng Premier League,28,1993,1.0,0,0,0,0,0,0,0,,0,0,0,0,4,4,1,0,Matches
1401,Sead Kolašinac,ba BIH,DF,Marseille,fr Ligue 1,28,1993,4.9,7,6,2,3,2,5,8,62.5,3,4,0,4,0,7,7,1,Matches
1402,Luca Koleosho,it ITA,FW,Espanyol,es La Liga,16,2004,0.0,0,0,0,0,0,0,0,,0,0,0,0,0,0,0,0,Matches
1403,Randal Kolo Muani,fr FRA,"FW,MF",Nantes,fr Ligue 1,22,1998,32.8,28,14,7,10,11,10,25,40.0,15,14,3,11,6,34,31,0,Matches
1404,Timothée Kolodziejczak,fr FRA,DF,Saint-Étienne,fr Ligue 1,29,1991,28.5,43,24,22,14,7,20,36,55.6,16,29,7,22,60,103,72,1,Matches
1405,Ghislain Konan,ci CIV,DF,Reims,fr Ligue 1,25,1995,26.9,35,19,19,15,1,16,30,53.3,14,35,8,27,28,63,45,0,Matches
1406,Ibrahima Konaté,fr FRA,DF,Liverpool,eng Premier League,22,1999,11.0,16,10,9,6,1,7,10,70.0,3,13,9,4,16,32,37,1,Matches
1407,Geoffrey Kondogbia,cf CTA,"MF,DF",Atlético Madrid,es La Liga,28,1993,20.9,74,44,25,40,9,21,49,42.9,28,16,5,11,44,118,24,0,Matches
1408,Ibrahima Koné,ml MLI,FW,Lorient,fr Ligue 1,22,1999,8.1,7,4,0,3,4,2,3,66.7,1,8,3,5,1,8,3,0,Matches
1409,Manu Koné,fr FRA,MF,Gladbach,de Bundesliga,20,2001,24.3,60,37,29,28,3,25,42,59.5,17,27,4,23,34,94,12,0,Matches
1410,Youssouf Koné,ml MLI,DF,Troyes,fr Ligue 1,26,1995,10.9,30,18,21,8,1,19,30,63.3,11,8,3,5,10,40,25,0,Matches
1411,Ezri Konsa,eng ENG,DF,Aston Villa,eng Premier League,23,1997,27.5,25,15,13,11,1,10,13,76.9,3,31,22,9,15,40,86,2,Matches
1412,Teun Koopmeiners,nl NED,MF,Atalanta,it Serie A,23,1998,23.6,40,24,10,19,11,22,54,40.7,32,31,2,29,15,55,19,0,Matches
1413,Laurent Koscielny,fr FRA,DF,Bordeaux,fr Ligue 1,35,1985,10.4,14,9,10,3,1,8,13,61.5,5,17,12,5,12,26,39,0,Matches
1414,Odilon Kossonou,ci CIV,DF,Leverkusen,de Bundesliga,20,2001,19.9,23,17,16,6,1,15,25,60.0,10,36,14,22,26,49,66,0,Matches
1415,Filip Kostić,rs SRB,"DF,FW",Eint Frankfurt,de Bundesliga,28,1992,28.0,44,17,26,9,9,20,53,37.7,33,24,1,23,15,59,24,0,Matches
1416,Rominigue Kouamé,ml MLI,MF,Troyes,fr Ligue 1,24,1996,33.0,47,22,24,20,3,19,58,32.8,39,33,5,28,46,93,22,2,Matches
1417,Kalidou Koulibaly,sn SEN,DF,Napoli,it Serie A,30,1991,26.7,39,23,31,6,2,25,38,65.8,13,41,25,16,29,68,90,1,Matches
1418,Jules Koundé,fr FRA,DF,Sevilla,es La Liga,22,1998,30.4,40,17,27,10,3,18,28,64.3,10,33,18,15,21,61,101,2,Matches
1419,Christos Kourfalidis,gr GRE,"MF,FW",Cagliari,it Serie A,18,2002,0.2,0,0,0,0,0,0,1,0.0,1,1,0,1,0,0,0,0,Matches
1420,Boubakar Kouyaté,ml MLI,DF,Metz,fr Ligue 1,24,1997,29.6,84,50,56,28,0,48,77,62.3,29,63,33,30,79,163,217,3,Matches
1421,Cheikhou Kouyaté,sn SEN,MF,Crystal Palace,eng Premier League,31,1989,21.9,52,38,28,22,2,18,39,46.2,21,40,14,26,38,90,39,0,Matches
1422,Mateo Kovačić,hr CRO,MF,Chelsea,eng Premier League,27,1994,17.3,51,31,14,26,11,17,35,48.6,18,19,4,15,7,58,9,1,Matches
1423,Viktor Kovalenko,ua UKR,MF,Spezia,it Serie A,25,1996,14.7,16,10,7,8,1,9,21,42.9,12,16,3,13,13,29,8,0,Matches
1424,Emil Krafth,se SWE,DF,Newcastle Utd,eng Premier League,26,1994,18.2,37,16,25,11,1,27,36,75.0,9,16,10,6,25,62,56,0,Matches
1425,Alex Král,cz CZE,MF,West Ham,eng Premier League,23,1998,0.0,0,0,0,0,0,0,0,,0,0,0,0,0,0,0,0,Matches
1426,Andrej Kramarić,hr CRO,"FW,MF",Hoffenheim,de Bundesliga,30,1991,30.1,8,4,1,5,2,7,17,41.2,10,10,0,10,9,17,7,1,Matches
1427,Christoph Kramer,de GER,MF,Gladbach,de Bundesliga,30,1991,8.3,28,11,15,10,3,12,28,42.9,16,18,5,13,12,40,9,0,Matches
1428,Jean-Philippe Krasso,ci CIV,FW,Saint-Étienne,fr Ligue 1,24,1997,5.0,7,5,0,5,2,2,10,20.0,8,7,1,6,0,7,1,0,Matches
1429,Julian Kristoffersen,no NOR,FW,Salernitana,it Serie A,24,1997,0.1,0,0,0,0,0,0,0,,0,0,0,0,0,0,0,0,Matches
1430,Toni Kroos,de GER,MF,Real Madrid,es La Liga,31,1990,23.4,34,26,13,17,4,14,36,38.9,22,16,3,13,12,46,13,1,Matches
1431,Florian Krüger,de GER,"FW,MF",Arminia,de Bundesliga,22,1999,12.5,3,1,0,3,0,2,10,20.0,8,12,1,11,2,5,13,0,Matches
1432,Tim Krul,nl NED,GK,Norwich City,eng Premier League,33,1988,29.0,1,1,1,0,0,1,4,25.0,3,0,0,0,0,1,10,4,Matches
1433,Rade Krunić,ba BIH,"MF,FW",Milan,it Serie A,27,1993,15.7,33,18,16,14,3,15,31,48.4,16,19,2,17,16,49,17,0,Matches
1434,Max Kruse,de GER,"MF,FW",Wolfsburg,de Bundesliga,33,1988,12.5,9,3,4,4,1,5,12,41.7,7,2,0,2,3,12,4,0,Matches
1435,Max Kruse,de GER,"FW,MF",Union Berlin,de Bundesliga,33,1988,14.1,4,1,0,3,1,2,16,12.5,14,12,0,12,3,7,2,0,Matches
1436,Lukas Kübler,de GER,"DF,MF",Freiburg,de Bundesliga,28,1992,25.9,62,35,38,16,8,28,49,57.1,21,24,8,16,44,106,70,0,Matches
1437,Takefusa Kubo,jp JPN,"FW,MF",Mallorca,es La Liga,20,2001,17.8,31,19,12,14,5,10,24,41.7,14,24,3,21,8,39,4,0,Matches
1438,Juraj Kucka,sk SVK,MF,Watford,eng Premier League,34,1987,21.3,59,39,32,25,2,27,73,37.0,46,30,9,21,27,86,46,2,Matches
1439,Mykola Kukharevych,ua UKR,FW,Troyes,fr Ligue 1,20,2001,0.2,0,0,0,0,0,0,0,,0,0,0,0,0,0,0,0,Matches
1440,Dejan Kulusevski,se SWE,"MF,FW",Tottenham,eng Premier League,21,2000,14.0,19,13,7,10,2,5,23,21.7,18,14,0,14,13,32,3,0,Matches
1441,Dejan Kulusevski,se SWE,"FW,MF",Juventus,it Serie A,21,2000,8.6,15,12,9,6,0,8,21,38.1,13,14,0,14,5,20,5,0,Matches
1442,Marash Kumbulla,al ALB,DF,Roma,it Serie A,21,2000,11.4,21,13,13,7,1,8,15,53.3,7,17,8,9,16,37,26,0,Matches
1443,Fabian Kunze,de GER,MF,Arminia,de Bundesliga,23,1998,14.0,35,21,14,20,1,15,32,46.9,17,17,2,15,19,54,27,1,Matches
1444,Enock Kwateng,fr FRA,DF,Bordeaux,fr Ligue 1,24,1997,22.2,54,35,31,19,4,33,72,45.8,39,17,4,13,43,97,48,1,Matches
1445,Grejohn Kyei,fr FRA,FW,Clermont Foot,fr Ligue 1,25,1995,4.4,3,2,1,1,1,0,6,0.0,6,6,0,6,0,3,1,0,Matches
1446,Giorgos Kyriakopoulos,gr GRE,"DF,FW",Sassuolo,it Serie A,25,1996,21.9,30,14,19,7,4,19,38,50.0,19,32,9,23,11,41,52,0,Matches
1447,Andrea La Mantia,it ITA,"FW,MF",Empoli,it Serie A,30,1991,5.4,2,0,0,0,2,1,2,50.0,1,3,1,2,1,3,6,0,Matches
1448,Gaëtan Laborde,fr FRA,FW,Montpellier,fr Ligue 1,27,1994,3.8,2,2,1,1,0,2,4,50.0,2,3,0,3,5,7,5,0,Matches
1449,Gaëtan Laborde,fr FRA,FW,Rennes,fr Ligue 1,27,1994,30.3,19,7,5,8,6,3,22,13.6,19,29,3,26,8,27,16,0,Matches
1450,Alexandre Lacazette,fr FRA,FW,Arsenal,eng Premier League,30,1991,19.8,27,10,8,13,6,7,21,33.3,14,12,1,11,5,32,6,0,Matches
1451,Tom Lacoux,fr FRA,"DF,MF",Bordeaux,fr Ligue 1,19,2002,10.1,18,13,11,5,2,9,24,37.5,15,14,4,10,9,27,20,1,Matches
1452,Lenny Lacroix,fr FRA,DF,Metz,fr Ligue 1,18,2003,2.2,9,7,8,1,0,5,8,62.5,3,5,1,4,10,19,5,0,Matches
1453,Maxence Lacroix,fr FRA,DF,Wolfsburg,de Bundesliga,21,2000,27.7,59,33,41,16,2,29,40,72.5,11,35,16,19,60,119,144,0,Matches
1454,Alban Lafont,fr FRA,GK,Nantes,fr Ligue 1,22,1999,38.0,3,3,3,0,0,3,8,37.5,5,1,0,1,1,4,25,2,Matches
1455,Víctor Laguardia,es ESP,DF,Alavés,es La Liga,31,1989,33.8,29,16,21,8,0,19,30,63.3,11,36,24,12,27,56,151,1,Matches
1456,Konrad Laimer,at AUT,MF,RB Leipzig,de Bundesliga,24,1997,13.8,38,24,11,22,5,24,53,45.3,29,29,3,26,4,42,9,0,Matches
1457,Stefan Lainer,at AUT,DF,Gladbach,de Bundesliga,28,1992,16.3,19,11,9,7,3,12,28,42.9,16,24,5,19,14,33,31,0,Matches
1458,Diego Lainez,mx MEX,FW,Betis,es La Liga,21,2000,1.6,1,1,0,1,0,0,3,0.0,3,3,0,3,1,2,0,0,Matches
1459,Adam Lallana,eng ENG,MF,Brighton,eng Premier League,33,1988,17.3,34,17,14,14,6,12,41,29.3,29,16,6,10,16,50,13,1,Matches
1460,Vassilis Lambropoulos,gr GRE,DF,Bochum,de Bundesliga,31,1990,13.0,18,12,13,3,2,11,25,44.0,14,21,10,11,17,35,56,0,Matches
1461,Érik Lamela,ar ARG,"FW,MF",Sevilla,es La Liga,29,1992,11.3,31,18,12,14,5,10,29,34.5,19,11,0,11,5,36,3,0,Matches
1462,Mohamed Lamine Bayo,gn GUI,FW,Clermont Foot,fr Ligue 1,23,1998,26.8,12,5,4,3,5,3,24,12.5,21,7,1,6,7,19,14,0,Matches
1463,Didier Lamkel Zé,cm CMR,FW,Metz,fr Ligue 1,24,1996,6.7,3,1,1,0,2,1,3,33.3,2,3,1,2,1,4,7,0,Matches
1464,Sam Lammers,nl NED,"FW,MF",Atalanta,it Serie A,24,1997,0.4,1,0,0,0,1,0,0,,0,0,0,0,0,1,0,0,Matches
1465,Sam Lammers,nl NED,"FW,MF",Eint Frankfurt,de Bundesliga,24,1997,5.7,4,4,0,2,2,2,6,33.3,4,9,2,7,2,6,4,0,Matches
1466,Tariq Lamptey,gh GHA,"DF,FW",Brighton,eng Premier League,20,2000,17.3,36,25,14,17,5,15,25,60.0,10,13,3,10,21,57,23,0,Matches
1467,Manuel Lanzini,ar ARG,"MF,FW",West Ham,eng Premier League,28,1993,19.8,28,15,10,11,7,10,35,28.6,25,16,0,16,19,47,10,0,Matches
1468,Aymeric Laporte,es ESP,DF,Manchester City,eng Premier League,27,1994,31.4,33,15,22,10,1,14,20,70.0,6,15,10,5,20,53,64,2,Matches
1469,Julien Laporte,fr FRA,DF,Lorient,fr Ligue 1,27,1993,32.1,63,45,35,26,2,32,64,50.0,32,37,22,15,54,117,174,0,Matches
1470,Yasser Larouci,dz ALG,DF,Troyes,fr Ligue 1,20,2001,3.8,6,5,2,4,0,3,3,100.0,0,1,0,1,7,13,5,0,Matches
1471,Kevin Lasagna,it ITA,"MF,FW",Hellas Verona,it Serie A,28,1992,13.2,13,7,4,5,4,4,15,26.7,11,16,0,16,3,16,7,0,Matches
1472,Jamaal Lascelles,eng ENG,DF,Newcastle Utd,eng Premier League,27,1993,22.9,15,7,9,5,1,4,12,33.3,8,38,28,10,22,37,121,1,Matches
1473,Bryan Lasme,fr FRA,FW,Arminia,de Bundesliga,22,1998,9.7,6,6,1,2,3,0,3,0.0,3,7,0,7,1,7,9,0,Matches
1474,Paul Lasne,fr FRA,MF,Brest,fr Ligue 1,32,1989,9.4,26,12,6,16,4,8,18,44.4,10,11,2,9,24,50,10,0,Matches
1475,Juanmi Latasa,es ESP,FW,Real Madrid,es La Liga,20,2001,0.1,0,0,0,0,0,0,0,,0,0,0,0,0,0,0,0,Matches
1476,Toni Lato,es ESP,DF,Valencia,es La Liga,23,1997,6.6,17,12,12,3,2,9,16,56.3,7,6,0,6,8,25,14,0,Matches
1477,Armand Lauriente,fr FRA,"FW,MF",Lorient,fr Ligue 1,22,1998,27.5,33,18,9,16,8,11,30,36.7,19,27,2,25,15,48,3,0,Matches
1478,Darko Lazović,rs SRB,DF,Hellas Verona,it Serie A,30,1990,30.7,36,23,20,8,8,21,39,53.8,18,28,4,24,19,55,49,1,Matches
1479,Manuel Lazzari,it ITA,DF,Lazio,it Serie A,27,1993,18.5,28,14,13,15,0,16,26,61.5,10,10,2,8,12,40,16,1,Matches
1480,Théo Le Bris,fr FRA,MF,Lorient,fr Ligue 1,18,2002,0.7,2,1,1,1,0,1,2,50.0,1,2,0,2,0,2,1,0,Matches
1481,Jérémy Le Douaron,fr FRA,"FW,MF",Brest,fr Ligue 1,23,1998,16.1,11,5,4,4,3,1,17,5.9,16,15,0,15,4,15,14,0,Matches
1482,Enzo Le Fée,fr FRA,"MF,FW",Lorient,fr Ligue 1,21,2000,24.4,70,44,25,36,9,41,90,45.6,49,25,1,24,29,99,18,0,Matches
1483,Vincent Le Goff,fr FRA,DF,Lorient,fr Ligue 1,31,1989,34.0,61,38,38,19,4,37,62,59.7,25,18,3,15,37,98,50,0,Matches
1484,Maxime Le Marchand,fr FRA,DF,Strasbourg,fr Ligue 1,31,1989,9.6,17,8,16,1,0,8,10,80.0,2,9,5,4,14,31,32,0,Matches
1485,Robin Le Normand,es ESP,DF,Real Sociedad,es La Liga,24,1996,37.0,49,32,36,8,5,28,36,77.8,8,34,22,12,48,97,125,0,Matches
1486,Patrick Leal,us USA,FW,Venezia,it Serie A,18,2003,0.0,0,0,0,0,0,0,1,0.0,1,0,0,0,0,0,0,0,Matches
1487,Rafael Leão,pt POR,FW,Milan,it Serie A,22,1999,28.9,17,7,3,9,5,10,20,50.0,10,12,1,11,12,29,8,0,Matches
1488,Jean-Louis Leca,fr FRA,GK,Lens,fr Ligue 1,35,1985,25.7,0,0,0,0,0,0,0,,0,1,0,1,1,1,11,1,Matches
1489,Jeremías Ledesma,ar ARG,GK,Cádiz,es La Liga,28,1993,38.0,3,1,3,0,0,3,4,75.0,1,0,0,0,1,4,21,4,Matches
1490,Pierre Lees-Melou,fr FRA,MF,Norwich City,eng Premier League,28,1993,25.2,58,36,23,29,6,25,92,27.2,67,37,11,26,25,83,23,0,Matches
1491,Wu Lei,cn CHN,"FW,MF",Espanyol,es La Liga,29,1991,5.3,3,2,1,2,0,3,8,37.5,5,4,0,4,4,7,3,0,Matches
1492,Maxim Leitsch,de GER,DF,Bochum,de Bundesliga,23,1998,17.1,18,10,9,7,2,10,15,66.7,5,31,19,12,31,49,74,1,Matches
1493,Lucas Leiva,br BRA,MF,Lazio,it Serie A,34,1987,18.9,55,30,26,25,4,15,53,28.3,38,27,10,17,28,83,37,0,Matches
1494,Florian Lejeune,fr FRA,DF,Alavés,es La Liga,30,1991,30.0,33,24,22,10,1,12,20,60.0,8,30,19,11,31,64,158,0,Matches
1495,Iñigo Lekue,es ESP,DF,Athletic Club,es La Liga,28,1993,21.4,32,23,16,12,4,22,44,50.0,22,37,12,25,23,55,63,0,Matches
1496,Thomas Lemar,fr FRA,MF,Atlético Madrid,es La Liga,25,1995,16.0,24,14,9,12,3,8,23,34.8,15,18,0,18,8,32,11,0,Matches
1497,Félix Lemaréchal,fr FRA,MF,Monaco,fr Ligue 1,17,2003,0.1,0,0,0,0,0,0,1,0.0,1,0,0,0,0,0,0,0,Matches
1498,Mario Lemina,ga GAB,MF,Nice,fr Ligue 1,27,1993,21.9,62,35,25,33,4,28,38,73.7,10,32,9,23,48,110,37,0,Matches
1499,Fabien Lemoine,fr FRA,MF,Lorient,fr Ligue 1,34,1987,12.4,35,22,20,14,1,17,41,41.5,24,21,4,17,14,49,24,1,Matches
1500,Tim Lemperle,de GER,"FW,MF",Köln,de Bundesliga,19,2002,1.7,4,1,2,1,1,1,3,33.3,2,1,0,1,2,6,2,0,Matches
1501,Ruben Lendinez,es ESP,DF,Valencia,es La Liga,18,2003,1.5,3,3,1,2,0,3,8,37.5,5,4,0,4,2,5,6,0,Matches
1502,Clément Lenglet,fr FRA,DF,Barcelona,es La Liga,26,1995,9.2,20,11,11,7,2,8,13,61.5,5,7,3,4,13,33,21,0,Matches
1503,Aaron Lennon,eng ENG,"MF,FW",Burnley,eng Premier League,34,1987,17.2,33,17,10,13,10,10,34,29.4,24,26,4,22,9,42,14,0,Matches
1504,Bernd Leno,de GER,GK,Arsenal,eng Premier League,29,1992,4.0,1,1,1,0,0,1,1,100.0,0,0,0,0,0,1,1,0,Matches
1505,Christopher Lenz,de GER,DF,Eint Frankfurt,de Bundesliga,26,1994,7.4,29,15,22,6,1,12,21,57.1,9,9,4,5,7,36,21,0,Matches
1506,Léo Leroy,fr FRA,MF,Montpellier,fr Ligue 1,21,2000,7.0,31,21,17,11,3,12,34,35.3,22,20,4,16,8,39,8,0,Matches
1507,Alexandre Letellier,fr FRA,GK,Paris S-G,fr Ligue 1,30,1990,0.1,0,0,0,0,0,0,0,,0,0,0,0,0,0,0,0,Matches
1508,Robert Lewandowski,pl POL,FW,Bayern Munich,de Bundesliga,32,1988,32.7,10,3,0,6,4,5,17,29.4,12,17,2,15,6,16,8,0,Matches
1509,Jamie Leweling,de GER,"FW,MF",Greuther Fürth,de Bundesliga,20,2001,21.8,13,8,3,7,3,3,16,18.8,13,9,0,9,13,26,5,0,Matches
1510,Jamal Lewis,nir NIR,DF,Newcastle Utd,eng Premier League,23,1998,2.9,8,6,6,1,1,3,4,75.0,1,3,2,1,3,11,8,0,Matches
1511,Luca Lezzerini,it ITA,GK,Venezia,it Serie A,26,1995,5.5,0,0,0,0,0,0,0,,0,1,0,1,0,0,0,0,Matches
1512,Ben Lhassine Kone,ci CIV,MF,Torino,it Serie A,21,2000,0.9,3,3,1,2,0,1,2,50.0,1,0,0,0,1,4,1,0,Matches
1513,Yanis Lhery,fr FRA,"FW,MF",Saint-Étienne,fr Ligue 1,18,2003,0.8,0,0,0,0,0,0,0,,0,4,0,4,0,0,0,0,Matches
1514,Dimitri Liénard,fr FRA,"DF,MF",Strasbourg,fr Ligue 1,33,1988,22.7,71,43,40,21,10,46,77,59.7,31,12,0,12,21,92,28,0,Matches
1515,Philipp Lienhart,at AUT,DF,Freiburg,de Bundesliga,25,1996,31.9,24,13,17,6,1,13,24,54.2,11,33,23,10,50,74,158,1,Matches
1516,Matthijs de Ligt,nl NED,DF,Juventus,it Serie A,21,1999,29.7,34,19,21,13,0,15,18,83.3,3,31,21,10,26,60,103,0,Matches
1517,Isaac Lihadji,fr FRA,"MF,FW",Lille,fr Ligue 1,19,2002,2.6,3,3,1,1,1,1,5,20.0,4,1,0,1,2,5,0,0,Matches
1518,Anderson Lima,br BRA,MF,Lazio,it Serie A,21,1999,0.7,2,0,1,1,0,0,2,0.0,2,1,0,1,2,4,1,0,Matches
1519,Andreas Linde,se SWE,GK,Greuther Fürth,de Bundesliga,28,1993,12.0,0,0,0,0,0,0,0,,0,0,0,0,1,1,1,1,Matches
1520,Victor Lindelöf,se SWE,DF,Manchester Utd,eng Premier League,27,1994,26.2,16,11,9,7,0,9,14,64.3,5,26,17,9,25,41,96,0,Matches
1521,Jesper Lindstrøm,dk DEN,"MF,FW",Eint Frankfurt,de Bundesliga,21,2000,22.0,28,13,6,13,9,12,36,33.3,24,30,0,30,24,52,11,1,Matches
1522,Karol Linetty,pl POL,"MF,FW",Torino,it Serie A,26,1995,10.0,14,8,3,4,7,6,18,33.3,12,8,0,8,3,17,2,0,Matches
1523,Jesse Lingard,eng ENG,"FW,MF",Manchester Utd,eng Premier League,28,1992,4.1,9,7,4,3,2,2,6,33.3,4,4,0,4,0,9,1,0,Matches
1524,Pol Lirola,es ESP,"DF,FW",Marseille,fr Ligue 1,23,1997,19.7,28,16,15,9,4,13,28,46.4,15,15,0,15,13,41,22,0,Matches
1525,Valentino Livramento,eng ENG,DF,Southampton,eng Premier League,18,2002,24.5,54,28,30,18,6,27,45,60.0,18,23,9,14,47,101,50,1,Matches
1526,Dejan Ljubicic,at AUT,"MF,FW",Köln,de Bundesliga,23,1997,21.9,33,19,12,13,8,13,49,26.5,36,19,1,18,15,48,11,0,Matches
1527,Javier Llabrés,es ESP,"FW,MF",Mallorca,es La Liga,18,2002,1.5,2,1,0,1,1,1,2,50.0,1,1,0,1,0,2,0,0,Matches
1528,Diego Llorente,es ESP,DF,Leeds United,eng Premier League,27,1993,26.0,53,31,32,19,2,33,47,70.2,14,35,17,18,40,93,77,2,Matches
1529,Marcos Llorente,es ESP,"MF,DF",Atlético Madrid,es La Liga,26,1995,27.2,51,23,25,22,4,28,43,65.1,15,33,10,23,27,78,44,0,Matches
1530,Hugo Lloris,fr FRA,GK,Tottenham,eng Premier League,34,1986,38.0,1,1,1,0,0,1,2,50.0,1,0,0,0,1,2,24,3,Matches
1531,Giovani Lo Celso,ar ARG,"MF,FW",Tottenham,eng Premier League,25,1996,2.6,8,4,4,2,2,4,10,40.0,6,6,1,5,1,9,0,1,Matches
1532,Giovani Lo Celso,ar ARG,"FW,MF",Villarreal,es La Liga,25,1996,11.0,22,12,8,10,4,9,22,40.9,13,4,0,4,5,27,3,0,Matches
1533,Julen Lobete,es ESP,"FW,MF",Real Sociedad,es La Liga,20,2000,3.2,4,3,3,0,1,1,2,50.0,1,6,1,5,1,5,1,0,Matches
1534,Stanislav Lobotka,sk SVK,MF,Napoli,it Serie A,26,1994,18.7,39,24,16,20,3,14,36,38.9,22,9,1,8,12,51,13,1,Matches
1535,Jürgen Locadia,nl NED,"MF,FW",Brighton,eng Premier League,27,1993,0.3,0,0,0,0,0,0,0,,0,0,0,0,0,0,0,0,Matches
1536,Jürgen Locadia,nl NED,"FW,MF",Bochum,de Bundesliga,27,1993,4.9,4,2,1,0,3,1,1,100.0,0,1,0,1,1,5,2,0,Matches
1537,Manuel Locatelli,it ITA,MF,Juventus,it Serie A,23,1998,24.0,44,25,21,16,7,21,47,44.7,26,43,21,22,22,66,33,0,Matches
1538,Bradley Locko,fr FRA,"MF,DF",Reims,fr Ligue 1,19,2002,11.2,28,19,13,11,4,14,24,58.3,10,20,8,12,14,42,15,0,Matches
1539,Renan Lodi,br BRA,DF,Atlético Madrid,es La Liga,23,1998,13.1,31,18,14,13,4,11,27,40.7,16,22,4,18,13,44,19,1,Matches
1540,Ruben Loftus-Cheek,eng ENG,"MF,DF",Chelsea,eng Premier League,25,1996,15.5,29,10,16,11,2,10,19,52.6,9,15,6,9,11,40,17,0,Matches
1541,Kevin Long,ie IRL,DF,Burnley,eng Premier League,30,1990,4.6,3,2,1,2,0,1,2,50.0,1,4,1,3,1,4,20,0,Matches
1542,Shane Long,ie IRL,FW,Southampton,eng Premier League,34,1987,3.4,9,5,2,4,3,1,1,100.0,0,4,0,4,0,9,2,0,Matches
1543,Sean Longstaff,eng ENG,MF,Newcastle Utd,eng Premier League,23,1997,16.3,54,34,18,31,5,24,65,36.9,41,18,6,12,9,63,18,0,Matches
1544,Ademola Lookman,ng NGA,"FW,MF",Leicester City,eng Premier League,23,1997,16.1,32,14,10,13,9,10,28,35.7,18,19,1,18,10,42,4,0,Matches
1545,Anthony Lopes,pt POR,GK,Lyon,fr Ligue 1,30,1990,33.1,0,0,0,0,0,0,0,,0,0,0,0,3,3,12,3,Matches
1546,David López,es ESP,"MF,DF",Espanyol,es La Liga,31,1989,8.3,18,13,9,8,1,9,16,56.3,7,10,8,2,10,28,25,2,Matches
1547,Diego López,es ESP,GK,Espanyol,es La Liga,39,1981,35.3,0,0,0,0,0,0,2,0.0,2,0,0,0,1,1,21,1,Matches
1548,Javi López,es ESP,DF,Alavés,es La Liga,19,2002,5.1,8,6,6,2,0,4,6,66.7,2,7,1,6,4,12,15,0,Matches
1549,Maxime Lopez,fr FRA,MF,Sassuolo,it Serie A,23,1997,32.6,69,36,40,27,2,35,87,40.2,52,33,7,26,42,111,38,1,Matches
1550,Pau López,es ESP,GK,Marseille,fr Ligue 1,26,1994,29.0,0,0,0,0,0,0,1,0.0,1,0,0,0,0,0,12,1,Matches
1551,Unai López,es ESP,MF,Rayo Vallecano,es La Liga,25,1995,12.9,19,9,6,10,3,10,33,30.3,23,7,0,7,10,29,8,1,Matches
1552,Dion Lopy,sn SEN,MF,Reims,fr Ligue 1,19,2002,18.2,53,29,22,24,7,21,53,39.6,32,20,4,16,22,75,17,0,Matches
1553,Samuel Loric,fr FRA,DF,Lorient,fr Ligue 1,21,2000,3.0,7,5,2,3,2,5,8,62.5,3,2,0,2,5,12,9,0,Matches
1554,Anthony Losilla,fr FRA,MF,Bochum,de Bundesliga,35,1986,32.6,65,39,29,30,6,34,69,49.3,35,32,9,23,70,135,53,1,Matches
1555,Jonas Lössl,dk DEN,GK,Brentford,eng Premier League,32,1989,2.0,0,0,0,0,0,0,0,,0,0,0,0,0,0,1,0,Matches
1556,Marcel Lotka,pl POL,GK,Hertha BSC,de Bundesliga,20,2001,9.8,1,0,1,0,0,1,1,100.0,0,0,0,0,1,2,3,3,Matches
1557,Jordan Lotomba,ch SUI,DF,Nice,fr Ligue 1,22,1998,19.8,33,17,21,9,3,16,30,53.3,14,17,4,13,12,45,28,0,Matches
1558,Johaneko Louisjean,fr FRA,DF,Bordeaux,fr Ligue 1,17,2004,0.1,0,0,0,0,0,0,0,,0,0,0,0,0,0,0,0,Matches
1559,Mamadou Loum,sn SEN,MF,Alavés,es La Liga,24,1996,25.7,49,22,26,22,1,17,45,37.8,28,30,11,19,37,86,68,1,Matches
1560,Imran Louza,ma MAR,MF,Watford,eng Premier League,22,1999,15.7,41,21,18,20,3,16,38,42.1,22,28,6,22,42,83,20,1,Matches
1561,Matteo Lovato,it ITA,DF,Atalanta,it Serie A,21,2000,3.4,5,4,4,1,0,0,1,0.0,1,4,2,2,7,12,8,0,Matches
1562,Matteo Lovato,it ITA,DF,Cagliari,it Serie A,21,2000,13.8,23,15,13,10,0,8,20,40.0,12,21,10,11,28,51,43,0,Matches
1563,Eduard Löwen,de GER,MF,Bochum,de Bundesliga,24,1997,15.7,28,22,12,11,5,10,43,23.3,33,17,2,15,9,37,15,1,Matches
1564,Matthew Lowton,eng ENG,DF,Burnley,eng Premier League,32,1989,19.7,38,24,20,10,8,20,37,54.1,17,25,11,14,26,64,68,0,Matches
1565,Anthony Lozano,hn HON,"FW,MF",Cádiz,es La Liga,28,1993,18.6,8,4,2,3,3,5,18,27.8,13,16,2,14,2,10,7,0,Matches
1566,Hirving Lozano,mx MEX,FW,Napoli,it Serie A,26,1995,17.9,28,20,12,11,5,8,30,26.7,22,24,0,24,9,37,9,0,Matches
1567,Jean Lucas,br BRA,MF,Monaco,fr Ligue 1,23,1998,16.1,43,25,14,24,5,17,40,42.5,23,15,5,10,13,56,4,1,Matches
1568,Anderson Lucoqui,ao ANG,DF,Mainz 05,de Bundesliga,24,1997,8.3,22,10,11,6,5,11,22,50.0,11,15,3,12,11,33,10,0,Matches
1569,Florentino Luís,pt POR,MF,Getafe,es La Liga,21,1999,11.0,42,25,22,17,3,17,35,48.6,18,21,2,19,21,63,11,1,Matches
1570,José Luis Gayà,es ESP,DF,Valencia,es La Liga,26,1995,20.8,35,21,24,10,1,16,34,47.1,18,17,3,14,19,54,37,0,Matches
1571,José Luis Morales,es ESP,"FW,MF",Levante,es La Liga,34,1987,30.2,27,17,6,9,12,12,42,28.6,30,29,0,29,4,31,7,0,Matches
1572,José Luis Palomino,ar ARG,DF,Atalanta,it Serie A,31,1990,29.7,78,40,42,33,3,32,50,64.0,18,43,21,22,100,178,80,2,Matches
1573,Luismi,es ESP,"FW,MF",Sevilla,es La Liga,20,2001,0.1,0,0,0,0,0,0,0,,0,0,0,0,0,0,0,0,Matches
1574,Douglas Luiz,br BRA,MF,Aston Villa,eng Premier League,23,1998,30.2,59,39,30,24,5,21,72,29.2,51,30,7,23,34,93,28,1,Matches
1575,Romelu Lukaku,be BEL,FW,Chelsea,eng Premier League,28,1993,17.7,2,1,0,1,1,1,5,20.0,4,11,1,10,0,2,20,0,Matches
1576,Castello Lukeba,fr FRA,DF,Lyon,fr Ligue 1,18,2002,23.3,34,19,27,7,0,15,23,65.2,8,18,9,9,38,72,64,2,Matches
1577,Dodi Lukebakio,be BEL,FW,Hertha BSC,de Bundesliga,23,1997,2.0,2,1,2,0,0,1,3,33.3,2,2,0,2,2,4,0,0,Matches
1578,Dodi Lukebakio,be BEL,"FW,MF",Wolfsburg,de Bundesliga,23,1997,9.8,7,4,3,2,2,1,10,10.0,9,5,0,5,13,20,4,0,Matches
1579,Saša Lukić,rs SRB,MF,Torino,it Serie A,24,1996,33.1,51,34,17,27,7,19,43,44.2,24,34,6,28,24,75,41,0,Matches
1580,Levi Lumeka,eng ENG,"MF,FW",Troyes,fr Ligue 1,22,1998,0.7,0,0,0,0,0,0,2,0.0,2,0,0,0,0,0,2,0,Matches
1581,Andriy Lunin,ua UKR,GK,Real Madrid,es La Liga,22,1999,2.0,0,0,0,0,0,0,0,,0,0,0,0,0,0,2,0,Matches
1582,Andrey Lunyov,ru RUS,GK,Leverkusen,de Bundesliga,29,1991,1.0,0,0,0,0,0,0,0,,0,0,0,0,0,0,0,0,Matches
1583,Sebastiano Luperto,it ITA,DF,Empoli,it Serie A,24,1996,21.8,29,17,17,10,2,10,20,50.0,10,32,26,6,45,74,132,0,Matches
1584,Andreas Luthe,de GER,GK,Union Berlin,de Bundesliga,34,1987,27.0,0,0,0,0,0,0,1,0.0,1,0,0,0,0,0,11,4,Matches
1585,Lyanco,br BRA,DF,Southampton,eng Premier League,24,1997,10.1,18,15,11,7,0,10,18,55.6,8,18,13,5,13,31,50,1,Matches
1586,Charalambos Lykogiannis,gr GRE,"DF,FW",Cagliari,it Serie A,27,1993,20.2,19,12,16,1,2,11,20,55.0,9,18,8,10,31,50,73,0,Matches
1587,Yannis M'Bemba,ga GAB,"DF,FW",Nantes,fr Ligue 1,20,2001,0.1,0,0,0,0,0,0,0,,0,0,0,0,0,0,1,0,Matches
1588,Alexis Mac Allister,ar ARG,"MF,FW",Brighton,eng Premier League,22,1998,23.6,65,40,23,30,12,29,68,42.6,39,37,7,30,13,78,22,0,Matches
1589,Deiver Machado,co COL,"DF,MF",Lens,fr Ligue 1,27,1993,5.8,16,14,11,1,4,12,14,85.7,2,9,1,8,3,19,12,1,Matches
1590,Darwin Machís,ve VEN,"MF,FW",Granada,es La Liga,28,1993,15.3,23,13,11,8,4,9,23,39.1,14,10,0,10,15,38,17,0,Matches
1591,Yvann Macon,fr FRA,DF,Saint-Étienne,fr Ligue 1,22,1998,17.0,41,22,24,14,3,16,42,38.1,26,18,4,14,18,59,27,0,Matches
1592,James Maddison,eng ENG,"MF,FW",Leicester City,eng Premier League,24,1996,27.3,40,20,8,24,8,14,46,30.4,32,18,3,15,11,51,12,0,Matches
1593,Niki Mäenpää,fi FIN,GK,Venezia,it Serie A,36,1985,16.5,0,0,0,0,0,0,0,,0,0,0,0,0,0,8,2,Matches
1594,Pablo Maffeo,es ESP,DF,Mallorca,es La Liga,24,1997,32.7,84,47,48,28,8,38,69,55.1,31,30,13,17,46,130,74,0,Matches
1595,Louis Mafouta,cf CTA,FW,Metz,fr Ligue 1,27,1994,5.8,0,0,0,0,0,0,5,0.0,5,1,0,1,0,0,4,0,Matches
1596,Gabriel Magalhães,br BRA,DF,Arsenal,eng Premier League,23,1997,34.0,50,30,36,12,2,30,41,73.2,11,34,26,8,13,63,112,4,Matches
1597,Giulio Maggiore,it ITA,MF,Spezia,it Serie A,23,1998,31.3,58,32,20,32,6,31,77,40.3,46,30,5,25,29,87,33,0,Matches
1598,Matej Maglica,hr CRO,MF,Stuttgart,de Bundesliga,22,1998,0.1,0,0,0,0,0,0,1,0.0,1,0,0,0,0,0,0,0,Matches
1599,Francesco Magnanelli,it ITA,MF,Sassuolo,it Serie A,36,1984,3.0,5,4,4,1,0,1,9,11.1,8,3,1,2,1,6,3,0,Matches
1600,Giangiacomo Magnani,it ITA,DF,Hellas Verona,it Serie A,25,1995,5.9,10,7,5,5,0,8,16,50.0,8,5,3,2,10,20,46,0,Matches
1601,Giangiacomo Magnani,it ITA,DF,Sampdoria,it Serie A,25,1995,2.7,4,2,4,0,0,1,1,100.0,0,2,2,0,7,11,12,0,Matches
1602,Hugo Magnetti,fr FRA,MF,Brest,fr Ligue 1,23,1998,16.3,50,34,27,20,3,22,50,44.0,28,14,3,11,25,75,13,0,Matches
1603,Yohann Magnin,fr FRA,"MF,DF",Clermont Foot,fr Ligue 1,24,1997,19.1,53,31,22,26,5,24,42,57.1,18,17,7,10,20,73,36,0,Matches
1604,Harry Maguire,eng ENG,DF,Manchester Utd,eng Premier League,28,1993,27.9,34,21,22,8,4,19,31,61.3,12,36,29,7,32,66,101,3,Matches
1605,Riyad Mahrez,dz ALG,FW,Manchester City,eng Premier League,30,1991,16.6,11,3,5,4,2,5,19,26.3,14,15,1,14,6,17,6,0,Matches
1606,Arne Maier,de GER,MF,Augsburg,de Bundesliga,22,1999,20.7,20,13,6,10,4,8,26,30.8,18,18,1,17,15,35,13,0,Matches
1607,Habib Maïga,ci CIV,MF,Metz,fr Ligue 1,25,1996,14.1,47,28,29,13,5,24,48,50.0,24,20,7,13,14,61,18,0,Matches
1608,Mike Maignan,fr FRA,GK,Milan,it Serie A,26,1995,32.0,2,1,2,0,0,2,2,100.0,0,0,0,0,1,3,4,2,Matches
1609,Ainsley Maitland-Niles,eng ENG,MF,Arsenal,eng Premier League,23,1997,3.0,8,4,5,3,0,2,4,50.0,2,2,0,2,4,12,4,0,Matches
1610,Ainsley Maitland-Niles,eng ENG,DF,Roma,it Serie A,23,1997,5.4,8,6,5,0,3,5,14,35.7,9,7,0,7,6,14,7,0,Matches
1611,Josh Maja,ng NGA,FW,Bordeaux,fr Ligue 1,22,1998,0.1,0,0,0,0,0,0,0,,0,1,0,1,0,0,0,0,Matches
1612,Abdul Majeed Waris,gh GHA,"FW,MF",Strasbourg,fr Ligue 1,29,1991,3.6,5,3,2,3,0,5,10,50.0,5,2,0,2,0,5,1,0,Matches
1613,Lovro Majer,hr CRO,"MF,FW",Rennes,fr Ligue 1,23,1998,20.4,32,21,9,14,9,11,42,26.2,31,26,2,24,11,43,9,0,Matches
1614,Jean-Victor Makengo,fr FRA,MF,Udinese,it Serie A,23,1998,26.1,30,21,7,17,6,15,29,51.7,14,26,6,20,19,49,17,0,Matches
1615,Béni Makouana,cg CGO,"FW,MF",Montpellier,fr Ligue 1,18,2002,3.6,2,2,0,0,2,0,1,0.0,1,1,0,1,3,5,2,0,Matches
1616,Nemanja Maksimović,rs SRB,MF,Getafe,es La Liga,26,1995,32.6,56,32,24,26,6,18,49,36.7,31,42,13,29,71,127,41,0,Matches
1617,Nikola Maksimović,rs SRB,DF,Genoa,it Serie A,29,1991,12.4,14,6,10,4,0,7,9,77.8,2,17,11,6,12,26,61,1,Matches
1618,Kévin Malcuit,ma MAR,"DF,MF",Napoli,it Serie A,30,1991,3.2,4,2,4,0,0,2,2,100.0,0,3,0,3,8,12,6,0,Matches
1619,Daniel Maldini,it ITA,MF,Milan,it Serie A,19,2001,1.6,8,3,4,3,1,2,6,33.3,4,4,0,4,1,9,0,0,Matches
1620,Youssef Maleh,ma MAR,MF,Fiorentina,it Serie A,22,1998,11.3,27,16,8,13,6,12,25,48.0,13,14,1,13,6,33,2,0,Matches
1621,Donyell Malen,nl NED,FW,Dortmund,de Bundesliga,22,1999,18.7,13,10,4,5,4,7,13,53.8,6,10,0,10,10,23,11,0,Matches
1622,Ruslan Malinovskyi,ua UKR,"MF,FW",Atalanta,it Serie A,28,1993,17.7,18,10,3,10,5,5,19,26.3,14,27,3,24,5,23,1,0,Matches
1623,Hugo Mallo,es ESP,DF,Celta Vigo,es La Liga,30,1991,20.3,45,25,24,19,2,16,31,51.6,15,23,9,14,20,65,53,0,Matches
1624,Lennard Maloney,us USA,DF,Dortmund,de Bundesliga,21,1999,0.1,1,0,1,0,0,1,1,100.0,0,0,0,0,0,1,0,0,Matches
1625,Mickael Malsa,mq MTQ,MF,Levante,es La Liga,25,1995,12.7,37,17,16,18,3,15,42,35.7,27,20,8,12,18,55,15,0,Matches
1626,Giorgi Mamardashvili,ge GEO,GK,Valencia,es La Liga,20,2000,18.0,0,0,0,0,0,0,0,,0,0,0,0,0,0,6,1,Matches
1627,Rey Manaj,al ALB,FW,Spezia,it Serie A,24,1997,19.6,19,12,3,11,5,6,26,23.1,20,16,0,16,4,23,13,0,Matches
1628,Hianga Mananga Mbock,fr FRA,MF,Brest,fr Ligue 1,21,1999,8.9,18,12,8,7,3,9,21,42.9,12,5,2,3,5,23,6,0,Matches
1629,Vincent Manceau,fr FRA,DF,Angers,fr Ligue 1,32,1989,26.2,32,19,18,13,1,14,37,37.8,23,23,6,17,32,64,72,0,Matches
1630,Gianluca Mancini,it ITA,DF,Roma,it Serie A,25,1996,32.0,41,25,22,18,1,18,33,54.5,15,38,19,19,39,80,69,0,Matches
1631,Leonardo Mancuso,it ITA,FW,Empoli,it Serie A,29,1992,4.7,1,1,0,1,0,0,6,0.0,6,2,0,2,1,2,2,0,Matches
1632,Steve Mandanda,fr FRA,GK,Marseille,fr Ligue 1,36,1985,9.0,0,0,0,0,0,0,1,0.0,1,1,0,1,1,1,4,1,Matches
1633,Reinildo Mandava,mz MOZ,DF,Atlético Madrid,es La Liga,27,1994,14.4,45,25,30,14,1,22,30,73.3,8,18,9,9,21,66,38,0,Matches
1634,Reinildo Mandava,mz MOZ,DF,Lille,fr Ligue 1,27,1994,16.9,43,23,29,11,3,32,51,62.7,19,13,4,9,37,80,55,0,Matches
1635,Aïssa Mandi,dz ALG,DF,Villarreal,es La Liga,29,1991,15.3,11,5,2,8,1,3,6,50.0,3,17,14,3,13,24,49,3,Matches
1636,Rolando Mandragora,it ITA,MF,Torino,it Serie A,24,1997,14.7,21,10,3,16,2,12,21,57.1,9,18,4,14,10,31,13,0,Matches
1637,Anthony Mandrea,dz ALG,GK,Angers,fr Ligue 1,24,1996,10.0,0,0,0,0,0,0,0,,0,0,0,0,0,0,9,0,Matches
1638,Sadio Mané,sn SEN,FW,Liverpool,eng Premier League,29,1992,31.3,33,20,7,14,12,8,26,30.8,18,30,1,29,8,41,15,0,Matches
1639,Eliaquim Mangala,fr FRA,DF,Saint-Étienne,fr Ligue 1,30,1991,13.1,17,12,12,5,0,8,12,66.7,4,11,8,3,17,34,61,1,Matches
1640,Orel Mangala,be BEL,MF,Stuttgart,de Bundesliga,23,1998,20.6,17,10,5,7,5,11,22,50.0,11,11,4,7,12,29,19,1,Matches
1641,Thomas Mangani,fr FRA,MF,Angers,fr Ligue 1,34,1987,24.4,58,30,23,34,1,31,68,45.6,37,38,11,27,36,94,29,0,Matches
1642,Ricardo Mangas,pt POR,DF,Bordeaux,fr Ligue 1,23,1998,26.1,35,22,22,8,5,26,41,63.4,15,18,4,14,25,60,47,3,Matches
1643,Kostas Manolas,gr GRE,DF,Napoli,it Serie A,30,1991,3.5,2,2,1,1,0,2,3,66.7,1,2,1,1,4,6,10,1,Matches
1644,Javier Manquillo,es ESP,DF,Newcastle Utd,eng Premier League,27,1994,14.0,39,29,28,10,1,21,36,58.3,15,15,6,9,10,49,32,0,Matches
1645,Myziane Maolida,km COM,MF,Nice,fr Ligue 1,22,1999,0.4,1,0,0,1,0,0,0,,0,1,0,1,0,1,0,0,Matches
1646,Myziane Maolida,km COM,"FW,MF",Hertha BSC,de Bundesliga,22,1999,8.6,7,4,5,1,1,3,9,33.3,6,5,0,5,1,8,6,0,Matches
1647,Sekou Mara,fr FRA,"FW,MF",Bordeaux,fr Ligue 1,19,2002,10.1,8,4,1,1,6,1,8,12.5,7,7,0,7,2,10,6,0,Matches
1648,Nikola Maraš,rs SRB,DF,Rayo Vallecano,es La Liga,25,1995,11.6,13,9,12,1,0,9,15,60.0,6,17,13,4,15,28,51,0,Matches
1649,Fernando Marçal,br BRA,"MF,DF",Wolves,eng Premier League,32,1989,16.1,42,22,27,14,1,21,37,56.8,16,25,4,21,28,70,52,0,Matches
1650,Marcelo,br BRA,DF,Real Madrid,es La Liga,33,1988,5.8,8,4,2,3,3,5,10,50.0,5,7,2,5,1,9,11,0,Matches
1651,Marcelo,br BRA,DF,Bordeaux,fr Ligue 1,34,1987,10.0,9,5,7,2,0,4,6,66.7,2,4,3,1,13,22,46,1,Matches
1652,Marcelo,br BRA,DF,Lyon,fr Ligue 1,34,1987,2.0,4,3,0,4,0,4,6,66.7,2,3,2,1,4,8,10,0,Matches
1653,Solly March,eng ENG,"DF,FW",Brighton,eng Premier League,27,1994,19.4,30,17,11,9,10,7,22,31.8,15,22,3,19,17,47,25,0,Matches
1654,Riccardo Marchizza,it ITA,DF,Empoli,it Serie A,23,1998,15.0,21,15,11,8,2,11,16,68.8,5,15,6,9,10,31,24,0,Matches
1655,Gian Marco Ferrari,it ITA,DF,Sassuolo,it Serie A,29,1992,34.7,16,11,10,6,0,10,23,43.5,13,37,27,10,43,59,114,2,Matches
1656,Iván Marcone,ar ARG,MF,Elche,es La Liga,31,1990,9.0,24,14,17,6,1,12,24,50.0,12,8,3,5,12,36,13,0,Matches
1657,Óscar de Marcos,es ESP,DF,Athletic Club,es La Liga,32,1989,18.7,50,37,24,19,7,28,43,65.1,15,20,3,17,19,69,27,0,Matches
1658,Davide Marfella,it ITA,GK,Napoli,it Serie A,21,1999,0.1,0,0,0,0,0,0,0,,0,0,0,0,0,0,0,0,Matches
1659,José Mari,es ESP,MF,Cádiz,es La Liga,33,1987,4.3,14,7,3,10,1,7,8,87.5,1,4,1,3,7,21,2,0,Matches
1660,Pablo Marí,es ESP,DF,Arsenal,eng Premier League,27,1993,2.0,5,3,1,3,1,3,6,50.0,3,5,4,1,3,8,10,0,Matches
1661,Pablo Marí,es ESP,DF,Udinese,it Serie A,27,1993,14.9,16,8,8,6,2,8,16,50.0,8,18,12,6,21,37,72,0,Matches
1662,José María Giménez,uy URU,DF,Atlético Madrid,es La Liga,26,1995,22.7,18,12,12,6,0,8,16,50.0,8,25,19,6,25,43,96,1,Matches
1663,Mariano,do DOM,FW,Real Madrid,es La Liga,27,1993,3.8,2,0,2,0,0,0,0,,0,2,0,2,1,3,3,0,Matches
1664,Răzvan Marin,ro ROU,MF,Cagliari,it Serie A,25,1996,31.3,42,21,16,22,4,24,54,44.4,30,23,5,18,10,52,17,1,Matches
1665,Guillermo Maripán,cl CHI,DF,Monaco,fr Ligue 1,27,1994,20.4,36,24,27,9,0,20,40,50.0,20,21,14,7,25,61,66,1,Matches
1666,Mika Màrmol,es ESP,DF,Barcelona,es La Liga,19,2002,0.0,0,0,0,0,0,0,0,,0,0,0,0,0,0,0,0,Matches
1667,Omar Marmoush,eg EGY,FW,Wolfsburg,de Bundesliga,22,1999,0.3,0,0,0,0,0,0,0,,0,0,0,0,0,0,0,0,Matches
1668,Omar Marmoush,eg EGY,FW,Stuttgart,de Bundesliga,22,1999,17.5,26,17,6,14,6,4,20,20.0,16,9,1,8,7,33,6,0,Matches
1669,Marquinhos,br BRA,DF,Paris S-G,fr Ligue 1,27,1994,31.8,37,14,25,11,1,20,35,57.1,15,35,19,16,16,53,102,0,Matches
1670,Roger Martí,es ESP,FW,Levante,es La Liga,30,1991,23.5,23,14,3,13,7,8,30,26.7,22,14,0,14,2,25,8,0,Matches
1671,Anthony Martial,fr FRA,FW,Manchester Utd,eng Premier League,25,1995,2.4,0,0,0,0,0,0,1,0.0,1,1,0,1,0,0,1,0,Matches
1672,Anthony Martial,fr FRA,"FW,MF",Sevilla,es La Liga,25,1995,5.4,2,1,0,0,2,2,6,33.3,4,4,0,4,0,2,3,0,Matches
1673,Martín,es ESP,MF,Cádiz,es La Liga,22,1999,1.3,2,2,0,2,0,0,0,,0,1,0,1,1,3,3,0,Matches
1674,Aarón Martín,es ESP,DF,Mainz 05,de Bundesliga,24,1997,25.5,54,33,32,18,4,24,55,43.6,31,24,4,20,20,74,35,0,Matches
1675,Ander Martin,es ESP,"FW,MF",Real Sociedad,es La Liga,20,2000,1.0,1,0,0,1,0,1,1,100.0,0,0,0,0,3,4,1,0,Matches
1676,Andrés Martín,es ESP,"FW,MF",Rayo Vallecano,es La Liga,22,1999,2.1,0,0,0,0,0,0,1,0.0,1,1,0,1,0,0,0,0,Matches
1677,Carlos Martín,es ESP,DF,Atlético Madrid,es La Liga,19,2002,0.1,0,0,0,0,0,0,0,,0,0,0,0,0,0,1,0,Matches
1678,Iván Martín,es ESP,"MF,FW",Alavés,es La Liga,22,1999,1.8,1,1,1,0,0,0,1,0.0,1,2,0,2,1,2,1,0,Matches
1679,Jonas Martin,fr FRA,MF,Rennes,fr Ligue 1,31,1990,23.4,35,20,12,21,2,19,53,35.8,34,17,3,14,22,57,28,1,Matches
1680,Gabriel Martinelli,br BRA,"FW,MF",Arsenal,eng Premier League,20,2001,20.7,27,19,7,14,6,10,29,34.5,19,26,1,25,20,47,15,0,Matches
1681,Emiliano Martínez,ar ARG,GK,Aston Villa,eng Premier League,28,1992,36.0,1,1,1,0,0,1,3,33.3,2,0,0,0,0,1,6,1,Matches
1682,Iñigo Martínez,es ESP,DF,Athletic Club,es La Liga,30,1991,26.0,28,13,18,7,3,14,23,60.9,9,22,10,12,39,67,143,0,Matches
1683,Javi Martínez,es ESP,"MF,FW",Osasuna,es La Liga,21,1999,9.8,21,14,8,11,2,10,29,34.5,19,6,0,6,9,30,10,0,Matches
1684,Josep Martinez,es ESP,GK,RB Leipzig,de Bundesliga,23,1998,1.0,0,0,0,0,0,0,0,,0,0,0,0,0,0,0,0,Matches
1685,Lautaro Martínez,ar ARG,FW,Inter,it Serie A,23,1997,25.4,20,10,3,10,7,6,11,54.5,5,21,1,20,18,38,6,0,Matches
1686,Pablo Martínez,es ESP,MF,Levante,es La Liga,23,1998,7.3,15,8,7,8,0,4,13,30.8,9,6,3,3,15,30,5,0,Matches
1687,Lucas Martínez Quarta,ar ARG,DF,Fiorentina,it Serie A,25,1996,15.9,36,25,23,11,2,21,34,61.8,13,22,9,13,19,55,46,0,Matches
1688,Gelson Martins,pt POR,"MF,FW",Monaco,fr Ligue 1,26,1995,21.2,42,27,10,26,6,21,59,35.6,38,26,1,25,17,59,4,0,Matches
1689,Adam Marušić,me MNE,DF,Lazio,it Serie A,28,1992,30.2,30,18,16,12,2,13,32,40.6,19,19,8,11,41,71,71,0,Matches
1690,Omar Mascarell,gq EQG,MF,Elche,es La Liga,28,1993,27.7,46,26,16,23,7,24,60,40.0,36,42,14,28,48,94,52,2,Matches
1691,Andrea Masiello,it ITA,DF,Genoa,it Serie A,35,1986,5.7,5,3,4,1,0,4,7,57.1,3,8,4,4,11,16,20,1,Matches
1692,Adam Masina,ma MAR,DF,Watford,eng Premier League,27,1994,12.0,24,13,11,10,3,12,29,41.4,17,18,6,12,18,42,45,0,Matches
1693,Erhan Mašović,rs SRB,DF,Bochum,de Bundesliga,22,1998,17.2,35,20,21,13,1,21,33,63.6,12,28,19,9,34,69,64,1,Matches
1694,Roberto Massimo,de GER,"DF,FW",Stuttgart,de Bundesliga,20,2000,9.7,14,5,6,7,1,4,16,25.0,12,9,0,9,3,17,6,0,Matches
1695,Arthur Masuaku,cd COD,"DF,FW",West Ham,eng Premier League,27,1993,7.2,31,23,19,11,1,14,23,60.9,9,9,1,8,9,40,17,0,Matches
1696,Jaime Mata,es ESP,FW,Getafe,es La Liga,32,1988,7.5,7,5,3,1,3,1,9,11.1,8,4,1,3,1,8,5,0,Matches
1697,Juan Mata,es ESP,MF,Manchester Utd,eng Premier League,33,1988,2.6,6,4,2,3,1,3,5,60.0,2,1,0,1,1,7,1,0,Matches
1698,Pape Matar Sarr,sn SEN,MF,Metz,fr Ligue 1,18,2002,23.7,45,26,21,23,1,18,39,46.2,21,33,3,30,29,74,22,0,Matches
1699,Eliot Matazo,be BEL,MF,Monaco,fr Ligue 1,19,2002,8.8,8,7,4,4,0,2,11,18.2,9,11,3,8,13,21,9,0,Matches
1700,Aleš Matějů,cz CZE,DF,Venezia,it Serie A,25,1996,8.1,16,12,10,5,1,13,29,44.8,16,10,6,4,9,25,15,0,Matches
1701,Jean-Philippe Mateta,fr FRA,FW,Crystal Palace,eng Premier League,24,1997,12.7,8,4,2,5,1,3,18,16.7,15,11,3,8,4,12,13,0,Matches
1702,Nemanja Matić,rs SRB,MF,Manchester Utd,eng Premier League,32,1988,15.4,31,18,19,11,1,15,31,48.4,16,21,6,15,31,62,21,3,Matches
1703,Joël Matip,cm CMR,DF,Liverpool,eng Premier League,29,1991,31.0,47,34,23,19,5,20,31,64.5,11,26,14,12,44,91,93,1,Matches
1704,Chrislain Matsima,fr FRA,DF,Monaco,fr Ligue 1,19,2002,1.5,3,2,1,2,0,2,7,28.6,5,3,3,0,1,4,6,1,Matches
1705,Azor Matusiwa,nl NED,MF,Reims,fr Ligue 1,23,1998,27.4,58,32,28,26,4,26,55,47.3,29,49,19,30,62,120,43,0,Matches
1706,Neal Maupay,fr FRA,FW,Brighton,eng Premier League,24,1996,25.3,17,10,2,6,9,4,18,22.2,14,21,2,19,2,19,2,0,Matches
1707,Stephy Mavididi,eng ENG,"FW,MF",Montpellier,fr Ligue 1,23,1998,25.5,24,13,11,7,6,14,39,35.9,25,23,2,21,8,32,11,0,Matches
1708,Konstantinos Mavropanos,gr GRE,DF,Stuttgart,de Bundesliga,23,1997,30.1,57,39,35,21,1,30,51,58.8,21,46,23,23,69,126,174,2,Matches
1709,Eric Maxim Choupo-Moting,cm CMR,"FW,MF",Bayern Munich,de Bundesliga,32,1989,4.2,10,9,3,6,1,3,10,30.0,7,1,0,1,5,15,2,0,Matches
1710,Luís Maximiano,pt POR,GK,Granada,es La Liga,22,1999,34.8,3,1,3,0,0,3,6,50.0,3,0,0,0,1,4,16,2,Matches
1711,Borja Mayoral,es ESP,"FW,DF",Roma,it Serie A,24,1997,1.1,0,0,0,0,0,0,0,,0,0,0,0,0,0,0,0,Matches
1712,Borja Mayoral,es ESP,FW,Getafe,es La Liga,24,1997,11.6,7,5,2,3,2,1,2,50.0,1,10,4,6,4,11,3,0,Matches
1713,Derek Mazou-Sacko,fr FRA,"FW,DF",Troyes,fr Ligue 1,16,2004,0.0,1,0,0,0,1,1,1,100.0,0,0,0,0,0,1,1,0,Matches
1714,Pasquale Mazzocchi,it ITA,DF,Venezia,it Serie A,26,1995,13.8,18,8,11,4,3,10,26,38.5,16,11,8,3,21,39,31,1,Matches
1715,Pasquale Mazzocchi,it ITA,DF,Salernitana,it Serie A,26,1995,14.1,28,19,15,11,2,14,34,41.2,20,5,0,5,11,39,31,0,Matches
1716,Kevin Mbabu,ch SUI,DF,Wolfsburg,de Bundesliga,26,1995,15.5,31,20,21,5,5,12,23,52.2,11,25,8,17,35,66,35,0,Matches
1717,Kylian Mbappé,fr FRA,FW,Paris S-G,fr Ligue 1,22,1998,33.6,11,8,1,4,6,7,13,53.8,6,6,0,6,5,16,13,0,Matches
1718,Ibrahima Mbaye,sn SEN,DF,Bologna,it Serie A,26,1994,1.2,1,1,1,0,0,1,2,50.0,1,1,1,0,1,2,6,0,Matches
1719,Amadou Mbengue,sn SEN,"DF,MF",Metz,fr Ligue 1,19,2002,6.8,19,10,10,9,0,11,22,50.0,11,7,2,5,10,29,19,0,Matches
1720,Bryan Mbeumo,cm CMR,FW,Brentford,eng Premier League,21,1999,32.3,28,16,1,12,15,6,20,30.0,14,21,6,15,11,39,20,0,Matches
1721,Jason Mbock,fr FRA,FW,Angers,fr Ligue 1,21,1999,0.2,0,0,0,0,0,0,0,,0,0,0,0,0,0,0,0,Matches
1722,Jordi Mboula,es ESP,FW,Mallorca,es La Liga,22,1999,4.8,8,2,3,3,2,5,9,55.6,4,7,1,6,3,11,3,0,Matches
1723,Moustapha Mbow,sn SEN,DF,Reims,fr Ligue 1,21,2000,1.0,6,6,3,2,1,3,3,100.0,0,0,0,0,1,7,6,0,Matches
1724,Nathanael Mbuku,fr FRA,"FW,MF",Reims,fr Ligue 1,19,2002,15.8,14,13,4,7,3,2,8,25.0,6,14,0,14,11,25,4,0,Matches
1725,James McArthur,sct SCO,MF,Crystal Palace,eng Premier League,33,1987,16.0,33,23,13,19,1,16,44,36.4,28,23,9,14,30,63,27,0,Matches
1726,James Mcatee,eng ENG,"MF,FW",Manchester City,eng Premier League,18,2002,0.2,0,0,0,0,0,0,2,0.0,2,0,0,0,0,0,0,0,Matches
1727,Kasey McAteer,eng ENG,FW,Leicester City,eng Premier League,19,2001,0.0,0,0,0,0,0,0,0,,0,0,0,0,0,0,0,0,Matches
1728,Liam McCarron,sct SCO,FW,Leeds United,eng Premier League,20,2001,0.1,0,0,0,0,0,0,0,,0,1,0,1,0,0,0,0,Matches
1729,Alex McCarthy,eng ENG,GK,Southampton,eng Premier League,31,1989,17.0,0,0,0,0,0,0,0,,0,0,0,0,0,0,4,0,Matches
1730,John McGinn,sct SCO,MF,Aston Villa,eng Premier League,26,1994,34.3,106,64,35,55,16,54,104,51.9,50,53,6,47,35,141,34,0,Matches
1731,Weston McKennie,us USA,MF,Juventus,it Serie A,22,1998,15.2,20,11,11,7,2,8,26,30.8,18,17,8,9,23,43,20,0,Matches
1732,Stuart McKinstry,sct SCO,MF,Leeds United,eng Premier League,18,2002,0.0,0,0,0,0,0,0,0,,0,0,0,0,0,0,0,0,Matches
1733,Kenny McLean,sct SCO,MF,Norwich City,eng Premier League,29,1992,30.1,42,22,18,20,4,17,59,28.8,42,29,7,22,34,76,54,0,Matches
1734,Dwight McNeil,eng ENG,MF,Burnley,eng Premier League,21,1999,34.5,78,49,27,38,13,33,73,45.2,40,64,11,53,35,113,31,1,Matches
1735,Scott McTominay,sct SCO,MF,Manchester Utd,eng Premier League,24,1996,26.5,65,33,32,24,9,30,61,49.2,31,45,10,35,31,96,60,1,Matches
1736,Gary Medel,cl CHI,DF,Bologna,it Serie A,33,1987,31.4,39,23,27,11,1,16,36,44.4,20,30,21,9,44,83,112,0,Matches
1737,Facundo Medina,ar ARG,DF,Lens,fr Ligue 1,22,1999,28.8,61,42,34,23,4,38,62,61.3,24,24,8,16,37,98,78,3,Matches
1738,Nathan de Medina,be BEL,DF,Arminia,de Bundesliga,23,1997,8.6,17,10,11,6,0,6,10,60.0,4,14,3,11,10,27,28,0,Matches
1739,Ben Mee,eng ENG,DF,Burnley,eng Premier League,31,1989,20.4,26,12,16,7,3,12,19,63.2,7,28,22,6,24,50,94,1,Matches
1740,Admir Mehmedi,ch SUI,DF,Wolfsburg,de Bundesliga,30,1991,0.0,0,0,0,0,0,0,0,,0,0,0,0,0,0,0,0,Matches
1741,Hannibal Mejbri,tn TUN,FW,Manchester Utd,eng Premier League,18,2003,0.8,2,1,1,1,0,1,1,100.0,0,0,0,0,0,2,0,0,Matches
1742,Farid El Melali,dz ALG,FW,Angers,fr Ligue 1,24,1997,0.2,0,0,0,0,0,0,1,0.0,1,1,0,1,0,0,1,0,Matches
1743,Filippo Melegoni,it ITA,"MF,FW",Genoa,it Serie A,22,1999,10.9,20,12,5,8,7,8,16,50.0,8,10,1,9,11,31,8,1,Matches
1744,Óscar Melendo,es ESP,"MF,FW",Espanyol,es La Liga,23,1997,11.0,11,5,4,4,3,3,13,23.1,10,4,1,3,1,12,10,0,Matches
1745,Gonzalo Melero,es ESP,MF,Levante,es La Liga,27,1994,18.8,29,16,10,15,4,16,36,44.4,20,21,8,13,7,36,22,0,Matches
1746,Birger Meling,no NOR,DF,Rennes,fr Ligue 1,26,1994,20.3,43,27,25,11,7,23,31,74.2,8,23,7,16,22,65,40,0,Matches
1747,Arthur Melo,br BRA,MF,Juventus,it Serie A,24,1996,10.7,25,12,10,14,1,13,24,54.2,11,11,2,9,7,32,8,1,Matches
1748,Memphis,nl NED,FW,Barcelona,es La Liga,27,1994,20.6,10,4,2,4,4,3,13,23.1,10,9,1,8,3,13,4,0,Matches
1749,Houboulang Mendes,gw GNB,DF,Lorient,fr Ligue 1,23,1998,35.8,58,28,37,18,3,40,57,70.2,17,41,21,20,41,99,128,4,Matches
1750,Nuno Mendes,pt POR,DF,Paris S-G,fr Ligue 1,19,2002,18.4,48,29,23,18,7,25,47,53.2,22,27,5,22,21,69,17,1,Matches
1751,Pedro Mendes,pt POR,DF,Montpellier,fr Ligue 1,30,1990,0.2,1,1,1,0,0,0,0,,0,1,1,0,0,1,2,0,Matches
1752,Thiago Mendes,br BRA,"MF,DF",Lyon,fr Ligue 1,29,1992,20.7,36,22,18,16,2,12,30,40.0,18,24,5,19,34,70,56,1,Matches
1753,Tomás Mendes,es ESP,MF,Alavés,es La Liga,16,2004,0.1,0,0,0,0,0,0,0,,0,0,0,0,0,0,1,0,Matches
1754,Brais Méndez,es ESP,MF,Celta Vigo,es La Liga,24,1997,33.6,68,35,24,35,9,26,87,29.9,61,52,6,46,37,105,30,0,Matches
1755,Édgar Méndez,es ESP,"FW,MF",Alavés,es La Liga,31,1990,17.9,25,14,11,10,4,11,34,32.4,23,16,0,16,4,29,17,0,Matches
1756,Arial Mendy,sn SEN,"DF,FW",Clermont Foot,fr Ligue 1,26,1994,8.8,6,4,4,2,0,2,11,18.2,9,6,1,5,7,13,17,0,Matches
1757,Batista Mendy,fr FRA,"MF,DF",Angers,fr Ligue 1,21,2000,26.8,49,28,21,22,6,23,45,51.1,22,37,6,31,34,83,40,0,Matches
1758,Benjamin Mendy,fr FRA,DF,Manchester City,eng Premier League,27,1994,0.9,2,2,1,1,0,2,6,33.3,4,0,0,0,0,2,0,0,Matches
1759,Edouard Mendy,sn SEN,GK,Chelsea,eng Premier League,29,1992,34.0,1,0,1,0,0,1,3,33.3,2,0,0,0,0,1,13,4,Matches
1760,Ferland Mendy,fr FRA,DF,Real Madrid,es La Liga,26,1995,19.3,24,14,11,10,3,8,14,57.1,6,8,2,6,18,42,27,3,Matches
1761,Nampalys Mendy,sn SEN,MF,Leicester City,eng Premier League,29,1992,11.5,12,6,8,4,0,6,17,35.3,11,7,4,3,11,23,11,1,Matches
1762,Gideon Mensah,gh GHA,DF,Bordeaux,fr Ligue 1,23,1998,13.4,37,24,19,12,6,18,38,47.4,20,11,2,9,16,53,21,0,Matches
1763,Jorge Meré,es ESP,DF,Köln,de Bundesliga,24,1997,5.4,9,6,3,6,0,4,7,57.1,3,6,4,2,10,19,19,0,Matches
1764,Alex Meret,it ITA,GK,Napoli,it Serie A,24,1997,6.9,0,0,0,0,0,0,0,,0,0,0,0,0,0,3,1,Matches
1765,Fran Mérida,es ESP,MF,Espanyol,es La Liga,31,1990,3.0,7,3,5,2,0,4,10,40.0,6,1,0,1,6,13,1,0,Matches
1766,Mikel Merino,es ESP,MF,Real Sociedad,es La Liga,25,1996,32.1,71,38,21,40,10,26,67,38.8,41,50,10,40,21,92,56,2,Matches
1767,Quentin Merlin,fr FRA,"DF,MF",Nantes,fr Ligue 1,19,2002,21.4,45,28,19,20,6,26,49,53.1,23,25,4,21,27,72,29,2,Matches
1768,Martín Merquelanz,es ESP,"FW,MF",Rayo Vallecano,es La Liga,26,1995,1.9,2,1,2,0,0,2,6,33.3,4,2,0,2,0,2,1,0,Matches
1769,Yıldırım Mert Çetin,tr TUR,MF,Hellas Verona,it Serie A,24,1997,0.5,1,0,1,0,0,1,1,100.0,0,0,0,0,0,1,2,0,Matches
1770,Dries Mertens,be BEL,"FW,MF",Napoli,it Serie A,34,1987,15.4,16,7,1,11,4,3,16,18.8,13,8,2,6,9,25,2,0,Matches
1771,Illan Meslier,fr FRA,GK,Leeds United,eng Premier League,21,2000,37.6,1,1,1,0,0,1,1,100.0,0,0,0,0,0,1,27,1,Matches
1772,Lionel Messi,ar ARG,"FW,MF",Paris S-G,fr Ligue 1,34,1987,23.9,10,3,1,5,4,3,13,23.1,10,5,0,5,4,14,0,0,Matches
1773,Junior Messias,br BRA,"FW,MF",Milan,it Serie A,30,1991,15.9,34,18,11,14,9,15,34,44.1,19,11,1,10,17,51,17,0,Matches
1774,Thomas Meunier,be BEL,DF,Dortmund,de Bundesliga,29,1991,15.6,29,19,13,12,4,16,33,48.5,17,10,2,8,12,41,25,1,Matches
1775,Mexer,mz MOZ,DF,Bordeaux,fr Ligue 1,32,1988,13.6,14,10,11,3,0,11,17,64.7,6,12,7,5,21,35,60,2,Matches
1776,Marco Meyerhöfer,de GER,DF,Greuther Fürth,de Bundesliga,25,1995,25.3,53,35,22,22,9,24,37,64.9,13,38,19,19,47,100,64,1,Matches
1777,Matt Miazga,us USA,DF,Alavés,es La Liga,26,1995,9.3,7,7,3,4,0,2,7,28.6,5,14,12,2,11,18,55,1,Matches
1778,Kingsley Michael,ng NGA,MF,Bologna,it Serie A,21,1999,0.8,4,1,2,2,0,1,2,50.0,1,2,1,1,1,5,1,1,Matches
1779,Sven Michel,de GER,FW,Union Berlin,de Bundesliga,31,1990,3.8,10,6,5,3,2,2,8,25.0,6,3,0,3,1,11,1,0,Matches
1780,Edouard Michut,fr FRA,MF,Paris S-G,fr Ligue 1,18,2003,0.8,0,0,0,0,0,0,2,0.0,2,2,0,2,1,1,2,0,Matches
1781,Miguel,es ESP,"FW,MF",Alavés,es La Liga,21,1999,9.2,7,3,1,5,1,2,15,13.3,13,6,0,6,1,8,7,0,Matches
1782,Valentin Mihaila,ro ROU,"MF,FW",Atalanta,it Serie A,21,2000,0.8,1,1,0,1,0,0,1,0.0,1,2,0,2,0,1,0,0,Matches
1783,Mikael,br BRA,"FW,MF",Salernitana,it Serie A,22,1999,1.0,1,1,0,1,0,0,0,,0,0,0,0,0,1,1,0,Matches
1784,Hilmir Mikaelsson,is ISL,FW,Venezia,it Serie A,17,2004,0.2,2,0,0,1,1,0,0,,0,0,0,0,0,2,0,0,Matches
1785,Georges Mikautadze,ge GEO,FW,Metz,fr Ligue 1,20,2000,0.0,0,0,0,0,0,0,0,,0,0,0,0,0,0,0,0,Matches
1786,William Mikelbrencis,fr FRA,DF,Metz,fr Ligue 1,17,2004,6.8,11,5,6,4,1,6,9,66.7,3,6,3,3,5,16,9,0,Matches
1787,Nikola Milenković,rs SRB,DF,Fiorentina,it Serie A,23,1997,32.5,54,32,31,20,3,29,34,85.3,5,30,15,15,39,93,94,0,Matches
1788,Arkadiusz Milik,pl POL,FW,Marseille,fr Ligue 1,27,1994,15.7,9,2,0,5,4,4,18,22.2,14,9,1,8,3,12,10,1,Matches
1789,Sergej Milinković-Savić,rs SRB,MF,Lazio,it Serie A,26,1995,34.4,67,44,20,32,15,29,67,43.3,38,50,9,41,34,101,43,1,Matches
1790,Vanja Milinković-Savić,rs SRB,GK,Torino,it Serie A,24,1997,27.0,0,0,0,0,0,0,1,0.0,1,0,0,0,0,0,7,2,Matches
1791,Éder Militão,br BRA,DF,Real Madrid,es La Liga,23,1998,33.7,50,32,30,12,8,20,39,51.3,19,42,20,22,52,102,107,3,Matches
1792,Luka Milivojević,rs SRB,MF,Crystal Palace,eng Premier League,30,1991,8.6,18,9,9,6,3,10,16,62.5,6,6,1,5,11,29,15,0,Matches
1793,Luis Milla,es ESP,MF,Granada,es La Liga,26,1994,30.8,59,29,25,30,4,25,64,39.1,39,28,4,24,25,84,34,0,Matches
1794,Pere Milla,es ESP,"MF,FW",Elche,es La Liga,28,1992,18.3,20,15,14,5,1,8,44,18.2,36,21,1,20,5,25,21,0,Matches
1795,Enzo Millot,fr FRA,MF,Stuttgart,de Bundesliga,19,2002,0.6,2,0,0,2,0,0,1,0.0,1,0,0,0,1,3,1,0,Matches
1796,James Milner,eng ENG,"MF,DF",Liverpool,eng Premier League,35,1986,9.5,28,16,12,11,5,12,29,41.4,17,19,5,14,17,45,20,0,Matches
1797,Santi Mina,es ESP,FW,Celta Vigo,es La Liga,25,1995,26.3,27,17,8,15,4,5,32,15.6,27,28,2,26,6,33,22,0,Matches
1798,Yerry Mina,co COL,DF,Everton,eng Premier League,26,1994,9.4,12,10,12,0,0,10,13,76.9,3,13,9,4,11,23,38,1,Matches
1799,Takumi Minamino,jp JPN,"FW,MF",Liverpool,eng Premier League,26,1995,2.1,3,2,1,1,1,2,8,25.0,6,2,0,2,1,4,2,0,Matches
1800,Tyrone Mings,eng ENG,DF,Aston Villa,eng Premier League,28,1993,35.4,23,12,17,3,3,14,22,63.6,8,47,30,17,46,69,153,2,Matches
1801,Óscar Mingueza,es ESP,DF,Barcelona,es La Liga,22,1999,9.9,25,11,12,11,2,16,23,69.6,7,5,0,5,9,34,22,1,Matches
1802,Rafa Mir,es ESP,FW,Sevilla,es La Liga,24,1997,20.1,4,3,1,1,2,0,11,0.0,11,4,3,1,0,4,17,0,Matches
1803,Jorge Miramón,es ESP,DF,Levante,es La Liga,32,1989,22.0,36,19,16,12,8,15,44,34.1,29,15,3,12,35,71,58,0,Matches
1804,Aleksei Miranchuk,ru RUS,"MF,FW",Atalanta,it Serie A,25,1995,8.6,11,7,3,7,1,4,12,33.3,8,3,0,3,1,12,7,0,Matches
1805,Juan Miranda,es ESP,DF,Betis,es La Liga,21,2000,8.7,21,11,16,4,1,12,22,54.5,10,10,4,6,15,36,22,0,Matches
1806,Fabio Miretti,it ITA,MF,Juventus,it Serie A,17,2003,3.6,4,2,2,2,0,2,9,22.2,7,3,1,2,2,6,3,0,Matches
1807,Tyrick Mitchell,eng ENG,DF,Crystal Palace,eng Premier League,21,1999,34.5,104,57,67,26,11,46,67,68.7,21,47,5,42,41,145,101,0,Matches
1808,Stefan Mitrović,rs SRB,DF,Getafe,es La Liga,31,1990,29.6,16,8,12,4,0,8,13,61.5,5,28,18,10,22,38,114,1,Matches
1809,Maximilian Mittelstädt,de GER,"DF,FW",Hertha BSC,de Bundesliga,24,1997,16.6,52,33,30,12,10,26,50,52.0,24,28,5,23,46,98,37,0,Matches
1810,Henrikh Mkhitaryan,am ARM,"MF,FW",Roma,it Serie A,32,1989,27.7,45,29,11,27,7,17,52,32.7,35,33,2,31,22,67,33,0,Matches
1811,Jakub Moder,pl POL,MF,Brighton,eng Premier League,22,1999,18.9,42,25,18,17,7,23,42,54.8,19,25,2,23,10,52,22,1,Matches
1812,Anthony Modeste,fr FRA,FW,Köln,de Bundesliga,33,1988,29.0,10,6,4,5,1,3,18,16.7,15,11,2,9,4,14,29,0,Matches
1813,Marco Modolo,it ITA,DF,Venezia,it Serie A,32,1989,4.4,6,3,4,2,0,2,5,40.0,3,6,6,0,4,10,26,0,Matches
1814,Luka Modrić,hr CRO,MF,Real Madrid,es La Liga,35,1985,22.6,18,10,8,7,3,6,27,22.2,21,10,4,6,20,38,9,0,Matches
1815,Terem Moffi,ng NGA,FW,Lorient,fr Ligue 1,22,1999,30.1,17,10,3,12,2,9,32,28.1,23,11,2,9,4,21,22,0,Matches
1816,Kevin Möhwald,de GER,MF,Union Berlin,de Bundesliga,28,1993,3.9,7,1,3,3,1,1,7,14.3,6,3,0,3,3,10,6,0,Matches
1817,Dion Moise Sahi,ci CIV,"FW,MF",Strasbourg,fr Ligue 1,19,2001,1.4,0,0,0,0,0,0,0,,0,1,0,1,1,1,1,0,Matches
1818,Johan Mojica,co COL,DF,Elche,es La Liga,28,1992,31.7,46,25,34,7,5,23,31,74.2,8,22,3,19,25,71,61,3,Matches
1819,Clinton Mola,eng ENG,DF,Stuttgart,de Bundesliga,20,2001,1.3,3,1,2,1,0,2,4,50.0,2,5,5,0,3,6,2,0,Matches
1820,Jorge Molina,es ESP,FW,Granada,es La Liga,39,1982,21.8,4,2,2,1,1,2,18,11.1,16,13,2,11,6,10,11,0,Matches
1821,Nahuel Molina,ar ARG,DF,Udinese,it Serie A,23,1998,29.3,41,24,17,21,3,16,48,33.3,32,24,3,21,22,63,44,2,Matches
1822,Cristian Molinaro,it ITA,DF,Venezia,it Serie A,38,1983,6.1,12,9,10,2,0,5,7,71.4,2,7,2,5,6,18,20,0,Matches
1823,Florent Mollet,fr FRA,"FW,MF",Montpellier,fr Ligue 1,29,1991,29.2,31,22,14,12,5,14,57,24.6,43,27,4,23,24,55,13,0,Matches
1824,Jon Moncayola,es ESP,MF,Osasuna,es La Liga,23,1998,32.4,40,20,18,18,4,17,44,38.6,27,26,9,17,20,60,43,0,Matches
1825,Monchu,es ESP,MF,Granada,es La Liga,21,1999,7.4,15,6,5,9,1,5,10,50.0,5,8,3,5,4,19,4,0,Matches
1826,Thomas Monconduit,fr FRA,MF,Lorient,fr Ligue 1,30,1991,25.0,41,25,19,17,5,20,57,35.1,37,21,10,11,22,63,51,1,Matches
1827,Gonzalo Montiel,ar ARG,DF,Sevilla,es La Liga,24,1997,11.8,15,4,8,5,2,12,24,50.0,12,8,2,6,10,25,22,0,Matches
1828,Lorenzo Montipò,it ITA,GK,Hellas Verona,it Serie A,25,1996,34.0,0,0,0,0,0,0,0,,0,0,0,0,1,1,16,3,Matches
1829,Ángel Montoro,es ESP,MF,Granada,es La Liga,33,1988,14.8,26,13,16,7,3,17,27,63.0,10,11,1,10,11,37,29,1,Matches
1830,Martín Montoya,es ESP,DF,Betis,es La Liga,30,1991,5.8,20,12,11,7,2,15,26,57.7,11,6,0,6,11,31,20,0,Matches
1831,Wesley Moraes,br BRA,FW,Aston Villa,eng Premier League,24,1996,0.0,0,0,0,0,0,0,0,,0,0,0,0,0,0,0,0,Matches
1832,Álvaro Morata,es ESP,FW,Juventus,it Serie A,28,1992,25.6,18,9,4,9,5,8,31,25.8,23,26,1,25,5,23,24,0,Matches
1833,Jan Morávek,cz CZE,MF,Augsburg,de Bundesliga,31,1989,5.2,11,6,3,7,1,6,18,33.3,12,11,2,9,6,17,8,0,Matches
1834,Jon Morcillo,es ESP,"MF,FW",Athletic Club,es La Liga,22,1998,0.6,3,0,1,2,0,3,4,75.0,1,1,0,1,0,3,0,0,Matches
1835,Jérémy Morel,mg MAD,DF,Lorient,fr Ligue 1,37,1984,6.7,13,9,8,4,1,6,6,100.0,0,9,7,2,7,20,31,0,Matches
1836,Alberto Moreno,es ESP,"MF,DF",Villarreal,es La Liga,29,1992,13.6,13,7,5,7,1,5,18,27.8,13,13,1,12,27,40,15,0,Matches
1837,Álex Moreno,es ESP,DF,Betis,es La Liga,28,1993,26.7,76,40,53,15,8,33,60,55.0,27,28,6,22,34,110,82,1,Matches
1838,Gerard Moreno,es ESP,FW,Villarreal,es La Liga,29,1992,13.2,5,2,2,2,1,1,7,14.3,6,6,1,5,6,11,14,0,Matches
1839,Tete Morente,es ESP,MF,Elche,es La Liga,24,1996,18.1,21,14,13,7,1,7,28,25.0,21,30,1,29,12,33,12,0,Matches
1840,Ilaix Moriba,gn GUI,MF,Valencia,es La Liga,18,2003,9.1,26,18,10,13,3,14,35,40.0,21,15,0,15,12,38,14,0,Matches
1841,Ilaix Moriba,gn GUI,MF,RB Leipzig,de Bundesliga,18,2003,0.4,0,0,0,0,0,0,4,0.0,4,2,0,2,1,1,0,0,Matches
1842,Manu Morlanes,es ESP,MF,Espanyol,es La Liga,22,1999,12.7,36,15,16,17,3,18,43,41.9,25,24,5,19,13,49,17,0,Matches
1843,Raúl Moro,es ESP,FW,Lazio,it Serie A,18,2002,2.2,3,3,0,2,1,1,5,20.0,4,2,0,2,0,3,0,0,Matches
1844,Loren Morón,es ESP,"FW,MF",Espanyol,es La Liga,27,1993,6.3,6,4,1,3,2,0,12,0.0,12,11,1,10,2,8,9,0,Matches
1845,Loren Morón,es ESP,FW,Betis,es La Liga,27,1993,0.0,1,1,1,0,0,1,1,100.0,0,0,0,0,0,1,0,0,Matches
1846,Tyler Morton,eng ENG,MF,Liverpool,eng Premier League,18,2002,0.7,0,0,0,0,0,0,2,0.0,2,0,0,0,3,3,0,0,Matches
1847,Cristhian Mosquera,co COL,DF,Valencia,es La Liga,17,2004,2.4,4,2,3,0,1,3,6,50.0,3,1,0,1,3,7,1,1,Matches
1848,Lebo Mothiba,za RSA,"FW,MF",Troyes,fr Ligue 1,25,1996,5.8,8,4,4,3,1,2,5,40.0,3,3,0,3,2,10,0,0,Matches
1849,Lebo Mothiba,za RSA,FW,Strasbourg,fr Ligue 1,25,1996,0.0,0,0,0,0,0,0,0,,0,0,0,0,0,0,0,0,Matches
1850,Andrei Motoc,ro ROU,DF,Salernitana,it Serie A,19,2002,1.0,1,1,0,1,0,0,0,,0,2,2,0,2,3,1,0,Matches
1851,Baptiste Mouazan,fr FRA,MF,Lorient,fr Ligue 1,19,2001,1.1,4,3,2,2,0,1,3,33.3,2,3,0,3,1,5,1,0,Matches
1852,Aimen Moueffek,fr FRA,MF,Saint-Étienne,fr Ligue 1,20,2001,4.8,7,4,2,3,2,2,8,25.0,6,3,0,3,2,9,4,0,Matches
1853,Youssoufa Moukoko,de GER,"FW,MF",Dortmund,de Bundesliga,16,2004,2.5,1,0,0,1,0,0,1,0.0,1,5,0,5,3,4,0,0,Matches
1854,Harold Moukoudi,cm CMR,DF,Saint-Étienne,fr Ligue 1,23,1997,18.5,25,12,17,8,0,14,25,56.0,11,27,14,13,35,60,48,0,Matches
1855,Jessy Moulin,fr FRA,GK,Troyes,fr Ligue 1,35,1986,7.0,0,0,0,0,0,0,0,,0,0,0,0,1,1,7,0,Matches
1856,Steve Mounié,bj BEN,FW,Brest,fr Ligue 1,26,1994,25.7,17,6,3,12,2,4,27,14.8,23,13,1,12,6,23,12,0,Matches
1857,Mason Mount,eng ENG,MF,Chelsea,eng Premier League,22,1999,26.3,41,16,10,17,14,10,34,29.4,24,18,1,17,13,54,12,0,Matches
1858,Lucas Moura,br BRA,"FW,MF",Tottenham,eng Premier League,28,1992,19.7,25,10,7,14,4,8,35,22.9,27,19,0,19,18,43,19,0,Matches
1859,Lys Mousset,fr FRA,"MF,FW",Salernitana,it Serie A,25,1996,1.8,1,0,0,1,0,0,0,,0,2,0,2,0,1,0,0,Matches
1860,João Moutinho,pt POR,MF,Wolves,eng Premier League,34,1986,33.0,74,39,34,27,13,30,106,28.3,76,48,8,40,34,108,36,2,Matches
1861,Samuel Moutoussamy,cd COD,MF,Nantes,fr Ligue 1,24,1996,16.8,48,32,20,20,8,23,62,37.1,39,14,2,12,17,65,16,0,Matches
1862,Toni Moya,es ESP,MF,Alavés,es La Liga,23,1998,15.4,23,10,7,13,3,13,43,30.2,30,18,5,13,20,43,18,0,Matches
1863,Samuel Mráz,sk SVK,FW,Spezia,it Serie A,24,1997,0.6,0,0,0,0,0,0,0,,0,1,0,1,0,0,0,0,Matches
1864,Nordi Mukiele,fr FRA,"DF,FW",RB Leipzig,de Bundesliga,23,1997,20.5,35,22,23,9,3,14,27,51.9,13,31,5,26,31,66,44,2,Matches
1865,Mert Müldür,tr TUR,DF,Sassuolo,it Serie A,22,1999,22.7,52,35,43,7,2,27,49,55.1,22,25,6,19,24,76,44,1,Matches
1866,Florian Müller,de GER,GK,Stuttgart,de Bundesliga,23,1997,30.0,0,0,0,0,0,0,1,0.0,1,1,0,1,0,0,13,2,Matches
1867,Thomas Müller,de GER,MF,Bayern Munich,de Bundesliga,31,1989,28.4,35,20,7,16,12,16,54,29.6,38,32,1,31,15,50,12,0,Matches
1868,Bali Mumba,eng ENG,DF,Norwich City,eng Premier League,19,2001,0.5,1,1,1,0,0,0,0,,0,0,0,0,0,1,5,0,Matches
1869,Marshall Munetsi,zw ZIM,"MF,DF",Reims,fr Ligue 1,25,1996,20.9,34,17,21,11,2,17,39,43.6,22,39,13,26,43,77,72,2,Matches
1870,Iker Muniain,es ESP,MF,Athletic Club,es La Liga,28,1992,30.9,32,10,8,19,5,12,40,30.0,28,20,1,19,17,49,8,1,Matches
1871,Aihen Muñoz,es ESP,DF,Real Sociedad,es La Liga,23,1997,14.9,28,17,14,13,1,18,29,62.1,11,11,1,10,17,45,34,0,Matches
1872,Luis Muriel,co COL,"FW,MF",Atalanta,it Serie A,30,1991,17.1,15,4,2,7,6,3,19,15.8,16,12,0,12,4,19,5,0,Matches
1873,Jeison Murillo,co COL,DF,Celta Vigo,es La Liga,29,1992,12.4,15,10,13,2,0,9,13,69.2,4,11,8,3,17,32,37,0,Matches
1874,Vedat Muriqi,xk KVX,FW,Lazio,it Serie A,27,1994,2.4,1,0,1,0,0,0,5,0.0,5,0,0,0,0,1,2,0,Matches
1875,Vedat Muriqi,xk KVX,FW,Mallorca,es La Liga,27,1994,16.0,6,3,1,3,2,1,7,14.3,6,12,0,12,6,12,29,0,Matches
1876,Jacob Murphy,eng ENG,"FW,DF",Newcastle Utd,eng Premier League,26,1995,16.4,49,26,34,11,4,26,41,63.4,15,20,2,18,23,72,17,0,Matches
1877,Nicola Murru,it ITA,DF,Sampdoria,it Serie A,26,1994,10.9,22,17,10,11,1,8,13,61.5,5,17,3,14,7,29,20,1,Matches
1878,Yunus Musah,us USA,"MF,FW",Valencia,es La Liga,18,2002,14.0,23,13,8,8,7,6,20,30.0,14,19,1,18,14,37,11,0,Matches
1879,Torben Müsel,de GER,MF,Gladbach,de Bundesliga,22,1999,0.1,0,0,0,0,0,0,0,,0,0,0,0,0,0,0,0,Matches
1880,Jamal Musiala,de GER,"MF,FW",Bayern Munich,de Bundesliga,18,2003,16.3,40,26,11,16,13,15,36,41.7,21,25,0,25,19,59,2,1,Matches
1881,Juan Musso,ar ARG,GK,Atalanta,it Serie A,27,1994,32.6,1,1,1,0,0,0,0,,0,0,0,0,0,1,17,1,Matches
1882,Shkodran Mustafi,de GER,DF,Levante,es La Liga,29,1992,7.3,9,6,6,3,0,5,9,55.6,4,6,3,3,15,24,40,0,Matches
1883,Junior Mwanga,fr FRA,DF,Bordeaux,fr Ligue 1,18,2003,1.0,5,2,4,1,0,3,3,100.0,0,1,0,1,0,5,1,0,Matches
1884,Enock Mwepu,zm ZAM,MF,Brighton,eng Premier League,23,1998,11.1,22,12,10,10,2,5,27,18.5,22,20,2,18,12,34,19,0,Matches
1885,Vitaliy Mykolenko,ua UKR,DF,Everton,eng Premier League,22,1999,11.7,25,15,15,7,3,12,21,57.1,9,15,2,13,16,41,37,0,Matches
1886,Joakim Mæhle,dk DEN,"DF,MF",Atalanta,it Serie A,24,1997,16.3,21,11,6,9,6,12,27,44.4,15,18,2,16,14,35,13,0,Matches
1887,Obite N'Dicka,ci CIV,DF,Eint Frankfurt,de Bundesliga,21,1999,31.7,60,34,29,27,4,44,59,74.6,15,46,20,26,48,108,137,0,Matches
1888,Kévin N'Doram,fr FRA,MF,Metz,fr Ligue 1,25,1996,13.7,10,8,3,5,2,3,20,15.0,17,24,5,19,19,29,21,0,Matches
1889,Eric N'Jo,fr FRA,DF,Troyes,fr Ligue 1,17,2004,1.1,0,0,0,0,0,0,1,0.0,1,1,1,0,2,2,1,0,Matches
1890,Vital N'Simba,cd COD,DF,Clermont Foot,fr Ligue 1,28,1993,31.0,66,45,38,23,5,36,63,57.1,27,28,7,21,29,95,30,0,Matches
1891,Nacho,es ESP,DF,Real Madrid,es La Liga,31,1990,17.3,18,14,9,9,0,12,22,54.5,10,22,15,7,34,52,50,0,Matches
1892,Mickael Nade,fr FRA,DF,Saint-Étienne,fr Ligue 1,22,1999,28.5,57,35,37,18,2,23,38,60.5,15,29,15,14,60,117,84,0,Matches
1893,Marvelous Nakamba,zw ZIM,MF,Aston Villa,eng Premier League,27,1994,10.0,32,19,18,14,0,12,34,35.3,22,14,4,10,12,44,17,1,Matches
1894,Nahitan Nández,uy URU,"MF,DF",Cagliari,it Serie A,25,1995,16.9,39,21,16,15,8,18,33,54.5,15,16,1,15,9,48,15,1,Matches
1895,Nani,pt POR,"MF,FW",Venezia,it Serie A,34,1986,3.2,2,1,1,1,0,0,1,0.0,1,1,0,1,2,4,0,1,Matches
1896,Paul Nardi,fr FRA,GK,Lorient,fr Ligue 1,27,1994,22.0,1,0,1,0,0,1,2,50.0,1,0,0,0,0,1,10,2,Matches
1897,Nikolas Nartey,dk DEN,"MF,DF",Stuttgart,de Bundesliga,21,2000,4.5,6,3,0,5,1,3,9,33.3,6,4,2,2,7,13,5,0,Matches
1898,Matija Nastasić,rs SRB,DF,Fiorentina,it Serie A,28,1993,2.4,1,1,1,0,0,1,1,100.0,0,1,1,0,5,6,11,0,Matches
1899,Roberto Navarro,es ESP,"MF,FW",Real Sociedad,es La Liga,19,2002,2.2,5,3,1,1,3,3,5,60.0,2,2,0,2,2,7,2,0,Matches
1900,Ximo Navarro,es ESP,DF,Alavés,es La Liga,31,1990,15.0,28,19,21,6,1,13,27,48.1,14,11,5,6,22,50,56,2,Matches
1901,Jesús Navas,es ESP,DF,Sevilla,es La Liga,35,1985,19.8,18,13,11,5,2,9,17,52.9,8,15,2,13,17,35,26,1,Matches
1902,Keylor Navas,cr CRC,GK,Paris S-G,fr Ligue 1,34,1986,20.6,0,0,0,0,0,0,0,,0,0,0,0,0,0,5,1,Matches
1903,Papa Ndiaga Yade,mr MTN,"DF,FW",Metz,fr Ligue 1,21,2000,7.7,15,10,8,7,0,8,18,44.4,10,4,1,3,10,25,9,0,Matches
1904,Wilfred Ndidi,ng NGA,"MF,DF",Leicester City,eng Premier League,24,1996,18.0,60,32,32,27,1,22,55,40.0,33,36,8,28,42,102,54,1,Matches
1905,Tanguy Ndombele,fr FRA,MF,Tottenham,eng Premier League,24,1996,5.4,10,7,3,5,2,1,8,12.5,7,5,0,5,1,11,1,0,Matches
1906,Tanguy Ndombele,fr FRA,MF,Lyon,fr Ligue 1,24,1996,7.8,25,14,5,17,3,12,19,63.2,7,8,3,5,3,28,6,2,Matches
1907,Dan Ndoye,ch SUI,"FW,MF",Nice,fr Ligue 1,20,2000,2.3,0,0,0,0,0,0,2,0.0,2,4,0,4,0,0,0,0,Matches
1908,Paul Nebel,de GER,"MF,FW",Mainz 05,de Bundesliga,18,2002,2.5,5,3,3,1,1,2,3,66.7,1,0,0,0,0,5,1,0,Matches
1909,Álvaro Negredo,es ESP,FW,Cádiz,es La Liga,35,1985,24.0,5,3,1,4,0,3,6,50.0,3,11,5,6,2,7,23,0,Matches
1910,Reiss Nelson,eng ENG,FW,Arsenal,eng Premier League,21,1999,0.2,1,0,0,0,1,0,1,0.0,1,1,0,1,0,1,0,0,Matches
1911,David Nemeth,at AUT,DF,Mainz 05,de Bundesliga,20,2001,3.5,3,2,2,1,0,1,3,33.3,2,5,1,4,6,9,11,1,Matches
1912,Ilija Nestorovski,mk MKD,FW,Udinese,it Serie A,31,1990,2.1,0,0,0,0,0,0,3,0.0,3,0,0,0,0,0,4,0,Matches
1913,Neto,br BRA,GK,Barcelona,es La Liga,32,1989,3.0,0,0,0,0,0,0,0,,0,0,0,0,0,0,2,1,Matches
1914,Pedro Neto,pt POR,"FW,MF",Wolves,eng Premier League,21,2000,5.2,4,4,2,0,2,0,9,0.0,9,0,0,0,6,10,1,0,Matches
1915,Luca Netz,de GER,"DF,FW",Gladbach,de Bundesliga,18,2003,15.5,24,11,12,10,2,11,40,27.5,29,24,4,20,13,37,33,1,Matches
1916,Manuel Neuer,de GER,GK,Bayern Munich,de Bundesliga,35,1986,27.9,2,1,2,0,0,1,2,50.0,1,0,0,0,0,2,7,1,Matches
1917,Florian Neuhaus,de GER,MF,Gladbach,de Bundesliga,24,1997,23.6,55,28,24,26,5,27,64,42.2,37,38,6,32,31,86,19,4,Matches
1918,Carlos Neva,es ESP,DF,Granada,es La Liga,25,1996,23.4,31,19,24,7,0,16,28,57.1,12,27,9,18,32,63,81,0,Matches
1919,Rúben Neves,pt POR,MF,Wolves,eng Premier League,24,1997,29.6,68,37,23,41,4,24,87,27.6,63,39,5,34,41,109,49,3,Matches
1920,Neymar,br BRA,"FW,MF",Paris S-G,fr Ligue 1,29,1992,20.6,29,19,5,12,12,12,36,33.3,24,9,1,8,4,33,2,1,Matches
1921,Yvan Neyou,cm CMR,MF,Saint-Étienne,fr Ligue 1,24,1997,10.4,29,13,14,12,3,9,27,33.3,18,8,3,5,23,52,13,0,Matches
1922,Jeremy Ngakia,eng ENG,DF,Watford,eng Premier League,20,2000,10.0,31,18,23,5,3,11,26,42.3,15,11,4,7,12,43,32,0,Matches
1923,Jessic Ngankam,de GER,FW,Greuther Fürth,de Bundesliga,21,2000,3.8,3,1,1,1,1,1,2,50.0,1,3,0,3,0,3,1,0,Matches
1924,Opa Nguette,sn SEN,"FW,MF",Metz,fr Ligue 1,27,1994,11.6,21,14,9,6,6,5,14,35.7,9,13,3,10,2,23,9,0,Matches
1925,Aurélien Nguiamba,fr FRA,MF,Spezia,it Serie A,22,1999,0.6,3,2,1,2,0,2,3,66.7,1,2,1,1,0,3,1,0,Matches
1926,Sikou Niakaté,ml MLI,DF,Metz,fr Ligue 1,22,1999,7.3,8,7,8,0,0,4,11,36.4,7,5,3,2,27,35,34,0,Matches
1927,Moussa Niakhate,sn SEN,DF,Mainz 05,de Bundesliga,25,1996,28.5,40,23,25,13,2,20,33,60.6,13,37,11,26,50,90,69,1,Matches
1928,Ibrahima Niane,sn SEN,FW,Metz,fr Ligue 1,22,1999,17.6,1,1,0,1,0,0,5,0.0,5,6,1,5,3,4,16,0,Matches
1929,M'Baye Niang,sn SEN,FW,Bordeaux,fr Ligue 1,26,1994,8.6,4,0,0,2,2,0,4,0.0,4,9,1,8,1,5,4,0,Matches
1930,Tanguy Nianzou,fr FRA,DF,Bayern Munich,de Bundesliga,19,2002,6.5,11,7,7,3,1,7,11,63.6,4,7,2,5,7,18,17,0,Matches
1931,Cheikh Niasse,sn SEN,"FW,MF",Lille,fr Ligue 1,21,2000,0.5,2,2,0,2,0,2,3,66.7,1,1,1,0,1,3,2,0,Matches
1932,Florian Niederlechner,de GER,FW,Augsburg,de Bundesliga,30,1990,12.9,6,5,1,3,2,4,13,30.8,9,9,0,9,4,10,7,0,Matches
1933,Håvard Nielsen,no NOR,"MF,FW",Greuther Fürth,de Bundesliga,28,1993,15.2,17,12,5,11,1,8,21,38.1,13,18,1,17,7,24,22,0,Matches
1934,Saúl Ñíguez,es ESP,"DF,MF",Chelsea,eng Premier League,26,1994,5.3,20,9,11,9,0,9,16,56.3,7,14,3,11,7,27,10,1,Matches
1935,Saúl Ñíguez,es ESP,"FW,MF",Atlético Madrid,es La Liga,26,1994,2.2,7,2,0,6,1,3,4,75.0,1,7,1,6,0,7,3,0,Matches
1936,Dimitris Nikolaou,gr GRE,DF,Spezia,it Serie A,22,1998,36.0,39,26,29,7,3,22,34,64.7,12,48,24,24,49,88,132,1,Matches
1937,Joakim Nilsson,se SWE,DF,Arminia,de Bundesliga,27,1994,30.4,37,19,24,13,0,20,26,76.9,6,36,23,13,56,93,143,1,Matches
1938,Casimir Ninga,td CHA,FW,Angers,fr Ligue 1,28,1993,4.5,5,1,1,4,0,2,5,40.0,3,2,0,2,1,6,0,0,Matches
1939,Fernando Niño,es ESP,FW,Mallorca,es La Liga,20,2000,9.8,10,4,3,2,5,2,12,16.7,10,9,2,7,3,13,15,0,Matches
1940,Eddie Nketiah,eng ENG,FW,Arsenal,eng Premier League,22,1999,9.3,9,4,1,4,4,1,4,25.0,3,9,2,7,4,13,5,0,Matches
1941,Nicolas Nkoulou,cm CMR,DF,Watford,eng Premier League,31,1990,1.9,1,0,0,1,0,0,0,,0,2,1,1,2,3,8,0,Matches
1942,Christopher Nkunku,fr FRA,"FW,MF",RB Leipzig,de Bundesliga,23,1997,30.3,23,10,10,11,2,9,35,25.7,26,23,2,21,15,38,15,0,Matches
1943,Felix Nmecha,de GER,"MF,FW",Wolfsburg,de Bundesliga,20,2000,3.6,3,1,1,1,1,0,2,0.0,2,2,0,2,7,10,6,0,Matches
1944,Lukas Nmecha,de GER,"FW,MF",Wolfsburg,de Bundesliga,22,1998,18.1,12,5,5,5,2,5,19,26.3,14,9,1,8,4,16,10,0,Matches
1945,Mark Noble,eng ENG,MF,West Ham,eng Premier League,34,1987,3.7,8,2,7,1,0,5,11,45.5,6,4,1,3,4,12,2,1,Matches
1946,Peru Nolaskoain,es ESP,DF,Athletic Club,es La Liga,22,1998,0.0,0,0,0,0,0,0,0,,0,0,0,0,0,0,0,0,Matches
1947,Nolito,es ESP,MF,Celta Vigo,es La Liga,34,1986,15.4,25,15,14,7,4,13,47,27.7,34,20,1,19,9,34,5,0,Matches
1948,Arnaud Nordin,fr FRA,"FW,MF",Saint-Étienne,fr Ligue 1,23,1998,20.8,21,11,8,8,5,8,22,36.4,14,19,0,19,6,27,8,0,Matches
1949,Håvard Nordtveit,no NOR,DF,Hoffenheim,de Bundesliga,31,1990,3.4,7,6,2,4,1,4,4,100.0,0,2,1,1,10,17,11,0,Matches
1950,Mathias Normann,no NOR,MF,Norwich City,eng Premier League,25,1996,18.3,34,21,19,14,1,17,46,37.0,29,17,8,9,19,53,43,1,Matches
1951,Connor Noß,ie IRL,MF,Gladbach,de Bundesliga,20,2001,0.6,1,0,0,1,0,0,1,0.0,1,1,1,0,0,1,0,0,Matches
1952,Hugo Novoa,es ESP,"MF,FW",RB Leipzig,de Bundesliga,18,2003,1.5,4,4,2,0,2,2,7,28.6,5,2,0,2,1,5,0,0,Matches
1953,Soma Novothny,hu HUN,"FW,MF",Bochum,de Bundesliga,27,1994,0.9,1,1,1,0,0,0,1,0.0,1,1,0,1,0,1,2,0,Matches
1954,Jean-Pierre Nsame,cm CMR,FW,Venezia,it Serie A,28,1993,2.7,1,1,0,0,1,0,0,,0,0,0,0,0,1,1,0,Matches
1955,Randy Nteka,ao ANG,"FW,MF",Rayo Vallecano,es La Liga,23,1997,16.2,24,13,9,11,4,8,19,42.1,11,21,1,20,8,32,12,0,Matches
1956,Alexander Nübel,de GER,GK,Monaco,fr Ligue 1,24,1996,38.0,0,0,0,0,0,0,1,0.0,1,0,0,0,0,0,11,1,Matches
1957,Kasim Nuhu,gh GHA,DF,Hoffenheim,de Bundesliga,26,1995,0.1,0,0,0,0,0,0,1,0.0,1,0,0,0,0,0,1,0,Matches
1958,Unai Núñez,es ESP,DF,Athletic Club,es La Liga,24,1997,6.9,4,4,2,2,0,3,6,50.0,3,9,8,1,8,12,26,2,Matches
1959,Hans Nunoo Sarpei,gh GHA,"DF,MF",Greuther Fürth,de Bundesliga,22,1998,7.1,16,11,9,7,0,10,14,71.4,4,8,5,3,14,30,21,0,Matches
1960,Bram Nuytinck,nl NED,DF,Udinese,it Serie A,31,1990,22.6,38,24,24,13,1,15,34,44.1,19,42,31,11,22,60,101,0,Matches
1961,Simeon Nwankwo,ng NGA,FW,Salernitana,it Serie A,29,1992,9.4,5,5,0,4,1,4,10,40.0,6,8,3,5,3,8,10,0,Matches
1962,Gerzino Nyamsi,fr FRA,DF,Strasbourg,fr Ligue 1,24,1997,33.2,35,21,24,9,2,20,27,74.1,7,25,16,9,25,60,90,1,Matches
1963,Allan Nyom,cm CMR,DF,Getafe,es La Liga,33,1988,2.7,3,1,2,1,0,2,2,100.0,0,2,1,1,2,5,7,0,Matches
1964,M'Bala Nzola,ao ANG,FW,Spezia,it Serie A,24,1996,11.9,2,2,0,0,2,1,6,16.7,5,8,0,8,0,2,13,0,Matches
1965,Christian Nørgaard,dk DEN,MF,Brentford,eng Premier League,27,1994,33.9,109,60,42,58,9,52,101,51.5,49,48,9,39,64,173,58,1,Matches
1966,Adam Obert,sk SVK,"DF,MF",Cagliari,it Serie A,18,2002,3.0,8,5,6,2,0,5,6,83.3,1,6,4,2,4,12,11,0,Matches
1967,Joel Obi,ng NGA,"MF,DF",Salernitana,it Serie A,30,1991,12.7,23,14,5,14,4,5,12,41.7,7,17,6,11,10,33,7,0,Matches
1968,Jan Oblak,si SVN,GK,Atlético Madrid,es La Liga,28,1993,38.0,0,0,0,0,0,0,0,,0,0,0,0,1,1,10,4,Matches
1969,Lucas Ocampos,ar ARG,FW,Sevilla,es La Liga,27,1994,23.6,45,24,23,18,4,23,55,41.8,32,35,1,34,9,54,24,1,Matches
1970,Bastian Oczipka,de GER,DF,Union Berlin,de Bundesliga,32,1989,10.4,24,15,15,7,2,10,13,76.9,3,10,2,8,12,36,21,0,Matches
1971,Brian Oddei,it ITA,FW,Sassuolo,it Serie A,18,2002,0.1,0,0,0,0,0,0,0,,0,0,0,0,0,0,0,0,Matches
1972,Álvaro Odriozola,es ESP,DF,Fiorentina,it Serie A,25,1995,19.3,25,15,12,6,7,15,32,46.9,17,17,6,11,8,33,25,2,Matches
1973,Angelo Ogbonna,it ITA,DF,West Ham,eng Premier League,33,1988,10.2,7,4,5,2,0,3,7,42.9,4,5,4,1,11,18,29,0,Matches
1974,Florent Ogier,fr FRA,DF,Clermont Foot,fr Ligue 1,32,1989,27.0,31,17,18,12,1,17,31,54.8,14,41,27,14,37,68,89,0,Matches
1975,Stefano Okaka,it ITA,FW,Udinese,it Serie A,31,1989,0.2,0,0,0,0,0,0,0,,0,2,0,2,0,0,1,0,Matches
1976,David Okereke,ng NGA,"FW,MF",Venezia,it Serie A,23,1997,22.8,16,10,4,9,3,3,20,15.0,17,19,3,16,10,26,20,0,Matches
1977,Masaya Okugawa,jp JPN,"MF,FW",Arminia,de Bundesliga,25,1996,28.1,46,25,18,22,6,12,37,32.4,25,29,1,28,20,66,13,0,Matches
1978,Lucas Olaza,uy URU,DF,Elche,es La Liga,27,1994,3.3,5,3,3,1,1,1,1,100.0,0,5,1,4,4,9,6,0,Matches
1979,Oier Olazábal,es ESP,GK,Espanyol,es La Liga,31,1989,1.5,0,0,0,0,0,0,0,,0,0,0,0,0,0,0,0,Matches
1980,Mathias Olesen,lu LUX,"MF,FW",Köln,de Bundesliga,20,2001,0.2,0,0,0,0,0,0,0,,0,0,0,0,1,1,0,0,Matches
1981,Michael Olise,fr FRA,"FW,MF",Crystal Palace,eng Premier League,19,2001,12.7,22,18,8,11,3,7,24,29.2,17,17,0,17,6,28,6,0,Matches
1982,Christian Oliva,uy URU,MF,Cagliari,it Serie A,25,1996,0.5,2,2,2,0,0,1,4,25.0,3,0,0,0,0,2,0,0,Matches
1983,Brian Oliván,es ESP,DF,Mallorca,es La Liga,27,1994,24.3,33,20,22,9,2,12,23,52.2,11,17,7,10,28,61,63,0,Matches
1984,Sérgio Oliveira,pt POR,MF,Roma,it Serie A,29,1992,9.9,27,14,11,14,2,15,30,50.0,15,13,0,13,10,37,7,0,Matches
1985,Mathías Olivera,uy URU,DF,Getafe,es La Liga,23,1997,31.1,79,47,39,34,6,40,69,58.0,29,45,4,41,55,134,67,1,Matches
1986,Dani Olmo,es ESP,"MF,FW",RB Leipzig,de Bundesliga,23,1998,8.3,14,6,5,7,2,5,18,27.8,13,5,1,4,4,18,1,0,Matches
1987,Robin Olsen,se SWE,GK,Aston Villa,eng Premier League,31,1990,1.0,0,0,0,0,0,0,0,,0,0,0,0,0,0,0,0,Matches
1988,Warmed Omari,fr FRA,DF,Rennes,fr Ligue 1,21,2000,31.1,33,17,22,10,1,15,23,65.2,8,20,13,7,31,64,94,5,Matches
1989,Jonas Omlin,ch SUI,GK,Montpellier,fr Ligue 1,27,1994,28.7,2,1,2,0,0,2,3,66.7,1,0,0,0,0,2,12,3,Matches
1990,Andrew Omobamidele,ie IRL,DF,Norwich City,eng Premier League,19,2002,4.2,8,6,5,3,0,5,11,45.5,6,8,8,0,5,13,13,0,Matches
1991,Amadou Onana,be BEL,MF,Lille,fr Ligue 1,19,2001,15.1,48,31,17,27,4,18,25,72.0,7,10,3,7,30,78,19,0,Matches
1992,Jean Onana,cm CMR,MF,Bordeaux,fr Ligue 1,21,2000,20.4,70,49,33,33,4,35,86,40.7,51,37,5,32,36,106,23,1,Matches
1993,Karim Onisiwo,at AUT,FW,Mainz 05,de Bundesliga,29,1992,26.2,18,10,4,6,8,7,22,31.8,15,27,2,25,7,25,8,0,Matches
1994,Javier Ontiveros,es ESP,"FW,MF",Osasuna,es La Liga,23,1997,0.4,0,0,0,0,0,0,2,0.0,2,0,0,0,1,1,0,1,Matches
1995,Tyler Onyango,eng ENG,MF,Everton,eng Premier League,18,2003,0.3,0,0,0,0,0,0,0,,0,0,0,0,0,0,1,0,Matches
1996,Frank Onyeka,ng NGA,MF,Brentford,eng Premier League,23,1998,11.6,25,17,13,9,3,8,27,29.6,19,16,2,14,14,39,13,0,Matches
1997,Willi Orban,hu HUN,DF,RB Leipzig,de Bundesliga,28,1992,29.4,32,22,20,11,1,13,25,52.0,12,40,24,16,44,76,123,2,Matches
1998,Divock Origi,be BEL,FW,Liverpool,eng Premier League,26,1995,1.5,0,0,0,0,0,0,2,0.0,2,1,0,1,1,1,2,0,Matches
1999,Riccardo Orsolini,it ITA,"FW,MF",Bologna,it Serie A,24,1997,19.8,21,13,9,11,1,13,29,44.8,16,9,4,5,5,26,14,0,Matches
2000,Stefan Ortega,de GER,GK,Arminia,de Bundesliga,28,1992,33.0,1,0,1,0,0,1,2,50.0,1,2,0,2,0,1,5,1,Matches
2001,Pedro Ortiz,es ESP,MF,Sevilla,es La Liga,20,2000,0.1,0,0,0,0,0,0,0,,0,0,0,0,0,0,1,0,Matches
2002,Victor Osimhen,ng NGA,FW,Napoli,it Serie A,22,1998,22.0,10,5,1,2,7,2,6,33.3,4,16,3,13,3,13,17,0,Matches
2003,Milutin Osmajić,me MNE,"FW,MF",Cádiz,es La Liga,22,1999,2.9,1,1,0,1,0,0,0,,0,0,0,0,1,2,3,0,Matches
2004,David Ospina,co COL,GK,Napoli,it Serie A,32,1988,31.0,0,0,0,0,0,0,0,,0,0,0,0,1,1,11,1,Matches
2005,Patrick Osterhage,de GER,MF,Bochum,de Bundesliga,21,2000,6.7,9,6,3,5,1,3,7,42.9,4,7,1,6,11,20,8,0,Matches
2006,Tomáš Ostrák,cz CZE,"MF,FW",Köln,de Bundesliga,21,2000,0.3,1,0,0,0,1,1,3,33.3,2,0,0,0,1,2,0,0,Matches
2007,Otávio,br BRA,MF,Bordeaux,fr Ligue 1,27,1994,12.7,36,23,13,21,2,16,39,41.0,23,9,3,6,18,54,11,0,Matches
2008,Paulo Otávio,br BRA,"DF,MF",Wolfsburg,de Bundesliga,26,1994,4.0,14,10,7,4,3,8,15,53.3,7,11,6,5,4,18,9,0,Matches
2009,Dango Ouattara,bf BFA,"MF,FW",Lorient,fr Ligue 1,19,2002,9.0,21,15,9,11,1,11,23,47.8,12,10,1,9,14,35,15,1,Matches
2010,Remi Oudin,fr FRA,"MF,FW",Bordeaux,fr Ligue 1,24,1996,19.3,34,18,19,13,2,18,32,56.3,14,14,3,11,27,61,21,0,Matches
2011,Alexandre Oukidja,dz ALG,GK,Metz,fr Ligue 1,33,1988,20.8,0,0,0,0,0,0,1,0.0,1,1,0,1,1,1,17,2,Matches
2012,Azzedine Ounahi,ma MAR,MF,Angers,fr Ligue 1,21,2000,18.1,39,22,16,22,1,11,40,27.5,29,19,1,18,26,65,13,0,Matches
2013,Adam Ounas,dz ALG,"MF,FW",Napoli,it Serie A,24,1996,3.6,6,1,0,3,3,3,7,42.9,4,3,0,3,2,8,3,0,Matches
2014,Jesús Owono,gq EQG,GK,Alavés,es La Liga,20,2001,1.0,0,0,0,0,0,0,0,,0,0,0,0,0,0,1,0,Matches
2015,Reece Oxford,eng ENG,DF,Augsburg,de Bundesliga,22,1998,29.9,27,14,16,9,2,15,31,48.4,16,42,33,9,72,99,172,1,Matches
2016,Alex Oxlade-Chamberlain,eng ENG,"MF,FW",Liverpool,eng Premier League,27,1993,8.7,15,11,2,8,5,3,14,21.4,11,12,2,10,6,21,5,0,Matches
2017,Mikel Oyarzabal,es ESP,"FW,MF",Real Sociedad,es La Liga,24,1997,18.6,18,10,7,7,4,7,21,33.3,14,18,2,16,10,28,16,1,Matches
2018,Ambroise Oyongo,cm CMR,DF,Montpellier,fr Ligue 1,30,1991,7.3,13,4,7,4,2,9,15,60.0,6,5,1,4,6,19,17,0,Matches
2019,Salih Özcan,tr TUR,MF,Köln,de Bundesliga,23,1998,25.7,42,30,14,23,5,22,51,43.1,29,37,5,32,51,93,35,1,Matches
2020,Levin Öztunalı,de GER,MF,Union Berlin,de Bundesliga,25,1996,6.4,14,11,6,5,3,7,17,41.2,10,3,0,3,4,18,12,0,Matches
2021,Fernando Pacheco,es ESP,GK,Alavés,es La Liga,29,1992,33.9,2,1,2,0,0,2,2,100.0,0,0,0,0,0,2,18,1,Matches
2022,Jon Pacheco,es ESP,DF,Real Sociedad,es La Liga,20,2001,4.2,6,4,4,2,0,3,3,100.0,0,6,4,2,6,12,18,0,Matches
2023,Gonçalo Paciência,pt POR,FW,Eint Frankfurt,de Bundesliga,26,1994,5.7,4,2,2,1,1,1,3,33.3,2,2,0,2,1,5,4,0,Matches
2024,Daniele Padelli,it ITA,GK,Udinese,it Serie A,35,1985,3.0,0,0,0,0,0,0,0,,0,0,0,0,0,0,2,1,Matches
2025,Simone Pafundi,it ITA,FW,Udinese,it Serie A,15,2006,0.3,0,0,0,0,0,0,1,0.0,1,0,0,0,0,0,0,0,Matches
2026,Vincent Pajot,fr FRA,MF,Metz,fr Ligue 1,30,1990,25.7,86,56,35,47,4,20,46,43.5,26,33,6,27,51,137,38,0,Matches
2027,Exequiel Palacios,ar ARG,MF,Leverkusen,de Bundesliga,22,1998,12.2,30,19,12,14,4,15,38,39.5,23,20,1,19,28,58,11,2,Matches
2028,Helibelton Palacios,co COL,DF,Elche,es La Liga,28,1993,21.5,69,38,56,10,3,37,55,67.3,18,21,8,13,18,87,61,0,Matches
2029,Isaac Palazón Camacho,es ESP,"FW,MF",Rayo Vallecano,es La Liga,26,1994,25.4,42,28,20,19,3,18,59,30.5,41,31,3,28,13,55,22,0,Matches
2030,Nicolas Pallois,fr FRA,DF,Nantes,fr Ligue 1,33,1987,27.2,51,33,40,11,0,34,59,57.6,25,40,19,21,53,104,116,1,Matches
2031,Cole Palmer,eng ENG,"FW,MF",Manchester City,eng Premier League,19,2002,1.4,2,1,1,1,0,0,2,0.0,2,3,0,3,1,3,0,0,Matches
2032,Erik Palmer-Brown,us USA,DF,Troyes,fr Ligue 1,24,1997,19.3,37,22,29,8,0,20,26,76.9,6,26,18,8,34,71,87,1,Matches
2033,Emerson Palmieri,it ITA,DF,Chelsea,eng Premier League,26,1994,0.1,0,0,0,0,0,0,0,,0,0,0,0,0,0,0,0,Matches
2034,Emerson Palmieri,it ITA,DF,Lyon,fr Ligue 1,26,1994,25.2,46,25,16,22,8,22,34,64.7,12,23,8,15,27,73,66,0,Matches
2035,Martin Palumbo,no NOR,FW,Juventus,it Serie A,19,2002,0.1,0,0,0,0,0,0,1,0.0,1,0,0,0,0,0,0,0,Matches
2036,Goran Pandev,mk MKD,"FW,MF",Genoa,it Serie A,38,1983,9.4,2,0,1,0,1,0,9,0.0,9,3,1,2,2,4,0,0,Matches
2037,Ivor Pandur,hr CRO,GK,Hellas Verona,it Serie A,21,2000,3.0,0,0,0,0,0,0,0,,0,0,0,0,0,0,2,0,Matches
2038,Miloš Pantović,rs SRB,"MF,FW",Bochum,de Bundesliga,25,1996,17.0,19,10,8,7,4,6,25,24.0,19,26,4,22,18,37,14,0,Matches
2039,Antonios Papadopoulos,de GER,"DF,MF",Dortmund,de Bundesliga,21,1999,0.2,0,0,0,0,0,0,0,,0,1,0,1,0,0,0,0,Matches
2040,Matondo-Merveille Papela,de GER,MF,Mainz 05,de Bundesliga,20,2001,0.9,3,2,2,1,0,2,3,66.7,1,2,0,2,2,5,0,0,Matches
2041,Lucas Paquetá,br BRA,"MF,FW",Lyon,fr Ligue 1,23,1997,30.0,68,38,24,26,18,17,51,33.3,34,43,5,38,9,77,22,0,Matches
2042,Rubén Pardo,es ESP,MF,Bordeaux,fr Ligue 1,28,1992,0.1,0,0,0,0,0,0,0,,0,0,0,0,0,0,0,0,Matches
2043,Kevin Paredes,us USA,"FW,DF",Wolfsburg,de Bundesliga,18,2003,0.2,1,0,0,0,1,0,0,,0,1,0,1,0,1,0,0,Matches
2044,Leandro Paredes,ar ARG,MF,Paris S-G,fr Ligue 1,27,1994,9.3,23,13,9,11,3,12,24,50.0,12,10,6,4,10,33,5,2,Matches
2045,Daniel Parejo,es ESP,MF,Villarreal,es La Liga,32,1989,30.0,43,29,15,15,13,20,52,38.5,32,32,7,25,29,72,19,1,Matches
2046,Fabiano Parisi,it ITA,DF,Empoli,it Serie A,20,2000,16.4,35,19,25,5,5,13,31,41.9,18,30,10,20,22,57,42,0,Matches
2047,Raúl Parra,es ESP,DF,Cádiz,es La Liga,21,1999,1.0,2,1,2,0,0,1,3,33.3,2,0,0,0,0,2,5,0,Matches
2048,Thomas Partey,gh GHA,MF,Arsenal,eng Premier League,28,1993,22.5,43,29,22,17,4,18,44,40.9,26,22,4,18,23,66,35,2,Matches
2049,Mario Pašalić,hr CRO,"MF,FW",Atalanta,it Serie A,26,1995,22.2,27,12,8,13,6,12,30,40.0,18,27,6,21,20,47,14,0,Matches
2050,Felix Passlack,de GER,DF,Dortmund,de Bundesliga,23,1998,5.2,13,9,8,4,1,6,12,50.0,6,5,1,4,4,17,7,0,Matches
2051,Javier Pastore,ar ARG,"MF,FW",Elche,es La Liga,32,1989,5.8,7,3,3,2,2,3,12,25.0,9,5,1,4,4,11,2,0,Matches
2052,Patric,es ESP,DF,Lazio,it Serie A,28,1993,18.3,21,15,17,4,0,9,20,45.0,11,22,11,11,12,33,44,2,Matches
2053,Rui Patrício,pt POR,GK,Roma,it Serie A,33,1988,38.0,0,0,0,0,0,0,0,,0,1,0,1,0,0,10,3,Matches
2054,Paulinho,br BRA,"FW,MF",Leverkusen,de Bundesliga,21,2000,13.5,22,13,6,13,3,13,27,48.1,14,14,1,13,6,28,7,0,Matches
2055,Gabriel Paulista,br BRA,DF,Valencia,es La Liga,30,1990,17.7,21,12,16,5,0,14,20,70.0,6,18,12,6,39,60,88,0,Matches
2056,Benjamin Pavard,fr FRA,DF,Bayern Munich,de Bundesliga,25,1996,23.1,35,20,21,13,1,19,29,65.5,10,28,16,12,36,71,50,1,Matches
2057,Strahinja Pavlović,rs SRB,DF,Monaco,fr Ligue 1,20,2001,5.0,23,16,8,13,2,8,12,66.7,4,5,3,2,9,32,15,0,Matches
2058,Leonardo Pavoletti,it ITA,FW,Cagliari,it Serie A,32,1988,16.9,10,6,2,5,3,3,9,33.3,6,9,5,4,2,12,12,0,Matches
2059,Dimitri Payet,fr FRA,"FW,MF",Marseille,fr Ligue 1,34,1987,28.8,16,8,4,10,2,7,31,22.6,24,9,0,9,9,25,3,0,Matches
2060,Mads Pedersen,dk DEN,"MF,DF",Augsburg,de Bundesliga,24,1996,15.5,28,21,8,15,5,12,27,44.4,15,13,4,9,15,43,30,0,Matches
2061,Alfonso Pedraza,es ESP,DF,Villarreal,es La Liga,25,1996,18.9,34,16,17,12,5,10,28,35.7,18,12,3,9,31,65,32,0,Matches
2062,Pedri,es ESP,MF,Barcelona,es La Liga,18,2002,9.8,20,12,9,8,3,7,20,35.0,13,13,0,13,5,25,7,1,Matches
2063,Pedro,es ESP,FW,Lazio,it Serie A,34,1987,22.6,36,23,8,19,9,16,47,34.0,31,18,2,16,6,42,8,0,Matches
2064,João Pedro,it ITA,FW,Cagliari,it Serie A,29,1992,36.9,15,12,2,8,5,4,18,22.2,14,23,5,18,8,23,18,1,Matches
2065,Adrià Pedrosa,es ESP,DF,Espanyol,es La Liga,23,1998,30.2,58,30,38,14,6,26,57,45.6,31,25,7,18,25,83,92,2,Matches
2066,Gianluca Pegolo,it ITA,GK,Sassuolo,it Serie A,40,1981,1.0,0,0,0,0,0,0,0,,0,0,0,0,0,0,0,1,Matches
2067,Peter Pekarík,sk SVK,DF,Hertha BSC,de Bundesliga,34,1986,24.8,45,29,33,11,1,32,46,69.6,14,28,10,18,29,74,58,0,Matches
2068,Pietro Pellegri,it ITA,FW,Torino,it Serie A,20,2001,2.4,1,1,0,1,0,0,4,0.0,4,0,0,0,0,1,5,0,Matches
2069,Pietro Pellegri,it ITA,FW,Milan,it Serie A,20,2001,1.5,2,2,0,1,1,0,1,0.0,1,0,0,0,0,2,1,0,Matches
2070,Lorenzo Pellegrini,it ITA,MF,Roma,it Serie A,25,1996,25.4,35,14,10,17,8,16,60,26.7,44,29,1,28,27,62,20,0,Matches
2071,Luca Pellegrini,it ITA,DF,Juventus,it Serie A,22,1999,12.3,23,10,13,5,5,12,19,63.2,7,9,1,8,5,28,23,0,Matches
2072,Facundo Pellistri,uy URU,"MF,FW",Alavés,es La Liga,19,2001,7.5,9,5,4,3,2,1,10,10.0,9,13,2,11,6,15,7,0,Matches
2073,Federico Peluso,it ITA,DF,Sassuolo,it Serie A,37,1984,0.1,1,1,0,1,0,1,1,100.0,0,0,0,0,0,1,0,0,Matches
2074,Timothee Pembele,fr FRA,DF,Bordeaux,fr Ligue 1,18,2002,15.7,20,8,8,10,2,10,29,34.5,19,12,3,9,16,36,24,0,Matches
2075,Rubén Peña,es ESP,"MF,FW",Villarreal,es La Liga,30,1991,1.5,2,0,1,1,0,2,6,33.3,4,1,0,1,5,7,2,0,Matches
2076,Philipp Pentke,de GER,GK,Hoffenheim,de Bundesliga,36,1985,1.0,0,0,0,0,0,0,0,,0,0,0,0,0,0,0,0,Matches
2077,Nicolas Pépé,ci CIV,"FW,MF",Arsenal,eng Premier League,26,1995,7.7,8,5,3,5,0,3,9,33.3,6,9,1,8,8,16,2,0,Matches
2078,Ricardo Pepi,us USA,"FW,MF",Augsburg,de Bundesliga,18,2003,5.3,4,2,1,3,0,1,8,12.5,7,7,0,7,3,7,8,0,Matches
2079,Alberto Perea,es ESP,MF,Cádiz,es La Liga,30,1990,8.6,19,9,7,9,3,6,20,30.0,14,15,1,14,9,28,4,0,Matches
2080,Brayann Pereira,fr FRA,"DF,MF",Lens,fr Ligue 1,18,2003,0.2,1,1,1,0,0,1,1,100.0,0,0,0,0,0,1,1,0,Matches
2081,Danilo Pereira,pt POR,MF,Paris S-G,fr Ligue 1,29,1991,22.6,33,17,10,20,3,14,28,50.0,14,19,10,9,37,70,29,1,Matches
2082,Mathias Pereira Lage,pt POR,DF,Angers,fr Ligue 1,24,1996,11.6,21,7,10,7,4,8,30,26.7,22,18,7,11,21,42,22,0,Matches
2083,Ricardo Pereira,pt POR,DF,Leicester City,eng Premier League,27,1993,11.0,37,20,19,13,5,21,40,52.5,19,13,1,12,17,54,39,0,Matches
2084,Gastón Pereiro,uy URU,"FW,MF",Cagliari,it Serie A,26,1995,10.8,13,5,7,4,2,5,18,27.8,13,12,1,11,1,14,8,0,Matches
2085,Luan Peres Petroni,br BRA,DF,Marseille,fr Ligue 1,27,1994,29.8,65,35,33,25,7,36,52,69.2,16,26,12,14,43,108,64,1,Matches
2086,Dor Peretz,il ISR,MF,Venezia,it Serie A,26,1995,6.5,27,18,8,16,3,13,25,52.0,12,8,4,4,8,35,11,0,Matches
2087,Roberto Pereyra,ar ARG,"MF,FW",Udinese,it Serie A,30,1991,19.9,18,12,7,6,5,7,23,30.4,16,26,5,21,12,30,11,0,Matches
2088,Ayoze Pérez,es ESP,"MF,FW",Leicester City,eng Premier League,28,1993,4.9,4,2,0,3,1,0,13,0.0,13,11,1,10,2,6,5,0,Matches
2089,Carles Pérez,es ESP,"MF,FW",Roma,it Serie A,23,1998,6.2,8,3,3,1,4,3,12,25.0,9,10,0,10,2,10,2,0,Matches
2090,Iñigo Pérez,es ESP,MF,Osasuna,es La Liga,33,1988,3.8,3,2,2,1,0,2,4,50.0,2,1,0,1,0,3,3,0,Matches
2091,Juan Pérez,es ESP,GK,Osasuna,es La Liga,25,1996,2.0,0,0,0,0,0,0,1,0.0,1,0,0,0,0,0,1,1,Matches
2092,Kike Pérez,es ESP,"MF,FW",Elche,es La Liga,24,1997,5.8,8,6,1,3,4,0,10,0.0,10,6,1,5,3,11,4,0,Matches
2093,Lucas Pérez,es ESP,FW,Elche,es La Liga,32,1988,14.1,4,1,2,1,1,3,10,30.0,7,2,0,2,3,7,4,0,Matches
2094,Lucas Pérez,es ESP,"FW,MF",Cádiz,es La Liga,32,1988,11.8,3,3,2,1,0,0,10,0.0,10,3,1,2,0,3,1,0,Matches
2095,Nehuén Pérez,ar ARG,DF,Udinese,it Serie A,21,2000,18.8,44,21,21,21,2,16,25,64.0,9,27,9,18,21,65,47,0,Matches
2096,Mattia Perin,it ITA,GK,Juventus,it Serie A,28,1992,4.5,0,0,0,0,0,0,0,,0,0,0,0,0,0,3,0,Matches
2097,Ivan Perišić,hr CRO,DF,Inter,it Serie A,32,1989,31.3,38,22,18,11,9,28,50,56.0,22,39,7,32,47,85,42,0,Matches
2098,Sonny Perkins,eng ENG,MF,West Ham,eng Premier League,17,2004,0.0,0,0,0,0,0,0,0,,0,0,0,0,0,0,0,0,Matches
2099,Diego Perotti,ar ARG,"MF,FW",Salernitana,it Serie A,33,1988,3.2,11,5,7,1,3,4,13,30.8,9,1,0,1,2,13,6,0,Matches
2100,Romain Perraud,fr FRA,DF,Southampton,eng Premier League,23,1997,18.0,34,22,18,14,2,16,29,55.2,13,24,6,18,17,51,42,0,Matches
2101,Lucas Perrin,fr FRA,DF,Strasbourg,fr Ligue 1,22,1998,27.8,43,32,24,17,2,26,45,57.8,19,28,11,17,42,85,67,0,Matches
2102,Mario Perrone,it ITA,DF,Salernitana,it Serie A,18,2003,0.2,0,0,0,0,0,0,0,,0,0,0,0,0,0,0,0,Matches
2103,Pavao Pervan,at AUT,GK,Wolfsburg,de Bundesliga,33,1987,6.0,0,0,0,0,0,0,0,,0,0,0,0,0,0,3,0,Matches
2104,Matteo Pessina,it ITA,"MF,FW",Atalanta,it Serie A,24,1997,16.0,27,14,10,11,6,14,33,42.4,19,22,3,19,13,40,7,0,Matches
2105,Andrea Petagna,it ITA,FW,Napoli,it Serie A,26,1995,6.5,3,3,0,3,0,1,4,25.0,3,1,0,1,0,3,5,0,Matches
2106,Nils Petersen,de GER,FW,Freiburg,de Bundesliga,32,1988,6.4,5,3,2,3,0,1,13,7.7,12,7,0,7,2,7,17,0,Matches
2107,Danijel Petković,me MNE,GK,Angers,fr Ligue 1,28,1993,15.0,0,0,0,0,0,0,1,0.0,1,0,0,0,1,1,9,5,Matches
2108,Léo Pétrot,fr FRA,DF,Lorient,fr Ligue 1,24,1997,20.2,31,17,23,8,0,21,29,72.4,8,33,17,16,22,53,86,0,Matches
2109,Njegoš Petrović,rs SRB,MF,Granada,es La Liga,22,1999,10.2,24,11,4,19,1,8,14,57.1,6,16,4,12,9,33,11,0,Matches
2110,Jens Petter Hauge,no NOR,"MF,FW",Eint Frankfurt,de Bundesliga,21,1999,11.6,14,5,6,7,1,7,23,30.4,16,7,0,7,3,17,5,0,Matches
2111,Alex Petxa,es ESP,"DF,MF",Athletic Club,es La Liga,24,1997,4.6,12,9,4,7,1,4,8,50.0,4,8,2,6,4,16,6,0,Matches
2112,Germán Pezzella,ar ARG,DF,Betis,es La Liga,30,1991,22.1,21,9,16,5,0,16,29,55.2,13,29,18,11,39,60,106,0,Matches
2113,Giuseppe Pezzella,it ITA,"DF,MF",Atalanta,it Serie A,23,1997,11.9,28,13,15,7,6,8,18,44.4,10,13,5,8,9,37,16,0,Matches
2114,Immanuel Pherai,sr SUR,MF,Dortmund,de Bundesliga,20,2001,0.0,0,0,0,0,0,0,0,,0,0,0,0,0,0,0,0,Matches
2115,Maximilian Philipp,de GER,MF,Wolfsburg,de Bundesliga,27,1994,10.7,15,11,6,7,2,5,21,23.8,16,12,1,11,4,19,5,0,Matches
2116,Romain Philippoteaux,fr FRA,MF,Brest,fr Ligue 1,33,1988,0.3,1,1,0,1,0,0,0,,0,0,0,0,0,1,0,0,Matches
2117,Kalvin Phillips,eng ENG,MF,Leeds United,eng Premier League,25,1995,17.7,54,25,24,25,5,24,57,42.1,33,37,9,28,24,78,18,0,Matches
2118,Jaden Philogene Bidace,eng ENG,FW,Aston Villa,eng Premier League,19,2002,0.1,0,0,0,0,0,0,0,,0,0,0,0,0,0,0,0,Matches
2119,Jérôme Phojo,fr FRA,DF,Clermont Foot,fr Ligue 1,28,1993,0.1,0,0,0,0,0,0,0,,0,0,0,0,0,0,1,0,Matches
2120,Krzysztof Piątek,pl POL,FW,Fiorentina,it Serie A,26,1995,8.1,5,4,1,1,3,2,3,66.7,1,6,0,6,2,7,8,0,Matches
2121,Krzysztof Piątek,pl POL,FW,Hertha BSC,de Bundesliga,26,1995,3.9,2,2,0,1,1,0,1,0.0,1,0,0,0,0,2,6,0,Matches
2122,Pablo Piatti,ar ARG,"MF,FW",Elche,es La Liga,32,1989,3.5,9,4,5,3,1,3,8,37.5,5,5,1,4,2,11,3,0,Matches
2123,Cristiano Piccini,it ITA,DF,Valencia,es La Liga,28,1992,3.6,14,8,9,5,0,5,7,71.4,2,3,2,1,1,15,11,0,Matches
2124,Roberto Piccoli,it ITA,FW,Genoa,it Serie A,20,2001,2.4,1,1,0,1,0,0,0,,0,0,0,0,1,2,1,1,Matches
2125,Roberto Piccoli,it ITA,FW,Atalanta,it Serie A,20,2001,2.2,2,0,0,0,2,0,2,0.0,2,1,0,1,0,2,0,0,Matches
2126,Jordan Pickford,eng ENG,GK,Everton,eng Premier League,27,1994,35.0,1,1,1,0,0,0,1,0.0,1,1,0,1,1,2,14,1,Matches
2127,Jérémy Pied,fr FRA,"DF,FW",Lille,fr Ligue 1,32,1989,0.1,0,0,0,0,0,0,0,,0,0,0,0,1,1,0,0,Matches
2128,Amos Pieper,de GER,DF,Arminia,de Bundesliga,23,1998,26.4,58,29,38,19,1,32,51,62.7,19,37,23,14,50,108,132,1,Matches
2129,Ronaël Pierre-Gabriel,fr FRA,DF,Brest,fr Ligue 1,23,1998,28.3,79,45,52,21,6,42,73,57.5,31,22,7,15,48,127,74,0,Matches
2130,Erik Pieters,nl NED,DF,Burnley,eng Premier League,32,1988,8.1,28,15,15,11,2,17,28,60.7,11,18,7,11,10,38,38,0,Matches
2131,Tomás Pina Isla,es ESP,MF,Alavés,es La Liga,33,1987,16.0,28,16,13,11,4,14,29,48.3,15,12,3,9,22,50,23,0,Matches
2132,Andrea Pinamonti,it ITA,FW,Empoli,it Serie A,22,1999,31.9,11,6,0,7,4,2,18,11.1,16,24,3,21,7,18,23,0,Matches
2133,Orbelín Pineda,mx MEX,"MF,FW",Celta Vigo,es La Liga,25,1996,1.1,4,1,4,0,0,1,2,50.0,1,0,0,0,0,4,1,0,Matches
2134,Ethan Pinnock,jm JAM,DF,Brentford,eng Premier League,28,1993,29.9,51,35,37,12,2,25,38,65.8,13,30,11,19,44,95,154,1,Matches
2135,Yeremi Pino,es ESP,"MF,FW",Villarreal,es La Liga,18,2002,18.6,32,14,14,8,10,10,24,41.7,14,33,4,29,6,38,12,1,Matches
2136,Carlo Pinsoglio,it ITA,GK,Juventus,it Serie A,31,1990,0.5,0,0,0,0,0,0,0,,0,0,0,0,0,0,0,0,Matches
2137,Riccardo Pinzi,it ITA,FW,Udinese,it Serie A,17,2003,0.0,0,0,0,0,0,0,0,,0,0,0,0,0,0,0,0,Matches
2138,Gerard Piqué,es ESP,DF,Barcelona,es La Liga,34,1987,23.2,22,12,18,4,0,11,14,78.6,3,19,16,3,34,56,86,1,Matches
2139,Marko Pjaca,hr CRO,MF,Torino,it Serie A,26,1995,12.8,7,4,1,4,2,3,8,37.5,5,10,2,8,4,11,2,0,Matches
2140,Marvin Plattenhardt,de GER,DF,Hertha BSC,de Bundesliga,29,1992,18.2,25,11,18,6,1,15,27,55.6,12,18,3,15,17,42,52,0,Matches
2141,Alassane Pléa,fr FRA,"MF,FW",Gladbach,de Bundesliga,28,1993,23.0,18,14,6,9,3,7,20,35.0,13,9,1,8,4,22,9,0,Matches
2142,Tommaso Pobega,it ITA,MF,Torino,it Serie A,22,1999,24.9,48,30,17,20,11,21,40,52.5,19,32,3,29,25,73,38,0,Matches
2143,Daniel Podence,pt POR,"FW,MF",Wolves,eng Premier League,25,1995,16.5,18,11,10,5,3,4,17,23.5,13,8,1,7,10,28,1,0,Matches
2144,Suf Podgoreanu,il ISR,FW,Spezia,it Serie A,19,2002,1.3,2,0,1,1,0,1,4,25.0,3,2,0,2,1,3,3,0,Matches
2145,Paul Pogba,fr FRA,"MF,FW",Manchester Utd,eng Premier League,28,1993,15.0,13,9,5,7,1,6,28,21.4,22,11,0,11,13,26,16,0,Matches
2146,Joel Pohjanpalo,fi FIN,FW,Leverkusen,de Bundesliga,26,1994,0.1,0,0,0,0,0,0,0,,0,0,0,0,0,0,0,0,Matches
2147,Matteo Politano,it ITA,FW,Napoli,it Serie A,27,1993,18.3,24,12,8,11,5,15,54,27.8,39,11,2,9,13,37,5,0,Matches
2148,Julian Pollersbeck,de GER,GK,Lyon,fr Ligue 1,26,1994,4.8,0,0,0,0,0,0,0,,0,0,0,0,1,1,1,0,Matches
2149,Sebastian Polter,de GER,FW,Bochum,de Bundesliga,30,1991,26.0,9,3,1,4,4,2,11,18.2,9,15,5,10,2,11,24,0,Matches
2150,Ezequiel Ponce,ar ARG,FW,Elche,es La Liga,24,1997,7.4,5,4,1,3,1,3,10,30.0,7,5,0,5,1,6,7,0,Matches
2151,Marin Pongračić,hr CRO,DF,Dortmund,de Bundesliga,23,1997,9.2,17,10,13,4,0,6,10,60.0,4,11,5,6,17,34,32,2,Matches
2152,Pere Pons,es ESP,MF,Alavés,es La Liga,28,1993,15.2,26,18,4,20,2,7,21,33.3,14,10,1,9,6,32,11,0,Matches
2153,Nick Pope,eng ENG,GK,Burnley,eng Premier League,29,1992,36.0,0,0,0,0,0,0,2,0.0,2,0,0,0,2,2,30,3,Matches
2154,Manolo Portanova,it ITA,"FW,MF",Genoa,it Serie A,21,2000,14.7,46,28,9,26,11,14,34,41.2,20,26,2,24,17,63,22,0,Matches
2155,Portu,es ESP,"FW,MF",Real Sociedad,es La Liga,29,1992,17.7,16,7,2,6,8,3,19,15.8,16,21,3,18,7,23,8,0,Matches
2156,Stefan Posch,at AUT,DF,Hoffenheim,de Bundesliga,24,1997,24.4,48,30,20,26,2,22,39,56.4,17,43,18,25,28,76,71,2,Matches
2157,Sergio Postigo,es ESP,DF,Levante,es La Liga,32,1988,9.4,11,7,8,2,1,4,8,50.0,4,7,5,2,7,18,45,1,Matches
2158,Yussuf Poulsen,dk DEN,"FW,MF",RB Leipzig,de Bundesliga,27,1994,12.0,13,4,3,6,4,3,13,23.1,10,13,0,13,3,16,9,0,Matches
2159,Gaëtan Poussin,fr FRA,GK,Bordeaux,fr Ligue 1,22,1999,13.0,1,1,1,0,0,1,1,100.0,0,0,0,0,0,1,15,1,Matches
2160,Darío Poveda,es ESP,"FW,MF",Getafe,es La Liga,24,1997,4.2,2,0,1,0,1,0,5,0.0,5,7,1,6,1,3,1,0,Matches
2161,José Pozo,es ESP,"MF,DF",Rayo Vallecano,es La Liga,25,1996,0.8,2,2,0,2,0,2,3,66.7,1,1,0,1,0,2,1,0,Matches
2162,Dennis Praet,be BEL,MF,Torino,it Serie A,27,1994,17.1,19,10,6,8,5,8,22,36.4,14,12,1,11,3,22,4,0,Matches
2163,Mateusz Praszelik,pl POL,MF,Hellas Verona,it Serie A,20,2000,0.3,0,0,0,0,0,0,0,,0,0,0,0,0,0,0,0,Matches
2164,Abdón Prats,es ESP,FW,Mallorca,es La Liga,28,1992,7.1,2,2,1,0,1,1,5,20.0,4,5,0,5,1,3,6,0,Matches
2165,Sanjin Prcić,ba BIH,MF,Strasbourg,fr Ligue 1,27,1993,24.3,47,28,14,27,6,14,29,48.3,15,18,3,15,47,94,19,0,Matches
2166,Nicolas de Préville,fr FRA,"FW,MF",Metz,fr Ligue 1,30,1991,21.9,17,8,7,8,2,3,19,15.8,16,12,4,8,5,22,11,0,Matches
2167,Isaac Price,nir NIR,MF,Everton,eng Premier League,17,2003,0.2,0,0,0,0,0,0,0,,0,1,0,1,0,0,0,0,Matches
2168,Manuel Prietl,at AUT,MF,Arminia,de Bundesliga,29,1991,23.6,59,26,23,31,5,23,60,38.3,37,28,3,25,39,98,33,0,Matches
2169,Alejandro Primo,es ESP,GK,Levante,es La Liga,17,2004,1.0,0,0,0,0,0,0,0,,0,0,0,0,0,0,0,0,Matches
2170,Grischa Prömel,de GER,MF,Union Berlin,de Bundesliga,26,1995,26.9,36,22,14,17,5,22,52,42.3,30,18,3,15,23,59,22,0,Matches
2171,Nick Proschwitz,de GER,FW,Hoffenheim,de Bundesliga,34,1986,0.3,0,0,0,0,0,0,0,,0,0,0,0,0,0,0,0,Matches
2172,Ivan Provedel,it ITA,GK,Spezia,it Serie A,27,1994,30.7,0,0,0,0,0,0,1,0.0,1,0,0,0,2,2,10,2,Matches
2173,Javi Puado,es ESP,"MF,FW",Espanyol,es La Liga,23,1998,24.9,24,14,18,5,1,12,37,32.4,25,18,2,16,11,35,24,0,Matches
2174,Pubill,es ESP,"DF,MF",Levante,es La Liga,18,2003,5.7,12,6,10,2,0,4,8,50.0,4,7,2,5,4,16,8,2,Matches
2175,Antonio Puertas,es ESP,"MF,FW",Granada,es La Liga,29,1992,25.1,34,20,18,12,4,17,44,38.6,27,33,3,30,11,45,36,0,Matches
2176,Riqui Puig,es ESP,MF,Barcelona,es La Liga,21,1999,5.4,6,3,2,4,0,2,14,14.3,12,5,0,5,3,9,0,0,Matches
2177,Teemu Pukki,fi FIN,FW,Norwich City,eng Premier League,31,1990,36.1,23,11,2,14,7,6,29,20.7,23,21,1,20,4,27,3,0,Matches
2178,Erick Pulgar,cl CHI,MF,Fiorentina,it Serie A,27,1994,3.8,6,6,4,2,0,4,9,44.4,5,5,1,4,5,11,2,1,Matches
2179,Christian Pulisic,us USA,"MF,FW",Chelsea,eng Premier League,22,1998,14.3,10,7,6,3,1,3,17,17.6,14,12,0,12,5,15,10,0,Matches
2180,Afimico Pululu,fr FRA,"FW,MF",Greuther Fürth,de Bundesliga,22,1999,0.8,1,0,1,0,0,1,2,50.0,1,1,0,1,0,1,0,0,Matches
2181,Ignacio Pussetto,ar ARG,"FW,MF",Udinese,it Serie A,25,1995,13.4,17,9,2,9,6,2,10,20.0,8,18,2,16,4,21,13,0,Matches
2182,Niklas Pyyhtiä,fi FIN,MF,Bologna,it Serie A,17,2003,0.2,0,0,0,0,0,0,1,0.0,1,0,0,0,0,0,0,0,Matches
2183,Przemysław Płacheta,pl POL,"FW,MF",Norwich City,eng Premier League,23,1998,5.6,4,3,3,1,0,2,7,28.6,5,3,1,2,2,6,5,1,Matches
2184,Yacine Qasmi,ma MAR,FW,Rayo Vallecano,es La Liga,30,1991,0.0,0,0,0,0,0,0,0,,0,0,0,0,0,0,0,0,Matches
2185,Fabio Quagliarella,it ITA,FW,Sampdoria,it Serie A,38,1983,18.5,6,2,2,2,2,2,15,13.3,13,14,1,13,3,9,12,0,Matches
2186,Quini,es ESP,DF,Granada,es La Liga,31,1989,25.6,73,34,48,21,4,42,79,53.2,37,28,10,18,36,109,62,0,Matches
2187,Dani Raba,es ESP,"MF,FW",Villarreal,es La Liga,25,1995,1.0,1,0,0,1,0,1,2,50.0,1,2,0,2,0,1,2,0,Matches
2188,Dani Raba,es ESP,"MF,FW",Granada,es La Liga,25,1995,0.3,2,2,1,0,1,2,3,66.7,1,0,0,0,1,3,0,0,Matches
2189,Adrien Rabiot,fr FRA,MF,Juventus,it Serie A,26,1995,25.4,64,43,32,24,8,15,34,44.1,19,34,8,26,20,84,41,1,Matches
2190,Uroš Račić,rs SRB,MF,Valencia,es La Liga,23,1998,13.4,32,18,9,19,4,12,33,36.4,21,16,6,10,16,48,21,0,Matches
2191,Nemanja Radoja,rs SRB,MF,Levante,es La Liga,28,1993,13.5,25,8,9,13,3,8,20,40.0,12,16,9,7,22,47,16,2,Matches
2192,Nemanja Radonjić,rs SRB,FW,Marseille,fr Ligue 1,25,1996,0.2,0,0,0,0,0,0,0,,0,0,0,0,0,0,0,0,Matches
2193,Ivan Radovanović,rs SRB,"DF,MF",Salernitana,it Serie A,32,1988,11.7,11,7,8,3,0,7,19,36.8,12,14,7,7,7,18,29,0,Matches
2194,Ionuț Radu,ro ROU,GK,Inter,it Serie A,24,1997,1.0,0,0,0,0,0,0,0,,0,0,0,0,0,0,0,1,Matches
2195,Ștefan Radu,ro ROU,DF,Lazio,it Serie A,34,1986,6.2,9,6,3,6,0,5,9,55.6,4,7,2,5,5,14,15,0,Matches
2196,Boris Radunović,rs SRB,GK,Cagliari,it Serie A,25,1996,3.0,0,0,0,0,0,0,0,,0,0,0,0,0,0,0,0,Matches
2197,Sidney Raebiger,de GER,MF,RB Leipzig,de Bundesliga,16,2005,0.0,0,0,0,0,0,0,0,,0,0,0,0,0,0,0,0,Matches
2198,Rafinha,br BRA,MF,Real Sociedad,es La Liga,28,1993,11.7,43,27,17,20,6,16,28,57.1,12,21,2,19,12,55,4,0,Matches
2199,Rafinha,br BRA,"FW,MF",Paris S-G,fr Ligue 1,28,1993,2.4,14,8,3,9,2,7,11,63.6,4,3,0,3,4,18,0,0,Matches
2200,Antonio Raillo,es ESP,DF,Mallorca,es La Liga,29,1991,17.0,16,7,10,4,2,5,6,83.3,1,17,14,3,18,34,81,0,Matches
2201,Antonio Raimondo,it ITA,FW,Bologna,it Serie A,17,2004,0.8,0,0,0,0,0,0,1,0.0,1,1,0,1,0,0,1,0,Matches
2202,Predrag Rajković,rs SRB,GK,Reims,fr Ligue 1,25,1995,38.0,2,2,2,0,0,2,3,66.7,1,1,0,1,1,3,21,1,Matches
2203,Jesurun Rak Sakyi,eng ENG,"FW,MF",Crystal Palace,eng Premier League,18,2002,0.9,0,0,0,0,0,0,1,0.0,1,3,0,3,1,1,0,0,Matches
2204,Ivan Rakitić,hr CRO,MF,Sevilla,es La Liga,33,1988,24.2,40,22,12,23,5,13,40,32.5,27,31,8,23,23,63,35,0,Matches
2205,Diant Ramaj,de GER,GK,Eint Frankfurt,de Bundesliga,19,2001,1.0,0,0,0,0,0,0,0,,0,0,0,0,0,0,3,0,Matches
2206,Jonás Ramalho,es ESP,DF,Osasuna,es La Liga,28,1993,2.7,4,2,2,2,0,2,3,66.7,1,4,1,3,3,7,9,0,Matches
2207,Adil Rami,fr FRA,DF,Troyes,fr Ligue 1,35,1985,13.0,10,9,6,4,0,7,8,87.5,1,17,9,8,16,26,43,0,Matches
2208,Sandro Ramírez,es ESP,FW,Getafe,es La Liga,26,1995,16.2,7,3,1,3,3,1,12,8.3,11,14,3,11,2,9,3,0,Matches
2209,Guilherme Ramos,pt POR,DF,Arminia,de Bundesliga,23,1997,10.1,25,15,17,8,0,12,19,63.2,7,21,8,13,27,52,52,0,Matches
2210,Sergio Ramos,es ESP,DF,Paris S-G,fr Ligue 1,35,1986,8.9,12,5,6,6,0,8,15,53.3,7,4,2,2,8,20,27,0,Matches
2211,Aaron Ramsdale,eng ENG,GK,Arsenal,eng Premier League,23,1998,34.0,2,1,2,0,0,1,2,50.0,1,0,0,0,0,2,26,3,Matches
2212,Aaron Ramsey,wls WAL,MF,Juventus,it Serie A,30,1990,1.1,0,0,0,0,0,0,0,,0,0,0,0,1,1,0,0,Matches
2213,Jacob Ramsey,eng ENG,MF,Aston Villa,eng Premier League,20,2001,27.4,67,44,31,28,8,30,69,43.5,39,36,7,29,24,91,28,0,Matches
2214,Luca Ranieri,it ITA,DF,Salernitana,it Serie A,22,1999,23.4,38,21,23,11,4,19,33,57.6,14,18,8,10,22,60,67,0,Matches
2215,Andrea Ranocchia,it ITA,DF,Inter,it Serie A,33,1988,3.8,8,4,5,1,2,1,3,33.3,2,4,3,1,4,12,16,0,Matches
2216,Raphinha,br BRA,"FW,MF",Leeds United,eng Premier League,24,1996,32.4,51,29,25,14,12,22,71,31.0,49,43,0,43,29,80,28,1,Matches
2217,Tobias Raschl,de GER,MF,Greuther Fürth,de Bundesliga,21,2000,6.6,12,9,4,8,0,5,7,71.4,2,10,1,9,3,15,1,0,Matches
2218,Elba Rashani,xk KVX,"FW,MF",Clermont Foot,fr Ligue 1,28,1993,19.5,40,21,15,21,4,17,55,30.9,38,34,3,31,11,51,20,0,Matches
2219,Marcus Rashford,eng ENG,"FW,MF",Manchester Utd,eng Premier League,23,1997,13.7,6,5,1,4,1,2,13,15.4,11,10,1,9,5,11,5,1,Matches
2220,Milot Rashica,xk KVX,"FW,MF",Norwich City,eng Premier League,25,1996,24.8,31,19,12,12,7,11,30,36.7,19,22,3,19,15,46,23,0,Matches
2221,Giacomo Raspadori,it ITA,"MF,FW",Sassuolo,it Serie A,21,2000,30.4,29,18,5,15,9,11,38,28.9,27,29,3,26,9,38,11,0,Matches
2222,Raúl,es ESP,"FW,DF",Betis,es La Liga,20,2000,0.0,0,0,0,0,0,0,0,,0,0,0,0,0,0,0,0,Matches
2223,David Raum,de GER,"DF,FW",Hoffenheim,de Bundesliga,23,1998,30.6,52,29,30,10,12,30,64,46.9,34,38,5,33,27,79,39,1,Matches
2224,Nicola Ravaglia,it ITA,GK,Sampdoria,it Serie A,32,1988,0.1,0,0,0,0,0,0,0,,0,0,0,0,0,0,0,0,Matches
2225,David Raya,es ESP,GK,Brentford,eng Premier League,25,1995,24.0,0,0,0,0,0,0,0,,0,1,0,1,0,0,10,1,Matches
2226,Ante Rebić,hr CRO,FW,Milan,it Serie A,27,1993,9.9,14,8,3,6,5,7,20,35.0,13,14,0,14,3,17,3,1,Matches
2227,Arkadiusz Reca,pl POL,DF,Spezia,it Serie A,26,1995,19.7,31,19,21,3,7,20,30,66.7,10,20,7,13,32,63,47,2,Matches
2228,Lluís Recasens,es ESP,DF,Espanyol,es La Liga,19,2002,0.5,2,0,2,0,0,1,1,100.0,0,0,0,0,2,4,2,0,Matches
2229,Nathan Redmond,eng ENG,"MF,FW",Southampton,eng Premier League,27,1994,20.4,22,14,9,9,4,7,30,23.3,23,21,2,19,8,30,16,0,Matches
2230,Sergio Reguilón,es ESP,"DF,MF",Tottenham,eng Premier League,24,1996,21.3,40,24,15,18,7,22,43,51.2,21,20,8,12,31,71,45,1,Matches
2231,Manolo Reina,es ESP,GK,Mallorca,es La Liga,36,1985,21.0,0,0,0,0,0,0,0,,0,0,0,0,1,1,6,2,Matches
2232,Pepe Reina,es ESP,GK,Lazio,it Serie A,38,1982,15.0,0,0,0,0,0,0,1,0.0,1,0,0,0,0,0,1,1,Matches
2233,Jeff Reine-Adélaïde,fr FRA,"MF,DF",Lyon,fr Ligue 1,23,1998,2.2,5,3,4,1,0,4,5,80.0,1,2,0,2,0,5,0,1,Matches
2234,Reinier,br BRA,"FW,MF",Dortmund,de Bundesliga,19,2002,1.8,5,3,4,0,1,1,1,100.0,0,3,0,3,0,5,0,0,Matches
2235,Karim Rekik,nl NED,DF,Sevilla,es La Liga,26,1994,12.2,11,8,4,6,1,2,9,22.2,7,11,6,5,9,20,19,0,Matches
2236,Álex Remiro,es ESP,GK,Real Sociedad,es La Liga,26,1995,35.0,0,0,0,0,0,0,0,,0,0,0,0,1,1,24,2,Matches
2237,Panagiotis Retsos,gr GRE,DF,Hellas Verona,it Serie A,22,1998,0.6,0,0,0,0,0,0,2,0.0,2,0,0,0,2,2,3,0,Matches
2238,Panagiotis Retsos,gr GRE,"DF,FW",Leverkusen,de Bundesliga,22,1998,0.4,0,0,0,0,0,0,0,,0,0,0,0,1,1,0,1,Matches
2239,Marco Reus,de GER,"MF,FW",Dortmund,de Bundesliga,32,1989,27.8,45,30,13,21,11,16,42,38.1,26,23,6,17,12,57,41,1,Matches
2240,Elvis Rexhbeçaj,de GER,MF,Bochum,de Bundesliga,23,1997,28.2,41,20,17,19,5,19,40,47.5,21,41,6,35,27,68,15,0,Matches
2241,Gio Reyna,us USA,MF,Dortmund,de Bundesliga,18,2002,4.9,7,4,2,4,1,3,9,33.3,6,6,0,6,1,8,3,0,Matches
2242,Bryan Reynolds,us USA,DF,Roma,it Serie A,20,2001,0.0,0,0,0,0,0,0,1,0.0,1,0,0,0,0,0,1,0,Matches
2243,Nico Ribaudo,es ESP,"MF,FW",Espanyol,es La Liga,20,2001,12.4,15,6,9,5,1,11,34,32.4,23,14,2,12,7,22,3,0,Matches
2244,Tiago Ribeiro,pt POR,FW,Monaco,fr Ligue 1,19,2002,0.0,0,0,0,0,0,0,0,,0,0,0,0,0,0,0,0,Matches
2245,Franck Ribéry,fr FRA,"MF,FW",Salernitana,it Serie A,38,1983,15.8,17,10,6,6,5,8,13,61.5,5,12,0,12,3,20,1,0,Matches
2246,Samuele Ricci,it ITA,MF,Torino,it Serie A,19,2001,8.0,8,4,4,2,2,2,5,40.0,3,7,1,6,14,22,9,0,Matches
2247,Samuele Ricci,it ITA,MF,Empoli,it Serie A,19,2001,17.0,33,19,17,13,3,20,34,58.8,14,24,5,19,31,64,18,0,Matches
2248,Declan Rice,eng ENG,MF,West Ham,eng Premier League,22,1999,35.3,80,42,45,32,3,38,71,53.5,33,45,21,24,63,143,52,1,Matches
2249,Chris Richards,us USA,DF,Hoffenheim,de Bundesliga,21,2000,14.5,26,15,10,15,1,11,18,61.1,7,21,9,12,22,48,50,1,Matches
2250,Chris Richards,us USA,DF,Bayern Munich,de Bundesliga,21,2000,0.0,0,0,0,0,0,0,0,,0,1,0,1,0,0,0,0,Matches
2251,Omar Richards,eng ENG,DF,Bayern Munich,de Bundesliga,23,1998,4.9,19,12,11,5,3,11,16,68.8,5,7,1,6,4,23,7,0,Matches
2252,Taylor Richards,eng ENG,MF,Brighton,eng Premier League,20,2000,0.3,1,0,0,1,0,1,2,50.0,1,0,0,0,0,1,0,0,Matches
2253,Richarlison,br BRA,FW,Everton,eng Premier League,24,1997,28.0,40,23,18,15,7,15,31,48.4,16,42,4,38,12,52,34,0,Matches
2254,Marco Richter,de GER,"FW,MF",Hertha BSC,de Bundesliga,23,1997,18.9,30,16,14,10,6,13,36,36.1,23,30,4,26,16,46,24,0,Matches
2255,Diego Rico,es ESP,DF,Real Sociedad,es La Liga,28,1993,18.3,41,20,19,17,5,22,45,48.9,23,29,4,25,30,71,54,0,Matches
2256,Sergio Rico,es ESP,GK,Mallorca,es La Liga,27,1993,14.0,0,0,0,0,0,0,0,,0,0,0,0,0,0,5,2,Matches
2257,Sergio Rico,es ESP,GK,Paris S-G,fr Ligue 1,27,1993,0.3,0,0,0,0,0,0,0,,0,0,0,0,0,0,1,0,Matches
2258,Jaïro Riedewald,nl NED,MF,Crystal Palace,eng Premier League,24,1996,1.3,1,1,0,1,0,1,2,50.0,1,1,0,1,1,2,2,0,Matches
2259,Manuel Riemann,de GER,GK,Bochum,de Bundesliga,32,1988,31.0,1,0,1,0,0,1,4,25.0,3,0,0,0,1,2,12,3,Matches
2260,Tomás Rincón,ve VEN,MF,Torino,it Serie A,33,1988,1.8,2,2,2,0,0,0,3,0.0,3,3,1,2,2,4,4,0,Matches
2261,Tomás Rincón,ve VEN,MF,Sampdoria,it Serie A,33,1988,13.0,22,13,9,10,3,13,34,38.2,21,15,2,13,18,40,11,0,Matches
2262,Luis Rioja,es ESP,"MF,FW",Alavés,es La Liga,27,1993,34.6,28,15,11,10,7,14,58,24.1,44,22,1,21,25,53,20,0,Matches
2263,Renaud Ripart,fr FRA,"MF,FW",Troyes,fr Ligue 1,28,1993,21.0,38,21,18,15,5,18,50,36.0,32,21,1,20,19,57,21,1,Matches
2264,Mihailo Ristić,rs SRB,DF,Montpellier,fr Ligue 1,25,1995,20.0,44,32,26,16,2,25,43,58.1,18,16,6,10,17,61,48,0,Matches
2265,Matt Ritchie,sct SCO,DF,Newcastle Utd,eng Premier League,31,1989,14.9,22,15,10,10,2,10,27,37.0,17,10,2,8,13,35,26,0,Matches
2266,Maxence Rivera,fr FRA,FW,Saint-Étienne,fr Ligue 1,19,2002,0.1,0,0,0,0,0,0,0,,0,0,0,0,0,0,0,0,Matches
2267,Rober,es ESP,DF,Levante,es La Liga,26,1995,22.3,36,20,27,7,2,23,39,59.0,16,25,15,10,30,66,90,1,Matches
2268,Sergi Roberto,es ESP,"MF,DF",Barcelona,es La Liga,29,1992,4.4,5,1,2,3,0,3,5,60.0,2,2,0,2,4,9,6,0,Matches
2269,Connor Roberts,wls WAL,DF,Burnley,eng Premier League,25,1995,18.8,20,13,10,7,3,10,15,66.7,5,25,5,20,22,42,62,1,Matches
2270,Patrick Roberts,eng ENG,MF,Troyes,fr Ligue 1,24,1997,0.2,0,0,0,0,0,0,0,,0,0,0,0,0,0,0,0,Matches
2271,Tyler Roberts,wls WAL,"MF,FW",Leeds United,eng Premier League,22,1999,11.0,16,7,6,7,3,9,16,56.3,7,11,1,10,5,21,11,0,Matches
2272,Andrew Robertson,sct SCO,DF,Liverpool,eng Premier League,27,1994,28.2,36,21,16,15,5,20,35,57.1,15,24,3,21,23,59,61,0,Matches
2273,Marc Roca,es ESP,MF,Bayern Munich,de Bundesliga,24,1996,4.2,9,7,2,4,3,2,8,25.0,6,6,0,6,6,15,4,0,Matches
2274,Rubén Rochina,es ESP,"MF,FW",Granada,es La Liga,30,1991,8.3,21,13,7,8,6,8,28,28.6,20,11,1,10,6,27,5,1,Matches
2275,Cimo Röcker,de GER,DF,Hertha BSC,de Bundesliga,27,1994,0.2,0,0,0,0,0,0,0,,0,0,0,0,2,2,0,0,Matches
2276,Enzo Roco,cl CHI,DF,Elche,es La Liga,28,1992,28.4,36,20,24,11,1,15,24,62.5,9,38,27,11,28,64,110,3,Matches
2277,Stian Rode Gregersen,no NOR,DF,Bordeaux,fr Ligue 1,26,1995,21.7,39,26,23,12,4,18,33,54.5,15,26,16,10,38,77,103,2,Matches
2278,Sebastian Rode,de GER,MF,Eint Frankfurt,de Bundesliga,30,1990,8.4,15,7,5,8,2,5,17,29.4,12,11,1,10,13,28,8,0,Matches
2279,Joe Rodon,wls WAL,DF,Tottenham,eng Premier League,23,1997,1.0,0,0,0,0,0,0,0,,0,2,1,1,0,0,7,0,Matches
2280,Rodri,es ESP,MF,Manchester City,eng Premier League,25,1996,32.0,72,43,24,38,10,32,59,54.2,27,28,5,23,28,100,45,0,Matches
2281,Rodri,es ESP,FW,Betis,es La Liga,21,2000,9.8,10,7,4,5,1,5,22,22.7,17,11,0,11,3,13,4,0,Matches
2282,Rodrigo,es ESP,"MF,FW",Leeds United,eng Premier League,30,1991,25.2,20,9,7,6,7,4,32,12.5,28,12,0,12,11,31,27,1,Matches
2283,Gerson Rodrigues,lu LUX,"FW,MF",Troyes,fr Ligue 1,26,1995,9.4,12,9,2,6,4,1,17,5.9,16,8,1,7,0,12,2,0,Matches
2284,Kévin Rodrigues,pt POR,"DF,FW",Rayo Vallecano,es La Liga,27,1994,4.8,15,11,8,7,0,6,10,60.0,4,10,1,9,7,22,6,0,Matches
2285,Ángel Rodríguez,es ESP,"FW,MF",Mallorca,es La Liga,34,1987,17.2,15,9,6,7,2,4,21,19.0,17,15,1,14,3,18,13,0,Matches
2286,Óscar Rodríguez Arnaiz,es ESP,"MF,FW",Getafe,es La Liga,23,1998,10.5,16,11,6,8,2,4,12,33.3,8,7,1,6,11,27,6,0,Matches
2287,Óscar Rodríguez Arnaiz,es ESP,"FW,MF",Sevilla,es La Liga,23,1998,4.6,4,3,1,3,0,2,3,66.7,1,2,0,2,5,9,7,1,Matches
2288,Dani Rodríguez,es ESP,"MF,FW",Mallorca,es La Liga,33,1988,31.5,53,31,20,24,9,15,46,32.6,31,28,3,25,20,73,27,0,Matches
2289,Guido Rodríguez,ar ARG,MF,Betis,es La Liga,27,1994,28.1,97,53,46,45,6,54,98,55.1,44,55,12,43,31,128,56,0,Matches
2290,Jay Rodriguez,eng ENG,FW,Burnley,eng Premier League,32,1989,15.4,20,12,8,8,4,4,14,28.6,10,19,1,18,4,24,12,0,Matches
2291,Ricardo Rodríguez,ch SUI,DF,Torino,it Serie A,28,1992,27.5,36,21,11,23,2,18,33,54.5,15,22,8,14,41,77,48,1,Matches
2292,Rodrygo,br BRA,FW,Real Madrid,es La Liga,20,2001,16.9,18,14,7,4,7,3,18,16.7,15,21,0,21,11,29,3,0,Matches
2293,Mads Roerslev,dk DEN,DF,Brentford,eng Premier League,22,1999,13.8,23,12,19,2,2,14,32,43.8,18,14,5,9,16,39,29,0,Matches
2294,Marko Rog,hr CRO,MF,Cagliari,it Serie A,26,1995,3.5,5,3,1,2,2,1,8,12.5,7,6,1,5,1,6,3,0,Matches
2295,Rogério,br BRA,DF,Sassuolo,it Serie A,23,1998,19.2,21,13,12,5,4,15,22,68.2,7,20,8,12,18,39,42,1,Matches
2296,Alessio Romagnoli,it ITA,DF,Milan,it Serie A,26,1995,15.7,24,14,14,10,0,14,18,77.8,4,21,12,9,19,43,45,0,Matches
2297,Simone Romagnoli,it ITA,DF,Empoli,it Serie A,31,1990,16.6,28,12,14,12,2,15,20,75.0,5,34,28,6,9,37,86,0,Matches
2298,Leonardo Román,es ESP,GK,Mallorca,es La Liga,21,2000,2.0,0,0,0,0,0,0,0,,0,0,0,0,0,0,2,0,Matches
2299,Cristian Romero,ar ARG,DF,Tottenham,eng Premier League,23,1998,20.5,62,39,39,21,2,22,34,64.7,12,46,21,25,33,95,74,1,Matches
2300,Iván Romero,es ESP,FW,Sevilla,es La Liga,20,2001,2.0,2,2,0,2,0,0,0,,0,1,0,1,2,4,0,0,Matches
2301,Luka Romero,ar ARG,FW,Lazio,it Serie A,16,2004,0.9,2,1,0,1,1,0,2,0.0,2,0,0,0,1,3,0,0,Matches
2302,Sergio Romero,ar ARG,GK,Venezia,it Serie A,34,1987,16.0,2,2,2,0,0,2,2,100.0,0,0,0,0,1,3,10,0,Matches
2303,Oriol Romeu,es ESP,MF,Southampton,eng Premier League,29,1991,32.1,77,39,25,45,7,28,73,38.4,45,39,8,31,51,128,43,0,Matches
2304,Cristiano Ronaldo,pt POR,FW,Manchester Utd,eng Premier League,36,1985,27.3,8,6,1,5,2,2,6,33.3,4,8,0,8,2,10,29,0,Matches
2305,Cristiano Ronaldo,pt POR,FW,Juventus,it Serie A,36,1985,0.3,1,0,0,1,0,1,1,100.0,0,0,0,0,0,1,0,0,Matches
2306,Salomón Rondón,ve VEN,FW,Everton,eng Premier League,31,1989,8.8,6,1,1,2,3,4,14,28.6,10,5,0,5,0,6,10,0,Matches
2307,Valentin Rongier,fr FRA,"MF,DF",Marseille,fr Ligue 1,26,1994,24.4,77,51,36,36,5,28,60,46.7,32,26,5,21,33,110,14,0,Matches
2308,Marten de Roon,nl NED,"MF,DF",Atalanta,it Serie A,30,1991,28.3,69,42,33,29,7,34,62,54.8,28,36,2,34,45,114,41,0,Matches
2309,Unai Ropero,es ESP,MF,Alavés,es La Liga,19,2001,0.1,0,0,0,0,0,0,0,,0,0,0,0,1,1,0,0,Matches
2310,Pablo Rosario,nl NED,MF,Nice,fr Ligue 1,24,1997,30.3,59,37,18,32,9,26,66,39.4,40,33,7,26,38,97,43,0,Matches
2311,Romario Rösch,de GER,MF,Mainz 05,de Bundesliga,22,1999,0.0,0,0,0,0,0,0,0,,0,0,0,0,0,0,0,0,Matches
2312,Danny Rose,eng ENG,DF,Watford,eng Premier League,31,1990,7.7,16,10,11,4,1,10,24,41.7,14,8,5,3,14,30,11,1,Matches
2313,Francesco Rossi,it ITA,GK,Atalanta,it Serie A,30,1991,0.4,0,0,0,0,0,0,0,,0,0,0,0,0,0,0,0,Matches
2314,Tom Rothe,de GER,DF,Dortmund,de Bundesliga,16,2004,1.0,4,3,2,2,0,3,6,50.0,3,2,0,2,2,6,3,0,Matches
2315,Jérôme Roussillon,fr FRA,DF,Wolfsburg,de Bundesliga,28,1993,19.7,14,9,8,6,0,10,16,62.5,6,24,5,19,14,28,34,2,Matches
2316,Nicolò Rovella,it ITA,MF,Genoa,it Serie A,19,2001,16.3,37,26,16,14,7,15,40,37.5,25,21,1,20,20,57,20,0,Matches
2317,Jon Rowe,eng ENG,"FW,MF",Norwich City,eng Premier League,18,2003,2.5,3,2,2,1,0,2,3,66.7,1,7,0,7,3,6,1,0,Matches
2318,Amir Rrahmani,xk KVX,DF,Napoli,it Serie A,27,1994,32.5,21,11,15,5,1,15,19,78.9,4,36,25,11,19,40,89,0,Matches
2319,Ruan,br BRA,DF,Sassuolo,it Serie A,22,1999,2.4,7,4,7,0,0,3,4,75.0,1,6,5,1,2,9,24,1,Matches
2320,Rubén,es ESP,DF,Espanyol,es La Liga,20,2001,1.7,6,1,4,2,0,4,7,57.1,3,0,0,0,2,8,4,0,Matches
2321,John Ruddy,eng ENG,GK,Wolves,eng Premier League,34,1986,1.5,0,0,0,0,0,0,0,,0,0,0,0,0,0,3,0,Matches
2322,Antonio Rüdiger,de GER,DF,Chelsea,eng Premier League,28,1993,33.7,48,28,29,15,4,36,48,75.0,12,20,11,9,28,76,91,1,Matches
2323,Sebastian Rudy,de GER,MF,Hoffenheim,de Bundesliga,31,1990,8.6,22,12,9,13,0,11,21,52.4,10,8,3,5,11,33,8,1,Matches
2324,Daniele Rugani,it ITA,DF,Juventus,it Serie A,27,1994,9.8,8,5,4,4,0,4,7,57.1,3,9,4,5,11,19,47,0,Matches
2325,Matteo Ruggeri,it ITA,DF,Salernitana,it Serie A,19,2002,7.5,8,4,5,2,1,7,10,70.0,3,6,1,5,2,10,25,0,Matches
2326,Mário Rui,pt POR,DF,Napoli,it Serie A,30,1991,33.2,68,43,32,28,8,39,84,46.4,45,31,7,24,40,108,50,0,Matches
2327,Aitor Ruibal,es ESP,"FW,DF",Betis,es La Liga,25,1996,9.5,21,15,13,3,5,10,34,29.4,24,8,0,8,8,29,6,0,Matches
2328,Isma Ruiz,es ESP,MF,Granada,es La Liga,20,2001,3.1,3,1,3,0,0,1,9,11.1,8,5,2,3,3,6,2,0,Matches
2329,Fabián Ruiz Peña,es ESP,MF,Napoli,it Serie A,25,1996,26.5,55,33,22,29,4,29,67,43.3,38,34,1,33,22,77,32,0,Matches
2330,Víctor Ruiz,es ESP,DF,Betis,es La Liga,32,1989,15.8,11,9,7,2,2,6,9,66.7,3,18,13,5,29,40,71,1,Matches
2331,Gerónimo Rulli,ar ARG,GK,Villarreal,es La Liga,29,1992,32.0,0,0,0,0,0,0,4,0.0,4,0,0,0,1,1,15,5,Matches
2332,Lukas Rupp,de GER,MF,Norwich City,eng Premier League,30,1991,8.5,9,4,5,3,1,4,15,26.7,11,11,1,10,9,18,7,0,Matches
2333,Alessandro Russo,it ITA,MF,Salernitana,it Serie A,17,2003,0.3,1,0,1,0,0,0,1,0.0,1,0,0,0,0,1,1,0,Matches
2334,Franco Russo,ar ARG,DF,Mallorca,es La Liga,26,1994,16.3,19,10,10,9,0,13,31,41.9,18,14,9,5,27,46,73,1,Matches
2335,Georginio Rutter,fr FRA,"FW,MF",Hoffenheim,de Bundesliga,19,2002,17.9,18,13,4,8,6,6,17,35.3,11,29,1,28,6,24,11,1,Matches
2336,Mathew Ryan,au AUS,GK,Real Sociedad,es La Liga,29,1992,3.0,0,0,0,0,0,0,0,,0,0,0,0,0,0,2,0,Matches
2337,Julian Ryerson,no NOR,DF,Union Berlin,de Bundesliga,23,1997,15.9,27,15,11,12,4,17,25,68.0,8,12,4,8,16,43,32,0,Matches
2338,Frederik Rønnow,dk DEN,GK,Union Berlin,de Bundesliga,28,1992,7.0,0,0,0,0,0,0,0,,0,0,0,0,0,0,1,0,Matches
2339,José Sá,pt POR,GK,Wolves,eng Premier League,28,1993,36.5,2,1,2,0,0,2,4,50.0,2,0,0,0,2,4,19,5,Matches
2340,Roli Pereira de Sa,fr FRA,MF,Nantes,fr Ligue 1,24,1996,6.4,12,4,3,5,4,3,20,15.0,17,6,0,6,6,18,3,0,Matches
2341,Youssouf Sabaly,sn SEN,DF,Betis,es La Liga,28,1993,8.8,12,10,11,0,1,7,13,53.8,6,11,4,7,13,25,16,1,Matches
2342,Mathys Saban,fr FRA,"FW,MF",Saint-Étienne,fr Ligue 1,19,2002,0.8,4,2,2,2,0,1,1,100.0,0,1,0,1,0,4,0,0,Matches
2343,Stefano Sabelli,it ITA,DF,Genoa,it Serie A,28,1993,3.9,6,3,3,2,1,3,9,33.3,6,5,1,4,3,9,12,0,Matches
2344,Abdelhamid Sabiri,ma MAR,"MF,FW",Sampdoria,it Serie A,24,1996,9.9,34,18,10,15,9,7,25,28.0,18,10,2,8,7,41,3,0,Matches
2345,Marcel Sabitzer,at AUT,"MF,FW",RB Leipzig,de Bundesliga,27,1994,0.5,2,1,1,1,0,1,1,100.0,0,0,0,0,1,3,0,0,Matches
2346,Marcel Sabitzer,at AUT,"MF,DF",Bayern Munich,de Bundesliga,27,1994,10.1,18,7,8,8,2,9,19,47.4,10,7,0,7,9,27,10,1,Matches
2347,Falaye Sacko,ml MLI,DF,Saint-Étienne,fr Ligue 1,26,1995,7.4,15,10,14,1,0,13,16,81.3,3,11,7,4,4,19,18,2,Matches
2348,Alexis Saelemaekers,be BEL,FW,Milan,it Serie A,22,1999,20.7,43,22,12,17,14,15,51,29.4,36,19,0,19,15,58,8,0,Matches
2349,Rafiki Said,km COM,"MF,FW",Brest,fr Ligue 1,21,2000,1.4,4,3,1,2,1,3,4,75.0,1,2,0,2,0,4,0,0,Matches
2350,Wesley Saïd,fr FRA,"FW,MF",Lens,fr Ligue 1,26,1995,7.3,10,5,1,8,1,1,9,11.1,8,4,0,4,2,12,0,0,Matches
2351,Allan Saint-Maximin,fr FRA,"FW,MF",Newcastle Utd,eng Premier League,24,1997,31.2,13,8,6,4,3,3,17,17.6,14,13,2,11,11,24,3,0,Matches
2352,Romain Saïss,ma MAR,DF,Wolves,eng Premier League,31,1990,30.1,40,27,28,11,1,19,33,57.6,14,41,21,20,58,98,158,2,Matches
2353,Bukayo Saka,eng ENG,"FW,MF",Arsenal,eng Premier League,19,2001,33.1,40,21,12,17,11,13,39,33.3,26,28,2,26,22,62,23,0,Matches
2354,Mamadou Sakho,fr FRA,DF,Montpellier,fr Ligue 1,31,1990,28.6,34,22,26,8,0,16,26,61.5,10,41,34,7,41,75,134,4,Matches
2355,Bakary Sako,ml MLI,"FW,MF",Saint-Étienne,fr Ligue 1,33,1988,1.7,0,0,0,0,0,0,1,0.0,1,3,1,2,0,0,0,0,Matches
2356,Jacopo Sala,it ITA,MF,Spezia,it Serie A,29,1991,9.8,22,11,10,10,2,13,30,43.3,17,6,0,6,14,36,11,0,Matches
2357,Mohamed Salah,eg EGY,FW,Liverpool,eng Premier League,29,1992,30.7,17,8,5,9,3,6,19,31.6,13,7,1,6,6,23,5,0,Matches
2358,Eddie Salcedo,it ITA,"MF,FW",Spezia,it Serie A,19,2001,4.8,1,1,0,0,1,0,1,0.0,1,2,1,1,0,1,7,1,Matches
2359,William Saliba,fr FRA,DF,Marseille,fr Ligue 1,20,2001,36.0,54,32,36,16,2,27,35,77.1,8,24,16,8,48,102,85,0,Matches
2360,Romain Salin,fr FRA,GK,Rennes,fr Ligue 1,37,1984,1.0,0,0,0,0,0,0,0,,0,0,0,0,0,0,0,0,Matches
2361,Mohammed Salisu,gh GHA,DF,Southampton,eng Premier League,22,1999,33.0,80,47,54,22,4,40,65,61.5,25,49,26,23,78,158,158,4,Matches
2362,Roland Sallai,hu HUN,"MF,FW",Freiburg,de Bundesliga,24,1997,17.2,22,16,8,11,3,7,23,30.4,16,12,0,12,11,33,12,0,Matches
2363,Yoann Salmier,gf GUF,DF,Troyes,fr Ligue 1,28,1992,29.6,58,33,44,11,3,26,34,76.5,8,30,14,16,40,98,94,0,Matches
2364,Salvi,es ESP,"MF,FW",Cádiz,es La Liga,30,1991,15.5,20,10,9,8,3,8,20,40.0,12,17,2,15,6,26,11,0,Matches
2365,Lazar Samardzic,rs SRB,"MF,FW",Udinese,it Serie A,19,2002,5.4,13,9,4,7,2,7,26,26.9,19,6,0,6,2,15,2,0,Matches
2366,Diadie Samassékou,ml MLI,MF,Hoffenheim,de Bundesliga,25,1996,18.4,41,26,14,21,6,21,44,47.7,23,27,11,16,28,69,26,0,Matches
2367,Mama Samba Baldé,gw GNB,"MF,FW",Troyes,fr Ligue 1,25,1995,19.1,40,28,16,14,10,8,26,30.8,18,32,1,31,5,45,9,0,Matches
2368,Albert Sambi Lokonga,be BEL,MF,Arsenal,eng Premier League,21,1999,12.6,22,18,11,9,2,12,14,85.7,2,12,7,5,13,35,12,4,Matches
2369,Junior Sambia,fr FRA,"DF,FW",Montpellier,fr Ligue 1,24,1996,17.0,22,13,12,7,3,13,22,59.1,9,22,3,19,21,43,31,0,Matches
2370,Luigi Samele,it ITA,FW,Sassuolo,it Serie A,19,2002,0.1,0,0,0,0,0,0,0,,0,0,0,0,0,0,1,0,Matches
2371,Fede San Emeterio,es ESP,MF,Cádiz,es La Liga,24,1997,9.2,16,5,5,8,3,5,15,33.3,10,5,0,5,8,24,6,0,Matches
2372,Antonio Sanabria,py PAR,FW,Torino,it Serie A,25,1996,20.0,3,2,0,1,2,1,4,25.0,3,11,4,7,2,5,10,0,Matches
2373,Oihan Sancet,es ESP,FW,Athletic Club,es La Liga,21,2000,15.8,12,7,2,8,2,5,20,25.0,15,2,0,2,5,17,13,0,Matches
2374,Renato Sanches,pt POR,"MF,FW",Lille,fr Ligue 1,23,1997,18.3,19,7,8,10,1,9,26,34.6,17,14,3,11,14,33,7,0,Matches
2375,Alexis Sánchez,cl CHI,FW,Inter,it Serie A,32,1988,9.8,9,8,0,6,3,2,11,18.2,9,4,0,4,2,11,3,0,Matches
2376,Antonio Sánchez,es ESP,"MF,FW",Mallorca,es La Liga,24,1997,18.0,53,24,29,17,7,19,49,38.8,30,32,2,30,32,85,32,1,Matches
2377,Davinson Sánchez,co COL,DF,Tottenham,eng Premier League,25,1996,18.1,41,22,25,14,2,19,28,67.9,9,24,16,8,30,71,54,3,Matches
2378,Germán Sánchez,es ESP,DF,Granada,es La Liga,34,1986,25.5,27,19,18,9,0,11,20,55.0,9,19,16,3,28,55,137,0,Matches
2379,Manu Sánchez,es ESP,DF,Osasuna,es La Liga,20,2000,25.1,72,34,41,22,9,43,79,54.4,36,28,3,25,18,90,43,0,Matches
2380,Robert Sánchez,es ESP,GK,Brighton,eng Premier League,23,1997,37.0,2,1,2,0,0,1,1,100.0,0,1,0,1,0,2,11,4,Matches
2381,Jadon Sancho,eng ENG,"FW,MF",Manchester Utd,eng Premier League,21,2000,21.1,14,8,9,4,1,8,22,36.4,14,19,0,19,15,29,5,3,Matches
2382,Philippe Sandler,nl NED,DF,Troyes,fr Ligue 1,24,1997,0.8,0,0,0,0,0,0,0,,0,1,1,0,3,3,6,0,Matches
2383,Alex Sandro,br BRA,DF,Juventus,it Serie A,30,1991,19.8,27,16,15,9,3,11,25,44.0,14,17,6,11,27,54,40,0,Matches
2384,Leroy Sané,de GER,"FW,MF",Bayern Munich,de Bundesliga,25,1996,22.0,28,16,5,19,4,9,24,37.5,15,18,0,18,12,40,2,1,Matches
2385,Oier Sanjurjo,es ESP,MF,Osasuna,es La Liga,35,1986,8.4,10,6,3,7,0,2,19,10.5,17,8,3,5,1,11,9,0,Matches
2386,Mohamed Sankoh,nl NED,FW,Stuttgart,de Bundesliga,17,2003,0.0,0,0,0,0,0,0,0,,0,0,0,0,0,0,0,0,Matches
2387,Morgan Sanson,fr FRA,MF,Aston Villa,eng Premier League,26,1994,4.0,12,8,7,2,3,3,7,42.9,4,13,0,13,10,22,2,1,Matches
2388,Nicola Sansone,it ITA,"FW,MF",Bologna,it Serie A,29,1991,10.0,13,7,5,6,2,3,15,20.0,12,1,0,1,4,17,2,0,Matches
2389,Baptiste Santamaria,fr FRA,"MF,DF",Rennes,fr Ligue 1,26,1995,28.0,52,27,15,31,6,24,44,54.5,20,33,12,21,33,85,42,0,Matches
2390,Baptiste Santamaria,fr FRA,MF,Freiburg,de Bundesliga,26,1995,0.2,0,0,0,0,0,0,1,0.0,1,0,0,0,1,1,1,0,Matches
2391,Federico Santander,py PAR,"FW,DF",Bologna,it Serie A,30,1991,0.7,2,1,1,1,0,1,1,100.0,0,0,0,0,0,2,0,0,Matches
2392,Jesús Santiago,es ESP,MF,Valencia,es La Liga,17,2004,0.9,2,2,1,1,0,0,2,0.0,2,1,0,1,0,2,1,0,Matches
2393,Samir Santos,br BRA,DF,Watford,eng Premier League,26,1994,18.6,24,11,18,6,0,8,19,42.1,11,21,11,10,43,67,85,3,Matches
2394,Samir Santos,br BRA,DF,Udinese,it Serie A,26,1994,15.8,36,16,22,13,1,15,25,60.0,10,21,7,14,42,78,62,0,Matches
2395,Sergio Santos,es ESP,DF,Real Madrid,es La Liga,20,2001,0.1,0,0,0,0,0,0,0,,0,0,0,0,0,0,0,0,Matches
2396,Alvaro Sanz,es ESP,MF,Barcelona,es La Liga,20,2001,0.3,0,0,0,0,0,0,1,0.0,1,0,0,0,0,0,0,0,Matches
2397,Riccardo Saponara,it ITA,FW,Fiorentina,it Serie A,29,1991,14.3,10,2,1,6,3,6,16,37.5,10,5,0,5,1,11,3,0,Matches
2398,Pablo Sarabia,es ESP,FW,Paris S-G,fr Ligue 1,29,1992,0.2,0,0,0,0,0,0,1,0.0,1,0,0,0,0,0,0,0,Matches
2399,Marcelo Saracchi,uy URU,DF,Levante,es La Liga,23,1998,2.1,8,5,6,1,1,2,4,50.0,2,3,0,3,4,12,7,1,Matches
2400,Josh Sargent,us USA,"FW,MF",Norwich City,eng Premier League,21,2000,17.5,26,14,15,7,4,14,39,35.9,25,29,2,27,11,37,18,2,Matches
2401,Jeremy Sarmiento,ec ECU,"FW,MF",Brighton,eng Premier League,19,2002,0.5,1,1,0,0,1,0,2,0.0,2,2,0,2,0,1,0,0,Matches
2402,Bouna Sarr,sn SEN,DF,Bayern Munich,de Bundesliga,29,1992,0.7,4,4,2,1,1,4,5,80.0,1,2,1,1,6,10,1,0,Matches
2403,Ismaila Sarr,sn SEN,"FW,MF",Watford,eng Premier League,23,1998,20.7,12,7,4,3,5,5,19,26.3,14,10,1,9,9,21,10,0,Matches
2404,Malang Sarr,fr FRA,DF,Chelsea,eng Premier League,22,1999,6.1,14,7,10,2,2,7,12,58.3,5,6,3,3,11,25,20,0,Matches
2405,Joan Sastre Vanrell,es ESP,DF,Mallorca,es La Liga,24,1997,2.9,6,3,5,0,1,3,4,75.0,1,3,0,3,2,8,10,0,Matches
2406,Giacomo Satalino,it ITA,GK,Sassuolo,it Serie A,22,1999,0.1,0,0,0,0,0,0,0,,0,0,0,0,0,0,0,0,Matches
2407,Martin Satriano,uy URU,"FW,MF",Inter,it Serie A,20,2001,0.4,1,0,0,0,1,1,1,100.0,0,0,0,0,0,1,0,0,Matches
2408,Martin Satriano,uy URU,FW,Brest,fr Ligue 1,20,2001,10.4,5,2,1,1,3,2,7,28.6,5,8,0,8,2,7,3,0,Matches
2409,Téji Savanier,fr FRA,MF,Montpellier,fr Ligue 1,29,1991,26.8,46,27,18,19,9,21,59,35.6,38,23,1,22,25,71,12,1,Matches
2410,Esteban Saveljich,me MNE,DF,Rayo Vallecano,es La Liga,30,1991,18.9,18,11,11,7,0,9,15,60.0,6,20,12,8,16,34,69,0,Matches
2411,Stefan Savić,me MNE,DF,Atlético Madrid,es La Liga,30,1991,27.1,46,20,25,20,1,29,43,67.4,14,19,12,7,37,83,102,1,Matches
2412,Joe Scally,us USA,DF,Gladbach,de Bundesliga,18,2002,21.2,40,30,21,14,5,17,41,41.5,24,27,4,23,22,62,38,0,Matches
2413,Giorgio Scalvini,it ITA,"DF,MF",Atalanta,it Serie A,17,2003,8.5,22,11,13,8,1,9,19,47.4,10,12,1,11,22,44,16,0,Matches
2414,Gianluca Scamacca,it ITA,FW,Sassuolo,it Serie A,22,1999,23.8,19,14,2,5,12,5,21,23.8,16,16,1,15,5,24,22,1,Matches
2415,Dane Scarlett,eng ENG,MF,Tottenham,eng Premier League,17,2004,0.0,0,0,0,0,0,0,0,,0,0,0,0,0,0,0,0,Matches
2416,Kevin Schade,de GER,"MF,FW",Freiburg,de Bundesliga,19,2001,9.2,9,7,6,2,1,3,10,30.0,7,15,3,12,3,12,16,0,Matches
2417,András Schäfer,hu HUN,MF,Union Berlin,de Bundesliga,22,1999,2.7,4,1,3,1,0,0,5,0.0,5,7,1,6,2,6,4,0,Matches
2418,Fabian Schär,ch SUI,DF,Newcastle Utd,eng Premier League,29,1991,24.0,16,11,11,3,2,8,16,50.0,8,27,18,9,32,48,95,2,Matches
2419,Louis Schaub,at AUT,"MF,FW",Köln,de Bundesliga,26,1994,7.3,16,10,7,7,2,11,20,55.0,9,17,3,14,3,19,3,0,Matches
2420,Andrea Schiavone,it ITA,MF,Salernitana,it Serie A,28,1993,6.3,14,8,5,9,0,10,23,43.5,13,13,3,10,8,22,12,0,Matches
2421,Patrik Schick,cz CZE,FW,Leverkusen,de Bundesliga,25,1996,23.1,5,2,2,2,1,1,9,11.1,8,6,1,5,3,8,28,0,Matches
2422,Kingsley Schindler,gh GHA,"DF,FW",Köln,de Bundesliga,28,1993,3.9,1,0,0,0,1,1,5,20.0,4,5,1,4,5,6,5,0,Matches
2423,Xaver Schlager,at AUT,MF,Wolfsburg,de Bundesliga,23,1997,11.6,43,20,20,20,3,20,49,40.8,29,25,2,23,9,52,14,0,Matches
2424,Keven Schlotterbeck,de GER,"DF,FW",Freiburg,de Bundesliga,24,1997,3.5,11,5,6,5,0,5,6,83.3,1,7,4,3,11,22,24,1,Matches
2425,Nico Schlotterbeck,de GER,DF,Freiburg,de Bundesliga,21,1999,30.9,72,43,36,34,2,33,48,68.8,15,41,32,9,56,128,154,1,Matches
2426,Jeffrey Schlupp,gh GHA,"MF,FW",Crystal Palace,eng Premier League,28,1992,20.6,46,25,16,23,7,24,50,48.0,26,39,9,30,18,64,32,0,Matches
2427,Kasper Schmeichel,dk DEN,GK,Leicester City,eng Premier League,34,1986,37.0,0,0,0,0,0,0,2,0.0,2,0,0,0,1,1,15,2,Matches
2428,Jonathan Schmid,fr FRA,DF,Freiburg,de Bundesliga,31,1990,6.5,12,6,6,3,3,5,7,71.4,2,7,1,6,6,18,15,0,Matches
2429,Benno Schmitz,de GER,DF,Köln,de Bundesliga,26,1994,26.9,57,37,21,27,9,42,86,48.8,44,44,8,36,39,96,39,0,Matches
2430,David Schnegg,at AUT,DF,Venezia,it Serie A,22,1998,1.6,2,0,1,1,0,1,3,33.3,2,4,0,4,3,5,6,0,Matches
2431,Morgan Schneiderlin,fr FRA,MF,Nice,fr Ligue 1,31,1989,7.2,21,12,9,11,1,6,13,46.2,7,8,2,6,20,41,18,0,Matches
2432,Alessandro Schöpf,at AUT,MF,Arminia,de Bundesliga,27,1994,26.6,40,22,19,16,5,14,30,46.7,16,31,5,26,30,70,21,1,Matches
2433,Jerdy Schouten,nl NED,MF,Bologna,it Serie A,24,1997,15.5,25,17,10,12,3,9,22,40.9,13,22,5,17,33,58,29,1,Matches
2434,Nico Schulz,de GER,DF,Dortmund,de Bundesliga,28,1993,9.3,21,12,9,7,5,9,21,42.9,12,8,1,7,11,32,8,0,Matches
2435,Marvin Schwäbe,de GER,GK,Köln,de Bundesliga,26,1995,21.0,0,0,0,0,0,0,0,,0,0,0,0,0,0,8,1,Matches
2436,Alexander Schwolow,de GER,GK,Hertha BSC,de Bundesliga,29,1992,24.2,0,0,0,0,0,0,1,0.0,1,0,0,0,2,2,18,3,Matches
2437,Valentino Scotta,es ESP,DF,Sevilla,es La Liga,19,2001,0.0,0,0,0,0,0,0,0,,0,0,0,0,0,0,0,0,Matches
2438,Demba Seck,sn SEN,"MF,FW",Torino,it Serie A,20,2001,1.6,2,1,0,2,0,0,0,,0,0,0,0,0,2,0,0,Matches
2439,Aleksandar Sedlar,rs SRB,"DF,MF",Mallorca,es La Liga,29,1991,4.5,5,3,4,1,0,3,5,60.0,2,4,4,0,5,10,19,0,Matches
2440,Paul Seguin,de GER,MF,Greuther Fürth,de Bundesliga,26,1995,23.4,50,31,15,32,3,26,56,46.4,30,27,3,24,19,69,30,1,Matches
2441,Alidu Seidu,gh GHA,DF,Clermont Foot,fr Ligue 1,21,2000,15.7,34,20,20,13,1,16,27,59.3,11,25,11,14,34,68,49,1,Matches
2442,Davie Selke,de GER,FW,Hertha BSC,de Bundesliga,26,1995,11.2,5,4,1,3,1,1,3,33.3,2,6,1,5,1,6,11,0,Matches
2443,Matz Sels,be BEL,GK,Strasbourg,fr Ligue 1,29,1992,37.0,1,1,1,0,0,0,0,,0,0,0,0,1,2,22,0,Matches
2444,Ken Sema,se SWE,"MF,FW",Watford,eng Premier League,27,1993,9.5,16,6,11,4,1,9,20,45.0,11,10,0,10,5,21,11,0,Matches
2445,Nélson Semedo,pt POR,"MF,DF",Wolves,eng Premier League,27,1993,23.7,58,39,39,17,2,25,49,51.0,24,23,4,19,21,79,64,1,Matches
2446,Lion Semić,de GER,DF,Dortmund,de Bundesliga,17,2003,0.0,0,0,0,0,0,0,0,,0,0,0,0,0,0,0,0,Matches
2447,Adrian Šemper,hr CRO,GK,Genoa,it Serie A,23,1998,1.0,0,0,0,0,0,0,0,,0,0,0,0,0,0,0,0,Matches
2448,Stefano Sensi,it ITA,"MF,FW",Sampdoria,it Serie A,25,1995,8.4,18,9,10,6,2,10,23,43.5,13,2,0,2,6,24,4,0,Matches
2449,Stefano Sensi,it ITA,"MF,FW",Inter,it Serie A,25,1995,1.9,4,3,1,3,0,2,4,50.0,2,2,0,2,0,4,2,0,Matches
2450,Luigi Sepe,it ITA,GK,Salernitana,it Serie A,30,1991,15.5,0,0,0,0,0,0,0,,0,0,0,0,1,1,3,0,Matches
2451,Suat Serdar,de GER,"MF,FW",Hertha BSC,de Bundesliga,24,1997,24.6,64,30,24,29,11,25,55,45.5,30,32,3,29,20,84,14,0,Matches
2452,Laurens Serpe,it ITA,DF,Genoa,it Serie A,20,2001,0.5,1,0,1,0,0,1,2,50.0,1,0,0,0,0,1,1,0,Matches
2453,Janni Serra,de GER,FW,Arminia,de Bundesliga,23,1998,12.4,4,2,2,0,2,2,7,28.6,5,8,3,5,5,9,19,0,Matches
2454,Javier Serrano,es ESP,MF,Atlético Madrid,es La Liga,18,2003,0.8,3,1,0,3,0,2,4,50.0,2,0,0,0,3,6,2,0,Matches
2455,Nicolás Serrano,es ESP,"MF,FW",Athletic Club,es La Liga,18,2003,3.5,9,6,3,5,1,3,10,30.0,7,5,1,4,2,11,3,0,Matches
2456,Zidan Sertdemir,dk DEN,"MF,FW",Leverkusen,de Bundesliga,16,2005,0.2,2,2,2,0,0,0,0,,0,0,0,0,0,2,0,0,Matches
2457,Ryan Sessegnon,eng ENG,"DF,MF",Tottenham,eng Premier League,21,2000,11.6,25,19,14,7,4,11,22,50.0,11,18,3,15,7,32,26,0,Matches
2458,Nils Seufert,de GER,MF,Greuther Fürth,de Bundesliga,24,1997,1.1,3,2,1,1,1,0,1,0.0,1,0,0,0,0,3,0,0,Matches
2459,Salva Sevilla,es ESP,MF,Mallorca,es La Liga,37,1984,16.7,18,12,8,8,2,6,17,35.3,11,12,6,6,14,32,11,0,Matches
2460,Stephan El Shaarawy,it ITA,"FW,DF",Roma,it Serie A,28,1992,11.7,13,8,4,9,0,4,6,66.7,2,10,2,8,11,24,8,0,Matches
2461,Jamie Shackleton,eng ENG,"DF,MF",Leeds United,eng Premier League,21,1999,7.9,27,16,19,7,1,13,25,52.0,12,11,7,4,8,35,12,1,Matches
2462,Xherdan Shaqiri,ch SUI,"FW,MF",Lyon,fr Ligue 1,29,1991,7.5,7,3,0,5,2,2,10,20.0,8,2,0,2,2,9,2,0,Matches
2463,Luke Shaw,eng ENG,DF,Manchester Utd,eng Premier League,26,1995,17.8,21,13,9,9,3,12,21,57.1,9,22,11,11,9,30,22,2,Matches
2464,Jonjo Shelvey,eng ENG,MF,Newcastle Utd,eng Premier League,29,1992,22.0,30,17,12,18,0,14,34,41.2,20,22,7,15,22,52,20,2,Matches
2465,Aimar Sher,se SWE,MF,Spezia,it Serie A,18,2002,0.5,2,1,1,1,0,0,1,0.0,1,1,0,1,3,5,1,0,Matches
2466,Eldor Shomurodov,uz UZB,"FW,MF",Roma,it Serie A,26,1995,8.7,5,4,0,4,1,1,10,10.0,9,8,0,8,2,7,5,0,Matches
2467,Shola Shoretire,eng ENG,MF,Manchester Utd,eng Premier League,17,2004,0.2,0,0,0,0,0,0,0,,0,0,0,0,0,0,0,0,Matches
2468,Mahame Siby,ml MLI,DF,Strasbourg,fr Ligue 1,25,1996,0.2,0,0,0,0,0,0,0,,0,0,0,0,1,1,2,0,Matches
2469,Aboubakar Sidibé,fr FRA,DF,Clermont Foot,fr Ligue 1,25,1996,0.1,0,0,0,0,0,0,0,,0,0,0,0,0,0,0,0,Matches
2470,Alassane Sidibe,ci CIV,MF,Atalanta,it Serie A,19,2002,0.1,1,1,1,0,0,0,0,,0,0,0,0,0,1,0,0,Matches
2471,Djibril Sidibé,fr FRA,DF,Monaco,fr Ligue 1,29,1992,10.5,24,13,13,8,3,9,24,37.5,15,10,1,9,16,40,13,0,Matches
2472,Kaj Sierhuis,nl NED,FW,Reims,fr Ligue 1,23,1998,0.9,1,1,1,0,0,1,3,33.3,2,0,0,0,0,1,1,0,Matches
2473,Francisco Sierralta,cl CHI,DF,Watford,eng Premier League,24,1997,4.7,7,3,7,0,0,5,8,62.5,3,7,2,5,6,13,35,0,Matches
2474,Arnór Sigurðsson,is ISL,"FW,MF",Venezia,it Serie A,22,1999,2.0,1,1,0,1,0,1,2,50.0,1,2,0,2,1,2,0,0,Matches
2475,Kiliann Sildillia,fr FRA,"DF,MF",Freiburg,de Bundesliga,19,2002,1.9,7,3,3,4,0,3,6,50.0,3,1,0,1,2,9,7,1,Matches
2476,Adrien Silva,pt POR,MF,Sampdoria,it Serie A,32,1989,12.0,24,12,14,5,5,9,33,27.3,24,15,5,10,23,47,23,0,Matches
2477,André Silva,pt POR,FW,RB Leipzig,de Bundesliga,25,1995,23.1,13,9,2,3,8,4,13,30.8,9,20,2,18,2,15,15,0,Matches
2478,Bernardo Silva,pt POR,"MF,FW",Manchester City,eng Premier League,26,1994,31.7,57,29,19,19,19,31,67,46.3,36,24,2,22,20,77,19,0,Matches
2479,Caio Henrique Oliveira Silva,br BRA,DF,Monaco,fr Ligue 1,24,1997,29.6,53,30,31,18,4,28,59,47.5,31,30,6,24,27,80,37,3,Matches
2480,David Silva,es ESP,MF,Real Sociedad,es La Liga,35,1986,19.1,28,17,10,11,7,3,20,15.0,17,13,3,10,7,35,12,0,Matches
2481,Fábio Silva,pt POR,FW,Wolves,eng Premier League,19,2002,6.4,3,2,0,2,1,0,8,0.0,8,2,0,2,1,4,1,0,Matches
2482,Gabriel Silva,br BRA,"DF,MF",Saint-Étienne,fr Ligue 1,30,1991,7.9,12,7,7,2,3,9,13,69.2,4,9,3,6,18,30,13,0,Matches
2483,Jonathan Silva,ar ARG,"DF,FW",Getafe,es La Liga,27,1994,2.5,10,8,4,4,2,7,12,58.3,5,4,0,4,3,13,7,0,Matches
2484,Rui Silva,pt POR,GK,Betis,es La Liga,27,1994,21.8,1,0,1,0,0,1,2,50.0,1,0,0,0,1,2,11,1,Matches
2485,Thiago Silva,br BRA,DF,Chelsea,eng Premier League,36,1984,29.4,32,21,19,12,1,11,22,50.0,11,54,31,23,44,76,100,0,Matches
2486,Marco Silvestri,it ITA,GK,Udinese,it Serie A,30,1991,35.0,0,0,0,0,0,0,1,0.0,1,0,0,0,1,1,11,1,Matches
2487,Mohamed Simakan,fr FRA,DF,RB Leipzig,de Bundesliga,21,2000,22.3,48,27,25,21,2,27,41,65.9,14,22,11,11,40,88,46,1,Matches
2488,Giovanni Simeone,ar ARG,FW,Hellas Verona,it Serie A,26,1995,29.5,27,15,6,12,9,9,39,23.1,30,37,3,34,6,33,23,0,Matches
2489,Giovanni Simeone,ar ARG,FW,Cagliari,it Serie A,26,1995,0.1,0,0,0,0,0,0,0,,0,0,0,0,0,0,0,0,Matches
2490,Giuliano Simeone,ar ARG,MF,Atlético Madrid,es La Liga,18,2002,0.0,0,0,0,0,0,0,0,,0,0,0,0,0,0,0,0,Matches
2491,Ellis Simms,eng ENG,FW,Everton,eng Premier League,20,2001,0.7,0,0,0,0,0,0,0,,0,1,1,0,0,0,1,0,Matches
2492,Moses Simon,ng NGA,"FW,MF",Nantes,fr Ligue 1,26,1995,25.9,17,11,6,5,6,11,23,47.8,12,14,3,11,12,29,5,0,Matches
2493,Unai Simón,es ESP,GK,Athletic Club,es La Liga,24,1997,34.0,0,0,0,0,0,0,0,,0,0,0,0,1,1,5,1,Matches
2494,Xavi Simons,nl NED,"MF,FW",Paris S-G,fr Ligue 1,18,2003,1.5,1,1,0,1,0,1,2,50.0,1,3,0,3,0,1,0,0,Matches
2495,Wilfried Singo,ci CIV,DF,Torino,it Serie A,20,2000,29.0,55,35,24,24,7,24,34,70.6,10,26,6,20,23,78,47,0,Matches
2496,Daley Sinkgraven,nl NED,DF,Leverkusen,de Bundesliga,26,1995,3.9,6,2,4,0,2,3,7,42.9,4,3,1,2,3,9,6,0,Matches
2497,Tobias Sippel,de GER,GK,Gladbach,de Bundesliga,33,1988,1.0,0,0,0,0,0,0,0,,0,0,0,0,0,0,0,0,Matches
2498,Hugo Siquet,be BEL,DF,Freiburg,de Bundesliga,19,2002,0.2,0,0,0,0,0,0,0,,0,0,0,0,0,0,0,0,Matches
2499,Salvatore Sirigu,it ITA,GK,Genoa,it Serie A,34,1987,37.0,1,1,1,0,0,1,2,50.0,1,0,0,0,0,1,19,2,Matches
2500,Issouf Sissokho,ml MLI,MF,Bordeaux,fr Ligue 1,19,2002,4.8,17,8,2,13,2,8,17,47.1,9,8,1,7,7,24,0,0,Matches
2501,Ibrahima Sissoko,ml MLI,"MF,DF",Strasbourg,fr Ligue 1,23,1997,25.6,47,23,18,20,9,19,46,41.3,27,32,11,21,35,82,31,0,Matches
2502,Moussa Sissoko,fr FRA,MF,Watford,eng Premier League,31,1989,35.8,53,27,27,20,6,28,42,66.7,14,42,13,29,30,83,64,0,Matches
2503,Nelson Sissoko,fr FRA,DF,Saint-Étienne,fr Ligue 1,24,1997,0.5,2,0,2,0,0,1,1,100.0,0,0,0,0,0,2,2,0,Matches
2504,Sambou Sissoko,fr FRA,"MF,DF",Reims,fr Ligue 1,22,1999,2.0,12,6,6,4,2,6,8,75.0,2,2,0,2,2,14,7,0,Matches
2505,Antonio Sivera,es ESP,GK,Alavés,es La Liga,24,1996,3.1,0,0,0,0,0,0,1,0.0,1,0,0,0,0,0,0,0,Matches
2506,Ellyes Skhiri,tn TUN,MF,Köln,de Bundesliga,26,1995,20.2,55,33,25,26,4,22,41,53.7,19,41,7,34,37,92,35,1,Matches
2507,Oliver Skipp,eng ENG,MF,Tottenham,eng Premier League,20,2000,15.0,33,19,14,18,1,15,31,48.4,16,19,7,12,12,45,10,1,Matches
2508,Leo Skiri Østigård,no NOR,DF,Genoa,it Serie A,21,1999,13.0,16,9,8,7,1,9,11,81.8,2,17,10,7,8,24,55,1,Matches
2509,Łukasz Skorupski,pl POL,GK,Bologna,it Serie A,30,1991,36.0,0,0,0,0,0,0,1,0.0,1,0,0,0,0,0,17,0,Matches
2510,Andreas Skov Olsen,dk DEN,"FW,DF",Bologna,it Serie A,21,1999,8.3,12,10,4,4,4,5,11,45.5,6,9,1,8,3,15,11,0,Matches
2511,Robert Skov,dk DEN,"FW,DF",Hoffenheim,de Bundesliga,25,1996,4.1,3,2,1,1,1,2,9,22.2,7,2,0,2,3,6,3,0,Matches
2512,Milan Škriniar,sk SVK,DF,Inter,it Serie A,26,1995,35.0,47,27,26,17,4,24,42,57.1,18,36,25,11,25,72,90,1,Matches
2513,Islam Slimani,dz ALG,FW,Lyon,fr Ligue 1,33,1988,6.4,3,2,0,1,2,1,6,16.7,5,4,0,4,2,5,5,0,Matches
2514,William Smallbone,ie IRL,"MF,FW",Southampton,eng Premier League,21,2000,1.5,4,4,2,2,0,1,3,33.3,2,4,0,4,2,6,0,0,Matches
2515,Chris Smalling,eng ENG,DF,Roma,it Serie A,31,1989,23.2,36,23,28,8,0,18,25,72.0,7,32,24,8,26,62,92,1,Matches
2516,Emile Smith Rowe,eng ENG,"MF,FW",Arsenal,eng Premier League,21,2000,21.3,14,7,7,7,0,4,20,20.0,16,18,1,17,15,29,10,1,Matches
2517,Cédric Soares,pt POR,DF,Arsenal,eng Premier League,29,1991,16.5,38,26,23,9,6,16,25,64.0,9,18,7,11,16,54,31,1,Matches
2518,Danilo Soares,br BRA,DF,Bochum,de Bundesliga,29,1991,28.5,109,71,61,39,9,56,84,66.7,28,63,9,54,62,171,65,2,Matches
2519,Rubén Sobrino,es ESP,MF,Valencia,es La Liga,29,1992,0.2,1,1,1,0,0,1,1,100.0,0,1,0,1,2,3,0,0,Matches
2520,Rubén Sobrino,es ESP,"FW,MF",Cádiz,es La Liga,29,1992,20.7,28,17,11,10,7,5,35,14.3,30,21,1,20,21,49,18,0,Matches
2521,Alex Sola,es ESP,"DF,FW",Real Sociedad,es La Liga,22,1999,0.5,1,1,1,0,0,1,3,33.3,2,1,0,1,2,3,3,0,Matches
2522,Augusto Solari,ar ARG,"MF,DF",Celta Vigo,es La Liga,29,1992,7.9,24,12,9,12,3,12,32,37.5,20,14,4,10,7,31,10,1,Matches
2523,Roberto Soldado,es ESP,FW,Levante,es La Liga,36,1985,7.4,3,1,0,1,2,1,3,33.3,2,4,0,4,1,4,7,0,Matches
2524,Carlos Soler,es ESP,MF,Valencia,es La Liga,24,1997,27.5,29,19,10,15,4,11,37,29.7,26,19,4,15,14,43,28,0,Matches
2525,Yann Sommer,ch SUI,GK,Gladbach,de Bundesliga,32,1988,33.0,0,0,0,0,0,0,2,0.0,2,0,0,0,3,3,8,3,Matches
2526,Son,es ESP,DF,Levante,es La Liga,27,1994,21.9,28,18,16,7,5,17,34,50.0,17,11,5,6,19,47,33,1,Matches
2527,Brandon Soppy,fr FRA,"DF,MF",Udinese,it Serie A,19,2002,8.6,20,9,8,10,2,11,16,68.8,5,10,2,8,5,25,9,1,Matches
2528,David Soria,es ESP,GK,Getafe,es La Liga,28,1993,37.9,1,0,1,0,0,1,2,50.0,1,0,0,0,0,1,22,2,Matches
2529,Roberto Soriano,it ITA,MF,Bologna,it Serie A,30,1991,29.1,57,30,27,22,8,17,56,30.4,39,37,3,34,22,79,32,0,Matches
2530,Alberto Soro,es ESP,"MF,FW",Granada,es La Liga,22,1999,6.4,12,10,3,6,3,1,7,14.3,6,21,2,19,3,15,4,0,Matches
2531,Borna Sosa,hr CRO,"DF,FW",Stuttgart,de Bundesliga,23,1998,27.8,22,12,14,5,3,12,26,46.2,14,30,3,27,26,48,61,0,Matches
2532,Hugo Sotelo,es ESP,FW,Celta Vigo,es La Liga,17,2003,0.0,0,0,0,0,0,0,0,,0,0,0,0,0,0,0,0,Matches
2533,Florian Sotoca,fr FRA,"FW,MF",Lens,fr Ligue 1,30,1990,27.6,31,19,7,20,4,12,51,23.5,39,31,4,27,25,56,41,0,Matches
2534,Riccardo Sottil,it ITA,FW,Fiorentina,it Serie A,22,1999,13.8,9,4,4,4,1,3,9,33.3,6,3,0,3,1,10,2,0,Matches
2535,Tomáš Souček,cz CZE,MF,West Ham,eng Premier League,26,1995,34.0,66,32,27,33,6,28,65,43.1,37,34,13,21,52,118,98,1,Matches
2536,Matìas Soulé,ar ARG,FW,Juventus,it Serie A,18,2003,0.1,0,0,0,0,0,0,1,0.0,1,0,0,0,0,0,0,0,Matches
2537,Sambou Soumano,sn SEN,"FW,MF",Lorient,fr Ligue 1,20,2001,5.0,4,1,1,2,1,2,2,100.0,0,3,0,3,1,5,7,0,Matches
2538,Adama Soumaoro,fr FRA,DF,Bologna,it Serie A,29,1992,25.2,15,5,5,8,2,4,9,44.4,5,22,16,6,34,49,95,0,Matches
2539,Boubakary Soumaré,fr FRA,MF,Leicester City,eng Premier League,22,1999,12.2,19,13,10,8,1,8,17,47.1,9,13,1,12,14,33,18,0,Matches
2540,Arnaud Souquet,fr FRA,DF,Montpellier,fr Ligue 1,29,1992,25.9,56,35,30,17,9,32,65,49.2,33,21,7,14,34,90,60,1,Matches
2541,Djibril Sow,ch SUI,MF,Eint Frankfurt,de Bundesliga,24,1997,26.8,57,33,28,25,4,22,60,36.7,38,35,8,27,50,107,20,1,Matches
2542,Saidou Sow,gn GUI,DF,Saint-Étienne,fr Ligue 1,19,2002,11.0,28,17,21,6,1,16,21,76.2,5,15,5,10,23,51,34,0,Matches
2543,Çağlar Söyüncü,tr TUR,DF,Leicester City,eng Premier League,25,1996,27.7,47,30,32,12,3,26,42,61.9,16,44,27,17,32,79,115,1,Matches
2544,Leonardo Spinazzola,it ITA,DF,Roma,it Serie A,28,1993,1.4,0,0,0,0,0,0,1,0.0,1,4,1,3,0,0,3,0,Matches
2545,Marco Sportiello,it ITA,GK,Atalanta,it Serie A,29,1992,5.0,0,0,0,0,0,0,0,,0,0,0,0,0,0,2,0,Matches
2546,Tony Springett,ie IRL,"MF,FW",Norwich City,eng Premier League,18,2002,1.6,2,1,1,1,0,1,4,25.0,3,0,0,0,0,2,2,0,Matches
2547,Jerry St. Juste,nl NED,DF,Mainz 05,de Bundesliga,24,1996,6.7,13,9,7,6,0,7,8,87.5,1,7,3,4,14,27,14,0,Matches
2548,Anton Stach,de GER,MF,Mainz 05,de Bundesliga,22,1998,20.7,28,19,14,13,1,15,38,39.5,23,24,5,19,51,79,25,0,Matches
2549,Kostas Stafylidis,gr GRE,"DF,MF",Bochum,de Bundesliga,27,1993,15.4,37,27,22,13,2,20,26,76.9,6,19,6,13,31,68,43,0,Matches
2550,Luca Stanga,it ITA,DF,Milan,it Serie A,19,2002,0.0,1,0,0,1,0,0,0,,0,0,0,0,0,1,0,0,Matches
2551,Josip Stanišić,hr CRO,DF,Bayern Munich,de Bundesliga,21,2000,7.2,21,10,7,12,2,12,18,66.7,6,7,0,7,11,32,10,2,Matches
2552,Niklas Stark,de GER,DF,Hertha BSC,de Bundesliga,26,1995,22.6,28,16,18,10,0,12,17,70.6,5,27,17,10,36,64,122,2,Matches
2553,Jason Steele,eng ENG,GK,Brighton,eng Premier League,30,1990,1.0,0,0,0,0,0,0,0,,0,0,0,0,0,0,0,0,Matches
2554,Jed Steer,eng ENG,GK,Aston Villa,eng Premier League,28,1992,1.0,0,0,0,0,0,0,0,,0,0,0,0,0,0,0,0,Matches
2555,Renato Steffen,ch SUI,"FW,MF",Wolfsburg,de Bundesliga,29,1991,10.7,20,16,10,10,0,9,16,56.3,7,7,0,7,13,33,14,0,Matches
2556,Zack Steffen,us USA,GK,Manchester City,eng Premier League,26,1995,1.0,0,0,0,0,0,0,0,,0,0,0,0,0,0,2,0,Matches
2557,Calvin Stengs,nl NED,MF,Nice,fr Ligue 1,22,1998,11.9,16,7,6,9,1,7,20,35.0,13,10,0,10,8,24,6,0,Matches
2558,Pascal Stenzel,de GER,DF,Stuttgart,de Bundesliga,25,1996,10.0,24,11,15,5,4,17,33,51.5,16,13,3,10,11,35,25,0,Matches
2559,Dale Stephens,eng ENG,MF,Burnley,eng Premier League,32,1989,1.4,4,1,0,3,1,3,8,37.5,5,4,1,3,1,5,1,0,Matches
2560,Jack Stephens,eng ENG,DF,Southampton,eng Premier League,27,1994,9.0,19,12,13,5,1,6,16,37.5,10,12,7,5,19,38,42,0,Matches
2561,Raheem Sterling,eng ENG,FW,Manchester City,eng Premier League,26,1994,23.6,23,10,3,11,9,10,23,43.5,13,12,0,12,12,35,3,0,Matches
2562,Finley Stevens,wls WAL,DF,Brentford,eng Premier League,18,2003,0.2,3,1,0,3,0,1,1,100.0,0,0,0,0,0,3,0,0,Matches
2563,Angelo Stiller,de GER,MF,Hoffenheim,de Bundesliga,20,2001,18.8,30,17,11,15,4,9,23,39.1,14,32,6,26,9,39,16,2,Matches
2564,Lars Stindl,de GER,"MF,FW",Gladbach,de Bundesliga,32,1988,18.1,23,15,6,14,3,9,33,27.3,24,28,2,26,10,33,14,0,Matches
2565,Riccardo Stivanello,it ITA,DF,Bologna,it Serie A,17,2004,0.5,1,1,1,0,0,1,1,100.0,0,2,2,0,0,1,6,0,Matches
2566,Kevin Stöger,at AUT,MF,Mainz 05,de Bundesliga,27,1993,4.7,10,5,5,5,0,4,10,40.0,6,6,0,6,5,15,1,1,Matches
2567,Petar Stojanović,si SVN,DF,Empoli,it Serie A,25,1995,30.4,96,63,55,32,9,59,114,51.8,55,39,13,26,27,123,65,1,Matches
2568,John Stones,eng ENG,DF,Manchester City,eng Premier League,27,1994,12.4,5,3,3,2,0,2,3,66.7,1,3,3,0,11,16,27,1,Matches
2569,Thomas Strakosha,al ALB,GK,Lazio,it Serie A,26,1995,23.0,0,0,0,0,0,0,0,,0,0,0,0,0,0,7,2,Matches
2570,Stefan Strandberg,no NOR,DF,Salernitana,it Serie A,31,1990,10.4,13,8,10,3,0,8,11,72.7,3,15,13,2,9,22,49,0,Matches
2571,Dávid Strelec,sk SVK,"FW,MF",Spezia,it Serie A,20,2001,5.6,4,4,1,2,1,2,9,22.2,7,8,1,7,2,6,1,0,Matches
2572,Tobias Strobl,de GER,"MF,DF",Augsburg,de Bundesliga,31,1990,3.6,8,3,3,5,0,3,11,27.3,8,7,2,5,7,15,3,0,Matches
2573,Kevin Strootman,nl NED,MF,Cagliari,it Serie A,31,1990,7.1,8,4,2,4,2,5,12,41.7,7,11,2,9,10,18,15,0,Matches
2574,Pascal Struijk,nl NED,"DF,MF",Leeds United,eng Premier League,21,1999,22.8,61,39,34,23,4,30,50,60.0,20,35,23,12,33,94,60,2,Matches
2575,Jens Stryger Larsen,dk DEN,DF,Udinese,it Serie A,30,1991,7.6,5,2,3,1,1,2,3,66.7,1,2,0,2,4,9,17,0,Matches
2576,Leo Štulac,si SVN,MF,Empoli,it Serie A,26,1994,9.3,13,6,5,6,2,7,19,36.8,12,6,2,4,8,21,15,0,Matches
2577,Stefano Sturaro,it ITA,MF,Genoa,it Serie A,28,1993,19.6,43,26,16,16,11,22,48,45.8,26,25,1,24,15,58,29,2,Matches
2578,Damián Suárez,uy URU,DF,Getafe,es La Liga,33,1988,30.1,74,47,34,30,10,42,91,46.2,49,46,5,41,31,105,30,0,Matches
2579,Denis Suárez,es ESP,MF,Celta Vigo,es La Liga,27,1994,31.3,61,29,20,33,8,25,82,30.5,57,32,4,28,16,77,11,0,Matches
2580,Luis Suárez,uy URU,FW,Atlético Madrid,es La Liga,34,1987,20.4,8,5,2,4,2,2,10,20.0,8,8,1,7,1,9,14,0,Matches
2581,Mario Suárez,es ESP,DF,Rayo Vallecano,es La Liga,34,1987,7.9,9,4,7,2,0,3,9,33.3,6,6,4,2,7,16,37,1,Matches
2582,Isaac Success,ng NGA,"FW,MF",Udinese,it Serie A,25,1996,10.1,5,2,0,3,2,1,5,20.0,4,2,0,2,2,7,6,0,Matches
2583,Niklas Süle,de GER,DF,Bayern Munich,de Bundesliga,25,1995,20.4,29,23,21,7,1,18,24,75.0,6,16,12,4,28,57,49,0,Matches
2584,Kamaldeen Sulemana,gh GHA,"MF,FW",Rennes,fr Ligue 1,19,2002,11.3,23,12,7,9,7,10,17,58.8,7,10,1,9,4,27,5,0,Matches
2585,Crysencio Summerville,nl NED,"MF,FW",Leeds United,eng Premier League,19,2001,1.4,5,3,1,1,3,2,3,66.7,1,2,0,2,2,7,0,0,Matches
2586,Vladyslav Supriaha,ua UKR,FW,Sampdoria,it Serie A,21,2000,0.2,0,0,0,0,0,0,1,0.0,1,0,0,0,0,0,0,0,Matches
2587,Suso,es ESP,FW,Sevilla,es La Liga,27,1993,4.3,4,3,1,3,0,3,13,23.1,10,4,0,4,0,4,0,0,Matches
2588,Bosko Sutalo,hr CRO,DF,Hellas Verona,it Serie A,21,2000,10.2,20,13,11,6,3,8,16,50.0,8,10,5,5,17,37,39,0,Matches
2589,Mattias Svanberg,se SWE,MF,Bologna,it Serie A,22,1999,28.5,39,15,15,16,8,16,54,29.6,38,31,9,22,28,67,34,0,Matches
2590,Michael Svoboda,at AUT,DF,Venezia,it Serie A,22,1998,13.7,33,17,26,6,1,18,32,56.3,14,27,15,12,10,43,61,5,Matches
2591,Abdoulaye Sylla,gn GUI,DF,Nantes,fr Ligue 1,21,2000,1.7,4,4,2,1,1,2,4,50.0,2,5,3,2,1,5,3,0,Matches
2592,Mamadou Sylla,sn SEN,"FW,MF",Alavés,es La Liga,27,1994,4.4,2,2,0,1,1,0,1,0.0,1,0,0,0,1,3,5,0,Matches
2593,Mamadou Sylla,sn SEN,FW,Rayo Vallecano,es La Liga,27,1994,2.8,1,1,1,0,0,0,1,0.0,1,2,0,2,4,5,3,0,Matches
2594,Ádám Szalai,hu HUN,FW,Mainz 05,de Bundesliga,33,1987,2.9,3,2,0,2,1,0,2,0.0,2,2,0,2,0,3,0,0,Matches
2595,Wojciech Szczęsny,pl POL,GK,Juventus,it Serie A,31,1990,33.0,1,1,1,0,0,1,2,50.0,1,0,0,0,0,1,8,1,Matches
2596,Dominik Szoboszlai,hu HUN,"MF,FW",RB Leipzig,de Bundesliga,20,2000,17.1,17,12,5,9,3,8,27,29.6,19,30,3,27,10,27,15,0,Matches
2597,Jakob Sørensen,dk DEN,"MF,DF",Norwich City,eng Premier League,23,1998,6.7,22,11,6,14,2,10,20,50.0,10,7,3,4,10,32,19,0,Matches
2598,Alexander Sørloth,no NOR,FW,Real Sociedad,es La Liga,25,1995,19.6,20,7,4,10,6,7,17,41.2,10,14,1,13,4,24,15,0,Matches
2599,Tachi,es ESP,DF,Alavés,es La Liga,23,1997,2.7,6,3,3,3,0,5,7,71.4,2,4,3,1,1,7,9,0,Matches
2600,Jonathan Tah,de GER,DF,Leverkusen,de Bundesliga,25,1996,32.0,25,18,19,5,1,17,33,51.5,16,31,20,11,43,68,156,0,Matches
2601,Waniss Taibi,fr FRA,"MF,FW",Angers,fr Ligue 1,19,2002,1.5,8,7,4,4,0,2,4,50.0,2,0,0,0,1,9,1,0,Matches
2602,Flavien Tait,fr FRA,MF,Rennes,fr Ligue 1,28,1993,23.6,28,19,13,9,6,13,40,32.5,27,15,4,11,19,47,13,1,Matches
2603,Adrien Tameze,cm CMR,"MF,DF",Hellas Verona,it Serie A,27,1994,28.6,52,29,24,21,7,20,59,33.9,39,40,5,35,52,104,41,0,Matches
2604,Japhet Tanganga,eng ENG,DF,Tottenham,eng Premier League,22,1999,8.2,14,8,7,6,1,9,19,47.4,10,13,5,8,9,23,31,0,Matches
2605,Renato Tapia,pe PER,MF,Celta Vigo,es La Liga,26,1995,15.7,50,31,15,31,4,20,50,40.0,30,21,5,16,28,78,43,0,Matches
2606,Edmond Tapsoba,bf BFA,DF,Leverkusen,de Bundesliga,22,1999,20.2,35,17,24,10,1,20,32,62.5,12,27,15,12,29,64,72,1,Matches
2607,Florian Tardieu,fr FRA,MF,Troyes,fr Ligue 1,29,1992,29.2,58,25,31,21,6,31,71,43.7,40,31,9,22,42,100,38,0,Matches
2608,Matt Targett,eng ENG,DF,Aston Villa,eng Premier League,25,1995,15.9,34,18,28,5,1,24,45,53.3,21,16,9,7,23,57,35,0,Matches
2609,Matt Targett,eng ENG,DF,Newcastle Utd,eng Premier League,25,1995,16.0,41,26,26,14,1,24,37,64.9,13,15,4,11,25,66,39,1,Matches
2610,Oussama Targhalline,ma MAR,FW,Marseille,fr Ligue 1,19,2002,0.1,0,0,0,0,0,0,0,,0,0,0,0,0,0,0,0,Matches
2611,James Tarkowski,eng ENG,DF,Burnley,eng Premier League,28,1992,34.5,65,45,47,17,1,33,47,70.2,14,75,61,14,48,113,186,4,Matches
2612,Ciprian Tătărușanu,ro ROU,GK,Milan,it Serie A,35,1986,6.0,0,0,0,0,0,0,1,0.0,1,0,0,0,0,0,2,1,Matches
2613,Niklas Tauer,de GER,"DF,MF",Mainz 05,de Bundesliga,20,2001,5.4,16,9,9,7,0,9,14,64.3,5,6,2,4,9,25,14,0,Matches
2614,Nuno Tavares,pt POR,DF,Arsenal,eng Premier League,21,2000,13.1,21,14,10,7,4,8,18,44.4,10,15,5,10,9,30,33,1,Matches
2615,Charlie Taylor,eng ENG,DF,Burnley,eng Premier League,27,1993,30.3,45,26,31,11,3,26,44,59.1,18,42,20,22,58,103,95,2,Matches
2616,Loum Tchaouna,fr FRA,"FW,MF",Rennes,fr Ligue 1,17,2003,1.0,3,1,1,2,0,1,5,20.0,4,0,0,0,2,5,0,0,Matches
2617,Warren Tchimbembé,cg CGO,MF,Metz,fr Ligue 1,23,1998,2.3,1,1,0,1,0,0,1,0.0,1,2,1,1,2,3,2,0,Matches
2618,Aurélien Tchouaméni,fr FRA,MF,Monaco,fr Ligue 1,21,2000,32.5,86,45,33,49,4,29,55,52.7,26,39,7,32,101,187,34,0,Matches
2619,Mathys Tel,fr FRA,"FW,MF",Rennes,fr Ligue 1,16,2005,0.6,2,1,1,1,0,0,0,,0,0,0,0,1,3,2,0,Matches
2620,Jordan Tell,gp GLP,FW,Clermont Foot,fr Ligue 1,24,1997,3.2,5,5,0,3,2,1,4,25.0,3,3,0,3,0,5,1,0,Matches
2621,Nathan Tella,ng NGA,"MF,FW",Southampton,eng Premier League,22,1999,8.9,13,9,5,7,1,6,17,35.3,11,13,0,13,6,19,9,0,Matches
2622,Alex Telles,br BRA,DF,Manchester Utd,eng Premier League,28,1992,18.4,48,27,35,9,4,27,43,62.8,16,17,4,13,26,74,45,0,Matches
2623,Cristian Tello,es ESP,FW,Betis,es La Liga,29,1991,9.1,17,11,6,7,4,13,31,41.9,18,9,0,9,10,27,6,0,Matches
2624,Nahuel Tenaglia,ar ARG,DF,Alavés,es La Liga,25,1996,11.9,42,27,30,9,3,24,37,64.9,13,10,2,8,26,68,42,0,Matches
2625,Marc Tenas,es ESP,"FW,MF",Alavés,es La Liga,20,2001,0.6,1,1,1,0,0,1,1,100.0,0,1,0,1,0,1,0,1,Matches
2626,Marc-André ter Stegen,de GER,GK,Barcelona,es La Liga,29,1992,35.0,0,0,0,0,0,0,1,0.0,1,0,0,0,1,1,13,5,Matches
2627,Filippo Terracciano,it ITA,DF,Hellas Verona,it Serie A,18,2003,0.1,0,0,0,0,0,0,0,,0,0,0,0,0,0,1,0,Matches
2628,Pietro Terracciano,it ITA,GK,Fiorentina,it Serie A,31,1990,31.8,0,0,0,0,0,0,4,0.0,4,0,0,0,2,2,20,1,Matches
2629,Martin Terrier,fr FRA,"FW,MF",Rennes,fr Ligue 1,24,1997,30.9,55,33,22,16,17,25,43,58.1,18,29,3,26,18,73,17,0,Matches
2630,Aleksa Terzić,rs SRB,DF,Fiorentina,it Serie A,21,1999,3.0,8,5,3,3,2,4,7,57.1,3,7,0,7,4,12,5,0,Matches
2631,Robert Tesche,de GER,MF,Bochum,de Bundesliga,34,1987,3.9,6,4,4,1,1,5,7,71.4,2,6,2,4,5,11,5,1,Matches
2632,Tanner Tessmann,us USA,MF,Venezia,it Serie A,19,2001,7.6,11,5,4,6,1,5,14,35.7,9,19,9,10,5,16,22,0,Matches
2633,Tetê,br BRA,"FW,MF",Lyon,fr Ligue 1,21,2000,6.5,10,5,4,5,1,3,13,23.1,10,4,0,4,3,13,1,0,Matches
2634,Cedric Teuchert,de GER,"MF,FW",Union Berlin,de Bundesliga,24,1997,1.2,3,2,3,0,0,2,6,33.3,4,1,0,1,0,3,0,0,Matches
2635,Arthur Theate,be BEL,DF,Bologna,it Serie A,21,2000,26.9,33,19,26,3,4,14,31,45.2,17,29,16,13,42,75,69,0,Matches
2636,Jan Thielmann,de GER,"MF,FW",Köln,de Bundesliga,19,2002,13.2,24,16,6,12,6,8,23,34.8,15,23,2,21,10,34,11,0,Matches
2637,Sada Thioub,sn SEN,FW,Angers,fr Ligue 1,26,1995,0.0,0,0,0,0,0,0,0,,0,0,0,0,0,0,0,0,Matches
2638,Sada Thioub,sn SEN,"DF,MF",Saint-Étienne,fr Ligue 1,26,1995,10.6,13,8,5,8,0,6,14,42.9,8,9,0,9,10,23,8,0,Matches
2639,Luke Thomas,eng ENG,DF,Leicester City,eng Premier League,20,2001,21.2,50,31,33,13,4,28,65,43.1,37,35,14,21,40,90,55,0,Matches
2640,Romain Thomas,fr FRA,DF,Angers,fr Ligue 1,33,1988,28.5,49,37,28,21,0,30,57,52.6,27,35,19,16,44,93,126,0,Matches
2641,Adrien Thomasson,fr FRA,MF,Strasbourg,fr Ligue 1,27,1993,26.5,64,31,18,27,19,30,93,32.3,63,56,4,52,29,93,16,1,Matches
2642,Erik Thommy,de GER,"FW,MF",Stuttgart,de Bundesliga,26,1994,3.0,2,0,0,2,0,1,2,50.0,1,3,0,3,4,6,0,0,Matches
2643,Dominic Thompson,eng ENG,DF,Brentford,eng Premier League,21,2000,1.6,1,0,1,0,0,0,1,0.0,1,2,2,0,2,3,3,0,Matches
2644,Morten Thorsby,no NOR,MF,Sampdoria,it Serie A,25,1996,32.7,46,26,15,23,8,28,56,50.0,28,37,12,25,25,71,39,0,Matches
2645,Thuler,br BRA,DF,Montpellier,fr Ligue 1,22,1999,9.5,21,12,17,4,0,8,15,53.3,7,9,7,2,9,30,30,0,Matches
2646,Khéphren Thuram,fr FRA,MF,Nice,fr Ligue 1,20,2001,21.1,33,19,11,18,4,17,35,48.6,18,31,11,20,28,61,19,0,Matches
2647,Marcus Thuram,fr FRA,FW,Gladbach,de Bundesliga,23,1997,10.9,6,5,0,5,1,1,4,25.0,3,5,0,5,5,11,5,0,Matches
2648,Alexis Tibidi,fr FRA,"MF,FW",Stuttgart,de Bundesliga,17,2003,4.3,7,3,1,3,3,3,4,75.0,1,4,0,4,3,10,2,0,Matches
2649,Cheikh Tidiane Sabaly,sn SEN,"FW,MF",Metz,fr Ligue 1,22,1999,1.7,6,3,1,4,1,2,2,100.0,0,1,0,1,0,6,1,0,Matches
2650,Youri Tielemans,be BEL,MF,Leicester City,eng Premier League,24,1997,29.2,74,38,23,45,6,42,100,42.0,58,47,13,34,21,95,41,3,Matches
2651,Kieran Tierney,sct SCO,DF,Arsenal,eng Premier League,24,1997,21.3,18,14,11,7,0,10,11,90.9,1,23,5,18,15,33,54,0,Matches
2652,Steffen Tigges,de GER,"FW,MF",Dortmund,de Bundesliga,23,1998,1.2,4,3,1,2,1,2,3,66.7,1,3,1,2,0,4,3,0,Matches
2653,Malik Tillman,us USA,"FW,MF",Bayern Munich,de Bundesliga,19,2002,1.2,2,1,0,1,1,0,1,0.0,1,5,1,4,2,4,1,0,Matches
2654,Timmy Tillman,de GER,MF,Greuther Fürth,de Bundesliga,22,1999,22.3,43,26,17,18,8,19,42,45.2,23,33,4,29,12,55,26,0,Matches
2655,David Timor,es ESP,MF,Getafe,es La Liga,31,1989,3.8,1,1,1,0,0,0,3,0.0,3,3,2,1,1,2,4,1,Matches
2656,Mircea Ţîrlea,ro ROU,DF,Alavés,es La Liga,21,2000,0.2,0,0,0,0,0,0,0,,0,0,0,0,0,0,1,0,Matches
2657,Jean-Clair Todibo,fr FRA,DF,Nice,fr Ligue 1,21,1999,34.6,59,37,43,15,1,39,60,65.0,21,45,21,24,51,110,130,2,Matches
2658,Umut Tohumcu,de GER,MF,Hoffenheim,de Bundesliga,16,2004,0.1,0,0,0,0,0,0,0,,0,0,0,0,0,0,0,0,Matches
2659,Karl Toko Ekambi,cm CMR,FW,Lyon,fr Ligue 1,28,1992,25.5,13,7,4,6,3,4,21,19.0,17,26,0,26,20,33,5,0,Matches
2660,Corentin Tolisso,fr FRA,MF,Bayern Munich,de Bundesliga,26,1994,7.8,11,5,1,9,1,7,17,41.2,10,5,1,4,9,20,10,0,Matches
2661,Jeremy Toljan,de GER,DF,Sassuolo,it Serie A,26,1994,15.5,18,10,12,4,2,13,20,65.0,7,12,5,7,12,30,41,0,Matches
2662,Rafael Tolói,it ITA,DF,Atalanta,it Serie A,30,1990,16.0,38,15,12,15,11,24,39,61.5,15,23,11,12,26,64,35,0,Matches
2663,Raúl de Tomás,es ESP,FW,Espanyol,es La Liga,26,1994,32.4,15,11,6,7,2,6,17,35.3,11,12,3,9,6,21,42,1,Matches
2664,Tiago Tomás,pt POR,FW,Stuttgart,de Bundesliga,19,2002,11.9,8,4,0,7,1,0,6,0.0,6,3,0,3,4,12,1,0,Matches
2665,Takehiro Tomiyasu,jp JPN,DF,Arsenal,eng Premier League,22,1998,18.7,35,17,19,13,3,21,32,65.6,11,22,3,19,24,59,64,2,Matches
2666,Takehiro Tomiyasu,jp JPN,DF,Bologna,it Serie A,22,1998,0.1,0,0,0,0,0,0,0,,0,1,0,1,1,1,0,0,Matches
2667,James Tomkins,eng ENG,DF,Crystal Palace,eng Premier League,32,1989,6.1,8,3,6,2,0,6,8,75.0,2,8,8,0,4,12,18,0,Matches
2668,Fikayo Tomori,eng ENG,DF,Milan,it Serie A,23,1997,30.2,73,44,36,34,3,18,26,69.2,8,37,23,14,45,118,84,1,Matches
2669,Sandro Tonali,it ITA,MF,Milan,it Serie A,21,2000,28.9,54,37,23,25,6,21,41,51.2,20,26,8,18,34,88,19,0,Matches
2670,Lorenzo Tonelli,it ITA,DF,Empoli,it Serie A,31,1990,9.7,17,9,11,4,2,6,13,46.2,7,14,8,6,19,36,28,2,Matches
2671,Ivan Toney,eng ENG,FW,Brentford,eng Premier League,25,1996,32.3,33,21,5,20,8,12,38,31.6,26,16,2,14,14,47,44,1,Matches
2672,Ernesto Torregrossa,ve VEN,FW,Sampdoria,it Serie A,29,1992,1.3,2,1,1,0,1,1,2,50.0,1,0,0,0,0,2,1,0,Matches
2673,Lucas Torreira,uy URU,MF,Fiorentina,it Serie A,25,1996,24.4,37,29,13,21,3,18,40,45.0,22,18,1,17,26,63,18,0,Matches
2674,Raúl Torrente,es ESP,DF,Granada,es La Liga,19,2001,14.2,31,21,18,11,2,16,29,55.2,13,14,9,5,12,43,69,0,Matches
2675,Ferrán Torres,es ESP,FW,Manchester City,eng Premier League,21,2000,3.4,2,2,0,1,1,0,3,0.0,3,2,0,2,0,2,1,0,Matches
2676,Ferrán Torres,es ESP,FW,Barcelona,es La Liga,21,2000,15.7,10,5,3,4,3,3,7,42.9,4,12,3,9,6,16,7,0,Matches
2677,Óliver Torres,es ESP,"MF,FW",Sevilla,es La Liga,26,1994,11.2,22,12,8,7,7,8,25,32.0,17,10,1,9,6,28,4,0,Matches
2678,Pau Torres,es ESP,DF,Villarreal,es La Liga,24,1997,31.7,32,19,23,7,2,18,25,72.0,7,32,23,9,19,51,105,2,Matches
2679,Roberto Torres,es ESP,"MF,FW",Osasuna,es La Liga,32,1989,9.0,7,4,3,1,3,3,15,20.0,12,8,0,8,8,15,4,0,Matches
2680,Lucas Torró,es ESP,MF,Osasuna,es La Liga,27,1994,30.3,71,40,25,38,8,29,57,50.9,28,32,11,21,47,118,55,0,Matches
2681,Jordan Torunarigha,de GER,DF,Hertha BSC,de Bundesliga,23,1997,5.4,4,1,1,3,0,4,5,80.0,1,4,2,2,17,21,30,0,Matches
2682,Cenk Tosun,tr TUR,MF,Everton,eng Premier League,30,1991,0.1,0,0,0,0,0,0,0,,0,0,0,0,0,0,0,0,Matches
2683,Abdoulaye Touré,gn GUI,MF,Genoa,it Serie A,27,1994,4.8,12,4,3,8,1,5,11,45.5,6,6,1,5,4,16,6,0,Matches
2684,Almamy Touré,ml MLI,"DF,MF",Eint Frankfurt,de Bundesliga,25,1996,5.6,12,9,8,3,1,4,17,23.5,13,10,3,7,5,17,19,0,Matches
2685,Lucas Tousart,fr FRA,MF,Hertha BSC,de Bundesliga,24,1997,21.8,42,25,15,22,5,10,34,29.4,24,30,6,24,35,77,55,0,Matches
2686,Yoann Touzghar,tn TUN,FW,Troyes,fr Ligue 1,34,1986,16.2,5,2,1,3,1,1,3,33.3,2,3,1,2,3,8,8,0,Matches
2687,Andros Townsend,eng ENG,"MF,FW",Everton,eng Premier League,30,1991,16.2,31,17,15,6,10,15,40,37.5,25,28,2,26,14,45,6,1,Matches
2688,Adama Traoré,es ESP,"FW,MF",Wolves,eng Premier League,25,1996,11.9,8,3,6,0,2,3,7,42.9,4,4,1,3,2,10,1,0,Matches
2689,Adama Traoré,es ESP,FW,Barcelona,es La Liga,25,1996,4.2,4,2,0,3,1,3,5,60.0,2,2,0,2,4,8,3,1,Matches
2690,Amadou Traore,fr FRA,FW,Bordeaux,fr Ligue 1,19,2002,0.2,0,0,0,0,0,0,0,,0,0,0,0,0,0,0,0,Matches
2691,Bertrand Traoré,bf BFA,"MF,FW",Aston Villa,eng Premier League,25,1995,2.4,3,3,0,1,2,1,2,50.0,1,0,0,0,0,3,1,0,Matches
2692,Boubacar Traoré,ml MLI,MF,Metz,fr Ligue 1,19,2001,19.2,43,26,18,23,2,10,39,25.6,29,29,5,24,25,68,11,1,Matches
2693,Charles Traore,ml MLI,DF,Nantes,fr Ligue 1,29,1992,8.0,16,12,10,4,2,2,13,15.4,11,11,4,7,15,31,30,0,Matches
2694,Hamari Traoré,ml MLI,DF,Rennes,fr Ligue 1,29,1992,32.1,63,36,25,26,12,41,59,69.5,18,29,8,21,37,100,81,1,Matches
2695,Ismaël Traoré,ci CIV,DF,Angers,fr Ligue 1,34,1986,35.7,28,17,16,11,1,13,28,46.4,15,25,17,8,44,72,122,1,Matches
2696,Kevin Trapp,de GER,GK,Eint Frankfurt,de Bundesliga,31,1990,32.0,0,0,0,0,0,0,1,0.0,1,0,0,0,1,1,13,2,Matches
2697,Miguel Trauco,pe PER,"DF,MF",Saint-Étienne,fr Ligue 1,28,1992,12.4,25,18,16,8,1,12,22,54.5,10,13,4,9,23,48,17,0,Matches
2698,Óscar Trejo,ar ARG,MF,Rayo Vallecano,es La Liga,33,1988,22.3,42,24,14,18,10,15,50,30.0,35,26,1,25,13,55,11,0,Matches
2699,Trézéguet,eg EGY,FW,Aston Villa,eng Premier League,26,1994,0.1,0,0,0,0,0,0,0,,0,0,0,0,0,0,0,0,Matches
2700,Manu Trigueros,es ESP,"MF,FW",Villarreal,es La Liga,29,1991,24.2,45,25,16,18,11,23,66,34.8,43,19,3,16,13,58,17,0,Matches
2701,Simone Trimboli,it ITA,MF,Sampdoria,it Serie A,19,2002,0.7,2,1,2,0,0,2,2,100.0,0,0,0,0,2,4,0,0,Matches
2702,Christopher Trimmel,at AUT,"DF,FW",Union Berlin,de Bundesliga,34,1987,22.1,49,30,25,19,5,26,45,57.8,19,20,3,17,34,83,75,0,Matches
2703,Francisco Trincão,pt POR,"FW,MF",Wolves,eng Premier League,21,1999,14.8,28,15,9,13,6,3,19,15.8,16,17,1,16,12,40,1,1,Matches
2704,Kieran Trippier,eng ENG,DF,Newcastle Utd,eng Premier League,30,1990,4.8,17,10,8,8,1,10,16,62.5,6,10,3,7,10,27,10,0,Matches
2705,Kieran Trippier,eng ENG,"DF,FW",Atlético Madrid,es La Liga,30,1990,10.8,22,12,12,5,5,12,21,57.1,9,12,1,11,10,32,11,0,Matches
2706,William Troost-Ekong,ng NGA,DF,Watford,eng Premier League,27,1993,15.4,18,9,11,6,1,10,15,66.7,5,24,14,10,7,25,82,1,Matches
2707,Leandro Trossard,be BEL,"FW,MF",Brighton,eng Premier League,26,1994,31.2,34,20,12,9,13,4,31,12.9,27,33,4,29,15,49,10,0,Matches
2708,Adrien Truffert,fr FRA,DF,Rennes,fr Ligue 1,19,2001,18.2,29,21,17,9,3,11,24,45.8,13,25,5,20,19,48,30,0,Matches
2709,Philipp Tschauner,de GER,GK,RB Leipzig,de Bundesliga,35,1985,0.0,0,0,0,0,0,0,0,,0,0,0,0,0,0,0,0,Matches
2710,Kostas Tsimikas,gr GRE,DF,Liverpool,eng Premier League,25,1996,9.7,27,12,12,8,7,12,16,75.0,4,6,2,4,10,37,22,2,Matches
2711,Axel Tuanzebe,cd COD,DF,Aston Villa,eng Premier League,23,1997,5.6,5,3,3,2,0,2,5,40.0,3,5,4,1,5,10,12,1,Matches
2712,Axel Tuanzebe,cd COD,DF,Napoli,it Serie A,23,1997,0.1,0,0,0,0,0,0,0,,0,1,1,0,0,0,0,0,Matches
2713,Ozan Tufan,tr TUR,MF,Watford,eng Premier League,26,1995,3.7,3,2,1,1,1,1,5,20.0,4,2,0,2,2,5,4,0,Matches
2714,Beñat Turrientes,es ESP,MF,Real Sociedad,es La Liga,19,2002,2.3,0,0,0,0,0,0,4,0.0,4,1,0,1,2,2,2,0,Matches
2715,Tuta,br BRA,DF,Eint Frankfurt,de Bundesliga,22,1999,24.3,46,28,20,22,4,26,47,55.3,21,43,15,28,41,87,76,1,Matches
2716,Christos Tzolis,gr GRE,"FW,MF",Norwich City,eng Premier League,19,2002,3.7,5,3,3,1,1,2,9,22.2,7,3,0,3,1,6,1,0,Matches
2717,Destiny Udogie,it ITA,DF,Udinese,it Serie A,18,2002,27.5,64,40,30,27,7,33,60,55.0,27,39,6,33,27,91,42,0,Matches
2718,Matthieu Udol,fr FRA,DF,Metz,fr Ligue 1,25,1996,11.2,23,14,11,10,2,12,18,66.7,6,20,7,13,31,54,29,1,Matches
2719,Ike Ugbo,ca CAN,FW,Troyes,fr Ligue 1,22,1998,9.0,3,1,0,1,2,0,1,0.0,1,4,1,3,2,5,1,0,Matches
2720,Lesley Ugochukwu,fr FRA,MF,Rennes,fr Ligue 1,17,2004,4.5,13,9,5,5,3,9,19,47.4,10,7,2,5,4,17,2,0,Matches
2721,Hwang Ui-jo,kr KOR,FW,Bordeaux,fr Ligue 1,28,1992,27.9,10,4,4,4,2,4,13,30.8,9,9,1,8,5,15,18,0,Matches
2722,Anthony Ujah,ng NGA,"FW,MF",Union Berlin,de Bundesliga,30,1990,0.4,0,0,0,0,0,0,0,,0,0,0,0,0,0,0,0,Matches
2723,Maximilian Ullmann,at AUT,DF,Venezia,it Serie A,25,1996,2.7,0,0,0,0,0,0,1,0.0,1,4,0,4,2,2,7,0,Matches
2724,Sven Ulreich,de GER,GK,Bayern Munich,de Bundesliga,32,1988,6.0,0,0,0,0,0,0,0,,0,0,0,0,0,0,1,0,Matches
2725,Samuel Umtiti,fr FRA,DF,Barcelona,es La Liga,27,1993,1.0,2,2,2,0,0,1,2,50.0,1,1,1,0,0,2,4,0,Matches
2726,Enes Ünal,tr TUR,FW,Getafe,es La Liga,24,1997,31.1,37,22,2,18,17,5,42,11.9,37,25,5,20,5,42,36,0,Matches
2727,Cengiz Ünder,tr TUR,"FW,MF",Marseille,fr Ligue 1,24,1997,24.4,18,13,5,6,7,5,18,27.8,13,13,2,11,14,32,9,0,Matches
2728,Dayot Upamecano,fr FRA,DF,Bayern Munich,de Bundesliga,22,1998,24.6,66,42,42,21,3,24,36,66.7,12,20,10,10,32,98,71,6,Matches
2729,Benjamin Uphoff,de GER,GK,Freiburg,de Bundesliga,27,1993,2.0,0,0,0,0,0,0,0,,0,0,0,0,0,0,2,2,Matches
2730,Kacper Urbanski,pl POL,MF,Bologna,it Serie A,16,2004,0.5,3,2,1,2,0,2,2,100.0,0,2,0,2,0,3,0,0,Matches
2731,Jere Uronen,fi FIN,DF,Brest,fr Ligue 1,27,1994,9.8,28,15,15,10,3,14,24,58.3,10,12,3,9,16,44,21,0,Matches
2732,Mark Uth,de GER,"MF,FW",Köln,de Bundesliga,29,1991,22.5,32,20,9,14,9,15,49,30.6,34,27,1,26,14,46,13,0,Matches
2733,Myrto Uzuni,al ALB,"FW,MF",Granada,es La Liga,26,1995,9.5,7,4,6,1,0,0,2,0.0,2,13,1,12,10,17,7,0,Matches
2734,Antonio Vacca,it ITA,MF,Venezia,it Serie A,31,1990,11.8,36,20,24,10,2,14,36,38.9,22,16,8,8,20,56,16,0,Matches
2735,Álvaro Vadillo,es ESP,"DF,MF",Espanyol,es La Liga,26,1994,0.1,1,1,1,0,0,1,2,50.0,1,0,0,0,0,1,1,0,Matches
2736,Óscar Valentín,es ESP,MF,Rayo Vallecano,es La Liga,26,1994,28.5,102,53,46,51,5,44,105,41.9,61,56,10,46,39,141,43,0,Matches
2737,Germán Valera,es ESP,FW,Real Sociedad,es La Liga,19,2002,0.6,3,2,3,0,0,1,1,100.0,0,0,0,0,0,3,1,0,Matches
2738,Yan Valery,tn TUN,DF,Southampton,eng Premier League,22,1999,4.1,8,6,4,3,1,4,9,44.4,5,6,3,3,6,14,19,1,Matches
2739,Martin Valjent,sk SVK,DF,Mallorca,es La Liga,25,1995,35.3,31,19,18,12,1,13,24,54.2,11,34,26,8,31,62,173,1,Matches
2740,Jesús Vallejo,es ESP,DF,Real Madrid,es La Liga,24,1997,3.8,7,5,7,0,0,5,6,83.3,1,9,8,1,6,13,16,0,Matches
2741,Manu Vallejo,es ESP,"MF,FW",Alavés,es La Liga,24,1997,4.1,8,2,1,4,3,4,13,30.8,9,7,0,7,0,8,4,0,Matches
2742,Manu Vallejo,es ESP,"FW,MF",Valencia,es La Liga,24,1997,1.1,2,1,1,1,0,0,1,0.0,1,0,0,0,0,2,1,0,Matches
2743,Federico Valverde,uy URU,MF,Real Madrid,es La Liga,23,1998,20.4,36,16,11,16,9,12,31,38.7,19,23,5,18,24,60,12,0,Matches
2744,Virgil van Dijk,nl NED,DF,Liverpool,eng Premier League,30,1991,34.0,16,10,11,5,0,11,16,68.8,5,21,14,7,31,47,109,0,Matches
2745,Vanderson,br BRA,"FW,DF",Monaco,fr Ligue 1,20,2001,12.4,35,19,10,19,6,15,23,65.2,8,17,4,13,13,48,12,0,Matches
2746,Zinho Vanheusden,be BEL,DF,Genoa,it Serie A,22,1999,11.0,18,6,12,5,1,8,14,57.1,6,19,14,5,23,41,42,0,Matches
2747,Jonathan Varane,fr FRA,MF,Lens,fr Ligue 1,19,2001,0.0,0,0,0,0,0,0,0,,0,0,0,0,0,0,0,0,Matches
2748,Raphaël Varane,fr FRA,DF,Manchester Utd,eng Premier League,28,1993,20.3,28,19,21,6,1,10,22,45.5,12,18,9,9,18,46,82,1,Matches
2749,Jamie Vardy,eng ENG,FW,Leicester City,eng Premier League,34,1987,20.1,6,5,0,4,2,1,7,14.3,6,9,0,9,1,7,17,0,Matches
2750,Ruben Vargas,ch SUI,"MF,FW",Augsburg,de Bundesliga,22,1998,22.0,28,21,7,14,7,11,30,36.7,19,9,1,8,16,44,13,0,Matches
2751,Sebastian Vasiliadis,gr GRE,MF,Arminia,de Bundesliga,23,1997,13.3,31,17,12,15,4,15,42,35.7,27,15,2,13,25,56,31,1,Matches
2752,Johan Vásquez,mx MEX,DF,Genoa,it Serie A,22,1998,25.3,79,46,44,32,3,48,75,64.0,27,32,10,22,42,121,85,0,Matches
2753,Denis Vavro,sk SVK,DF,Lazio,it Serie A,25,1996,0.1,0,0,0,0,0,0,0,,0,0,0,0,0,0,0,0,Matches
2754,José Luis García Vayá,es ESP,MF,Levante,es La Liga,22,1998,22.4,46,27,10,31,5,16,41,39.0,25,24,5,19,38,84,30,0,Matches
2755,Jesus Vazquez,es ESP,DF,Valencia,es La Liga,18,2003,9.0,24,13,10,8,6,10,22,45.5,12,16,3,13,9,33,19,0,Matches
2756,Kevin Vázquez,es ESP,DF,Celta Vigo,es La Liga,28,1993,14.8,34,24,12,13,9,14,28,50.0,14,20,7,13,36,70,34,0,Matches
2757,Lucas Vázquez,es ESP,DF,Real Madrid,es La Liga,30,1991,20.4,43,22,24,9,10,17,35,48.6,18,25,7,18,20,63,41,1,Matches
2758,Matías Vecino,uy URU,MF,Inter,it Serie A,29,1991,4.2,7,5,2,3,2,3,9,33.3,6,10,1,9,4,11,7,0,Matches
2759,Gabriel Veiga,es ESP,MF,Celta Vigo,es La Liga,19,2002,1.2,5,4,0,4,1,3,12,25.0,9,2,0,2,4,9,1,0,Matches
2760,Miguel Veloso,pt POR,MF,Hellas Verona,it Serie A,35,1986,14.9,23,15,4,17,2,10,16,62.5,6,18,5,13,11,34,18,1,Matches
2761,Joël Veltman,nl NED,DF,Brighton,eng Premier League,29,1992,31.9,74,48,47,21,6,21,53,39.6,32,46,16,30,45,119,89,0,Matches
2762,Micky van de Ven,nl NED,DF,Wolfsburg,de Bundesliga,20,2001,2.1,4,4,3,1,0,0,1,0.0,1,4,1,3,2,6,8,0,Matches
2763,Unai Vencedor Paris,es ESP,MF,Athletic Club,es La Liga,20,2000,26.5,26,11,11,9,6,8,42,19.0,34,31,13,18,19,45,22,0,Matches
2764,Lorenzo Venuti,it ITA,DF,Fiorentina,it Serie A,26,1995,17.5,25,10,13,10,2,14,24,58.3,10,13,4,9,5,30,27,0,Matches
2765,Daniele Verde,it ITA,"FW,MF",Spezia,it Serie A,25,1996,21.7,11,4,8,2,1,9,20,45.0,11,17,2,15,18,29,8,0,Matches
2766,Simone Verdi,it ITA,"MF,FW",Torino,it Serie A,29,1992,0.5,1,1,0,1,0,0,0,,0,0,0,0,0,1,0,0,Matches
2767,Simone Verdi,it ITA,"FW,MF",Salernitana,it Serie A,29,1992,9.2,12,8,5,2,5,9,20,45.0,11,4,0,4,3,15,1,0,Matches
2768,Gonzalo Verdú,es ESP,DF,Elche,es La Liga,32,1988,15.5,19,9,15,4,0,8,16,50.0,8,20,14,6,13,32,59,1,Matches
2769,Jordan Veretout,fr FRA,MF,Roma,it Serie A,28,1993,25.8,34,25,20,12,2,15,39,38.5,24,12,1,11,27,61,22,1,Matches
2770,Edoardo Vergani,it ITA,"FW,MF",Salernitana,it Serie A,20,2001,1.1,2,2,2,0,0,0,0,,0,2,2,0,0,2,2,0,Matches
2771,Vincent Vermeij,nl NED,MF,Freiburg,de Bundesliga,26,1994,0.0,0,0,0,0,0,0,0,,0,1,0,1,0,0,0,0,Matches
2772,Marco Verratti,it ITA,MF,Paris S-G,fr Ligue 1,28,1992,21.5,60,40,16,30,14,32,64,50.0,32,36,10,26,18,78,14,2,Matches
2773,Valerio Verre,it ITA,"MF,FW",Sampdoria,it Serie A,27,1994,4.7,7,5,1,4,2,4,9,44.4,5,7,0,7,0,7,5,0,Matches
2774,Valerio Verre,it ITA,MF,Empoli,it Serie A,27,1994,3.4,4,2,3,1,0,2,7,28.6,5,2,0,2,1,5,0,0,Matches
2775,Freddie Veseli,al ALB,DF,Salernitana,it Serie A,28,1992,6.6,7,2,4,3,0,5,6,83.3,1,10,5,5,4,11,19,0,Matches
2776,Mikel Vesga,es ESP,MF,Athletic Club,es La Liga,28,1993,15.1,27,14,7,18,2,11,31,35.5,20,16,5,11,20,47,34,2,Matches
2777,Jannik Vestergaard,dk DEN,DF,Leicester City,eng Premier League,28,1992,6.3,15,10,12,3,0,8,15,53.3,7,10,8,2,7,22,36,0,Matches
2778,Rúben Vezo,pt POR,DF,Levante,es La Liga,27,1994,26.9,41,29,28,12,1,26,41,63.4,15,41,25,16,36,77,105,1,Matches
2779,Guglielmo Vicario,it ITA,GK,Empoli,it Serie A,24,1996,38.0,1,1,1,0,0,1,1,100.0,0,1,0,1,1,2,21,1,Matches
2780,Aleix Vidal,es ESP,"DF,MF",Espanyol,es La Liga,31,1989,21.1,31,25,17,9,5,19,39,48.7,20,19,6,13,25,56,35,2,Matches
2781,Arturo Vidal,cl CHI,MF,Inter,it Serie A,34,1987,8.2,26,10,16,9,1,9,26,34.6,17,13,5,8,7,33,7,1,Matches
2782,Nacho Vidal,es ESP,DF,Osasuna,es La Liga,26,1995,32.2,83,47,49,25,9,39,77,50.6,38,32,14,18,58,141,79,0,Matches
2783,Gabriel Vidovic,hr CRO,"FW,MF",Bayern Munich,de Bundesliga,17,2003,0.4,0,0,0,0,0,0,0,,0,0,0,0,0,0,0,0,Matches
2784,Ronaldo Vieira,eng ENG,MF,Sampdoria,it Serie A,23,1998,5.5,10,6,6,4,0,5,10,50.0,5,5,2,3,6,16,5,1,Matches
2785,Nick Viergever,nl NED,DF,Greuther Fürth,de Bundesliga,31,1989,23.7,32,23,25,7,0,24,34,70.6,10,31,22,9,37,69,119,1,Matches
2786,Luca Vignali,it ITA,"DF,MF",Spezia,it Serie A,25,1996,0.9,1,1,0,1,0,0,3,0.0,3,0,0,0,1,2,1,0,Matches
2787,Emanuel Vignato,it ITA,"MF,DF",Bologna,it Serie A,20,2000,6.6,12,7,5,7,0,6,13,46.2,7,2,0,2,2,14,5,0,Matches
2788,Dídac Vilà,es ESP,"DF,MF",Espanyol,es La Liga,32,1989,2.3,7,5,2,5,0,4,9,44.4,5,2,1,1,3,10,8,0,Matches
2789,Tonny Vilhena,nl NED,"MF,FW",Espanyol,es La Liga,26,1995,10.3,16,6,7,8,1,7,21,33.3,14,10,2,8,8,24,17,0,Matches
2790,Daniel Villahermosa,es ESP,MF,Espanyol,es La Liga,20,2001,0.3,0,0,0,0,0,0,0,,0,0,0,0,0,0,1,0,Matches
2791,Asier Villalibre,es ESP,FW,Athletic Club,es La Liga,23,1997,6.1,4,3,2,1,1,1,2,50.0,1,3,1,2,1,5,7,0,Matches
2792,Gonzalo Villar,es ESP,MF,Getafe,es La Liga,23,1998,3.3,5,3,4,1,0,2,5,40.0,3,4,1,3,1,6,1,0,Matches
2793,Matías Viña,uy URU,"DF,FW",Roma,it Serie A,23,1997,17.4,46,30,27,14,5,29,59,49.2,30,26,3,23,25,71,33,0,Matches
2794,Nicolas Viola,it ITA,MF,Bologna,it Serie A,31,1989,1.1,2,2,1,1,0,1,2,50.0,1,1,1,0,0,2,1,0,Matches
2795,Mattia Viti,it ITA,DF,Empoli,it Serie A,19,2002,16.6,28,16,16,9,3,15,24,62.5,9,28,25,3,29,57,69,1,Matches
2796,Vitolo,es ESP,MF,Getafe,es La Liga,31,1989,2.5,3,2,1,1,1,2,5,40.0,3,3,0,3,1,4,1,0,Matches
2797,Daniel Vivian,es ESP,DF,Athletic Club,es La Liga,22,1999,22.1,32,21,24,7,1,17,24,70.8,7,20,15,5,26,58,107,1,Matches
2798,Dušan Vlahović,rs SRB,FW,Fiorentina,it Serie A,21,2000,20.6,5,0,0,2,3,2,11,18.2,9,6,2,4,1,6,16,0,Matches
2799,Dušan Vlahović,rs SRB,FW,Juventus,it Serie A,21,2000,12.0,0,0,0,0,0,0,4,0.0,4,3,0,3,0,0,7,0,Matches
2800,Nikola Vlašić,hr CRO,"FW,MF",West Ham,eng Premier League,23,1997,6.2,11,7,4,6,1,5,20,25.0,15,4,0,4,2,13,1,0,Matches
2801,Andreas Voglsammer,de GER,"FW,MF",Union Berlin,de Bundesliga,29,1992,9.8,14,9,8,3,3,6,14,42.9,8,9,2,7,2,16,7,0,Matches
2802,Kevin Vogt,de GER,DF,Hoffenheim,de Bundesliga,29,1991,28.5,21,12,15,6,0,11,21,52.4,10,18,7,11,13,34,101,1,Matches
2803,Mërgim Vojvoda,xk KVX,DF,Torino,it Serie A,26,1995,22.0,38,23,23,11,4,20,36,55.6,16,27,8,19,20,58,51,0,Matches
2804,Kevin Volland,de GER,"MF,FW",Monaco,fr Ligue 1,29,1992,27.1,24,10,2,18,4,6,31,19.4,25,20,0,20,3,27,9,0,Matches
2805,Cristian Volpato,it ITA,"FW,MF",Roma,it Serie A,17,2003,0.4,1,1,0,0,1,1,1,100.0,0,0,0,0,0,1,0,0,Matches
2806,Aster Vranckx,be BEL,MF,Wolfsburg,de Bundesliga,18,2002,12.7,34,13,14,16,4,14,26,53.8,12,19,7,12,13,47,16,0,Matches
2807,Stefan de Vrij,nl NED,DF,Inter,it Serie A,29,1992,26.8,38,29,22,16,0,12,17,70.6,5,17,8,9,32,70,52,0,Matches
2808,Šime Vrsaljko,hr CRO,DF,Atlético Madrid,es La Liga,29,1992,10.2,27,17,14,12,1,12,20,60.0,8,10,1,9,12,39,30,0,Matches
2809,Nikola Vukčević,me MNE,MF,Levante,es La Liga,29,1991,1.3,3,2,2,1,0,0,1,0.0,1,2,0,2,2,5,1,0,Matches
2810,Matěj Vydra,cz CZE,FW,Burnley,eng Premier League,29,1992,7.5,12,7,3,4,5,3,7,42.9,4,5,1,4,0,12,9,0,Matches
2811,Elye Wahi,fr FRA,FW,Montpellier,fr Ligue 1,18,2003,19.8,18,10,9,6,3,6,16,37.5,10,7,0,7,4,22,4,0,Matches
2812,Walace,br BRA,MF,Udinese,it Serie A,26,1995,33.0,83,49,37,38,8,50,113,44.2,63,51,5,46,54,137,32,1,Matches
2813,Theo Walcott,eng ENG,"MF,FW",Southampton,eng Premier League,32,1989,4.2,4,2,2,0,2,1,5,20.0,4,3,0,3,5,9,2,0,Matches
2814,Luca Waldschmidt,de GER,"MF,FW",Wolfsburg,de Bundesliga,25,1996,8.0,9,1,3,5,1,5,13,38.5,8,5,0,5,8,17,3,0,Matches
2815,Kyle Walker,eng ENG,DF,Manchester City,eng Premier League,31,1990,19.5,15,6,7,7,1,8,17,47.1,9,14,4,10,14,29,16,1,Matches
2816,Kyle Walker-Peters,eng ENG,DF,Southampton,eng Premier League,24,1997,29.3,57,33,28,21,8,26,38,68.4,12,29,8,21,37,94,53,1,Matches
2817,Sebastian Walukiewicz,pl POL,DF,Cagliari,it Serie A,21,2000,3.4,9,5,7,2,0,3,5,60.0,2,5,2,3,7,16,14,0,Matches
2818,Aaron Wan-Bissaka,eng ENG,DF,Manchester Utd,eng Premier League,23,1997,19.9,49,36,25,18,6,14,20,70.0,6,24,14,10,34,83,41,2,Matches
2819,Paul Wanner,de GER,"FW,MF",Bayern Munich,de Bundesliga,15,2005,0.4,2,2,0,2,0,1,1,100.0,0,0,0,0,0,2,0,0,Matches
2820,Danny Ward,wls WAL,GK,Leicester City,eng Premier League,28,1993,1.0,0,0,0,0,0,0,0,,0,0,0,0,0,0,1,0,Matches
2821,Joel Ward,eng ENG,DF,Crystal Palace,eng Premier League,31,1989,27.6,44,26,30,11,3,30,57,52.6,27,24,11,13,32,76,107,1,Matches
2822,James Ward-Prowse,eng ENG,MF,Southampton,eng Premier League,26,1994,35.7,41,24,12,24,5,19,70,27.1,51,43,15,28,40,81,45,1,Matches
2823,Magnus Warming,dk DEN,"MF,FW",Torino,it Serie A,21,2000,0.6,1,1,0,1,0,0,0,,0,2,0,2,0,1,0,0,Matches
2824,Daniel Wass,dk DEN,"DF,FW",Atlético Madrid,es La Liga,32,1989,0.5,0,0,0,0,0,0,0,,0,0,0,0,0,0,3,0,Matches
2825,Daniel Wass,dk DEN,MF,Valencia,es La Liga,32,1989,17.6,23,13,6,14,3,8,31,25.8,23,13,2,11,13,36,19,0,Matches
2826,Ollie Watkins,eng ENG,FW,Aston Villa,eng Premier League,25,1995,32.8,17,13,2,7,8,2,15,13.3,13,25,3,22,12,29,27,0,Matches
2827,Timothy Weah,us USA,"MF,FW",Lille,fr Ligue 1,21,2000,18.0,19,7,8,8,3,10,20,50.0,10,16,1,15,10,29,7,0,Matches
2828,Adam Webster,eng ENG,DF,Brighton,eng Premier League,26,1995,15.9,26,8,17,7,2,13,20,65.0,7,25,17,8,17,43,66,2,Matches
2829,Wout Weghorst,nl NED,FW,Burnley,eng Premier League,28,1992,16.1,17,9,3,9,5,6,19,31.6,13,16,5,11,6,23,13,0,Matches
2830,Wout Weghorst,nl NED,FW,Wolfsburg,de Bundesliga,28,1992,17.3,13,7,3,3,7,7,17,41.2,10,10,3,7,2,15,11,1,Matches
2831,Noah Weißhaupt,de GER,"MF,FW",Freiburg,de Bundesliga,19,2001,1.1,1,1,1,0,0,1,2,50.0,1,2,0,2,1,2,1,1,Matches
2832,Danny Welbeck,eng ENG,"FW,MF",Brighton,eng Premier League,30,1990,16.4,14,7,2,8,4,3,10,30.0,7,18,2,16,5,19,18,0,Matches
2833,Timo Werner,de GER,"FW,MF",Chelsea,eng Premier League,25,1996,14.3,8,4,3,3,2,2,20,10.0,18,9,0,9,2,10,4,0,Matches
2834,Ashley Westwood,eng ENG,MF,Burnley,eng Premier League,31,1990,25.4,21,12,8,12,1,10,31,32.3,21,21,9,12,30,51,16,1,Matches
2835,Ben White,eng ENG,DF,Arsenal,eng Premier League,23,1997,32.0,44,23,30,8,6,28,45,62.2,17,42,24,18,42,86,102,0,Matches
2836,Silvan Widmer,ch SUI,DF,Mainz 05,de Bundesliga,28,1993,32.4,60,28,32,20,8,36,61,59.0,25,44,16,28,43,103,59,2,Matches
2837,Georginio Wijnaldum,nl NED,MF,Paris S-G,fr Ligue 1,30,1990,18.4,15,9,2,12,1,11,19,57.9,8,13,3,10,9,24,7,0,Matches
2838,Jetro Willems,nl NED,DF,Greuther Fürth,de Bundesliga,27,1994,17.8,30,15,18,10,2,15,26,57.7,11,15,3,12,14,44,42,0,Matches
2839,Brandon Williams,eng ENG,DF,Norwich City,eng Premier League,20,2000,23.6,55,37,35,18,2,36,64,56.3,28,26,6,20,44,99,50,0,Matches
2840,Iñaki Williams,gh GHA,FW,Athletic Club,es La Liga,27,1994,30.9,14,5,1,6,7,5,17,29.4,12,18,3,15,3,17,20,0,Matches
2841,Neco Williams,wls WAL,DF,Liverpool,eng Premier League,20,2001,0.1,0,0,0,0,0,0,0,,0,0,0,0,0,0,0,0,Matches
2842,Nico Williams,es ESP,MF,Athletic Club,es La Liga,19,2002,14.9,20,10,6,11,3,10,31,32.3,21,18,2,16,5,25,9,0,Matches
2843,Joe Willock,eng ENG,MF,Newcastle Utd,eng Premier League,21,1999,22.6,64,37,30,28,6,29,68,42.6,39,37,6,31,21,85,10,1,Matches
2844,Callum Wilson,eng ENG,FW,Newcastle Utd,eng Premier League,29,1992,15.4,9,8,1,5,3,1,4,25.0,3,7,2,5,3,12,10,0,Matches
2845,Patrick Wimmer,at AUT,"FW,MF",Arminia,de Bundesliga,20,2001,22.8,53,31,13,31,9,22,61,36.1,39,30,1,29,27,80,13,0,Matches
2846,Jonas Wind,dk DEN,"FW,MF",Wolfsburg,de Bundesliga,22,1999,13.1,10,6,1,7,2,1,4,25.0,3,8,3,5,6,16,13,0,Matches
2847,Marten Winkler,de GER,MF,Hertha BSC,de Bundesliga,18,2002,0.3,0,0,0,0,0,0,0,,0,0,0,0,0,0,0,0,Matches
2848,Harry Winks,eng ENG,MF,Tottenham,eng Premier League,25,1996,10.1,15,10,4,9,2,8,21,38.1,13,14,3,11,16,31,10,2,Matches
2849,Frederik Winther,dk DEN,DF,Augsburg,de Bundesliga,20,2001,3.6,7,2,7,0,0,5,6,83.3,1,4,1,3,8,15,21,0,Matches
2850,Florian Wirtz,de GER,"MF,FW",Leverkusen,de Bundesliga,18,2003,20.6,25,10,6,16,3,10,28,35.7,18,12,1,11,13,38,4,0,Matches
2851,Yoane Wissa,cd COD,FW,Brentford,eng Premier League,24,1996,14.3,12,6,5,4,3,1,16,6.3,15,12,5,7,8,20,6,0,Matches
2852,Axel Witsel,be BEL,"MF,DF",Dortmund,de Bundesliga,32,1989,21.6,42,27,12,23,7,18,30,60.0,12,24,9,15,27,69,38,0,Matches
2853,Hannes Wolf,at AUT,"FW,MF",Gladbach,de Bundesliga,22,1999,3.4,23,12,4,13,6,10,20,50.0,10,10,0,10,2,25,1,0,Matches
2854,Marius Wolf,de GER,"DF,FW",Dortmund,de Bundesliga,26,1995,14.7,26,10,13,9,4,12,24,50.0,12,14,1,13,13,39,8,0,Matches
2855,Luca Wollschläger,de GER,"FW,MF",Hertha BSC,de Bundesliga,18,2003,0.2,1,1,0,1,0,0,1,0.0,1,0,0,0,0,1,0,0,Matches
2856,Jeong Woo-yeong,kr KOR,"FW,MF",Freiburg,de Bundesliga,21,1999,19.8,15,9,6,7,2,5,15,33.3,10,8,1,7,7,22,11,0,Matches
2857,Chris Wood,nz NZL,FW,Burnley,eng Premier League,29,1991,15.2,7,5,0,3,4,3,10,30.0,7,13,4,9,0,7,3,0,Matches
2858,Chris Wood,nz NZL,FW,Newcastle Utd,eng Premier League,29,1991,14.7,2,0,1,1,0,1,2,50.0,1,5,2,3,2,4,9,0,Matches
2859,Freddie Woodman,eng ENG,GK,Newcastle Utd,eng Premier League,24,1997,4.0,0,0,0,0,0,0,0,,0,0,0,0,0,0,0,1,Matches
2860,Christopher Wooh,cm CMR,DF,Lens,fr Ligue 1,19,2001,11.7,29,11,20,8,1,11,18,61.1,7,21,14,7,21,50,40,1,Matches
2861,Joscha Wosz,de GER,DF,RB Leipzig,de Bundesliga,19,2002,0.1,0,0,0,0,0,0,0,,0,0,0,0,0,0,0,0,Matches
2862,Xeka,pt POR,MF,Lille,fr Ligue 1,26,1994,18.0,47,27,18,24,5,27,56,48.2,29,23,3,20,24,71,26,1,Matches
2863,Granit Xhaka,ch SUI,"MF,DF",Arsenal,eng Premier League,28,1992,25.9,32,18,16,12,4,16,41,39.0,25,21,6,15,21,53,31,0,Matches
2864,Sekou Yansané,gn GUI,FW,Paris S-G,fr Ligue 1,18,2003,0.2,0,0,0,0,0,0,1,0.0,1,0,0,0,0,0,1,0,Matches
2865,Andriy Yarmolenko,ua UKR,"FW,MF",West Ham,eng Premier League,31,1989,3.5,4,2,2,2,0,2,8,25.0,6,4,2,2,0,4,2,0,Matches
2866,Yusuf Yazıcı,tr TUR,"MF,FW",Lille,fr Ligue 1,24,1997,5.7,10,5,3,6,1,1,9,11.1,8,4,0,4,2,12,1,0,Matches
2867,Kelvin Yeboah,it ITA,"FW,MF",Genoa,it Serie A,21,2000,9.4,14,7,5,7,2,9,19,47.4,10,22,1,21,1,15,7,0,Matches
2868,Gerard Yepes,es ESP,"MF,DF",Sampdoria,it Serie A,18,2002,0.2,1,0,0,1,0,1,1,100.0,0,1,0,1,0,1,0,0,Matches
2869,Burak Yılmaz,tr TUR,FW,Lille,fr Ligue 1,36,1985,24.6,7,2,0,2,5,2,17,11.8,15,8,1,7,2,9,11,0,Matches
2870,Okay Yokuşlu,tr TUR,"DF,MF",Getafe,es La Liga,27,1994,5.2,9,8,6,2,1,5,5,100.0,0,7,5,2,5,14,17,0,Matches
2871,Okay Yokuşlu,tr TUR,"DF,MF",Celta Vigo,es La Liga,27,1994,1.6,4,1,2,1,1,2,3,66.7,1,2,1,1,2,6,6,0,Matches
2872,Leny Yoro,fr FRA,MF,Lille,fr Ligue 1,15,2005,0.1,1,0,0,1,0,0,0,,0,1,0,1,0,1,0,0,Matches
2873,Maya Yoshida,jp JPN,DF,Sampdoria,it Serie A,32,1988,20.3,17,10,8,9,0,8,15,53.3,7,27,20,7,28,45,72,1,Matches
2874,Ashley Young,eng ENG,"DF,FW",Aston Villa,eng Premier League,36,1985,13.9,18,6,9,6,3,11,16,68.8,5,10,4,6,13,31,25,1,Matches
2875,Nathan Young-Coombes,eng ENG,MF,Brentford,eng Premier League,18,2003,0.0,0,0,0,0,0,0,0,,0,0,0,0,0,0,0,0,Matches
2876,Zaydou Youssouf,fr FRA,MF,Saint-Étienne,fr Ligue 1,22,1999,17.3,48,26,21,25,2,14,34,41.2,20,11,3,8,17,65,13,0,Matches
2877,Mattia Zaccagni,it ITA,MF,Hellas Verona,it Serie A,26,1995,2.0,3,1,1,0,2,1,2,50.0,1,1,0,1,4,7,0,0,Matches
2878,Mattia Zaccagni,it ITA,FW,Lazio,it Serie A,26,1995,20.8,33,16,10,13,10,11,19,57.9,8,17,2,15,20,53,5,0,Matches
2879,Dan-Axel Zagadou,fr FRA,DF,Dortmund,de Bundesliga,22,1999,10.6,13,7,11,1,1,7,10,70.0,3,14,4,10,15,28,38,2,Matches
2880,Wilfried Zaha,ci CIV,FW,Crystal Palace,eng Premier League,28,1992,30.7,40,20,14,15,11,10,31,32.3,21,28,0,28,5,45,5,0,Matches
2881,Denis Zakaria,ch SUI,MF,Juventus,it Serie A,24,1996,6.6,11,7,3,6,2,3,11,27.3,8,16,3,13,11,22,7,0,Matches
2882,Denis Zakaria,ch SUI,"MF,DF",Gladbach,de Bundesliga,24,1996,15.5,23,14,9,10,4,12,35,34.3,23,25,5,20,19,42,22,1,Matches
2883,Joseba Zaldúa,es ESP,DF,Real Sociedad,es La Liga,29,1992,13.0,31,22,20,8,3,16,22,72.7,6,14,4,10,13,44,35,0,Matches
2884,Nicola Zalewski,pl POL,DF,Roma,it Serie A,19,2002,8.8,32,19,17,11,4,21,35,60.0,14,18,1,17,16,48,4,0,Matches
2885,Andre-Frank Zambo Anguissa,cm CMR,MF,Napoli,it Serie A,25,1995,21.4,50,26,24,17,9,25,51,49.0,26,31,5,26,24,74,33,1,Matches
2886,Nicolò Zaniolo,it ITA,"FW,MF",Roma,it Serie A,22,1999,21.9,24,15,0,15,9,6,28,21.4,22,19,0,19,7,31,6,0,Matches
2887,Alessandro Zanoli,it ITA,DF,Napoli,it Serie A,20,2000,5.1,10,7,6,3,1,3,5,60.0,2,2,1,1,4,14,16,0,Matches
2888,Mattia Zanotti,it ITA,DF,Inter,it Serie A,18,2003,0.1,1,0,1,0,0,0,1,0.0,1,0,0,0,0,1,0,0,Matches
2889,Duván Zapata,co COL,FW,Atalanta,it Serie A,30,1991,19.1,6,2,0,4,2,4,8,50.0,4,8,1,7,3,9,5,0,Matches
2890,Gabriele Zappa,it ITA,DF,Cagliari,it Serie A,21,1999,12.7,21,9,12,6,3,6,24,25.0,18,15,5,10,14,35,28,0,Matches
2891,Davide Zappacosta,it ITA,DF,Atalanta,it Serie A,29,1992,26.1,32,22,12,13,7,19,37,51.4,18,32,2,30,12,44,22,0,Matches
2892,Oier Zarraga,es ESP,MF,Athletic Club,es La Liga,22,1999,13.0,13,5,4,7,2,3,28,10.7,25,17,10,7,19,32,10,0,Matches
2893,Simone Zaza,it ITA,"FW,DF",Torino,it Serie A,30,1991,1.4,2,2,1,1,0,1,1,100.0,0,3,0,3,0,2,3,0,Matches
2894,Akim Zedadka,dz ALG,DF,Clermont Foot,fr Ligue 1,26,1995,37.1,72,44,34,29,9,37,71,52.1,34,32,8,24,58,130,48,0,Matches
2895,Deyovaisio Zeefuik,nl NED,DF,Hertha BSC,de Bundesliga,23,1998,6.3,11,10,6,4,1,6,12,50.0,6,12,4,8,11,22,21,1,Matches
2896,Marvin Zeegelaar,nl NED,DF,Udinese,it Serie A,30,1990,7.1,15,11,6,8,1,5,14,35.7,9,12,4,8,12,27,22,1,Matches
2897,Arber Zeneli,xk KVX,FW,Reims,fr Ligue 1,26,1995,4.5,1,0,0,0,1,1,5,20.0,4,0,0,0,1,2,1,0,Matches
2898,Robin Zentner,de GER,GK,Mainz 05,de Bundesliga,26,1994,32.0,2,2,2,0,0,2,2,100.0,0,0,0,0,2,4,21,1,Matches
2899,Andi Zeqiri,ch SUI,"FW,MF",Augsburg,de Bundesliga,22,1999,11.3,14,7,3,5,6,3,12,25.0,9,10,1,9,2,16,12,0,Matches
2900,Mehdi Zerkane,dz ALG,"MF,DF",Bordeaux,fr Ligue 1,22,1999,0.9,0,0,0,0,0,0,1,0.0,1,1,1,0,2,2,0,0,Matches
2901,Edon Zhegrova,xk KVX,"MF,FW",Lille,fr Ligue 1,22,1999,5.3,14,5,2,8,4,5,6,83.3,1,4,1,3,2,16,2,0,Matches
2902,Luca Zidane,fr FRA,GK,Rayo Vallecano,es La Liga,23,1998,7.2,0,0,0,0,0,0,1,0.0,1,0,0,0,0,0,1,1,Matches
2903,Piotr Zieliński,pl POL,MF,Napoli,it Serie A,27,1994,23.2,19,12,5,9,5,6,21,28.6,15,13,2,11,8,27,4,0,Matches
2904,David Zima,cz CZE,DF,Torino,it Serie A,20,2000,14.6,20,12,8,11,1,9,20,45.0,11,15,13,2,23,43,42,0,Matches
2905,Christoph Zimmermann,de GER,DF,Norwich City,eng Premier League,28,1993,1.7,6,3,5,1,0,3,4,75.0,1,0,0,0,1,7,4,0,Matches
2906,Oleksandr Zinchenko,ua UKR,DF,Manchester City,eng Premier League,24,1996,11.6,20,14,7,10,3,11,20,55.0,9,11,3,8,14,34,15,1,Matches
2907,Hakim Ziyech,ma MAR,"MF,FW",Chelsea,eng Premier League,28,1993,14.7,19,10,5,12,2,10,36,27.8,26,11,1,10,10,29,10,0,Matches
2908,Jeroen Zoet,nl NED,GK,Spezia,it Serie A,30,1991,7.0,1,0,1,0,0,1,1,100.0,0,0,0,0,0,1,4,0,Matches
2909,Simon Zoller,de GER,FW,Bochum,de Bundesliga,30,1991,6.6,4,2,2,1,1,1,3,33.3,2,3,0,3,4,8,2,0,Matches
2910,Nadir Zortea,it ITA,"DF,MF",Salernitana,it Serie A,22,1999,15.7,21,15,9,7,5,11,19,57.9,8,14,2,12,7,28,33,0,Matches
2911,Tanguy Zoukrou,fr FRA,DF,Troyes,fr Ligue 1,18,2003,0.9,1,0,1,0,0,1,2,50.0,1,0,0,0,0,1,2,0,Matches
2912,Kurt Zouma,fr FRA,DF,West Ham,eng Premier League,26,1994,23.1,11,6,8,3,0,4,7,57.1,3,31,26,5,34,45,132,0,Matches
2913,Petar Zovko,ba BIH,GK,Spezia,it Serie A,19,2002,0.3,0,0,0,0,0,0,0,,0,0,0,0,0,0,1,0,Matches
2914,Igor Zubeldia,es ESP,DF,Real Sociedad,es La Liga,24,1997,18.3,20,10,12,8,0,12,18,66.7,6,16,6,10,27,47,53,0,Matches
2915,Martín Zubimendi,es ESP,MF,Real Sociedad,es La Liga,22,1999,28.8,52,25,19,30,3,22,44,50.0,22,30,13,17,49,101,48,1,Matches
2916,Szymon Żurkowski,pl POL,MF,Empoli,it Serie A,23,1997,25.6,58,33,24,21,13,29,68,42.6,39,43,10,33,35,93,32,1,Matches
2917,Martin Ødegaard,no NOR,"MF,FW",Arsenal,eng Premier League,22,1998,30.9,49,21,6,24,19,22,61,36.1,39,18,1,17,11,60,11,1,Matches
2918,Milan Đurić,ba BIH,FW,Salernitana,it Serie A,31,1990,24.1,1,1,0,1,0,1,3,33.3,2,6,1,5,2,3,32,0,Matches
2919,Filip Đuričić,rs SRB,"MF,FW",Sassuolo,it Serie A,29,1992,7.5,13,10,7,1,5,5,13,38.5,8,7,1,6,4,17,1,0,Matches
