,Player,Nation,Pos,Squad,Comp,Age,Born,90s,Tackles,Tackles_Won,Tackles_Def_3rd,Tackles_Mid_3rd,Tackles_Att_3rd,Dribblers_Tackled,Dribblers_Challenged,Dribblers_Tackle_W%,Dribblers_Tackle_Lost,Blocks,Shots_Blocked,Passes_Blocked,Interceptions,Tackles+Interceptions,Clearances,Errors_Shots,Matches
0,Brenden Aaronson,us USA,"MF,FW",Leeds United,eng Premier League,21,2000,26.4,45,18,16,22,7,15,46,32.6,31,43,3,40,5,50,6,1,Matches
1,Paxten Aaronson,us USA,"MF,DF",Eint Frankfurt,de Bundesliga,18,2003,1.9,6,5,2,2,2,2,3,66.7,1,2,1,1,0,6,2,0,Matches
2,James Abankwah,ie IRL,DF,Udinese,it Serie A,18,2004,0.7,1,1,0,1,0,0,0,,0,4,2,2,0,1,5,0,Matches
3,George Abbott,eng ENG,MF,Tottenham,eng Premier League,16,2005,0.0,0,0,0,0,0,0,0,,0,0,0,0,1,1,0,0,Matches
4,Yunis Abdelhamid,ma MAR,DF,Reims,fr Ligue 1,34,1987,37.0,82,50,47,33,2,39,52,75.0,13,65,27,38,64,146,116,1,Matches
5,Himad Abdelli,dz ALG,"MF,FW",Angers,fr Ligue 1,22,1999,23.7,64,38,22,32,10,31,67,46.3,36,30,1,29,28,92,15,0,Matches
6,Salis Abdul Samed,gh GHA,MF,Lens,fr Ligue 1,22,2000,32.2,46,26,18,23,5,29,52,55.8,23,38,9,29,36,82,26,0,Matches
7,Laurent Abergel,fr FRA,MF,Lorient,fr Ligue 1,29,1993,26.0,92,52,59,30,3,39,92,42.4,53,47,8,39,34,126,39,0,Matches
8,Oliver Abildgaard,dk DEN,MF,Hellas Verona,it Serie A,26,1996,6.6,10,6,6,3,1,7,16,43.8,9,7,1,6,5,15,17,0,Matches
9,Matthis Abline,fr FRA,"FW,MF",Auxerre,fr Ligue 1,19,2003,9.0,4,2,0,3,1,0,5,0.0,5,6,1,5,1,5,1,0,Matches
10,Matthis Abline,fr FRA,"FW,MF",Rennes,fr Ligue 1,19,2003,1.2,1,1,0,0,1,1,1,100.0,0,1,0,1,2,3,1,0,Matches
11,Abner,br BRA,DF,Betis,es La Liga,22,2000,6.7,12,9,9,2,1,7,16,43.8,9,8,2,6,8,20,24,0,Matches
12,Zakaria Aboukhlal,ma MAR,"FW,MF",Toulouse,fr Ligue 1,22,2000,27.5,33,23,13,9,11,14,45,31.1,31,18,1,17,22,55,23,0,Matches
13,Tammy Abraham,eng ENG,FW,Roma,it Serie A,24,1997,24.3,17,10,4,8,5,3,16,18.8,13,10,4,6,3,20,14,0,Matches
14,Christian Acella,it ITA,MF,Cremonese,it Serie A,20,2002,0.2,1,0,1,0,0,0,2,0.0,2,0,0,0,0,1,0,0,Matches
15,Francesco Acerbi,it ITA,DF,Inter,it Serie A,34,1988,26.9,33,19,22,7,4,20,27,74.1,7,25,18,7,41,74,85,2,Matches
16,Álvaro Aceves,es ESP,GK,Valladolid,es La Liga,19,2003,0.1,0,0,0,0,0,0,0,,0,0,0,0,0,0,0,0,Matches
17,Mohamed Achi,fr FRA,FW,Nantes,fr Ligue 1,20,2002,0.4,1,1,1,0,0,1,1,100.0,0,0,0,0,0,1,0,0,Matches
18,Marcos Acuña,ar ARG,DF,Sevilla,es La Liga,30,1991,21.2,57,36,34,17,6,30,42,71.4,12,16,5,11,23,80,36,0,Matches
19,Che Adams,sct SCO,FW,Southampton,eng Premier League,26,1996,22.1,17,13,7,8,2,7,12,58.3,5,13,4,9,4,21,22,0,Matches
20,Tyler Adams,us USA,MF,Leeds United,eng Premier League,23,1999,24.0,89,46,44,35,10,50,77,64.9,27,48,8,40,35,124,29,0,Matches
21,Sargis Adamyan,am ARM,"FW,MF",Köln,de Bundesliga,29,1993,7.2,14,7,5,3,6,7,17,41.2,10,12,0,12,4,18,5,0,Matches
22,Tosin Adarabioyo,eng ENG,DF,Fulham,eng Premier League,24,1997,23.2,30,13,22,6,2,16,23,69.6,7,20,15,5,26,56,140,1,Matches
23,Martin Adeline,fr FRA,"MF,FW",Reims,fr Ligue 1,18,2003,1.2,3,3,2,1,0,3,4,75.0,1,3,1,2,3,6,3,0,Matches
24,Karim Adeyemi,de GER,"FW,MF",Dortmund,de Bundesliga,20,2002,15.4,16,11,6,6,4,8,30,26.7,22,18,1,17,7,23,3,0,Matches
25,Amine Adli,ma MAR,"FW,MF",Leverkusen,de Bundesliga,22,2000,15.9,18,10,4,6,8,5,17,29.4,12,28,2,26,6,24,7,0,Matches
26,Yacine Adli,fr FRA,"MF,FW",Milan,it Serie A,22,2000,1.6,6,3,2,4,0,2,2,100.0,0,2,0,2,1,7,1,0,Matches
27,Michel Aebischer,ch SUI,"FW,MF",Bologna,it Serie A,25,1997,17.1,12,6,3,6,3,2,18,11.1,16,14,2,12,7,19,9,0,Matches
28,Felix Afena-Gyan,gh GHA,"FW,MF",Cremonese,it Serie A,19,2003,9.1,7,3,4,1,2,2,10,20.0,8,5,1,4,1,8,6,0,Matches
29,Emmanuel Agbadou,ci CIV,DF,Reims,fr Ligue 1,25,1997,26.5,71,49,53,16,2,42,65,64.6,23,30,14,16,32,103,107,3,Matches
30,Julen Agirrezabala,es ESP,GK,Athletic Club,es La Liga,21,2000,7.5,0,0,0,0,0,0,0,,0,0,0,0,0,0,2,0,Matches
31,Lucien Agoume,fr FRA,MF,Troyes,fr Ligue 1,20,2002,12.2,42,25,18,15,9,17,33,51.5,16,14,5,9,27,69,24,0,Matches
32,Felix Agu,de GER,"DF,FW",Werder Bremen,de Bundesliga,22,1999,0.5,1,0,0,1,0,0,0,,0,1,1,0,0,1,0,0,Matches
33,Álvaro Aguado,es ESP,MF,Valladolid,es La Liga,26,1996,21.0,27,15,13,11,3,15,25,60.0,10,16,4,12,13,40,15,0,Matches
34,Kevin Agudelo,co COL,"MF,FW",Spezia,it Serie A,23,1998,23.7,71,38,22,30,19,25,59,42.4,34,39,5,34,10,81,6,0,Matches
35,Nayef Aguerd,ma MAR,DF,West Ham,eng Premier League,26,1996,17.7,27,18,18,8,1,13,20,65.0,7,26,24,2,18,45,79,2,Matches
36,Ruben Aguilar,fr FRA,DF,Monaco,fr Ligue 1,29,1993,13.0,19,9,7,7,5,8,22,36.4,14,13,1,12,18,37,28,1,Matches
37,Naouirou Ahamada,fr FRA,"MF,FW",Crystal Palace,eng Premier League,20,2002,1.0,3,2,3,0,0,1,3,33.3,2,2,0,2,0,3,0,0,Matches
38,Naouirou Ahamada,fr FRA,MF,Stuttgart,de Bundesliga,20,2002,15.5,17,11,7,7,3,8,20,40.0,12,16,5,11,8,25,7,0,Matches
39,Amar Ahmed,se SWE,FW,Troyes,fr Ligue 1,18,2004,0.2,1,1,0,1,0,0,1,0.0,1,0,0,0,1,2,0,0,Matches
40,Jean-Eudes Aholou,ci CIV,MF,Strasbourg,fr Ligue 1,28,1994,14.4,34,20,10,20,4,12,31,38.7,19,25,0,25,24,58,15,0,Matches
41,Joseph Aidoo,gh GHA,DF,Celta Vigo,es La Liga,26,1995,34.7,51,36,33,17,1,16,28,57.1,12,26,14,12,31,82,150,0,Matches
42,Ola Aina,ng NGA,DF,Torino,it Serie A,25,1996,9.7,17,13,5,8,4,9,15,60.0,6,12,2,10,11,28,26,0,Matches
43,Rayan Aït-Nouri,dz ALG,DF,Wolves,eng Premier League,21,2001,12.0,33,20,25,7,1,9,16,56.3,7,3,0,3,9,42,28,0,Matches
44,Emanuel Aiwum,at AUT,DF,Cremonese,it Serie A,21,2000,18.4,55,34,36,17,2,33,47,70.2,14,28,16,12,25,80,52,3,Matches
45,Kristoffer Ajer,no NOR,DF,Brentford,eng Premier League,24,1998,8.5,11,8,5,4,2,9,16,56.3,7,6,5,1,7,18,22,0,Matches
46,Ludovic Ajorque,fr FRA,FW,Strasbourg,fr Ligue 1,28,1994,8.6,5,4,1,4,0,3,9,33.3,6,3,1,2,2,7,7,0,Matches
47,Ludovic Ajorque,fr FRA,"FW,MF",Mainz 05,de Bundesliga,28,1994,13.5,6,5,1,4,1,1,9,11.1,8,8,2,6,1,7,8,0,Matches
48,Manuel Akanji,ch SUI,DF,Manchester City,eng Premier League,27,1995,25.4,36,25,15,18,3,23,36,63.9,13,27,9,18,16,52,33,1,Matches
49,Nathan Aké,nl NED,DF,Manchester City,eng Premier League,27,1995,20.8,26,12,15,9,2,11,15,73.3,4,20,10,10,20,46,48,0,Matches
50,Sergio Akieme,es ESP,DF,Almería,es La Liga,24,1997,25.5,27,16,19,6,2,12,22,54.5,10,22,6,16,14,41,41,0,Matches
51,Babatunde Akinsola,ng NGA,FW,Valladolid,es La Liga,19,2003,0.1,1,1,0,0,1,0,0,,0,0,0,0,0,1,0,0,Matches
52,Maghnes Akliouche,fr FRA,"MF,FW",Monaco,fr Ligue 1,20,2002,4.5,7,4,4,3,0,2,8,25.0,6,2,0,2,3,10,2,0,Matches
53,Paul Akouokou,ci CIV,"MF,DF",Betis,es La Liga,24,1997,5.0,16,9,13,3,0,13,20,65.0,7,2,2,0,12,28,17,1,Matches
54,Jean-Daniel Akpa-Akpro,ci CIV,"MF,FW",Empoli,it Serie A,29,1992,15.1,53,37,25,19,9,23,42,54.8,19,35,4,31,13,66,27,0,Matches
55,Kevin Akpoguma,ng NGA,DF,Hoffenheim,de Bundesliga,27,1995,21.7,75,44,45,27,3,32,45,71.1,13,45,16,29,24,99,70,1,Matches
56,David Alaba,at AUT,DF,Real Madrid,es La Liga,30,1992,20.4,15,11,8,4,3,9,15,60.0,6,18,9,9,14,29,37,1,Matches
57,Ángel Alarcón,es ESP,FW,Barcelona,es La Liga,18,2004,0.3,,0,,,,,,,,,,,0,,,,Matches
58,Tomás Alarcón,cl CHI,MF,Cádiz,es La Liga,23,1999,2.5,3,2,0,2,1,1,2,50.0,1,1,0,1,2,5,2,0,Matches
59,Lucas Alario,ar ARG,"FW,MF",Eint Frankfurt,de Bundesliga,29,1992,3.7,3,2,1,0,2,0,1,0.0,1,0,0,0,2,5,13,0,Matches
60,Jordi Alba,es ESP,DF,Barcelona,es La Liga,33,1989,15.8,25,18,13,11,1,12,28,42.9,16,12,5,7,11,36,23,0,Matches
61,Luis Alberto,es ESP,MF,Lazio,it Serie A,29,1992,27.1,49,29,18,20,11,23,72,31.9,49,35,6,29,9,58,4,0,Matches
62,Raúl Albiol,es ESP,DF,Villarreal,es La Liga,36,1985,23.5,25,17,17,6,2,14,18,77.8,4,17,13,4,14,39,111,0,Matches
63,Marc Albrighton,eng ENG,"FW,MF",Leicester City,eng Premier League,32,1989,2.6,4,1,0,2,2,1,8,12.5,7,6,2,4,1,5,5,0,Matches
64,Thiago Alcántara,es ESP,MF,Liverpool,eng Premier League,31,1991,13.9,43,24,20,21,2,14,23,60.9,9,15,3,12,21,64,13,2,Matches
65,Carlos Alcaraz,ar ARG,"MF,FW",Southampton,eng Premier League,19,2002,11.4,10,5,2,7,1,6,22,27.3,16,14,5,9,1,11,11,0,Matches
66,Rubén Alcaraz,es ESP,MF,Cádiz,es La Liga,31,1991,22.7,43,31,24,18,1,19,54,35.2,35,23,8,15,19,62,37,0,Matches
67,Omar Alderete,py PAR,DF,Getafe,es La Liga,25,1996,22.7,35,20,21,14,0,28,40,70.0,12,23,16,7,26,61,85,0,Matches
68,Iván Alejo,es ESP,"MF,FW",Cádiz,es La Liga,27,1995,14.6,32,21,19,9,4,17,37,45.9,20,18,3,15,5,37,12,1,Matches
69,Doğan Alemdar,tr TUR,GK,Rennes,fr Ligue 1,19,2002,4.5,0,0,0,0,0,0,0,,0,0,0,0,0,0,1,1,Matches
70,Carles Aleñá,es ESP,"MF,FW",Getafe,es La Liga,24,1998,23.5,18,10,7,5,6,5,34,14.7,29,19,1,18,4,22,18,0,Matches
71,Trent Alexander-Arnold,eng ENG,DF,Liverpool,eng Premier League,23,1998,32.5,57,40,32,16,9,42,80,52.5,38,25,7,18,43,100,41,2,Matches
72,Alejandro Alfaro,es ESP,MF,Elche,es La Liga,20,2002,0.2,0,0,0,0,0,0,0,,0,0,0,0,0,0,0,0,Matches
73,Ángel Algobia,es ESP,MF,Getafe,es La Liga,23,1999,12.6,27,13,14,13,0,22,48,45.8,26,15,5,10,3,30,11,0,Matches
74,Mohamed Ali Cho,fr FRA,"FW,MF",Real Sociedad,es La Liga,18,2004,6.5,13,10,6,5,2,4,10,40.0,6,9,0,9,2,15,2,0,Matches
75,Faride Alidou,de GER,"DF,MF",Eint Frankfurt,de Bundesliga,21,2001,2.0,8,5,3,4,1,3,9,33.3,6,3,0,3,1,9,3,0,Matches
76,Alisson,br BRA,GK,Liverpool,eng Premier League,29,1992,37.0,0,0,0,0,0,0,3,0.0,3,3,0,3,0,0,20,0,Matches
77,Jim Allevinah,ga GAB,"DF,FW",Clermont Foot,fr Ligue 1,27,1995,24.9,39,24,24,11,4,19,62,30.6,43,24,2,22,24,63,26,1,Matches
78,Dele Alli,eng ENG,MF,Everton,eng Premier League,26,1996,0.4,0,0,0,0,0,0,0,,0,0,0,0,0,0,0,0,Matches
79,Domingos André Ribeiro Almeida,pt POR,MF,Valencia,es La Liga,22,2000,28.2,66,42,23,32,11,26,57,45.6,31,26,0,26,20,86,16,1,Matches
80,Miguel Almirón,py PAR,FW,Newcastle Utd,eng Premier League,28,1994,27.7,46,30,16,19,11,18,42,42.9,24,25,2,23,10,56,17,0,Matches
81,Marcos Alonso,es ESP,DF,Barcelona,es La Liga,31,1990,13.0,15,10,10,5,0,9,12,75.0,3,14,10,4,11,26,32,0,Matches
82,Mickaël Alphonse,gp GLP,DF,Ajaccio,fr Ligue 1,33,1989,15.1,35,23,20,11,4,20,33,60.6,13,17,5,12,35,70,44,1,Matches
83,Éder Álvarez Balanta,co COL,"MF,FW",Schalke 04,de Bundesliga,29,1993,2.6,5,4,2,3,0,2,6,33.3,4,0,0,0,3,8,4,0,Matches
84,Carlos Álvarez,es ESP,MF,Sevilla,es La Liga,18,2003,0.1,1,1,0,1,0,0,0,,0,0,0,0,0,1,0,0,Matches
85,Gastón Álvarez,uy URU,DF,Getafe,es La Liga,22,2000,16.7,38,30,24,9,5,23,42,54.8,19,15,5,10,15,53,35,0,Matches
86,Julián Álvarez,ar ARG,"FW,MF",Manchester City,eng Premier League,22,2000,16.3,26,16,3,13,10,9,30,30.0,21,13,0,13,2,28,6,0,Matches
87,Agustín Álvarez Martínez,uy URU,"FW,MF",Sassuolo,it Serie A,21,2001,4.1,6,3,0,5,1,1,4,25.0,3,5,1,4,3,9,3,0,Matches
88,Yeray Álvarez,es ESP,DF,Athletic Club,es La Liga,27,1995,25.9,34,23,26,7,1,24,31,77.4,7,23,13,10,48,82,101,0,Matches
89,Ibrahim Amadou,fr FRA,"DF,MF",Angers,fr Ligue 1,29,1993,4.7,10,7,6,3,1,7,11,63.6,4,7,3,4,10,20,20,0,Matches
90,Selim Amallah,ma MAR,"MF,FW",Valladolid,es La Liga,25,1996,3.0,15,9,7,8,0,5,8,62.5,3,2,0,2,5,20,2,0,Matches
91,Daniel Amartey,gh GHA,DF,Leicester City,eng Premier League,27,1994,17.9,19,8,13,5,1,12,14,85.7,2,24,17,7,8,27,71,0,Matches
92,Amath,sn SEN,"MF,FW",Mallorca,es La Liga,26,1996,13.6,29,19,14,8,7,14,22,63.6,8,13,1,12,5,34,5,0,Matches
93,Jordan Amavi,fr FRA,DF,Getafe,es La Liga,28,1994,2.2,3,2,3,0,0,1,3,33.3,2,3,0,3,4,7,7,0,Matches
94,Lukáš Ambros,cz CZE,MF,Wolfsburg,de Bundesliga,18,2004,0.2,1,0,1,0,0,1,4,25.0,3,1,0,1,0,1,2,1,Matches
95,Kelvin Amian,fr FRA,DF,Spezia,it Serie A,24,1998,26.4,54,32,33,12,9,24,31,77.4,7,34,12,22,22,76,87,1,Matches
96,Bruno Amione,ar ARG,DF,Hellas Verona,it Serie A,20,2002,0.6,1,1,1,0,0,1,2,50.0,1,1,0,1,0,1,4,0,Matches
97,Bruno Amione,ar ARG,DF,Sampdoria,it Serie A,20,2002,23.2,50,33,36,14,0,19,43,44.2,24,26,11,15,25,75,62,1,Matches
98,Nadiem Amiri,de GER,"MF,FW",Leverkusen,de Bundesliga,25,1996,10.9,15,6,5,8,2,9,20,45.0,11,12,1,11,6,21,10,2,Matches
99,Samuel Amo-Ameyaw,eng ENG,MF,Southampton,eng Premier League,16,2006,0.0,0,0,0,0,0,0,1,0.0,1,0,0,0,0,0,0,0,Matches
100,Ethan Ampadu,wls WAL,"DF,MF",Spezia,it Serie A,21,2000,29.3,66,37,33,28,5,17,41,41.5,24,48,23,25,36,102,98,0,Matches
101,Sofyan Amrabat,ma MAR,MF,Fiorentina,it Serie A,25,1996,22.2,39,24,15,17,7,16,29,55.2,13,23,5,18,21,60,18,2,Matches
102,Ayoub Amraoui,ma MAR,"DF,FW",Nice,fr Ligue 1,18,2004,3.3,6,5,3,3,0,2,5,40.0,3,1,0,1,4,10,4,0,Matches
103,Joachim Andersen,dk DEN,DF,Crystal Palace,eng Premier League,26,1996,30.9,42,22,30,12,0,16,32,50.0,16,28,13,15,24,66,188,1,Matches
104,Elliot Anderson,sct SCO,"MF,FW",Newcastle Utd,eng Premier League,19,2002,4.6,11,5,5,3,3,6,12,50.0,6,11,2,9,6,17,2,0,Matches
105,Felipe Anderson,br BRA,FW,Lazio,it Serie A,29,1993,32.9,80,50,31,41,8,31,88,35.2,57,58,6,52,31,111,27,0,Matches
106,Benjamin André,fr FRA,MF,Lille,fr Ligue 1,31,1990,32.4,128,74,51,60,17,65,121,53.7,56,50,8,42,47,175,60,0,Matches
107,Marcos André,br BRA,"FW,MF",Valencia,es La Liga,25,1996,5.0,4,1,1,1,2,1,2,50.0,1,4,1,3,0,4,0,0,Matches
108,Komnen Andrić,rs SRB,FW,Clermont Foot,fr Ligue 1,27,1995,16.1,13,5,2,7,4,2,15,13.3,13,8,1,7,8,21,13,0,Matches
109,Robert Andrich,de GER,MF,Leverkusen,de Bundesliga,27,1994,26.7,61,38,30,27,4,26,45,57.8,19,27,9,18,42,103,55,2,Matches
110,Angeliño,es ESP,DF,Hoffenheim,de Bundesliga,25,1997,29.1,40,24,19,18,3,23,37,62.2,14,32,6,26,25,65,67,0,Matches
111,Fabrizio Angileri,ar ARG,DF,Getafe,es La Liga,28,1994,6.5,12,9,8,3,1,10,17,58.8,7,8,3,5,7,19,10,0,Matches
112,Jaidon Anthony,eng ENG,"MF,FW",Bournemouth,eng Premier League,22,1999,14.0,30,17,15,9,6,8,24,33.3,16,30,3,27,10,40,19,0,Matches
113,Janis Antiste,fr FRA,FW,Sassuolo,it Serie A,19,2002,0.6,1,0,1,0,0,1,1,100.0,0,0,0,0,0,1,0,0,Matches
114,Waldemar Anton,de GER,DF,Stuttgart,de Bundesliga,26,1996,32.6,49,27,27,19,3,27,51,52.9,24,44,16,28,38,87,123,2,Matches
115,Josep Antoni Gayá,es ESP,"DF,MF",Mallorca,es La Liga,22,2000,1.1,0,0,0,0,0,0,0,,0,4,2,2,1,1,6,0,Matches
116,José Antonio,es ESP,"MF,DF",Cádiz,es La Liga,18,2004,0.5,2,1,0,0,2,0,0,,0,0,0,0,0,2,0,0,Matches
117,Marcos Antônio,br BRA,MF,Lazio,it Serie A,22,2000,6.6,9,6,4,5,0,9,20,45.0,11,7,2,5,11,20,18,0,Matches
118,Michail Antonio,jm JAM,FW,West Ham,eng Premier League,32,1990,20.3,14,7,1,8,5,3,12,25.0,9,13,5,8,5,19,9,0,Matches
119,Antony,br BRA,FW,Manchester Utd,eng Premier League,22,2000,20.0,22,9,9,9,4,8,28,28.6,20,18,0,18,11,33,6,0,Matches
120,Valentin Antov,bg BUL,DF,Monza,it Serie A,21,2000,3.4,6,5,3,3,0,1,5,20.0,4,5,4,1,4,10,14,1,Matches
121,Christopher Antwi-Adjei,gh GHA,"FW,MF",Bochum,de Bundesliga,28,1994,22.0,23,15,7,8,8,10,29,34.5,19,17,0,17,5,28,16,0,Matches
122,Anuar,ma MAR,"MF,FW",Valladolid,es La Liga,27,1995,2.3,4,4,0,1,3,0,0,,0,5,2,3,3,7,3,0,Matches
123,Houssem Aouar,dz ALG,MF,Lyon,fr Ligue 1,24,1998,5.8,12,5,5,5,2,3,9,33.3,6,12,2,10,8,20,3,0,Matches
124,Adil Aouchiche,fr FRA,MF,Lorient,fr Ligue 1,20,2002,2.8,5,2,3,1,1,1,9,11.1,8,1,0,1,4,9,1,0,Matches
125,Dennis Appiah,fr FRA,"DF,MF",Nantes,fr Ligue 1,30,1992,8.8,21,11,14,7,0,10,27,37.0,17,13,5,8,10,31,16,0,Matches
126,Stredair Appuah,fr FRA,"DF,MF",Nantes,fr Ligue 1,18,2004,0.7,2,1,0,2,0,0,0,,0,2,0,2,1,3,0,0,Matches
127,Mauro Arambarri,uy URU,MF,Getafe,es La Liga,26,1995,11.0,14,6,9,4,1,3,17,17.6,14,17,5,12,14,28,19,0,Matches
128,Charles Aránguiz,cl CHI,MF,Leverkusen,de Bundesliga,33,1989,5.5,17,7,7,10,0,12,20,60.0,8,4,0,4,7,24,4,0,Matches
129,Ronald Araújo,uy URU,DF,Barcelona,es La Liga,23,1999,20.0,26,18,12,13,1,6,9,66.7,3,15,7,8,12,38,41,1,Matches
130,Cameron Archer,eng ENG,"FW,MF",Aston Villa,eng Premier League,21,2001,0.5,0,0,0,0,0,0,0,,0,0,0,0,0,0,0,0,Matches
131,Taïryk Arconte,fr FRA,FW,Brest,fr Ligue 1,18,2003,1.4,1,1,0,0,1,0,3,0.0,3,1,0,1,0,1,2,0,Matches
132,Alphonse Areola,fr FRA,GK,West Ham,eng Premier League,29,1993,3.4,0,0,0,0,0,0,0,,0,0,0,0,0,0,0,0,Matches
133,Adu Ares,es ESP,"FW,MF",Athletic Club,es La Liga,20,2001,0.9,4,2,2,1,1,4,4,100.0,0,1,0,1,2,6,1,0,Matches
134,Joe Aribo,ng NGA,"MF,FW",Southampton,eng Premier League,26,1996,13.6,31,20,15,12,4,11,20,55.0,9,14,1,13,10,41,11,0,Matches
135,Adam Armstrong,eng ENG,"FW,MF",Southampton,eng Premier League,25,1997,14.8,14,9,6,5,3,3,10,30.0,7,15,3,12,5,19,6,0,Matches
136,Stuart Armstrong,sct SCO,"MF,FW",Southampton,eng Premier League,30,1992,15.6,32,21,15,13,4,14,39,35.9,25,18,0,18,10,42,9,2,Matches
137,Marko Arnautović,at AUT,FW,Bologna,it Serie A,33,1989,17.0,9,6,2,5,2,1,6,16.7,5,11,1,10,2,11,10,0,Matches
138,Maximilian Arnold,de GER,MF,Wolfsburg,de Bundesliga,28,1994,30.7,62,31,25,28,9,28,54,51.9,26,34,11,23,26,88,65,2,Matches
139,Mohamed El Arouch,fr FRA,MF,Lyon,fr Ligue 1,18,2004,0.0,1,1,1,0,0,0,0,,0,0,0,0,0,1,0,0,Matches
140,Sergio Arribas,es ESP,"MF,FW",Real Madrid,es La Liga,20,2001,0.2,0,0,0,0,0,0,0,,0,1,0,1,0,0,0,0,Matches
141,Kepa Arrizabalaga,es ESP,GK,Chelsea,eng Premier League,27,1994,28.5,2,2,2,0,0,2,3,66.7,1,0,0,0,1,3,16,2,Matches
142,Roberto Arroyo,es ESP,MF,Valladolid,es La Liga,18,2003,0.2,1,1,0,1,0,1,1,100.0,0,0,0,0,0,1,0,0,Matches
143,Tolgay Arslan,de GER,MF,Udinese,it Serie A,31,1990,13.5,29,18,13,15,1,14,39,35.9,25,19,0,19,12,41,9,1,Matches
144,Ricard Artero,es ESP,"MF,FW",Girona,es La Liga,19,2003,1.5,3,3,2,1,0,1,1,100.0,0,2,0,2,1,4,3,0,Matches
145,Santiago Arzamendia,py PAR,"DF,MF",Cádiz,es La Liga,24,1998,5.4,9,8,7,1,1,6,21,28.6,15,11,1,10,2,11,15,1,Matches
146,Takuma Asano,jp JPN,"FW,MF",Bochum,de Bundesliga,27,1994,19.0,14,9,4,4,6,7,16,43.8,9,17,1,16,8,22,8,0,Matches
147,Santiago Ascacíbar,ar ARG,MF,Cremonese,it Serie A,25,1997,8.1,29,14,17,10,2,14,35,40.0,21,14,2,12,13,42,11,0,Matches
148,Sergio Asenjo,es ESP,GK,Valladolid,es La Liga,33,1989,10.0,0,0,0,0,0,0,0,,0,0,0,0,0,0,10,2,Matches
149,Marco Asensio,es ESP,"FW,MF",Real Madrid,es La Liga,26,1996,16.0,16,10,8,6,2,8,19,42.1,11,8,3,5,5,21,4,0,Matches
150,Kristoffer Askildsen,no NOR,MF,Lecce,it Serie A,21,2001,8.1,7,3,2,3,2,4,10,40.0,6,15,4,11,11,18,6,0,Matches
151,Fisnik Asllani,xk KVX,FW,Hoffenheim,de Bundesliga,19,2002,1.9,0,0,0,0,0,0,4,0.0,4,2,0,2,3,3,3,0,Matches
152,Kristjan Asllani,al ALB,MF,Inter,it Serie A,20,2002,6.6,11,5,1,8,2,7,10,70.0,3,3,1,2,6,17,4,0,Matches
153,Iago Aspas,es ESP,FW,Celta Vigo,es La Liga,34,1987,31.9,8,4,0,4,4,3,22,13.6,19,10,1,9,7,15,23,0,Matches
154,Lorenz Assignon,tg TOG,DF,Rennes,fr Ligue 1,22,2000,2.9,6,2,4,2,0,2,4,50.0,2,6,0,6,2,8,9,0,Matches
155,Youcef Atal,dz ALG,"DF,MF",Nice,fr Ligue 1,26,1996,8.7,38,22,18,15,5,23,32,71.9,9,9,0,9,14,52,13,0,Matches
156,Valentin Atangana Edoa,fr FRA,MF,Reims,fr Ligue 1,16,2005,1.9,8,3,4,2,2,3,6,50.0,3,2,1,1,0,8,1,0,Matches
157,Pierre-Emerick Aubameyang,ga GAB,FW,Chelsea,eng Premier League,33,1989,6.2,1,0,1,0,0,0,1,0.0,1,2,0,2,2,3,4,2,Matches
158,Pierre-Emerick Aubameyang,ga GAB,FW,Barcelona,es La Liga,33,1989,0.1,0,0,0,0,0,0,0,,0,0,0,0,0,0,0,0,Matches
159,Emil Audero,it ITA,GK,Sampdoria,it Serie A,25,1997,25.0,0,0,0,0,0,0,2,0.0,2,0,0,0,0,0,7,1,Matches
160,Tommaso Augello,it ITA,DF,Sampdoria,it Serie A,27,1994,34.0,17,14,13,2,2,9,20,45.0,11,23,7,16,17,34,61,1,Matches
161,Ludwig Augustinsson,se SWE,DF,Aston Villa,eng Premier League,28,1994,0.9,1,1,1,0,0,0,0,,0,0,0,0,0,1,1,0,Matches
162,Ludwig Augustinsson,se SWE,DF,Mallorca,es La Liga,28,1994,1.5,2,1,2,0,0,1,3,33.3,2,1,0,1,1,3,3,0,Matches
163,Carlos Augusto,br BRA,DF,Monza,it Serie A,23,1999,34.3,73,38,42,23,8,33,54,61.1,21,24,6,18,24,97,85,1,Matches
164,Serge Aurier,ci CIV,DF,Nott'ham Forest,eng Premier League,29,1992,21.6,64,41,41,18,5,23,33,69.7,10,34,11,23,29,93,75,0,Matches
165,Mathias Autret,fr FRA,"MF,FW",Auxerre,fr Ligue 1,31,1991,14.3,22,10,10,10,2,7,16,43.8,9,14,2,12,12,34,13,0,Matches
166,Ezequiel Ávila,ar ARG,"FW,MF",Osasuna,es La Liga,28,1994,19.0,8,5,2,4,2,6,23,26.1,17,12,1,11,8,16,16,0,Matches
167,Cédric Avinel,gp GLP,DF,Ajaccio,fr Ligue 1,35,1986,19.9,13,7,8,5,0,8,12,66.7,4,20,13,7,15,28,91,1,Matches
168,Taiwo Awoniyi,ng NGA,FW,Nott'ham Forest,eng Premier League,24,1997,15.6,17,10,2,10,5,6,12,50.0,6,18,4,14,4,21,20,0,Matches
169,Yasin Ayari,se SWE,MF,Brighton,eng Premier League,18,2003,0.7,2,2,1,1,0,0,4,0.0,4,1,0,1,0,2,0,0,Matches
170,Mehmet Aydin,de GER,"DF,FW",Schalke 04,de Bundesliga,20,2002,6.3,25,18,14,9,2,11,24,45.8,13,11,0,11,10,35,15,0,Matches
171,André Ayew,gh GHA,"FW,MF",Nott'ham Forest,eng Premier League,32,1989,3.5,5,3,0,4,1,2,4,50.0,2,6,1,5,0,5,7,0,Matches
172,Jordan Ayew,gh GHA,"FW,MF",Crystal Palace,eng Premier League,30,1991,30.2,66,41,23,20,23,21,53,39.6,32,35,4,31,15,81,31,0,Matches
173,Kaan Ayhan,tr TUR,DF,Sassuolo,it Serie A,27,1994,6.1,10,4,6,4,0,7,7,100.0,0,5,4,1,5,15,26,1,Matches
174,Luke Ayling,eng ENG,DF,Leeds United,eng Premier League,30,1991,22.8,66,37,42,15,9,42,85,49.4,43,34,11,23,26,92,52,2,Matches
175,Ayman Azhil,ma MAR,MF,Leverkusen,de Bundesliga,21,2001,0.0,0,0,0,0,0,0,0,,0,0,0,0,0,0,0,0,Matches
176,Sardar Azmoun,ir IRN,"FW,MF",Leverkusen,de Bundesliga,27,1995,10.3,6,3,1,4,1,1,7,14.3,6,4,0,4,2,8,14,0,Matches
177,César Azpilicueta,es ESP,DF,Chelsea,eng Premier League,32,1989,17.0,43,25,23,15,5,22,37,59.5,15,26,5,21,19,62,54,1,Matches
178,Sanoussy Ba,de GER,DF,RB Leipzig,de Bundesliga,18,2004,0.0,0,0,0,0,0,0,0,,0,0,0,0,0,0,0,0,Matches
179,Iddrisu Baba,gh GHA,"MF,DF",Mallorca,es La Liga,26,1996,18.9,31,17,15,16,0,15,32,46.9,17,18,8,10,11,42,39,0,Matches
180,Srđan Babić,rs SRB,DF,Almería,es La Liga,26,1996,33.3,28,18,20,8,0,15,32,46.9,17,34,22,12,29,57,124,1,Matches
181,Loïc Bade,fr FRA,DF,Sevilla,es La Liga,22,2000,16.1,27,20,23,3,1,17,30,56.7,13,21,13,8,23,50,77,0,Matches
182,Loïc Bade,fr FRA,DF,Rennes,fr Ligue 1,22,2000,1.0,1,1,1,0,0,0,0,,0,0,0,0,1,2,3,0,Matches
183,Édgar Badía,es ESP,GK,Elche,es La Liga,30,1992,36.0,1,0,1,0,0,1,2,50.0,1,0,0,0,0,1,19,3,Matches
184,Benoît Badiashile,fr FRA,DF,Chelsea,eng Premier League,21,2001,10.1,14,8,10,4,0,9,14,64.3,5,5,2,3,16,30,34,1,Matches
185,Benoît Badiashile,fr FRA,DF,Monaco,fr Ligue 1,21,2001,9.3,10,8,6,4,0,5,10,50.0,5,9,6,3,17,27,40,1,Matches
186,Alex Baena,es ESP,"MF,FW",Villarreal,es La Liga,21,2001,21.6,30,17,9,15,6,15,45,33.3,30,15,3,12,7,37,16,0,Matches
187,Jaime Báez,uy URU,DF,Cremonese,it Serie A,27,1995,1.1,4,2,3,0,1,3,6,50.0,3,0,0,0,0,4,2,1,Matches
188,Leon Bailey,jm JAM,"FW,MF",Aston Villa,eng Premier League,24,1997,21.9,14,6,6,7,1,5,20,25.0,15,13,0,13,6,20,12,0,Matches
189,Eric Bailly,ci CIV,DF,Marseille,fr Ligue 1,28,1994,6.0,13,10,6,6,1,7,7,100.0,0,15,12,3,12,25,18,1,Matches
190,Dénys Bain,fr FRA,DF,Auxerre,fr Ligue 1,29,1993,1.4,4,3,3,1,0,1,2,50.0,1,2,1,1,2,6,4,0,Matches
191,Brandon Baiye,be BEL,MF,Clermont Foot,fr Ligue 1,21,2000,0.6,3,2,2,1,0,2,3,66.7,1,1,0,1,1,4,3,0,Matches
192,Stefan Bajcetic,es ESP,MF,Liverpool,eng Premier League,17,2004,5.8,9,6,5,3,1,8,27,29.6,19,7,0,7,9,18,4,0,Matches
193,Nedim Bajrami,al ALB,"MF,FW",Empoli,it Serie A,23,1999,10.4,8,4,3,3,2,4,6,66.7,2,5,0,5,7,15,4,0,Matches
194,Nedim Bajrami,al ALB,"FW,MF",Sassuolo,it Serie A,23,1999,9.1,12,7,6,2,4,5,11,45.5,6,9,1,8,7,19,6,0,Matches
195,Cédric Bakambu,cd COD,MF,Marseille,fr Ligue 1,31,1991,0.7,2,1,2,0,0,2,2,100.0,0,0,0,0,0,2,0,0,Matches
196,Tiemoué Bakayoko,fr FRA,MF,Milan,it Serie A,27,1994,0.5,5,5,4,1,0,3,3,100.0,0,0,0,0,0,5,0,1,Matches
197,Mitchel Bakker,nl NED,"DF,MF",Leverkusen,de Bundesliga,22,2000,18.4,16,8,9,7,0,6,15,40.0,9,20,2,18,15,31,20,2,Matches
198,Ridle Baku,de GER,"DF,FW",Wolfsburg,de Bundesliga,24,1998,28.7,50,26,29,17,4,32,58,55.2,26,44,6,38,21,71,59,0,Matches
199,Tommaso Baldanzi,it ITA,MF,Empoli,it Serie A,19,2003,19.7,25,12,9,13,3,7,32,21.9,25,21,1,20,2,27,5,0,Matches
200,Alejandro Balde,es ESP,DF,Barcelona,es La Liga,18,2003,27.5,42,30,22,16,4,24,41,58.5,17,25,3,22,12,54,17,1,Matches
201,Thierno Balde,fr FRA,"DF,MF",Troyes,fr Ligue 1,20,2002,23.9,27,14,19,4,4,18,30,60.0,12,15,3,12,23,50,39,0,Matches
202,Carlos Baleba,cm CMR,MF,Lille,fr Ligue 1,18,2004,5.3,13,11,2,9,2,9,14,64.3,5,13,3,10,1,14,3,2,Matches
203,Mikel Balenziaga,es ESP,DF,Athletic Club,es La Liga,34,1988,1.3,4,4,1,2,1,4,4,100.0,0,0,0,0,1,5,2,0,Matches
204,Leonardo Balerdi,ar ARG,DF,Marseille,fr Ligue 1,23,1999,29.3,57,37,43,12,2,32,45,71.1,13,48,29,19,63,120,91,1,Matches
205,Dominic Ballard,eng ENG,"FW,MF",Southampton,eng Premier League,17,2005,0.3,0,0,0,0,0,0,0,,0,0,0,0,1,1,0,0,Matches
206,Iván Balliu,al ALB,DF,Rayo Vallecano,es La Liga,30,1992,35.9,52,29,26,20,6,18,30,60.0,12,26,3,23,25,77,72,1,Matches
207,Fodé Ballo-Touré,sn SEN,DF,Milan,it Serie A,25,1997,5.8,14,9,7,6,1,7,10,70.0,3,11,3,8,2,16,3,0,Matches
208,Folarin Balogun,us USA,FW,Reims,fr Ligue 1,21,2001,33.3,9,5,1,5,3,2,20,10.0,18,20,1,19,3,12,15,0,Matches
209,Abdoulaye Bamba,ci CIV,DF,Angers,fr Ligue 1,32,1990,15.2,22,12,15,5,2,16,19,84.2,3,7,3,4,18,40,38,0,Matches
210,Jonathan Bamba,ci CIV,FW,Lille,fr Ligue 1,26,1996,30.9,37,17,12,14,11,14,45,31.1,31,36,1,35,22,59,14,0,Matches
211,Patrick Bamford,eng ENG,FW,Leeds United,eng Premier League,28,1993,16.8,9,6,0,6,3,4,20,20.0,16,12,5,7,5,14,13,0,Matches
212,Lameck Banda,zm ZAM,"FW,MF",Lecce,it Serie A,21,2001,18.2,30,20,13,14,3,15,41,36.6,26,24,2,22,8,38,5,0,Matches
213,Filippo Bandinelli,it ITA,MF,Empoli,it Serie A,27,1995,25.1,55,34,19,26,10,17,45,37.8,28,20,7,13,18,73,40,0,Matches
214,Léo Baptistão,br BRA,"FW,MF",Almería,es La Liga,29,1992,19.2,32,20,13,16,3,13,33,39.4,20,17,2,15,19,51,12,0,Matches
215,Shandon Baptiste,gd GRN,MF,Brentford,eng Premier League,24,1998,6.9,15,9,6,6,3,7,17,41.2,10,10,2,8,7,22,10,0,Matches
216,Antonín Barák,cz CZE,MF,Hellas Verona,it Serie A,27,1994,0.3,0,0,0,0,0,0,0,,0,0,0,0,0,0,0,0,Matches
217,Antonín Barák,cz CZE,MF,Fiorentina,it Serie A,27,1994,20.0,21,9,5,7,9,6,16,37.5,10,16,2,14,3,24,13,0,Matches
218,Andrea Barberis,it ITA,MF,Monza,it Serie A,28,1993,3.8,7,2,4,3,0,5,11,45.5,6,0,0,0,8,15,1,0,Matches
219,Tommaso Barbieri,it ITA,DF,Juventus,it Serie A,19,2002,1.2,3,3,3,0,0,3,8,37.5,5,3,0,3,0,3,2,0,Matches
220,Bradley Barcola,fr FRA,"FW,MF",Lyon,fr Ligue 1,19,2002,16.0,25,16,8,10,7,8,39,20.5,31,29,0,29,19,44,10,0,Matches
221,Melvin Bard,fr FRA,DF,Nice,fr Ligue 1,21,2000,27.3,96,60,61,29,6,59,89,66.3,30,35,4,31,64,160,40,1,Matches
222,Francesco Bardi,it ITA,GK,Bologna,it Serie A,30,1992,1.0,0,0,0,0,0,0,0,,0,0,0,0,0,0,0,0,Matches
223,Keidi Bare,al ALB,MF,Espanyol,es La Liga,24,1997,5.6,15,8,7,5,3,7,13,53.8,6,8,2,6,11,26,8,0,Matches
224,Nicolò Barella,it ITA,MF,Inter,it Serie A,25,1997,29.0,49,25,17,26,6,28,53,52.8,25,29,5,24,12,61,12,0,Matches
225,Kike Barja,es ESP,"FW,MF",Osasuna,es La Liga,25,1997,14.6,15,9,6,5,4,8,24,33.3,16,7,0,7,4,19,3,0,Matches
226,Ross Barkley,eng ENG,"MF,FW",Nice,fr Ligue 1,28,1993,10.7,16,9,7,4,5,7,13,53.8,6,7,2,5,8,24,6,0,Matches
227,Aymen Barkok,ma MAR,MF,Mainz 05,de Bundesliga,24,1998,6.5,18,8,10,5,3,5,10,50.0,5,7,0,7,3,21,9,0,Matches
228,Harvey Barnes,eng ENG,"FW,MF",Leicester City,eng Premier League,24,1997,30.1,26,14,8,14,4,14,42,33.3,28,32,1,31,8,34,12,0,Matches
229,Leandro Barreiro Martins,lu LUX,MF,Mainz 05,de Bundesliga,22,2000,23.8,60,38,19,28,13,22,49,44.9,27,38,13,25,41,101,39,1,Matches
230,Enzo Barrenechea,ar ARG,MF,Juventus,it Serie A,21,2001,1.8,8,3,3,4,1,3,5,60.0,2,3,0,3,2,10,3,0,Matches
231,Ander Barrenetxea,es ESP,"FW,DF",Real Sociedad,es La Liga,20,2001,9.8,21,15,15,6,0,12,28,42.9,16,15,1,14,5,26,7,0,Matches
232,Mickaël Barreto,fr FRA,MF,Ajaccio,fr Ligue 1,31,1991,14.7,32,20,12,17,3,8,45,17.8,37,17,0,17,18,50,11,0,Matches
233,Pablo Barrios,es ESP,MF,Atlético Madrid,es La Liga,19,2003,8.0,19,10,3,10,6,8,15,53.3,7,12,2,10,9,28,6,1,Matches
234,Musa Barrow,gm GAM,"FW,MF",Bologna,it Serie A,23,1998,21.8,21,4,10,6,5,8,14,57.1,6,25,1,24,1,22,7,0,Matches
235,Federico Baschirotto,it ITA,DF,Lecce,it Serie A,25,1996,37.0,40,30,35,5,0,22,36,61.1,14,45,29,16,36,76,192,0,Matches
236,Toma Bašić,hr CRO,MF,Lazio,it Serie A,25,1996,5.7,6,4,4,1,1,3,8,37.5,5,9,0,9,7,13,8,0,Matches
237,Alberto Basso,it ITA,MF,Cremonese,it Serie A,18,2004,0.2,0,0,0,0,0,0,0,,0,0,0,0,0,0,0,0,Matches
238,Gil Bastião Dias,pt POR,FW,Stuttgart,de Bundesliga,25,1996,4.4,8,6,3,4,1,3,12,25.0,9,7,0,7,2,10,3,0,Matches
239,Alessandro Bastoni,it ITA,DF,Inter,it Serie A,23,1999,24.0,41,20,20,14,7,11,27,40.7,16,27,13,14,24,65,45,0,Matches
240,Simone Bastoni,it ITA,"MF,DF",Spezia,it Serie A,25,1996,13.2,47,24,23,19,5,15,33,45.5,18,20,5,15,8,55,14,0,Matches
241,Rodrigo Battaglia,ar ARG,MF,Mallorca,es La Liga,31,1991,7.6,12,5,7,5,0,6,14,42.9,8,16,7,9,5,17,18,0,Matches
242,Maximilian Bauer,de GER,DF,Augsburg,de Bundesliga,22,2000,20.5,31,17,18,12,1,17,34,50.0,17,25,9,16,23,54,79,1,Matches
243,Oliver Baumann,de GER,GK,Hoffenheim,de Bundesliga,32,1990,34.0,0,0,0,0,0,0,0,,0,0,0,0,0,0,15,1,Matches
244,Timo Baumgartl,de GER,DF,Union Berlin,de Bundesliga,26,1996,6.2,11,6,5,4,2,5,18,27.8,13,12,4,8,2,13,14,0,Matches
245,Julian Baumgartlinger,at AUT,MF,Augsburg,de Bundesliga,34,1988,6.2,15,4,5,6,4,6,19,31.6,13,4,2,2,4,19,15,0,Matches
246,Christoph Baumgartner,at AUT,"MF,FW",Hoffenheim,de Bundesliga,22,1999,28.5,36,19,12,17,7,9,52,17.3,43,57,5,52,15,51,19,1,Matches
247,Cyrille Bayala,bf BFA,MF,Ajaccio,fr Ligue 1,26,1996,22.3,53,37,16,20,17,23,47,48.9,24,20,3,17,25,78,21,0,Matches
248,Brian Bayeye,cd COD,DF,Torino,it Serie A,22,2000,0.7,3,0,3,0,0,1,1,100.0,0,1,1,0,1,4,2,0,Matches
249,Noah Joel Sarenren Bazee,ng NGA,"MF,FW",Augsburg,de Bundesliga,25,1996,0.2,0,0,0,0,0,0,1,0.0,1,1,0,1,0,0,0,0,Matches
250,Gavin Bazunu,ie IRL,GK,Southampton,eng Premier League,20,2002,32.0,1,0,1,0,0,1,1,100.0,0,0,0,0,1,2,24,2,Matches
251,Bebé,cv CPV,FW,Rayo Vallecano,es La Liga,32,1990,0.7,0,0,0,0,0,0,2,0.0,2,1,0,1,0,0,0,0,Matches
252,Ihlas Bebou,tg TOG,"FW,DF",Hoffenheim,de Bundesliga,28,1994,15.7,19,16,8,7,4,11,17,64.7,6,9,2,7,7,26,15,0,Matches
253,Rodrigo Becão,br BRA,DF,Udinese,it Serie A,26,1996,27.6,70,36,50,17,3,40,53,75.5,13,44,24,20,26,96,68,2,Matches
254,Mads Bech Sørensen,dk DEN,"DF,MF",Brentford,eng Premier League,23,1999,0.2,0,0,0,0,0,0,0,,0,0,0,0,1,1,1,0,Matches
255,Julius Beck,dk DEN,MF,Spezia,it Serie A,17,2005,0.1,2,1,1,1,0,0,0,,0,0,0,0,0,2,0,0,Matches
256,Sheraldo Becker,sr SUR,FW,Union Berlin,de Bundesliga,27,1995,28.4,15,5,1,7,7,2,11,18.2,9,13,1,12,3,18,7,1,Matches
257,Jan Bednarek,pl POL,DF,Southampton,eng Premier League,26,1996,18.6,27,21,20,7,0,12,16,75.0,4,38,27,11,49,76,87,0,Matches
258,Jan Bednarek,pl POL,DF,Aston Villa,eng Premier League,26,1996,1.1,3,3,0,3,0,1,1,100.0,0,3,1,2,2,5,5,0,Matches
259,Donny van de Beek,nl NED,MF,Manchester Utd,eng Premier League,25,1997,1.9,0,0,0,0,0,0,1,0.0,1,2,1,1,1,1,1,0,Matches
260,Asmir Begović,ba BIH,GK,Everton,eng Premier League,35,1987,1.0,0,0,0,0,0,0,0,,0,0,0,0,0,0,1,0,Matches
261,Yanis Begraoui,ma MAR,"FW,MF",Toulouse,fr Ligue 1,21,2001,0.7,2,0,1,0,1,1,2,50.0,1,0,0,0,1,3,0,0,Matches
262,Kevin Behrens,de GER,FW,Union Berlin,de Bundesliga,31,1991,17.1,11,7,4,4,3,4,18,22.2,14,18,3,15,5,16,25,0,Matches
263,Alexis Beka Beka,fr FRA,"MF,DF",Nice,fr Ligue 1,21,2001,6.1,16,5,6,9,1,4,15,26.7,11,9,1,8,12,28,6,0,Matches
264,Jérémie Bela,ao ANG,"DF,MF",Clermont Foot,fr Ligue 1,29,1993,8.3,6,4,2,1,3,3,4,75.0,1,10,1,9,9,15,8,0,Matches
265,Reda Belahyane,fr FRA,MF,Nice,fr Ligue 1,18,2004,2.0,8,6,5,3,0,3,5,60.0,2,5,1,4,2,10,0,0,Matches
266,Youcef Belaïli,dz ALG,"MF,FW",Ajaccio,fr Ligue 1,30,1992,12.8,18,10,3,9,6,8,20,40.0,12,10,1,9,5,23,4,0,Matches
267,Youcef Belaïli,dz ALG,"FW,MF",Brest,fr Ligue 1,30,1992,4.0,5,2,3,2,0,2,7,28.6,5,2,0,2,1,6,1,0,Matches
268,Haris Belkebla,dz ALG,MF,Brest,fr Ligue 1,28,1994,29.5,80,48,35,40,5,44,85,51.8,41,32,6,26,52,132,21,3,Matches
269,Stefan Bell,de GER,DF,Mainz 05,de Bundesliga,30,1991,26.6,43,28,32,10,1,22,44,50.0,22,42,15,27,44,87,133,0,Matches
270,Armel Bella Kotchap,de GER,DF,Southampton,eng Premier League,20,2001,20.9,37,17,28,9,0,15,20,75.0,5,29,12,17,44,81,110,0,Matches
271,Raoul Bellanova,it ITA,DF,Inter,it Serie A,22,2000,5.5,14,6,11,2,1,9,14,64.3,5,6,1,5,4,18,14,0,Matches
272,Karim Bellarabi,de GER,"FW,MF",Leverkusen,de Bundesliga,32,1990,0.9,2,0,1,1,0,2,3,66.7,1,0,0,0,0,2,0,0,Matches
273,Jean-Ricner Bellegarde,fr FRA,"MF,FW",Strasbourg,fr Ligue 1,24,1998,26.9,47,25,15,21,11,11,25,44.0,14,26,3,23,26,73,22,0,Matches
274,Héctor Bellerín,es ESP,DF,Barcelona,es La Liga,27,1995,1.6,2,0,0,2,0,2,3,66.7,1,2,0,2,3,5,2,0,Matches
275,Jude Bellingham,eng ENG,MF,Dortmund,de Bundesliga,19,2003,29.9,76,42,28,34,14,34,51,66.7,17,51,4,47,35,111,30,0,Matches
276,Jeanuël Belocian,fr FRA,DF,Rennes,fr Ligue 1,17,2005,5.6,10,7,3,5,2,5,9,55.6,4,6,3,3,6,16,11,0,Matches
277,Andrea Belotti,it ITA,FW,Roma,it Serie A,28,1993,12.7,12,5,3,5,4,5,11,45.5,6,11,1,10,3,15,5,0,Matches
278,Fran Beltrán,es ESP,MF,Celta Vigo,es La Liga,23,1999,31.7,34,22,15,14,5,14,55,25.5,41,29,5,24,53,87,35,2,Matches
279,Eliesse Ben Seghir,ma MAR,"FW,MF",Monaco,fr Ligue 1,17,2005,11.7,18,10,4,12,2,4,12,33.3,8,18,1,17,4,22,1,0,Matches
280,Salim Ben Seghir,fr FRA,MF,Marseille,fr Ligue 1,19,2003,0.0,0,0,0,0,0,0,0,,0,1,0,1,0,0,0,0,Matches
281,Wissam Ben Yedder,fr FRA,FW,Monaco,fr Ligue 1,31,1990,23.5,16,9,2,5,9,4,13,30.8,9,15,0,15,4,20,0,0,Matches
282,Marco Benassi,it ITA,DF,Fiorentina,it Serie A,27,1994,1.0,3,3,2,0,1,3,4,75.0,1,0,0,0,1,4,1,0,Matches
283,Marco Benassi,it ITA,MF,Cremonese,it Serie A,27,1994,11.1,26,15,9,11,6,15,24,62.5,9,13,1,12,12,38,19,0,Matches
284,Iker Benito,es ESP,"FW,MF",Osasuna,es La Liga,19,2002,2.0,4,3,0,3,1,2,4,50.0,2,0,0,0,2,6,4,0,Matches
285,Ismaël Bennacer,dz ALG,MF,Milan,it Serie A,24,1997,22.3,59,33,26,31,2,30,51,58.8,21,25,7,18,26,85,16,1,Matches
286,Saïd Benrahma,dz ALG,"FW,MF",West Ham,eng Premier League,26,1995,23.0,25,15,11,7,7,11,27,40.7,16,23,1,22,9,34,13,0,Matches
287,Ramy Bensebaini,dz ALG,DF,Gladbach,de Bundesliga,27,1995,27.6,34,21,21,10,3,26,39,66.7,13,44,14,30,36,70,98,1,Matches
288,Nabil Bentaleb,dz ALG,MF,Angers,fr Ligue 1,27,1994,27.7,74,40,31,35,8,36,61,59.0,25,33,11,22,44,118,29,3,Matches
289,Rodrigo Bentancur,uy URU,MF,Tottenham,eng Premier League,25,1997,16.7,45,28,15,21,9,16,28,57.1,12,28,15,13,20,65,22,0,Matches
290,Daniel Bentley,eng ENG,GK,Wolves,eng Premier League,29,1993,2.0,1,1,1,0,0,1,1,100.0,0,0,0,0,0,1,0,1,Matches
291,Karim Benzema,fr FRA,FW,Real Madrid,es La Liga,34,1987,22.6,9,5,2,4,3,2,11,18.2,9,11,0,11,2,11,5,0,Matches
292,Domenico Berardi,it ITA,FW,Sassuolo,it Serie A,27,1994,20.7,23,14,8,10,5,9,40,22.5,31,13,0,13,19,42,18,0,Matches
293,Yuri Berchiche,es ESP,DF,Athletic Club,es La Liga,32,1990,26.7,56,32,28,20,8,35,59,59.3,24,37,12,25,40,96,59,1,Matches
294,Álex Berenguer,es ESP,FW,Athletic Club,es La Liga,27,1995,25.5,58,37,17,25,16,23,60,38.3,37,37,4,33,10,68,6,0,Matches
295,Bartosz Bereszyński,pl POL,DF,Sampdoria,it Serie A,30,1992,13.3,28,18,15,11,2,17,26,65.4,9,18,4,14,21,49,25,0,Matches
296,Bartosz Bereszyński,pl POL,DF,Napoli,it Serie A,30,1992,1.8,3,2,1,1,1,2,2,100.0,0,4,0,4,3,6,3,0,Matches
297,Patrick Berg,no NOR,"MF,FW",Lens,fr Ligue 1,24,1997,0.3,0,0,0,0,0,0,1,0.0,1,0,0,0,1,1,0,0,Matches
298,Mitchell van Bergen,nl NED,"FW,DF",Reims,fr Ligue 1,22,1999,10.1,18,8,6,7,5,8,20,40.0,12,8,2,6,6,24,11,0,Matches
299,Mergim Berisha,de GER,FW,Augsburg,de Bundesliga,24,1998,18.7,11,6,4,3,4,4,14,28.6,10,16,1,15,0,11,19,0,Matches
300,Quentin Bernard,fr FRA,DF,Auxerre,fr Ligue 1,33,1989,7.0,9,7,4,2,3,7,15,46.7,8,9,1,8,15,24,17,0,Matches
301,Paul Bernardoni,fr FRA,GK,Angers,fr Ligue 1,25,1997,27.0,2,0,2,0,0,2,3,66.7,1,1,0,1,1,3,12,1,Matches
302,Juan Bernat,es ESP,"DF,MF",Paris S-G,fr Ligue 1,29,1993,18.3,32,16,18,9,5,21,39,53.8,18,11,2,9,9,41,22,1,Matches
303,Victor Bernth Kristiansen,dk DEN,DF,Leicester City,eng Premier League,19,2002,9.9,38,23,18,16,4,22,30,73.3,8,16,4,12,3,41,26,1,Matches
304,Jason Berthomier,fr FRA,MF,Clermont Foot,fr Ligue 1,32,1990,0.3,0,0,0,0,0,0,0,,0,0,0,0,0,0,0,0,Matches
305,Marco Bertini,it ITA,MF,Lazio,it Serie A,19,2002,0.0,0,0,0,0,0,0,0,,0,0,0,0,0,0,0,0,Matches
306,Beto,gw GNB,FW,Udinese,it Serie A,24,1998,23.7,16,9,0,9,7,4,17,23.5,13,18,3,15,6,22,30,0,Matches
307,Owen Bevan,wls WAL,DF,Bournemouth,eng Premier League,18,2003,0.1,0,0,0,0,0,0,0,,0,0,0,0,0,0,0,0,Matches
308,Matteo Bianchetti,it ITA,DF,Cremonese,it Serie A,29,1993,23.7,32,19,21,9,2,20,32,62.5,12,31,17,14,20,52,111,0,Matches
309,Alessandro Bianco,it ITA,MF,Fiorentina,it Serie A,19,2002,1.7,5,2,2,3,0,2,3,66.7,1,1,0,1,0,5,0,0,Matches
310,Giulian Biancone,fr FRA,DF,Nott'ham Forest,eng Premier League,22,2000,0.2,2,1,2,0,0,1,1,100.0,0,0,0,0,1,3,0,0,Matches
311,Ermin Bičakčić,ba BIH,DF,Hoffenheim,de Bundesliga,32,1990,2.9,8,4,6,1,1,2,6,33.3,4,4,3,1,5,13,14,0,Matches
312,Pedro Bigas,es ESP,DF,Elche,es La Liga,31,1990,22.4,37,20,30,7,0,18,29,62.1,11,25,14,11,33,70,95,0,Matches
313,Jaka Bijol,si SVN,DF,Udinese,it Serie A,23,1999,30.3,39,23,32,7,0,16,27,59.3,11,41,25,16,29,68,165,0,Matches
314,El Bilal Touré,ml MLI,FW,Almería,es La Liga,20,2001,14.0,4,3,2,1,1,0,3,0.0,3,6,1,5,1,5,23,0,Matches
315,El Bilal Touré,ml MLI,FW,Reims,fr Ligue 1,20,2001,1.0,0,0,0,0,0,0,0,,0,2,0,2,0,0,1,0,Matches
316,Philip Billing,dk DEN,"MF,FW",Bournemouth,eng Premier League,26,1996,30.7,63,36,21,33,9,11,42,26.2,31,48,8,40,31,94,58,1,Matches
317,Jean-Claude Billong,cm CMR,MF,Clermont Foot,fr Ligue 1,28,1993,0.3,0,0,0,0,0,0,0,,0,1,1,0,1,1,0,0,Matches
318,Cristiano Biraghi,it ITA,DF,Fiorentina,it Serie A,29,1992,28.3,65,38,29,29,7,32,65,49.2,33,32,7,25,14,79,42,1,Matches
319,Samuele Birindelli,it ITA,DF,Monza,it Serie A,23,1999,15.6,35,19,21,10,4,18,29,62.1,11,28,8,20,16,51,30,0,Matches
320,Veljko Birmančević,rs SRB,"FW,MF",Toulouse,fr Ligue 1,24,1998,4.9,13,7,5,4,4,7,21,33.3,14,12,2,10,7,20,1,0,Matches
321,Tom Bischof,de GER,"MF,FW",Hoffenheim,de Bundesliga,17,2005,3.5,15,10,8,3,4,7,10,70.0,3,5,1,4,1,16,1,0,Matches
322,Yves Bissouma,ml MLI,MF,Tottenham,eng Premier League,25,1996,11.2,16,13,6,6,4,2,7,28.6,5,15,6,9,12,28,10,0,Matches
323,Kristijan Bistrović,hr CRO,MF,Lecce,it Serie A,24,1998,5.1,3,1,3,0,0,0,5,0.0,5,3,0,3,0,3,4,0,Matches
324,Leonardo Bittencourt,de GER,"MF,DF",Werder Bremen,de Bundesliga,28,1993,18.1,53,28,20,25,8,25,62,40.3,37,13,0,13,10,63,15,0,Matches
325,Marco Bizot,nl NED,GK,Brest,fr Ligue 1,31,1991,37.0,0,0,0,0,0,0,1,0.0,1,1,0,1,0,0,24,4,Matches
326,Antonio Blanco,es ESP,MF,Cádiz,es La Liga,22,2000,1.8,6,4,5,1,0,4,6,66.7,2,5,0,5,1,7,3,0,Matches
327,Lautaro Blanco,ar ARG,"DF,MF",Elche,es La Liga,23,1999,9.7,16,9,10,4,2,9,26,34.6,17,8,1,7,2,18,10,1,Matches
328,Rubén Blanco,es ESP,GK,Marseille,fr Ligue 1,27,1995,5.5,0,0,0,0,0,0,0,,0,0,0,0,0,0,1,0,Matches
329,Ludovic Blas,fr FRA,"MF,FW",Nantes,fr Ligue 1,24,1997,31.3,47,30,17,19,11,17,49,34.7,32,26,1,25,19,66,8,0,Matches
330,Janis Blaswich,de GER,GK,RB Leipzig,de Bundesliga,31,1991,26.0,0,0,0,0,0,0,0,,0,0,0,0,0,0,10,0,Matches
331,Miha Blažič,si SVN,DF,Angers,fr Ligue 1,29,1993,22.0,8,6,8,0,0,7,15,46.7,8,25,19,6,22,30,80,1,Matches
332,Joaquín Blázquez,ar ARG,GK,Brest,fr Ligue 1,21,2001,1.0,0,0,0,0,0,0,0,,0,0,0,0,0,0,2,0,Matches
333,Alexis Blin,fr FRA,MF,Lecce,it Serie A,25,1996,26.4,69,39,27,33,9,38,73,52.1,35,55,15,40,34,103,74,0,Matches
334,Daley Blind,nl NED,"DF,MF",Bayern Munich,de Bundesliga,32,1990,1.5,2,0,2,0,0,0,1,0.0,1,4,2,2,2,4,6,0,Matches
335,Myron Boadu,nl NED,FW,Monaco,fr Ligue 1,21,2001,3.3,3,3,0,2,1,1,7,14.3,6,1,0,1,0,3,1,0,Matches
336,Jérôme Boateng,de GER,DF,Lyon,fr Ligue 1,33,1988,4.8,3,0,2,1,0,2,6,33.3,4,8,5,3,6,9,16,0,Matches
337,Kevin-Prince Boateng,gh GHA,MF,Hertha BSC,de Bundesliga,35,1987,5.2,8,6,4,2,2,3,9,33.3,6,11,3,8,3,11,5,0,Matches
338,Antonin Bobichon,fr FRA,MF,Angers,fr Ligue 1,26,1995,0.2,0,0,0,0,0,0,0,,0,1,0,1,0,0,0,0,Matches
339,Jean-Paul Boëtius,nl NED,MF,Hertha BSC,de Bundesliga,28,1994,11.7,30,16,19,9,2,8,25,32.0,17,25,5,20,14,44,10,0,Matches
340,Jeremie Boga,ci CIV,"MF,FW",Atalanta,it Serie A,25,1997,8.7,9,5,3,2,4,2,5,40.0,3,6,0,6,1,10,1,0,Matches
341,Emil Bohinen,no NOR,MF,Salernitana,it Serie A,23,1999,9.2,25,13,15,8,2,12,23,52.2,11,25,7,18,17,42,21,0,Matches
342,Quentin Boisgard,fr FRA,MF,Lorient,fr Ligue 1,25,1997,2.0,6,2,1,4,1,3,4,75.0,1,3,1,2,4,10,2,0,Matches
343,Willy Boly,ci CIV,DF,Nott'ham Forest,eng Premier League,31,1991,7.6,13,6,8,3,2,8,13,61.5,5,13,4,9,12,25,45,0,Matches
344,Giacomo Bonaventura,it ITA,MF,Fiorentina,it Serie A,32,1989,21.2,35,23,14,15,6,24,37,64.9,13,14,0,14,16,51,5,1,Matches
345,Federico Bonazzoli,it ITA,"FW,MF",Salernitana,it Serie A,25,1997,12.4,5,3,0,3,2,0,9,0.0,9,9,1,8,3,8,0,0,Matches
346,Warren Bondo,fr FRA,MF,Monza,it Serie A,18,2003,0.7,1,0,1,0,0,0,0,,0,1,0,1,0,1,0,0,Matches
347,Theo Bongonda,cd COD,"MF,FW",Cádiz,es La Liga,26,1995,21.5,28,20,11,14,3,17,40,42.5,23,21,2,19,6,34,14,0,Matches
348,Kevin Bonifazi,it ITA,DF,Bologna,it Serie A,26,1996,10.0,13,8,7,6,0,6,12,50.0,6,11,8,3,12,25,39,0,Matches
349,Leonardo Bonucci,it ITA,DF,Juventus,it Serie A,35,1987,9.8,5,4,1,4,0,2,4,50.0,2,12,8,4,13,18,29,0,Matches
350,Neto Borges,br BRA,DF,Clermont Foot,fr Ligue 1,25,1996,31.5,75,45,45,20,10,46,75,61.3,29,45,11,34,41,116,62,1,Matches
351,Yvandro Borges Sanches,lu LUX,"FW,MF",Gladbach,de Bundesliga,18,2004,0.3,2,2,0,2,0,2,2,100.0,0,0,0,0,0,2,0,0,Matches
352,Sebastiaan Bornauw,be BEL,DF,Wolfsburg,de Bundesliga,23,1999,21.4,29,17,17,10,2,16,22,72.7,6,27,12,15,31,60,83,1,Matches
353,Rafael Borré,co COL,"MF,FW",Eint Frankfurt,de Bundesliga,26,1995,12.0,25,15,4,13,8,4,17,23.5,13,10,2,8,2,27,9,0,Matches
354,Erik Botheim,no NOR,"MF,FW",Salernitana,it Serie A,22,2000,9.6,11,7,3,4,4,6,13,46.2,7,3,0,3,0,11,4,0,Matches
355,Sven Botman,nl NED,DF,Newcastle Utd,eng Premier League,22,2000,34.7,38,24,31,7,0,22,28,78.6,6,44,24,20,34,72,126,2,Matches
356,Kenji-Van Boto,mg MAD,DF,Auxerre,fr Ligue 1,26,1996,2.0,3,2,2,0,1,2,4,50.0,2,0,0,0,1,4,3,0,Matches
357,Kouamé Botué,bf BFA,"FW,MF",Ajaccio,fr Ligue 1,19,2002,2.5,4,2,2,1,1,0,2,0.0,2,1,0,1,0,4,1,0,Matches
358,Badredine Bouanani,dz ALG,"FW,MF",Nice,fr Ligue 1,17,2004,9.6,13,9,2,7,4,7,14,50.0,7,4,0,4,1,14,2,0,Matches
359,Hicham Boudaoui,dz ALG,MF,Nice,fr Ligue 1,22,1999,20.8,67,32,31,30,6,35,53,66.0,18,34,5,29,36,103,16,0,Matches
360,Franci Bouebari,fr FRA,DF,Strasbourg,fr Ligue 1,18,2003,0.8,3,0,1,2,0,3,5,60.0,2,0,0,0,2,5,2,0,Matches
361,Sofiane Boufal,ma MAR,"FW,MF",Angers,fr Ligue 1,28,1993,9.3,14,9,7,4,3,3,14,21.4,11,6,0,6,5,19,1,0,Matches
362,Yassine Bounou,ma MAR,GK,Sevilla,es La Liga,31,1991,23.9,2,1,2,0,0,1,4,25.0,3,0,0,0,2,4,11,1,Matches
363,Ismaëlben Boura,km COM,"DF,FW",Lens,fr Ligue 1,21,2000,1.0,6,4,4,2,0,5,6,83.3,1,2,1,1,2,8,3,0,Matches
364,Mehdi Bourabia,ma MAR,MF,Spezia,it Serie A,30,1991,30.8,41,20,13,22,6,19,41,46.3,22,39,12,27,32,73,57,0,Matches
365,Benjamin Bourigeaud,fr FRA,"MF,FW",Rennes,fr Ligue 1,28,1994,34.1,45,29,16,23,6,21,65,32.3,44,38,3,35,31,76,32,0,Matches
366,Edoardo Bove,it ITA,MF,Roma,it Serie A,20,2002,11.0,35,18,12,15,8,16,39,41.0,23,15,1,14,10,45,11,0,Matches
367,Jarrod Bowen,eng ENG,"FW,MF",West Ham,eng Premier League,25,1996,35.9,39,16,14,11,14,16,58,27.6,42,47,9,38,36,75,25,0,Matches
368,Lucas Boyé,ar ARG,FW,Elche,es La Liga,26,1996,27.4,36,16,12,16,8,17,35,48.6,18,33,5,28,15,51,46,0,Matches
369,Jayden Braaf,nl NED,"MF,FW",Hellas Verona,it Serie A,19,2002,3.2,5,3,2,3,0,0,0,,0,1,0,1,2,7,1,0,Matches
370,Domagoj Bradarić,hr CRO,DF,Salernitana,it Serie A,22,1999,25.0,26,19,14,8,4,7,16,43.8,9,20,5,15,21,47,44,0,Matches
371,Bilal Brahimi,dz ALG,"FW,MF",Nice,fr Ligue 1,22,2000,8.9,8,5,2,5,1,1,7,14.3,6,4,0,4,4,12,0,0,Matches
372,Martin Braithwaite,dk DEN,"FW,MF",Espanyol,es La Liga,31,1991,27.3,12,2,2,4,6,5,14,35.7,9,10,0,10,5,17,11,0,Matches
373,Juan Brandáriz,es ESP,DF,Almería,es La Liga,23,1999,16.5,29,16,18,9,2,14,23,60.9,9,20,7,13,15,44,53,0,Matches
374,Julian Brandt,de GER,"MF,FW",Dortmund,de Bundesliga,26,1996,26.6,29,20,6,14,9,12,43,27.9,31,23,0,23,15,44,9,1,Matches
375,Darko Brašanac,rs SRB,MF,Osasuna,es La Liga,30,1992,11.6,29,20,12,10,7,12,23,52.2,11,14,2,12,12,41,9,0,Matches
376,Lilian Brassier,fr FRA,DF,Brest,fr Ligue 1,22,1999,34.4,42,30,31,8,3,23,32,71.9,9,42,19,23,53,95,132,1,Matches
377,Claudio Bravo,cl CHI,GK,Betis,es La Liga,39,1983,12.0,0,0,0,0,0,0,0,,0,0,0,0,2,2,1,1,Matches
378,Fabian Bredlow,de GER,GK,Stuttgart,de Bundesliga,27,1995,15.0,1,1,1,0,0,1,1,100.0,0,0,0,0,0,1,4,2,Matches
379,James Bree,eng ENG,DF,Southampton,eng Premier League,24,1997,4.1,5,3,4,1,0,3,4,75.0,1,3,1,2,6,11,11,0,Matches
380,Josip Brekalo,hr CRO,"FW,MF",Fiorentina,it Serie A,24,1998,2.5,2,1,0,1,1,1,4,25.0,3,1,0,1,1,3,1,0,Matches
381,Josip Brekalo,hr CRO,"MF,FW",Wolfsburg,de Bundesliga,24,1998,3.0,2,1,2,0,0,0,4,0.0,4,0,0,0,2,4,2,0,Matches
382,Gleison Bremer,br BRA,DF,Juventus,it Serie A,25,1997,29.3,29,20,23,5,1,19,26,73.1,7,44,22,22,42,71,120,2,Matches
383,Armando Broja,al ALB,FW,Chelsea,eng Premier League,20,2001,3.3,4,1,0,3,1,1,1,100.0,0,10,1,9,1,5,1,0,Matches
384,Dylan Bronn,tn TUN,DF,Salernitana,it Serie A,27,1995,18.7,34,18,17,16,1,20,30,66.7,10,32,20,12,20,54,58,1,Matches
385,David Brooks,wls WAL,"FW,MF",Bournemouth,eng Premier League,25,1997,1.9,1,0,1,0,0,0,1,0.0,1,2,0,2,2,3,5,0,Matches
386,John Brooks,us USA,DF,Hoffenheim,de Bundesliga,29,1993,15.0,18,12,10,8,0,13,18,72.2,5,17,12,5,10,28,105,0,Matches
387,Moritz Broschinski,de GER,"FW,MF",Bochum,de Bundesliga,21,2000,2.4,0,0,0,0,0,0,5,0.0,5,1,0,1,0,0,6,0,Matches
388,Marcelo Brozović,hr CRO,MF,Inter,it Serie A,29,1992,19.7,37,22,13,22,2,11,37,29.7,26,23,7,16,22,59,28,0,Matches
389,Cédric Brunner,ch SUI,DF,Schalke 04,de Bundesliga,28,1994,25.7,39,27,26,11,2,30,45,66.7,15,24,7,17,43,82,79,0,Matches
390,Lewis Brunt,eng ENG,DF,Leicester City,eng Premier League,21,2000,0.3,0,0,0,0,0,0,0,,0,0,0,0,0,0,2,0,Matches
391,Jacob Bruun Larsen,dk DEN,FW,Hoffenheim,de Bundesliga,23,1998,3.6,4,3,0,1,3,3,4,75.0,1,3,1,2,1,5,0,0,Matches
392,Andreas Bruus,dk DEN,"DF,FW",Troyes,fr Ligue 1,23,1999,18.1,12,6,9,3,0,8,20,40.0,12,13,2,11,17,29,24,0,Matches
393,Joe Bryan,eng ENG,"MF,DF",Nice,fr Ligue 1,28,1993,2.0,5,4,3,2,0,4,4,100.0,0,2,0,2,1,6,1,0,Matches
394,Lee Buchanan,eng ENG,"DF,FW",Werder Bremen,de Bundesliga,21,2001,5.2,14,10,2,11,1,6,12,50.0,6,5,0,5,12,26,21,0,Matches
395,Ante Budimir,hr CRO,FW,Osasuna,es La Liga,31,1991,20.0,19,9,0,12,7,2,10,20.0,8,10,0,10,5,24,19,0,Matches
396,Emi Buendía,ar ARG,"MF,FW",Aston Villa,eng Premier League,25,1996,26.8,52,23,20,20,12,21,74,28.4,53,20,2,18,20,72,17,0,Matches
397,Hugo Bueno,es ESP,DF,Wolves,eng Premier League,19,2002,14.6,33,16,23,6,4,17,33,51.5,16,14,1,13,10,43,36,0,Matches
398,Santiago Bueno,uy URU,DF,Girona,es La Liga,23,1998,33.4,63,38,43,19,1,24,36,66.7,12,34,22,12,31,94,105,2,Matches
399,Adam Buksa,pl POL,"FW,MF",Lens,fr Ligue 1,26,1996,1.1,1,0,0,0,1,0,3,0.0,3,0,0,0,0,1,0,0,Matches
400,Marius Bülter,de GER,"FW,MF",Schalke 04,de Bundesliga,29,1993,28.9,22,11,8,7,7,12,32,37.5,20,34,1,33,10,32,20,0,Matches
401,Cristian Buonaiuto,it ITA,"MF,FW",Cremonese,it Serie A,29,1992,10.9,25,16,8,11,6,12,26,46.2,14,11,0,11,14,39,7,0,Matches
402,Facundo Buonanotte,ar ARG,"FW,MF",Brighton,eng Premier League,17,2004,6.3,2,1,1,1,0,1,22,4.5,21,5,2,3,4,6,3,0,Matches
403,Alessandro Buongiorno,it ITA,DF,Torino,it Serie A,23,1999,30.2,38,25,22,16,0,16,31,51.6,15,38,19,19,60,98,105,2,Matches
404,Delano Burgzorg,nl NED,"FW,MF",Mainz 05,de Bundesliga,23,1998,2.7,3,3,1,1,1,2,3,66.7,1,2,0,2,0,3,2,0,Matches
405,Jonathan Burkardt,de GER,"MF,FW",Mainz 05,de Bundesliga,22,2000,5.9,3,1,0,1,2,1,4,25.0,3,6,1,5,1,4,1,0,Matches
406,Oliver Burke,sct SCO,"FW,MF",Werder Bremen,de Bundesliga,25,1997,3.0,1,0,0,0,1,0,0,,0,2,0,2,0,1,0,0,Matches
407,Dan Burn,eng ENG,DF,Newcastle Utd,eng Premier League,30,1992,34.6,60,38,29,23,8,34,67,50.7,33,42,16,26,32,92,120,2,Matches
408,Maxime Busi,be BEL,DF,Reims,fr Ligue 1,22,1999,11.6,21,16,9,11,1,13,29,44.8,16,14,6,8,14,35,24,0,Matches
409,Sergio Busquets,es ESP,MF,Barcelona,es La Liga,34,1988,26.0,58,26,24,26,8,29,51,56.9,22,32,6,26,27,85,36,2,Matches
410,Aurélio Buta,pt POR,DF,Eint Frankfurt,de Bundesliga,25,1997,14.6,33,19,15,13,5,15,27,55.6,12,18,1,17,9,42,34,0,Matches
411,Leonardo Buta,pt POR,DF,Udinese,it Serie A,20,2002,0.2,1,1,0,1,0,0,0,,0,0,0,0,0,1,0,0,Matches
412,Marcin Bułka,pl POL,GK,Nice,fr Ligue 1,22,1999,2.0,0,0,0,0,0,0,1,0.0,1,0,0,0,1,1,0,0,Matches
413,Jamie Bynoe-Gittens,eng ENG,"FW,MF",Dortmund,de Bundesliga,17,2004,5.9,8,4,2,5,1,2,7,28.6,5,1,0,1,1,9,2,0,Matches
414,Rémy Cabella,fr FRA,"MF,FW",Lille,fr Ligue 1,32,1990,28.1,64,37,21,28,15,29,64,45.3,35,41,5,36,17,81,7,1,Matches
415,Jimmy Cabot,fr FRA,"DF,MF",Lens,fr Ligue 1,28,1994,5.7,20,12,10,8,2,12,26,46.2,14,5,0,5,4,24,12,0,Matches
416,Arthur Cabral,br BRA,FW,Fiorentina,it Serie A,24,1998,15.9,9,2,1,4,4,4,8,50.0,4,10,1,9,1,10,12,0,Matches
417,Leandro Cabrera,uy URU,DF,Espanyol,es La Liga,31,1991,29.7,46,24,34,12,0,28,43,65.1,15,37,23,14,43,89,114,2,Matches
418,Liberato Cacace,nz NZL,DF,Empoli,it Serie A,21,2000,6.5,25,10,12,8,5,9,15,60.0,6,15,7,8,4,29,16,0,Matches
419,Anthony Caci,fr FRA,DF,Mainz 05,de Bundesliga,25,1997,22.6,58,33,32,20,6,28,42,66.7,14,28,4,24,54,112,40,0,Matches
420,Cafú,pt POR,MF,Nott'ham Forest,eng Premier League,29,1993,0.1,0,0,0,0,0,0,0,,0,0,0,0,0,0,1,0,Matches
421,Moisés Caicedo,ec ECU,MF,Brighton,eng Premier League,20,2001,34.9,100,50,41,47,12,40,68,58.8,28,43,7,36,56,156,31,3,Matches
422,Tom Cairney,sct SCO,MF,Fulham,eng Premier League,31,1991,11.0,17,6,4,8,5,7,10,70.0,3,18,3,15,5,22,3,0,Matches
423,Jens Cajuste,se SWE,MF,Reims,fr Ligue 1,22,1999,17.0,46,25,25,14,7,25,48,52.1,23,30,6,24,18,64,22,0,Matches
424,Cala,es ESP,DF,Cádiz,es La Liga,32,1989,1.5,2,1,1,1,0,1,2,50.0,1,2,1,1,1,3,12,0,Matches
425,Davide Calabria,it ITA,DF,Milan,it Serie A,25,1996,18.8,71,44,31,32,8,38,61,62.3,23,22,7,15,25,96,34,0,Matches
426,Mattia Caldara,it ITA,DF,Spezia,it Serie A,28,1994,13.9,23,14,10,11,2,9,20,45.0,11,23,16,7,17,40,88,2,Matches
427,Luca Caldirola,it ITA,DF,Monza,it Serie A,31,1991,26.1,26,14,19,4,3,13,26,50.0,13,32,18,14,25,51,66,1,Matches
428,Fernando Calero,es ESP,"DF,MF",Espanyol,es La Liga,26,1995,17.9,46,29,27,15,4,21,34,61.8,13,31,13,18,13,59,52,0,Matches
429,Duje Ćaleta-Car,hr CRO,DF,Southampton,eng Premier League,25,1996,10.5,14,10,9,4,1,6,9,66.7,3,15,11,4,15,29,65,1,Matches
430,Duje Ćaleta-Car,hr CRO,DF,Marseille,fr Ligue 1,25,1996,0.1,0,0,0,0,0,0,0,,0,0,0,0,0,0,1,0,Matches
431,Hakan Çalhanoğlu,tr TUR,MF,Inter,it Serie A,28,1994,26.3,48,27,17,26,5,16,43,37.2,27,30,5,25,25,73,13,1,Matches
432,Kerim Calhanoglu,de GER,DF,Schalke 04,de Bundesliga,19,2002,0.7,2,1,2,0,0,2,2,100.0,0,1,0,1,0,2,3,0,Matches
433,Daniel Caligiuri,it ITA,"DF,MF",Augsburg,de Bundesliga,34,1988,3.2,8,5,5,3,0,4,5,80.0,1,3,2,1,3,11,2,0,Matches
434,Alexander Callens,pe PER,DF,Girona,es La Liga,30,1992,1.3,3,3,2,1,0,3,4,75.0,1,3,1,2,1,4,9,0,Matches
435,Dominic Calvert-Lewin,eng ENG,FW,Everton,eng Premier League,25,1997,12.9,4,2,1,0,3,1,5,20.0,4,5,1,4,3,7,18,0,Matches
436,Mahdi Camara,fr FRA,MF,Brest,fr Ligue 1,24,1998,20.2,63,36,18,38,7,25,43,58.1,18,35,4,31,40,103,16,0,Matches
437,Mohamed Camara,gn GUI,MF,Roma,it Serie A,25,1997,7.7,13,10,3,7,3,5,15,33.3,10,5,1,4,10,23,8,0,Matches
438,Mohamed Camara,ml MLI,MF,Monaco,fr Ligue 1,22,2000,24.4,83,45,38,39,6,48,92,52.2,44,45,6,39,27,110,14,1,Matches
439,Ousmane Camara,gn GUI,"FW,MF",Auxerre,fr Ligue 1,20,2001,0.3,1,1,0,0,1,0,0,,0,0,0,0,0,1,0,0,Matches
440,Ousmane Camara,fr FRA,DF,Angers,fr Ligue 1,19,2003,5.8,10,6,5,5,0,5,12,41.7,7,4,2,2,11,21,15,0,Matches
441,Eduardo Camavinga,fr FRA,"MF,DF",Real Madrid,es La Liga,19,2002,22.3,68,48,32,21,15,24,64,37.5,40,24,5,19,17,85,25,0,Matches
442,Nicolò Cambiaghi,it ITA,"FW,MF",Empoli,it Serie A,21,2000,14.3,30,22,11,12,7,8,27,29.6,19,19,1,18,9,39,8,0,Matches
443,Andrea Cambiaso,it ITA,DF,Bologna,it Serie A,22,2000,24.1,57,34,34,20,3,28,65,43.1,37,26,2,24,26,83,33,1,Matches
444,Axel Camblan,fr FRA,"FW,MF",Brest,fr Ligue 1,18,2003,0.8,2,2,1,1,0,0,1,0.0,1,0,0,0,0,2,0,0,Matches
445,Sergio Camello,es ESP,FW,Rayo Vallecano,es La Liga,21,2001,26.7,16,10,3,9,4,5,17,29.4,12,9,1,8,2,18,26,0,Matches
446,Chem Campbell,wls WAL,"FW,MF",Wolves,eng Premier League,19,2002,0.8,2,1,1,1,0,0,1,0.0,1,2,0,2,1,3,0,0,Matches
447,Emre Can,de GER,MF,Dortmund,de Bundesliga,28,1994,21.1,57,28,25,27,5,22,43,51.2,21,16,6,10,25,82,39,1,Matches
448,Sergio Canales,es ESP,"FW,MF",Betis,es La Liga,31,1991,26.7,25,14,10,8,7,14,33,42.4,19,18,0,18,14,39,8,0,Matches
449,Matteo Cancellieri,it ITA,FW,Lazio,it Serie A,20,2002,2.8,10,4,5,3,2,5,9,55.6,4,4,0,4,1,11,2,0,Matches
450,João Cancelo,pt POR,DF,Manchester City,eng Premier League,28,1994,14.2,29,21,16,9,4,17,24,70.8,7,7,1,6,19,48,9,1,Matches
451,João Cancelo,pt POR,"DF,FW",Bayern Munich,de Bundesliga,28,1994,11.2,23,14,9,10,4,10,23,43.5,13,14,2,12,15,38,22,0,Matches
452,Antonio Candreva,it ITA,"MF,DF",Salernitana,it Serie A,35,1987,30.3,17,7,13,2,2,11,38,28.9,27,7,3,4,17,34,32,0,Matches
453,Thomas Cannon,ie IRL,FW,Everton,eng Premier League,19,2002,0.3,0,0,0,0,0,0,0,,0,0,0,0,0,0,0,0,Matches
454,Sergi Canós,es ESP,"FW,DF",Brentford,eng Premier League,25,1997,0.9,0,0,0,0,0,0,2,0.0,2,3,1,2,0,0,1,0,Matches
455,Ander Capa,es ESP,DF,Athletic Club,es La Liga,30,1992,1.2,1,1,1,0,0,1,5,20.0,4,5,0,5,0,1,2,0,Matches
456,Pierrick Capelle,fr FRA,"MF,DF",Angers,fr Ligue 1,35,1987,15.9,36,21,17,15,4,22,55,40.0,33,24,3,21,15,51,24,0,Matches
457,Étienne Capoue,fr FRA,MF,Villarreal,es La Liga,34,1988,21.7,21,12,6,13,2,10,18,55.6,8,12,5,7,19,40,20,1,Matches
458,Gianluca Caprari,it ITA,"MF,FW",Monza,it Serie A,29,1993,27.1,16,6,3,11,2,8,26,30.8,18,22,1,21,8,24,3,0,Matches
459,Francesco Caputo,it ITA,FW,Sampdoria,it Serie A,34,1987,12.2,3,1,0,0,3,0,3,0.0,3,0,0,0,1,4,3,0,Matches
460,Francesco Caputo,it ITA,FW,Empoli,it Serie A,34,1987,19.0,2,2,0,1,1,0,1,0.0,1,7,2,5,2,4,8,0,Matches
461,Maxence Caqueret,fr FRA,MF,Lyon,fr Ligue 1,22,2000,30.7,87,54,27,38,22,43,109,39.4,66,45,3,42,39,126,27,0,Matches
462,Andrea Carboni,it ITA,DF,Monza,it Serie A,21,2001,1.9,3,2,2,0,1,2,5,40.0,3,3,2,1,3,6,2,1,Matches
463,Franco Carboni,it ITA,"DF,FW",Monza,it Serie A,19,2003,0.7,1,1,1,0,0,0,2,0.0,2,3,0,3,1,2,0,0,Matches
464,Valentin Carboni,ar ARG,"MF,DF",Inter,it Serie A,17,2005,0.3,1,1,0,1,0,1,3,33.3,2,1,0,1,0,1,0,0,Matches
465,Isaac Carcelen,es ESP,DF,Cádiz,es La Liga,29,1993,24.4,69,51,41,22,6,41,63,65.1,22,35,11,24,19,88,80,1,Matches
466,Irvin Cardona,fr FRA,"FW,MF",Brest,fr Ligue 1,24,1997,2.6,2,0,1,1,0,0,3,0.0,3,3,0,3,2,4,2,0,Matches
467,Irvin Cardona,fr FRA,"MF,FW",Augsburg,de Bundesliga,24,1997,3.5,1,1,1,0,0,1,5,20.0,4,3,0,3,4,5,8,0,Matches
468,Igor Carioca,br BRA,DF,Lorient,fr Ligue 1,25,1996,5.1,18,11,12,2,4,12,21,57.1,9,7,0,7,5,23,17,0,Matches
469,Diego Carlos,br BRA,DF,Aston Villa,eng Premier League,29,1993,2.3,1,0,0,1,0,0,1,0.0,1,2,2,0,1,2,2,0,Matches
470,Juan Carlos,es ESP,GK,Girona,es La Liga,34,1988,10.0,0,0,0,0,0,0,0,,0,0,0,0,1,1,7,1,Matches
471,José Carlos Lazo,es ESP,"MF,FW",Almería,es La Liga,26,1996,0.2,0,0,0,0,0,0,0,,0,0,0,0,0,0,0,0,Matches
472,José Carlos Lazo,es ESP,"MF,FW",Espanyol,es La Liga,26,1996,1.8,5,3,2,2,1,3,3,100.0,0,2,0,2,3,8,5,0,Matches
473,Carmona,es ESP,"MF,DF",Elche,es La Liga,20,2002,6.5,16,9,7,6,3,6,16,37.5,10,14,2,12,8,24,9,0,Matches
474,Carmona,es ESP,DF,Sevilla,es La Liga,20,2002,5.9,13,11,5,3,5,9,16,56.3,7,10,6,4,7,20,17,1,Matches
475,Marco Carnesecchi,it ITA,GK,Cremonese,it Serie A,22,2000,27.0,1,1,1,0,0,1,2,50.0,1,0,0,0,0,1,11,2,Matches
476,Yannick Carrasco,be BEL,"DF,MF",Atlético Madrid,es La Liga,28,1993,25.7,35,14,21,10,4,23,54,42.6,31,23,1,22,12,47,19,0,Matches
477,Dani Carvajal,es ESP,DF,Real Madrid,es La Liga,30,1992,19.8,32,18,15,12,5,18,35,51.4,17,24,6,18,15,47,49,0,Matches
478,Fabio Carvalho,pt POR,"MF,FW",Liverpool,eng Premier League,19,2002,3.9,8,8,3,3,2,3,6,50.0,3,6,0,6,6,14,0,0,Matches
479,Matis Carvalho,pt POR,GK,Montpellier,fr Ligue 1,23,1999,1.5,0,0,0,0,0,0,0,,0,0,0,0,1,1,0,0,Matches
480,William Carvalho,pt POR,MF,Betis,es La Liga,30,1992,27.1,43,27,18,23,2,17,44,38.6,27,27,6,21,16,59,22,0,Matches
481,Nicolò Casale,it ITA,DF,Lazio,it Serie A,24,1998,27.1,42,20,28,14,0,22,34,64.7,12,25,17,8,17,59,73,1,Matches
482,Casemiro,br BRA,MF,Manchester Utd,eng Premier League,30,1992,23.6,88,46,43,35,10,47,92,51.1,45,49,11,38,34,122,64,0,Matches
483,Casemiro,br BRA,MF,Real Madrid,es La Liga,30,1992,0.1,0,0,0,0,0,0,0,,0,0,0,0,0,0,1,0,Matches
484,Matty Cash,pl POL,DF,Aston Villa,eng Premier League,24,1997,20.2,55,32,36,15,4,26,37,70.3,11,20,5,15,26,81,43,0,Matches
485,Tommaso Cassandro,it ITA,DF,Lecce,it Serie A,22,2000,0.1,1,1,0,1,0,0,0,,0,1,1,0,0,1,0,0,Matches
486,Timothy Castagne,be BEL,DF,Leicester City,eng Premier League,26,1995,36.2,87,44,53,27,7,41,84,48.8,43,50,13,37,43,130,110,0,Matches
487,Michele Castagnetti,it ITA,MF,Cremonese,it Serie A,32,1989,15.7,46,21,20,24,2,18,54,33.3,36,14,4,10,15,61,22,0,Matches
488,Koen Casteels,be BEL,GK,Wolfsburg,de Bundesliga,30,1992,34.0,0,0,0,0,0,0,0,,0,0,0,0,1,1,10,1,Matches
489,Valentín Castellanos,ar ARG,FW,Girona,es La Liga,23,1998,28.9,12,5,2,7,3,0,18,0.0,18,22,2,20,6,18,26,0,Matches
490,Jean-Charles Castelletto,cm CMR,DF,Nantes,fr Ligue 1,27,1995,28.5,43,26,29,12,2,22,36,61.1,14,35,22,13,58,101,90,0,Matches
491,Samu Castillejo,es ESP,"FW,MF",Valencia,es La Liga,27,1995,15.1,21,12,8,9,4,8,40,20.0,32,21,2,19,9,30,2,0,Matches
492,Jonny Castro,es ESP,DF,Wolves,eng Premier League,28,1994,14.0,33,15,22,10,1,17,38,44.7,21,26,5,21,14,47,28,2,Matches
493,Gaetano Castrovilli,it ITA,MF,Fiorentina,it Serie A,25,1997,8.0,10,8,1,7,2,2,9,22.2,7,5,1,4,8,18,5,0,Matches
494,Danilo Cataldi,it ITA,MF,Lazio,it Serie A,27,1994,21.3,25,16,7,15,3,14,40,35.0,26,23,9,14,24,49,33,0,Matches
495,Catena,es ESP,DF,Rayo Vallecano,es La Liga,27,1994,34.5,29,14,23,4,2,13,27,48.1,14,32,25,7,28,57,159,1,Matches
496,Yoann Cathline,fr FRA,"FW,MF",Lorient,fr Ligue 1,20,2002,12.1,19,12,7,6,6,5,12,41.7,7,10,1,9,8,27,16,1,Matches
497,Maximiliano Caufriez,be BEL,DF,Clermont Foot,fr Ligue 1,25,1997,24.7,40,24,31,8,1,20,28,71.4,8,33,18,15,34,74,70,0,Matches
498,Edinson Cavani,uy URU,FW,Valencia,es La Liga,35,1987,16.1,7,4,3,3,1,3,15,20.0,12,10,3,7,2,9,11,0,Matches
499,Dani Ceballos,es ESP,MF,Real Madrid,es La Liga,25,1996,17.4,43,29,13,15,15,25,64,39.1,39,23,2,21,25,68,6,1,Matches
500,Pietro Ceccaroni,it ITA,DF,Lecce,it Serie A,26,1995,0.5,0,0,0,0,0,0,0,,0,1,1,0,3,3,2,0,Matches
501,Federico Ceccherini,it ITA,DF,Hellas Verona,it Serie A,30,1992,15.7,25,19,15,9,1,13,23,56.5,10,17,10,7,19,44,55,0,Matches
502,Assan Ceesay,gm GAM,FW,Lecce,it Serie A,28,1994,20.1,23,18,7,8,8,9,17,52.9,8,15,2,13,3,26,24,0,Matches
503,Emil Ceide,no NOR,FW,Sassuolo,it Serie A,20,2001,5.7,5,2,5,0,0,3,5,60.0,2,3,1,2,1,6,0,0,Matches
504,Zeki Çelik,tr TUR,DF,Roma,it Serie A,25,1997,16.7,42,21,19,21,2,24,41,58.5,17,33,6,27,14,56,36,2,Matches
505,Álex Centelles,es ESP,DF,Almería,es La Liga,24,1997,12.5,22,14,16,3,3,16,22,72.7,6,13,2,11,11,33,40,0,Matches
506,Fabien Centonze,fr FRA,DF,Nantes,fr Ligue 1,26,1996,18.8,58,37,30,22,6,30,42,71.4,12,24,7,17,44,102,55,1,Matches
507,Michele Cerofolini,it ITA,GK,Fiorentina,it Serie A,23,1999,5.0,0,0,0,0,0,0,0,,0,0,0,0,1,1,2,0,Matches
508,Franco Cervi,ar ARG,"MF,DF",Celta Vigo,es La Liga,28,1994,21.0,76,46,29,36,11,33,66,50.0,33,33,1,32,36,112,16,0,Matches
509,Julian Chabot,de GER,DF,Köln,de Bundesliga,24,1998,20.0,36,23,19,14,3,20,35,57.1,15,30,18,12,41,77,105,0,Matches
510,Florian Chabrolle,fr FRA,MF,Ajaccio,fr Ligue 1,24,1998,3.7,6,4,1,5,0,2,4,50.0,2,3,0,3,7,13,2,0,Matches
511,El Chadaille Bitshiabu,fr FRA,DF,Paris S-G,fr Ligue 1,17,2005,6.5,10,7,7,2,1,3,12,25.0,9,9,7,2,9,19,13,3,Matches
512,Fares Chaïbi,dz ALG,"FW,MF",Toulouse,fr Ligue 1,19,2002,26.0,31,18,8,15,8,17,50,34.0,33,38,5,33,19,50,36,1,Matches
513,Nathaniel Chalobah,eng ENG,MF,Fulham,eng Premier League,27,1994,0.1,1,1,1,0,0,1,1,100.0,0,0,0,0,0,1,2,0,Matches
514,Trevoh Chalobah,eng ENG,DF,Chelsea,eng Premier League,23,1999,17.9,31,20,22,6,3,24,35,68.6,11,17,7,10,24,55,56,1,Matches
515,Muhammed Cham,at AUT,MF,Clermont Foot,fr Ligue 1,21,2000,21.9,30,15,15,4,11,13,35,37.1,22,13,0,13,7,37,5,0,Matches
516,Calum Chambers,eng ENG,"DF,MF",Aston Villa,eng Premier League,27,1995,3.9,9,6,7,2,0,6,8,75.0,2,5,4,1,7,16,10,1,Matches
517,Timothy Chandler,us USA,DF,Eint Frankfurt,de Bundesliga,32,1990,1.0,2,2,2,0,0,2,2,100.0,0,1,0,1,0,2,3,0,Matches
518,Gaëtan Charbonnier,fr FRA,"FW,MF",Auxerre,fr Ligue 1,33,1988,2.8,2,1,0,2,0,0,4,0.0,4,2,0,2,0,2,5,0,Matches
519,Brendan Chardonnet,fr FRA,DF,Brest,fr Ligue 1,27,1994,27.7,45,27,27,18,0,20,38,52.6,18,40,19,21,63,108,86,1,Matches
520,Shea Charles,nir NIR,DF,Manchester City,eng Premier League,18,2003,0.3,4,0,4,0,0,1,1,100.0,0,0,0,0,1,5,2,0,Matches
521,Xavier Chavalerin,fr FRA,MF,Troyes,fr Ligue 1,31,1991,27.0,82,50,39,30,13,27,71,38.0,44,31,8,23,41,123,24,0,Matches
522,Pep Chavarría,es ESP,"FW,MF",Rayo Vallecano,es La Liga,24,1998,4.1,6,4,2,1,3,1,5,20.0,4,8,0,8,2,8,8,0,Matches
523,Ivane Chegra,fr FRA,"MF,FW",Ajaccio,fr Ligue 1,18,2004,2.1,8,3,6,1,1,4,11,36.4,7,0,0,0,1,9,0,0,Matches
524,Pape Cheikh Diop,sn SEN,MF,Elche,es La Liga,24,1997,0.4,0,0,0,0,0,0,1,0.0,1,0,0,0,0,0,0,0,Matches
525,Rayan Cherki,fr FRA,"MF,FW",Lyon,fr Ligue 1,18,2003,20.8,14,8,2,5,7,8,23,34.8,15,6,0,6,5,19,1,0,Matches
526,Ilyes Cheti,dz ALG,DF,Angers,fr Ligue 1,27,1995,2.3,6,4,4,0,2,5,8,62.5,3,5,1,4,4,10,7,0,Matches
527,Lucas Chevalier,fr FRA,GK,Lille,fr Ligue 1,20,2001,32.0,2,1,2,0,0,2,2,100.0,0,1,0,1,2,4,7,2,Matches
528,Fabio Chiarodia,it ITA,DF,Werder Bremen,de Bundesliga,17,2005,0.7,0,0,0,0,0,0,0,,0,1,0,1,2,2,4,0,Matches
529,Federico Chiesa,it ITA,"DF,MF",Juventus,it Serie A,24,1997,9.5,22,11,6,6,10,5,14,35.7,9,13,1,12,0,22,1,0,Matches
530,Ben Chilwell,eng ENG,"DF,MF",Chelsea,eng Premier League,25,1996,15.6,21,17,12,8,1,13,25,52.0,12,21,2,19,18,39,26,0,Matches
531,Vlad Chiricheș,ro ROU,DF,Cremonese,it Serie A,32,1989,10.9,35,20,27,7,1,16,24,66.7,8,36,23,13,22,57,44,0,Matches
532,Pedro Chirivella,es ESP,MF,Nantes,fr Ligue 1,25,1997,22.5,33,22,12,15,6,17,44,38.6,27,24,1,23,20,53,7,0,Matches
533,Joris Chotard,fr FRA,MF,Montpellier,fr Ligue 1,20,2001,27.3,64,34,37,23,4,40,78,51.3,38,40,11,29,40,104,42,1,Matches
534,Andreas Christensen,dk DEN,DF,Barcelona,es La Liga,26,1996,19.6,20,15,9,11,0,10,16,62.5,6,14,12,2,21,41,47,0,Matches
535,Oliver Christensen,dk DEN,GK,Hertha BSC,de Bundesliga,23,1999,33.0,1,0,1,0,0,0,2,0.0,2,0,0,0,0,1,22,2,Matches
536,Ryan Christie,sct SCO,"MF,FW",Bournemouth,eng Premier League,27,1995,20.4,34,22,10,23,1,14,50,28.0,36,16,4,12,26,60,20,0,Matches
537,Carney Chukwuemeka,eng ENG,"MF,FW",Chelsea,eng Premier League,18,2003,3.9,13,7,7,6,0,3,5,60.0,2,7,0,7,6,19,1,0,Matches
538,Samuel Chukwueze,ng NGA,"FW,MF",Villarreal,es La Liga,23,1999,26.0,14,7,7,2,5,7,23,30.4,16,13,0,13,12,26,16,0,Matches
539,Darko Churlinov,mk MKD,FW,Stuttgart,de Bundesliga,22,2000,0.3,3,2,2,1,0,2,3,66.7,1,1,0,1,0,3,0,0,Matches
540,Víctor Chust,es ESP,DF,Cádiz,es La Liga,22,2000,10.7,9,6,7,2,0,4,7,57.1,3,8,3,5,10,19,53,0,Matches
541,Tolga Ciğerci,tr TUR,MF,Hertha BSC,de Bundesliga,30,1992,7.5,16,13,6,9,1,10,16,62.5,6,6,2,4,8,24,5,0,Matches
542,Yanis Cimignani,fr FRA,"MF,DF",Ajaccio,fr Ligue 1,20,2002,3.1,11,5,3,7,1,4,5,80.0,1,5,1,4,2,13,2,0,Matches
543,Daniel Ciofani,it ITA,FW,Cremonese,it Serie A,37,1985,11.8,6,3,1,2,3,4,7,57.1,3,7,1,6,2,8,10,0,Matches
544,Tio Cipot,si SVN,"FW,MF",Spezia,it Serie A,19,2003,1.5,12,7,6,3,3,6,8,75.0,2,0,0,0,0,12,2,0,Matches
545,Pathé Ciss,sn SEN,"MF,DF",Rayo Vallecano,es La Liga,28,1994,14.2,39,29,11,23,5,15,34,44.1,19,23,10,13,22,61,34,0,Matches
546,Souleymane Cissé,fr FRA,DF,Clermont Foot,fr Ligue 1,19,2002,0.4,1,1,1,0,0,1,1,100.0,0,1,1,0,1,2,2,0,Matches
547,Patrick Ciurria,it ITA,"DF,MF",Monza,it Serie A,27,1995,30.6,31,18,20,10,1,17,33,51.5,16,24,2,22,7,38,32,0,Matches
548,Bobby Clark,eng ENG,MF,Liverpool,eng Premier League,17,2005,0.1,0,0,0,0,0,0,0,,0,2,0,2,0,0,0,0,Matches
549,Alexis Claude-Maurice,fr FRA,FW,Nice,fr Ligue 1,24,1998,0.7,3,2,2,1,0,3,3,100.0,0,0,0,0,2,5,1,0,Matches
550,Alexis Claude-Maurice,fr FRA,"MF,FW",Lens,fr Ligue 1,24,1998,6.7,14,9,5,8,1,6,16,37.5,10,6,0,6,2,16,1,0,Matches
551,Jonathan Clauss,fr FRA,DF,Marseille,fr Ligue 1,29,1992,28.8,46,28,21,16,9,23,52,44.2,29,29,4,25,31,77,40,2,Matches
552,Carlos Clerc,es ESP,"DF,MF",Elche,es La Liga,30,1992,29.3,75,51,55,16,4,31,50,62.0,19,29,7,22,28,103,94,1,Matches
553,Nathaniel Clyne,eng ENG,DF,Crystal Palace,eng Premier League,31,1991,18.2,27,16,13,9,5,14,23,60.9,9,22,4,18,19,46,34,0,Matches
554,Conor Coady,eng ENG,DF,Everton,eng Premier League,29,1993,23.3,14,9,8,6,0,7,15,46.7,8,21,17,4,14,28,88,3,Matches
555,Nicolò Cocetta,it ITA,DF,Udinese,it Serie A,18,2003,0.4,0,0,0,0,0,0,1,0.0,1,1,1,0,1,1,1,0,Matches
556,Marcus Coco,fr FRA,"FW,MF",Nantes,fr Ligue 1,26,1996,7.1,24,15,11,9,4,11,23,47.8,12,13,3,10,14,38,7,0,Matches
557,Alexandre Coeff,fr FRA,DF,Auxerre,fr Ligue 1,30,1992,6.5,10,5,6,4,0,4,9,44.4,5,9,4,5,8,18,35,1,Matches
558,Jack Colback,eng ENG,MF,Nott'ham Forest,eng Premier League,32,1989,5.5,18,13,12,6,0,5,8,62.5,3,3,0,3,3,21,9,0,Matches
559,Séamus Coleman,ie IRL,DF,Everton,eng Premier League,33,1988,18.4,35,26,21,10,4,19,29,65.5,10,14,7,7,22,57,58,2,Matches
560,David Čolina,hr CRO,"DF,FW",Augsburg,de Bundesliga,22,2000,1.8,4,1,1,1,2,2,2,100.0,0,8,0,8,4,8,3,0,Matches
561,Álex Collado,es ESP,MF,Elche,es La Liga,23,1999,8.1,26,14,13,11,2,8,13,61.5,5,12,1,11,2,28,4,0,Matches
562,Diego Collado,es ESP,FW,Villarreal,es La Liga,21,2001,0.1,0,0,0,0,0,0,0,,0,0,0,0,0,0,0,0,Matches
563,Omar Colley,gm GAM,DF,Sampdoria,it Serie A,29,1992,15.4,17,10,10,7,0,9,12,75.0,3,9,5,4,22,39,69,1,Matches
564,Nathan Collins,ie IRL,DF,Wolves,eng Premier League,21,2001,20.2,27,15,19,8,0,15,24,62.5,9,35,28,7,21,48,84,0,Matches
565,Lorenzo Colombo,it ITA,FW,Lecce,it Serie A,20,2002,16.8,17,9,1,9,7,6,14,42.9,8,22,0,22,2,19,7,0,Matches
566,Andrea Colpani,it ITA,MF,Monza,it Serie A,23,1999,10.5,14,9,6,5,3,8,12,66.7,4,14,2,12,3,17,6,0,Matches
567,Levi Colwill,eng ENG,DF,Brighton,eng Premier League,19,2003,13.6,8,7,4,4,0,4,9,44.4,5,5,3,2,15,23,37,1,Matches
568,Kingsley Coman,fr FRA,"FW,MF",Bayern Munich,de Bundesliga,26,1996,15.7,11,8,3,5,3,7,17,41.2,10,19,1,18,2,13,7,0,Matches
569,Eray Cömert,ch SUI,DF,Valencia,es La Liga,24,1998,18.6,35,23,24,10,1,17,33,51.5,16,23,8,15,29,64,76,1,Matches
570,Santi Comesaña,es ESP,MF,Rayo Vallecano,es La Liga,25,1996,27.2,71,44,24,41,6,38,82,46.3,44,39,3,36,32,103,17,0,Matches
571,Andrea Consigli,it ITA,GK,Sassuolo,it Serie A,35,1987,35.0,1,0,1,0,0,0,1,0.0,1,0,0,0,0,1,13,3,Matches
572,Abdu Conté,pt POR,DF,Troyes,fr Ligue 1,24,1998,14.6,25,17,14,8,3,12,22,54.5,10,13,6,7,6,31,25,0,Matches
573,Andrea Conti,it ITA,DF,Sampdoria,it Serie A,28,1994,0.3,0,0,0,0,0,0,0,,0,0,0,0,0,0,0,0,Matches
574,Lewis Cook,eng ENG,MF,Bournemouth,eng Premier League,25,1997,19.1,37,22,10,22,5,18,44,40.9,26,29,10,19,23,60,31,0,Matches
575,Steve Cook,eng ENG,DF,Nott'ham Forest,eng Premier League,31,1991,10.6,8,4,4,4,0,5,7,71.4,2,16,11,5,12,20,51,0,Matches
576,Liam Cooper,sct SCO,DF,Leeds United,eng Premier League,30,1991,15.8,38,23,27,9,2,23,36,63.9,13,16,8,8,34,72,57,3,Matches
577,Copete,es ESP,DF,Mallorca,es La Liga,22,1999,24.5,53,28,35,16,2,26,36,72.2,10,38,17,21,44,97,111,2,Matches
578,Diego Coppola,it ITA,DF,Hellas Verona,it Serie A,18,2003,13.1,25,17,15,10,0,11,24,45.8,13,20,6,14,14,39,38,0,Matches
579,Francis Coquelin,fr FRA,MF,Villarreal,es La Liga,31,1991,8.3,18,13,7,9,2,7,7,100.0,0,8,2,6,9,27,7,0,Matches
580,Sébastien Corchia,fr FRA,DF,Nantes,fr Ligue 1,31,1990,8.7,16,6,10,2,4,11,22,50.0,11,9,3,6,14,30,21,0,Matches
581,Alex Cordaz,it ITA,GK,Inter,it Serie A,39,1983,0.3,0,0,0,0,0,0,0,,0,0,0,0,0,0,0,0,Matches
582,Maxwel Cornet,ci CIV,FW,West Ham,eng Premier League,25,1996,2.7,7,3,5,0,2,4,6,66.7,2,6,0,6,2,9,3,0,Matches
583,Jesús Corona,mx MEX,FW,Sevilla,es La Liga,29,1993,1.2,1,0,1,0,0,0,1,0.0,1,0,0,0,1,2,1,0,Matches
584,Ángel Correa,ar ARG,"FW,MF",Atlético Madrid,es La Liga,27,1995,16.2,12,6,6,3,3,5,16,31.3,11,17,0,17,10,22,6,1,Matches
585,Joaquín Correa,ar ARG,FW,Inter,it Serie A,27,1994,10.6,12,7,3,6,3,4,15,26.7,11,4,1,3,3,15,0,0,Matches
586,Thierry Correia,pt POR,DF,Valencia,es La Liga,23,1999,22.3,71,52,46,22,3,31,54,57.4,23,25,2,23,24,95,54,2,Matches
587,Alessandro Cortinovis,it ITA,MF,Hellas Verona,it Serie A,21,2001,0.1,1,0,1,0,0,0,0,,0,1,0,1,0,1,0,0,Matches
588,Danny da Costa,de GER,DF,Mainz 05,de Bundesliga,29,1993,13.7,20,16,7,8,5,12,20,60.0,8,22,3,19,9,29,26,0,Matches
589,David Pereira da Costa,pt POR,"MF,FW",Lens,fr Ligue 1,21,2001,15.6,13,7,1,10,2,7,19,36.8,12,19,1,18,11,24,6,0,Matches
590,Diego Costa,es ESP,FW,Wolves,eng Premier League,33,1988,13.8,3,1,3,0,0,2,9,22.2,7,6,1,5,2,5,17,0,Matches
591,Jaume Costa,es ESP,DF,Mallorca,es La Liga,34,1988,28.9,50,34,26,17,7,29,51,56.9,22,13,5,8,22,72,44,1,Matches
592,Logan Costa,cv CPV,DF,Toulouse,fr Ligue 1,21,2001,4.6,9,4,7,1,1,6,9,66.7,3,6,3,3,4,13,12,0,Matches
593,Nuno da Costa,cv CPV,"FW,MF",Auxerre,fr Ligue 1,31,1991,22.3,45,23,14,23,8,11,46,23.9,35,21,1,20,20,65,15,0,Matches
594,Samu Costa,pt POR,MF,Almería,es La Liga,21,2000,22.1,61,31,35,20,6,29,61,47.5,32,29,7,22,37,98,64,4,Matches
595,Benoît Costil,fr FRA,GK,Auxerre,fr Ligue 1,35,1987,19.0,2,0,2,0,0,2,4,50.0,2,0,0,0,0,2,5,0,Matches
596,Vladimír Coufal,cz CZE,DF,West Ham,eng Premier League,29,1992,23.7,58,31,37,15,6,36,51,70.6,15,24,6,18,38,96,70,0,Matches
597,Lassana Coulibaly,ml MLI,MF,Salernitana,it Serie A,26,1996,32.1,84,50,42,35,7,30,73,41.1,43,35,7,28,25,109,33,2,Matches
598,Soumaïla Coulibaly,fr FRA,DF,Dortmund,de Bundesliga,18,2003,0.5,0,0,0,0,0,0,0,,0,0,0,0,0,0,0,1,Matches
599,Tanguy Coulibaly,fr FRA,"FW,DF",Stuttgart,de Bundesliga,21,2001,3.6,12,9,9,1,2,5,12,41.7,7,10,0,10,3,15,0,0,Matches
600,Thibaut Courtois,be BEL,GK,Real Madrid,es La Liga,30,1992,31.0,1,0,1,0,0,1,1,100.0,0,0,0,0,3,4,7,1,Matches
601,Mathieu Coutadeur,fr FRA,MF,Ajaccio,fr Ligue 1,36,1986,21.6,23,13,13,10,0,8,28,28.6,20,19,3,16,19,42,21,0,Matches
602,Philippe Coutinho,br BRA,"MF,FW",Aston Villa,eng Premier League,30,1992,8.8,19,14,8,8,3,9,15,60.0,6,11,1,10,4,23,2,0,Matches
603,Yan Couto,br BRA,"DF,MF",Girona,es La Liga,20,2002,12.9,25,18,11,11,3,12,20,60.0,8,7,2,5,5,30,10,0,Matches
604,Conor Coventry,ie IRL,"MF,FW",West Ham,eng Premier League,22,2000,0.0,0,0,0,0,0,0,0,,0,0,0,0,0,0,0,0,Matches
605,Nicolas Cozza,fr FRA,DF,Montpellier,fr Ligue 1,23,1999,14.2,38,21,27,9,2,26,38,68.4,12,11,5,6,21,59,35,1,Matches
606,Nicolas Cozza,fr FRA,DF,Wolfsburg,de Bundesliga,23,1999,1.1,3,3,1,2,0,2,3,66.7,1,3,1,2,0,3,0,0,Matches
607,Alessio Cragno,it ITA,GK,Monza,it Serie A,28,1994,1.0,0,0,0,0,0,0,1,0.0,1,0,0,0,0,0,0,0,Matches
608,Matthew Craig,sct SCO,MF,Tottenham,eng Premier League,19,2003,0.2,4,1,2,2,0,0,0,,0,0,0,0,0,4,0,0,Matches
609,Aaron Cresswell,eng ENG,DF,West Ham,eng Premier League,32,1989,24.8,21,11,12,7,2,12,31,38.7,19,21,11,10,27,48,56,0,Matches
610,Bryan Cristante,it ITA,"MF,DF",Roma,it Serie A,27,1995,32.6,113,62,55,49,9,55,90,61.1,35,39,10,29,18,131,53,0,Matches
611,Domen Črnigoj,si SVN,MF,Salernitana,it Serie A,26,1995,3.3,8,3,0,7,1,1,2,50.0,1,9,1,8,9,17,6,0,Matches
612,Juan Cruz Armada,es ESP,DF,Osasuna,es La Liga,30,1992,22.9,24,14,17,4,3,13,23,56.5,10,21,8,13,13,37,58,0,Matches
613,Juan Cruz,es ESP,FW,Betis,es La Liga,22,2000,2.0,1,0,0,1,0,1,3,33.3,2,1,0,1,0,1,0,0,Matches
614,Juan Cuadrado,co COL,"DF,FW",Juventus,it Serie A,34,1988,23.1,50,34,34,13,3,27,65,41.5,38,15,2,13,24,74,32,0,Matches
615,Marc Cucurella,es ESP,DF,Chelsea,eng Premier League,24,1998,18.6,66,33,40,15,11,30,60,50.0,30,28,8,20,16,82,48,1,Matches
616,Jorge Cuenca,es ESP,DF,Villarreal,es La Liga,22,1999,5.6,9,7,7,2,0,4,7,57.1,3,10,8,2,6,15,44,0,Matches
617,Braian Cufré,ar ARG,DF,Mallorca,es La Liga,25,1996,2.4,5,2,2,1,2,2,5,40.0,3,2,1,1,2,7,1,0,Matches
618,Mickaël Cuisance,fr FRA,MF,Sampdoria,it Serie A,22,1999,6.9,13,10,7,5,1,5,23,21.7,18,10,0,10,5,18,4,0,Matches
619,Matheus Cunha,br BRA,FW,Wolves,eng Premier League,23,1999,10.7,7,4,0,5,2,2,10,20.0,8,15,3,12,9,16,11,0,Matches
620,Matheus Cunha,br BRA,"FW,MF",Atlético Madrid,es La Liga,23,1999,4.2,4,1,1,3,0,0,3,0.0,3,4,1,3,2,6,3,0,Matches
621,Curro,es ESP,MF,Almería,es La Liga,26,1996,0.5,2,0,1,1,0,1,2,50.0,1,0,0,0,0,2,0,0,Matches
622,Marco D'Alessandro,it ITA,"DF,FW",Monza,it Serie A,31,1991,3.2,4,4,3,1,0,2,5,40.0,3,2,0,2,1,5,3,0,Matches
623,Danilo D'Ambrosio,it ITA,DF,Inter,it Serie A,33,1988,8.1,25,17,17,7,1,15,27,55.6,12,12,4,8,10,35,17,0,Matches
624,Luca D'Andrea,it ITA,FW,Sassuolo,it Serie A,17,2004,3.5,4,0,2,1,1,1,4,25.0,3,2,0,2,1,5,1,0,Matches
625,Damien Da Silva,fr FRA,DF,Lyon,fr Ligue 1,34,1988,3.8,8,7,5,3,0,3,3,100.0,0,4,3,1,5,13,12,0,Matches
626,Moanes Dabbur,il ISR,FW,Hoffenheim,de Bundesliga,30,1992,10.4,11,8,4,5,2,3,9,33.3,6,8,0,8,5,16,0,0,Matches
627,Andréa Dacourt,fr FRA,MF,Nice,fr Ligue 1,17,2005,0.0,0,0,0,0,0,0,0,,0,0,0,0,0,0,0,0,Matches
628,Colin Dagba,fr FRA,"DF,MF",Strasbourg,fr Ligue 1,23,1998,10.6,32,20,17,10,5,19,26,73.1,7,18,2,16,17,49,19,0,Matches
629,Finn Dahmen,de GER,GK,Mainz 05,de Bundesliga,24,1998,8.0,0,0,0,0,0,0,0,,0,0,0,0,0,0,3,0,Matches
630,Mahmoud Dahoud,de GER,MF,Dortmund,de Bundesliga,26,1996,3.7,11,9,3,4,4,7,7,100.0,0,6,2,4,7,18,3,0,Matches
631,Patson Daka,zm ZAM,FW,Leicester City,eng Premier League,23,1998,13.2,14,8,6,8,0,3,13,23.1,10,14,2,12,7,21,7,0,Matches
632,Thijs Dallinga,nl NED,FW,Toulouse,fr Ligue 1,21,2000,26.1,8,6,2,2,4,1,13,7.7,12,17,3,14,3,11,20,0,Matches
633,Diogo Dalot,pt POR,DF,Manchester Utd,eng Premier League,23,1999,23.9,54,41,40,13,1,33,45,73.3,12,25,7,18,37,91,55,2,Matches
634,Muhammed Damar,de GER,MF,Hoffenheim,de Bundesliga,18,2004,1.8,6,3,1,2,3,1,2,50.0,1,3,0,3,0,6,0,0,Matches
635,Mikkel Damsgaard,dk DEN,"MF,FW",Brentford,eng Premier League,22,2000,11.0,31,21,13,13,5,15,42,35.7,27,20,2,18,10,41,14,0,Matches
636,Flavius Daniliuc,at AUT,DF,Salernitana,it Serie A,21,2001,24.4,57,29,37,17,3,26,47,55.3,21,30,13,17,29,86,76,0,Matches
637,Flavius Daniliuc,at AUT,DF,Nice,fr Ligue 1,21,2001,1.0,2,0,2,0,0,1,1,100.0,0,4,1,3,0,2,1,0,Matches
638,Danilo,br BRA,MF,Nott'ham Forest,eng Premier League,21,2001,10.8,18,7,7,9,2,6,25,24.0,19,26,6,20,9,27,19,0,Matches
639,Danilo,br BRA,DF,Juventus,it Serie A,31,1991,35.4,92,62,61,23,8,52,73,71.2,21,39,20,19,47,139,114,1,Matches
640,Arnaut Danjuma,nl NED,"FW,MF",Tottenham,eng Premier League,25,1997,1.9,2,0,1,1,0,0,0,,0,1,0,1,0,2,0,0,Matches
641,Arnaut Danjuma,nl NED,FW,Villarreal,es La Liga,25,1997,5.3,3,3,1,0,2,1,2,50.0,1,0,0,0,0,3,1,1,Matches
642,Kévin Danois,fr FRA,MF,Auxerre,fr Ligue 1,18,2004,0.0,1,1,0,1,0,0,0,,0,0,0,0,1,2,0,0,Matches
643,Kevin Danso,at AUT,DF,Lens,fr Ligue 1,23,1998,35.9,37,19,25,11,1,19,30,63.3,11,48,34,14,33,70,124,0,Matches
644,Dante,br BRA,DF,Nice,fr Ligue 1,38,1983,36.7,70,40,45,21,4,36,59,61.0,23,52,31,21,47,117,125,2,Matches
645,Márton Dárdai,hu HUN,"DF,MF",Hertha BSC,de Bundesliga,20,2002,10.5,17,8,9,8,0,9,18,50.0,9,14,9,5,11,28,45,1,Matches
646,Sergi Darder,es ESP,MF,Espanyol,es La Liga,28,1993,36.9,69,38,12,43,14,29,73,39.7,44,34,2,32,24,93,23,0,Matches
647,Achraf Dari,ma MAR,DF,Brest,fr Ligue 1,23,1999,14.6,21,14,15,5,1,14,20,70.0,6,16,10,6,19,40,65,2,Matches
648,Vladimír Darida,cz CZE,MF,Hertha BSC,de Bundesliga,31,1990,0.3,1,1,0,1,0,0,0,,0,1,0,1,0,1,0,0,Matches
649,Matteo Darmian,it ITA,DF,Inter,it Serie A,32,1989,22.5,56,30,29,15,12,31,47,66.0,16,33,5,28,21,77,36,0,Matches
650,Josh Dasilva,eng ENG,MF,Brentford,eng Premier League,23,1998,15.4,18,9,6,6,6,6,16,37.5,10,22,6,16,5,23,7,1,Matches
651,David Datro Fofana,ci CIV,FW,Chelsea,eng Premier League,19,2002,0.8,3,1,1,1,1,1,1,100.0,0,1,0,1,0,3,0,0,Matches
652,Juan David Cabal,co COL,DF,Hellas Verona,it Serie A,21,2001,4.9,10,6,7,3,0,7,12,58.3,5,8,5,3,13,23,12,0,Matches
653,Jonathan David,ca CAN,FW,Lille,fr Ligue 1,22,2000,35.2,24,17,6,11,7,10,27,37.0,17,20,2,18,8,32,13,0,Matches
654,Alphonso Davies,ca CAN,DF,Bayern Munich,de Bundesliga,21,2000,22.7,45,28,25,13,7,18,39,46.2,21,28,4,24,24,69,24,4,Matches
655,Ben Davies,wls WAL,DF,Tottenham,eng Premier League,29,1993,25.4,28,11,13,13,2,14,26,53.8,12,17,8,9,18,46,72,0,Matches
656,Tom Davies,eng ENG,MF,Everton,eng Premier League,24,1998,6.0,15,9,5,9,1,7,14,50.0,7,10,1,9,4,19,7,1,Matches
657,Paweł Dawidowicz,pl POL,DF,Hellas Verona,it Serie A,27,1995,18.1,48,31,28,17,3,22,31,71.0,9,14,9,5,23,71,71,0,Matches
658,Craig Dawson,eng ENG,DF,West Ham,eng Premier League,32,1990,8.0,11,7,9,2,0,5,7,71.4,2,9,6,3,6,17,26,0,Matches
659,Craig Dawson,eng ENG,DF,Wolves,eng Premier League,32,1990,15.7,9,6,6,3,0,4,7,57.1,3,31,23,8,12,21,74,2,Matches
660,Kevin De Bruyne,be BEL,MF,Manchester City,eng Premier League,31,1991,26.9,28,12,3,12,13,14,39,35.9,25,27,2,25,9,37,10,0,Matches
661,Charles De Ketelaere,be BEL,"MF,FW",Milan,it Serie A,21,2001,12.4,26,12,7,14,5,13,30,43.3,17,14,2,12,4,30,9,0,Matches
662,Manuel De Luca,it ITA,"FW,MF",Sampdoria,it Serie A,24,1998,0.5,0,0,0,0,0,0,0,,0,0,0,0,0,0,0,0,Matches
663,Tommaso De Nipoti,it ITA,MF,Atalanta,it Serie A,19,2003,0.0,1,0,0,1,0,0,0,,0,0,0,0,0,1,0,0,Matches
664,Rodrigo De Paul,ar ARG,MF,Atlético Madrid,es La Liga,28,1994,21.4,35,21,11,18,6,18,35,51.4,17,20,3,17,8,43,7,0,Matches
665,Mattia De Sciglio,it ITA,DF,Juventus,it Serie A,29,1992,11.6,14,7,8,3,3,9,14,64.3,5,9,3,6,4,18,20,0,Matches
666,Lorenzo De Silvestri,it ITA,DF,Bologna,it Serie A,34,1988,7.5,3,2,2,0,1,3,7,42.9,4,6,5,1,3,6,20,0,Matches
667,Thibault De Smet,be BEL,DF,Reims,fr Ligue 1,24,1998,19.5,24,17,10,14,0,11,37,29.7,26,28,5,23,20,44,40,1,Matches
668,Koni De Winter,be BEL,DF,Empoli,it Serie A,20,2002,11.4,14,9,11,3,0,5,13,38.5,8,14,12,2,6,20,65,0,Matches
669,Grégoire Defrel,mq MTQ,FW,Sassuolo,it Serie A,31,1991,13.0,9,7,5,2,2,4,13,30.8,9,11,0,11,2,11,5,0,Matches
670,Duccio Degl'Innocenti,it ITA,MF,Empoli,it Serie A,19,2003,0.0,0,0,0,0,0,0,0,,0,0,0,0,1,1,0,0,Matches
671,Brecht Dejaegere,be BEL,MF,Toulouse,fr Ligue 1,31,1991,20.1,40,23,10,20,10,15,51,29.4,36,25,5,20,14,54,11,0,Matches
672,Romain Del Castillo,fr FRA,"MF,FW",Brest,fr Ligue 1,26,1996,15.8,39,24,13,17,9,16,36,44.4,20,14,1,13,11,50,5,0,Matches
673,Alberto Del Moral,es ESP,MF,Villarreal,es La Liga,22,2000,0.1,0,0,0,0,0,0,0,,0,0,0,0,0,0,0,0,Matches
674,Thomas Delaine,fr FRA,"DF,MF",Strasbourg,fr Ligue 1,30,1992,11.9,28,14,16,6,6,13,26,50.0,13,8,3,5,16,44,9,0,Matches
675,Thomas Delaney,dk DEN,MF,Sevilla,es La Liga,30,1991,3.4,4,2,0,4,0,3,5,60.0,2,3,2,1,4,8,3,0,Matches
676,Thomas Delaney,dk DEN,MF,Hoffenheim,de Bundesliga,30,1991,3.3,6,3,3,2,1,3,8,37.5,5,5,0,5,1,7,4,0,Matches
677,Sacha Delaye,fr FRA,"FW,MF",Montpellier,fr Ligue 1,20,2002,0.2,1,0,0,0,1,1,1,100.0,0,0,0,0,0,1,0,0,Matches
678,Fran Delgado,es ESP,DF,Betis,es La Liga,21,2001,0.1,0,0,0,0,0,0,0,,0,0,0,0,0,0,0,0,Matches
679,Andy Delort,dz ALG,FW,Nice,fr Ligue 1,30,1991,8.7,2,0,1,1,0,1,2,50.0,1,0,0,0,1,3,7,0,Matches
680,Andy Delort,dz ALG,FW,Nantes,fr Ligue 1,30,1991,5.2,5,4,1,2,2,2,6,33.3,4,3,0,3,0,5,2,0,Matches
681,Karamoko Dembele,sct SCO,"FW,MF",Brest,fr Ligue 1,19,2003,2.0,2,0,1,1,0,2,2,100.0,0,1,0,1,1,3,0,0,Matches
682,Moussa Dembélé,fr FRA,"FW,MF",Lyon,fr Ligue 1,26,1996,9.7,8,4,3,3,2,4,7,57.1,3,5,0,5,2,10,6,0,Matches
683,Ousmane Dembélé,fr FRA,FW,Barcelona,es La Liga,25,1997,15.7,19,12,4,8,7,4,15,26.7,11,10,1,9,0,19,2,0,Matches
684,Siriki Dembélé,ci CIV,"FW,MF",Bournemouth,eng Premier League,25,1996,1.2,3,1,2,1,0,0,1,0.0,1,1,0,1,1,4,1,0,Matches
685,Siriki Dembélé,ci CIV,"MF,FW",Auxerre,fr Ligue 1,25,1996,4.1,10,6,4,3,3,4,12,33.3,8,2,0,2,1,11,2,0,Matches
686,Merih Demiral,tr TUR,DF,Atalanta,it Serie A,24,1998,17.1,41,29,30,11,0,26,36,72.2,10,24,7,17,24,65,57,1,Matches
687,Kerem Demirbay,de GER,MF,Leverkusen,de Bundesliga,29,1993,17.2,36,18,16,17,3,18,34,52.9,16,26,6,20,16,52,11,0,Matches
688,Ermedin Demirović,ba BIH,"FW,MF",Augsburg,de Bundesliga,24,1998,26.3,31,14,9,12,10,9,22,40.9,13,31,4,27,14,45,37,0,Matches
689,Diego Demme,de GER,MF,Napoli,it Serie A,30,1991,1.6,1,0,1,0,0,0,4,0.0,4,2,0,2,0,1,1,0,Matches
690,Sepp van den Berg,nl NED,DF,Schalke 04,de Bundesliga,20,2001,7.7,5,4,2,2,1,1,4,25.0,3,8,5,3,13,18,33,2,Matches
691,Branco van den Boomen,nl NED,MF,Toulouse,fr Ligue 1,27,1995,32.1,71,36,26,32,13,36,89,40.4,53,27,4,23,10,81,27,2,Matches
692,Leander Dendoncker,be BEL,MF,Aston Villa,eng Premier League,27,1995,7.7,19,9,11,6,2,11,22,50.0,11,19,4,15,10,29,12,0,Matches
693,Leander Dendoncker,be BEL,MF,Wolves,eng Premier League,27,1995,2.4,4,2,0,3,1,2,3,66.7,1,2,0,2,9,13,4,0,Matches
694,Emmanuel Dennis,ng NGA,"FW,MF",Nott'ham Forest,eng Premier League,24,1997,8.0,17,11,5,5,7,8,18,44.4,10,13,1,12,2,19,6,0,Matches
695,Fabio Depaoli,it ITA,DF,Hellas Verona,it Serie A,25,1997,24.1,48,28,25,16,7,25,44,56.8,19,32,6,26,18,66,33,3,Matches
696,Fabio Depaoli,it ITA,"DF,MF",Sampdoria,it Serie A,25,1997,1.5,5,3,2,3,0,3,4,75.0,1,1,0,1,1,6,4,0,Matches
697,Kastriot Dermaku,al ALB,DF,Lecce,it Serie A,30,1992,0.4,0,0,0,0,0,0,0,,0,0,0,0,0,0,0,0,Matches
698,Halil Dervişoğlu,tr TUR,MF,Brentford,eng Premier League,22,1999,0.1,0,0,0,0,0,0,1,0.0,1,0,0,0,0,0,0,0,Matches
699,Rémy Descamps,fr FRA,GK,Nantes,fr Ligue 1,26,1996,1.0,0,0,0,0,0,0,0,,0,0,0,0,0,0,0,0,Matches
700,Mikkel Desler,dk DEN,DF,Toulouse,fr Ligue 1,27,1995,25.1,71,38,36,27,8,43,67,64.2,24,35,6,29,36,107,48,2,Matches
701,Cyriel Dessers,ng NGA,FW,Cremonese,it Serie A,27,1994,17.6,11,4,4,4,3,2,6,33.3,4,14,2,12,3,14,5,0,Matches
702,Sergiño Dest,us USA,DF,Milan,it Serie A,21,2000,3.7,12,6,3,5,4,3,4,75.0,1,1,0,1,4,16,2,0,Matches
703,Mattia Destro,it ITA,"FW,MF",Empoli,it Serie A,31,1991,6.4,1,1,0,1,0,0,0,,0,2,0,2,1,2,5,0,Matches
704,Gerard Deulofeu,es ESP,FW,Udinese,it Serie A,28,1994,13.5,8,5,5,1,2,5,15,33.3,10,8,1,7,2,10,1,0,Matches
705,Kiernan Dewsbury-Hall,eng ENG,MF,Leicester City,eng Premier League,23,1998,25.6,53,29,14,34,5,19,47,40.4,28,55,13,42,28,81,21,0,Matches
706,Samuel Di Carmine,it ITA,"FW,MF",Cremonese,it Serie A,33,1988,0.3,0,0,0,0,0,0,0,,0,0,0,0,0,0,0,0,Matches
707,Federico Di Francesco,it ITA,"FW,MF",Lecce,it Serie A,28,1994,22.6,28,16,7,11,10,9,19,47.4,10,16,0,16,8,36,14,0,Matches
708,Michele Di Gregorio,it ITA,GK,Monza,it Serie A,25,1997,37.0,0,0,0,0,0,0,3,0.0,3,1,0,1,4,4,18,3,Matches
709,Giovanni Di Lorenzo,it ITA,DF,Napoli,it Serie A,28,1993,36.2,60,29,33,19,8,25,49,51.0,24,30,9,21,30,90,60,0,Matches
710,Ángel Di María,ar ARG,"FW,MF",Juventus,it Serie A,34,1988,15.1,10,5,3,5,2,3,19,15.8,16,15,0,15,7,17,0,0,Matches
711,Boulaye Dia,sn SEN,"FW,MF",Salernitana,it Serie A,25,1996,28.0,12,5,3,6,3,2,7,28.6,5,10,0,10,7,19,27,1,Matches
712,Moussa Diaby,fr FRA,"FW,MF",Leverkusen,de Bundesliga,23,1999,30.0,14,8,4,8,2,7,14,50.0,7,8,0,8,5,19,3,0,Matches
713,Mouctar Diakhaby,gn GUI,DF,Valencia,es La Liga,25,1996,27.2,30,16,19,11,0,13,20,65.0,7,30,17,13,20,50,111,2,Matches
714,Mamadou Diakhon,fr FRA,FW,Reims,fr Ligue 1,16,2005,0.2,2,0,2,0,0,0,1,0.0,1,1,0,1,1,3,0,0,Matches
715,Bafodé Diakité,fr FRA,DF,Lille,fr Ligue 1,21,2001,29.5,54,35,23,24,7,32,57,56.1,25,37,8,29,17,71,58,0,Matches
716,Ibrahim Diakité,gn GUI,DF,Reims,fr Ligue 1,18,2003,1.5,3,3,3,0,0,2,3,66.7,1,0,0,0,5,8,6,0,Matches
717,Abdou Diallo,sn SEN,"DF,MF",RB Leipzig,de Bundesliga,26,1996,5.3,6,5,5,1,0,1,3,33.3,2,8,5,3,8,14,22,0,Matches
718,Baila Diallo,fr FRA,"DF,MF",Clermont Foot,fr Ligue 1,21,2001,1.0,1,0,1,0,0,0,0,,0,1,1,0,0,1,1,0,Matches
719,Habib Diallo,sn SEN,FW,Strasbourg,fr Ligue 1,27,1995,32.0,18,10,8,7,3,6,16,37.5,10,19,4,15,12,30,26,0,Matches
720,Ibrahima Diallo,fr FRA,MF,Southampton,eng Premier League,23,1999,9.1,25,15,14,10,1,8,14,57.1,6,11,1,10,6,31,11,0,Matches
721,Ismael Diallo,ci CIV,DF,Ajaccio,fr Ligue 1,25,1997,24.2,46,33,35,9,2,35,63,55.6,28,26,12,14,30,76,46,1,Matches
722,Habib Diarra,sn SEN,"MF,FW",Strasbourg,fr Ligue 1,18,2004,18.1,24,16,10,11,3,15,29,51.7,14,17,1,16,11,35,13,0,Matches
723,Mamady Diarra,ml MLI,"MF,DF",Cádiz,es La Liga,22,2000,0.7,2,1,2,0,0,1,2,50.0,1,2,0,2,0,2,0,0,Matches
724,Moussa Diarra,ml MLI,DF,Toulouse,fr Ligue 1,21,2000,13.6,20,9,9,9,2,9,15,60.0,6,25,10,15,19,39,27,1,Matches
725,Stéphane Diarra,fr FRA,"FW,MF",Lorient,fr Ligue 1,23,1998,11.8,25,17,14,9,2,11,29,37.9,18,13,1,12,22,47,9,0,Matches
726,Youba Diarra,ml MLI,MF,Cádiz,es La Liga,24,1998,1.1,3,0,2,1,0,1,5,20.0,4,7,1,6,2,5,3,0,Matches
727,Rúben Dias,pt POR,DF,Manchester City,eng Premier League,25,1997,22.2,21,13,10,10,1,11,18,61.1,7,21,13,8,18,39,56,1,Matches
728,Krépin Diatta,sn SEN,"MF,FW",Monaco,fr Ligue 1,23,1999,23.0,30,21,4,17,9,13,32,40.6,19,29,1,28,17,47,12,0,Matches
729,Mory Diaw,sn SEN,GK,Clermont Foot,fr Ligue 1,29,1993,37.0,0,0,0,0,0,0,4,0.0,4,0,0,0,2,2,13,5,Matches
730,Brahim Díaz,ma MAR,"MF,FW",Milan,it Serie A,22,1999,21.4,32,15,5,22,5,5,15,33.3,10,11,0,11,7,39,6,0,Matches
731,Luis Díaz,co COL,FW,Liverpool,eng Premier League,25,1997,11.1,17,11,4,8,5,8,15,53.3,7,8,0,8,6,23,2,0,Matches
732,Justin Diehl,de GER,"MF,FW",Köln,de Bundesliga,17,2004,0.2,0,0,0,0,0,0,0,,0,0,0,0,0,0,0,0,Matches
733,Bamba Dieng,sn SEN,"FW,MF",Marseille,fr Ligue 1,22,2000,2.2,4,4,2,1,1,3,4,75.0,1,5,1,4,0,4,0,0,Matches
734,Bamba Dieng,sn SEN,FW,Lorient,fr Ligue 1,22,2000,8.3,19,10,5,12,2,3,11,27.3,8,6,0,6,2,21,6,0,Matches
735,Eric Dier,eng ENG,DF,Tottenham,eng Premier League,28,1994,31.3,30,19,16,12,2,9,19,47.4,10,41,24,17,35,65,112,2,Matches
736,Florian Dietz,de GER,FW,Köln,de Bundesliga,23,1998,4.4,2,1,0,2,0,1,4,25.0,3,4,1,3,0,2,2,0,Matches
737,Lucas Digne,fr FRA,DF,Aston Villa,eng Premier League,29,1993,16.7,30,12,20,9,1,20,33,60.6,13,18,5,13,18,48,45,0,Matches
738,Federico Dimarco,it ITA,DF,Inter,it Serie A,24,1997,23.0,31,25,6,18,7,9,19,47.4,10,15,4,11,18,49,20,0,Matches
739,Stole Dimitrievski,mk MKD,GK,Rayo Vallecano,es La Liga,28,1993,36.9,1,0,1,0,0,1,2,50.0,1,2,0,2,1,2,17,3,Matches
740,Junior Dina Ebimbe,fr FRA,"DF,MF",Eint Frankfurt,de Bundesliga,21,2000,11.8,30,19,16,14,0,16,33,48.5,17,18,5,13,11,41,20,0,Matches
741,Tristan Dingomé,cm CMR,MF,Troyes,fr Ligue 1,31,1991,1.1,1,1,0,1,0,0,2,0.0,2,0,0,0,0,1,0,0,Matches
742,Eren Dinkçi,de GER,"FW,MF",Werder Bremen,de Bundesliga,20,2001,2.6,5,5,2,1,2,2,6,33.3,4,2,0,2,0,5,2,0,Matches
743,Sinaly Diomande,ci CIV,DF,Lyon,fr Ligue 1,21,2001,21.7,42,24,26,15,1,31,49,63.3,18,26,13,13,49,91,75,1,Matches
744,Lois Diony,fr FRA,FW,Angers,fr Ligue 1,29,1992,5.6,1,0,0,1,0,1,3,33.3,2,2,0,2,0,1,1,0,Matches
745,Edan Diop,fr FRA,"DF,FW",Monaco,fr Ligue 1,17,2004,2.5,13,8,3,3,7,7,15,46.7,8,7,1,6,4,17,1,0,Matches
746,Issa Diop,fr FRA,DF,Fulham,eng Premier League,25,1997,22.4,28,19,18,9,1,17,32,53.1,15,24,17,7,35,63,86,0,Matches
747,Sofiane Diop,fr FRA,"MF,FW",Nice,fr Ligue 1,22,2000,13.6,23,11,12,6,5,7,20,35.0,13,14,2,12,16,39,5,0,Matches
748,Sofiane Diop,fr FRA,MF,Monaco,fr Ligue 1,22,2000,0.7,0,0,0,0,0,0,0,,0,0,0,0,1,1,0,0,Matches
749,Yehvann Diouf,fr FRA,GK,Reims,fr Ligue 1,22,1999,31.0,2,0,2,0,0,1,3,33.3,2,0,0,0,1,3,13,5,Matches
750,Axel Disasi,fr FRA,DF,Monaco,fr Ligue 1,24,1998,37.0,30,20,13,13,4,13,27,48.1,14,51,31,20,56,86,112,2,Matches
751,Tiago Djaló,pt POR,DF,Lille,fr Ligue 1,22,2000,22.4,31,21,23,7,1,13,20,65.0,7,17,11,6,23,54,60,1,Matches
752,Djené,tg TOG,DF,Getafe,es La Liga,30,1991,31.6,41,28,23,17,1,22,38,57.9,16,25,10,15,42,83,81,1,Matches
753,Moussa Djenepo,ml MLI,"DF,FW",Southampton,eng Premier League,24,1998,7.9,19,11,13,5,1,11,27,40.7,16,19,2,17,11,30,7,0,Matches
754,Koffi Djidji,ci CIV,DF,Torino,it Serie A,29,1992,26.9,50,25,32,17,1,18,32,56.3,14,29,14,15,34,84,72,0,Matches
755,Alexander Djiku,gh GHA,DF,Strasbourg,fr Ligue 1,27,1994,29.7,53,36,37,16,0,26,46,56.5,20,45,19,26,66,119,151,3,Matches
756,Berat Djimsiti,al ALB,DF,Atalanta,it Serie A,29,1993,20.0,34,19,21,13,0,17,25,68.0,8,17,7,10,36,70,74,1,Matches
757,Moussa Djitte,sn SEN,FW,Ajaccio,fr Ligue 1,22,1999,1.5,1,0,0,0,1,1,2,50.0,1,0,0,0,0,1,1,0,Matches
758,Ouparine Djoco,gw GNB,GK,Clermont Foot,fr Ligue 1,24,1998,1.0,0,0,0,0,0,0,0,,0,0,0,0,0,0,1,0,Matches
759,Marko Dmitrović,rs SRB,GK,Sevilla,es La Liga,30,1992,14.1,0,0,0,0,0,0,0,,0,0,0,0,0,0,6,0,Matches
760,Alan Do Marcolino,ga GAB,FW,Rennes,fr Ligue 1,20,2002,0.2,0,0,0,0,0,0,0,,0,0,0,0,0,0,1,0,Matches
761,Ben Doak,sct SCO,FW,Liverpool,eng Premier League,16,2005,0.3,3,2,1,2,0,1,1,100.0,0,1,0,1,0,3,0,0,Matches
762,Ritsu Doan,jp JPN,"MF,FW",Freiburg,de Bundesliga,24,1998,26.9,61,29,19,29,13,25,54,46.3,29,40,1,39,14,75,12,0,Matches
763,Dodô,br BRA,DF,Fiorentina,it Serie A,23,1998,25.9,40,22,20,14,6,22,46,47.8,24,26,2,24,25,65,37,0,Matches
764,Danilho Doekhi,nl NED,DF,Union Berlin,de Bundesliga,24,1998,24.6,38,23,21,17,0,14,26,53.8,12,27,12,15,29,67,93,0,Matches
765,Matt Doherty,ie IRL,"DF,MF",Tottenham,eng Premier League,30,1992,7.4,16,10,12,3,1,8,10,80.0,2,11,6,5,8,24,14,1,Matches
766,Matt Doherty,ie IRL,DF,Atlético Madrid,es La Liga,30,1992,0.2,0,0,0,0,0,0,0,,0,2,0,2,0,0,0,0,Matches
767,Josh Doig,sct SCO,DF,Hellas Verona,it Serie A,20,2002,15.0,19,8,6,7,6,6,16,37.5,10,25,6,19,11,30,13,1,Matches
768,Jeremy Doku,be BEL,"MF,FW",Rennes,fr Ligue 1,20,2002,14.3,25,16,6,13,6,12,24,50.0,12,10,0,10,5,30,2,0,Matches
769,Kasper Dolberg,dk DEN,FW,Sevilla,es La Liga,24,1997,2.2,1,0,0,1,0,1,3,33.3,2,0,0,0,0,1,5,0,Matches
770,Kasper Dolberg,dk DEN,"FW,MF",Hoffenheim,de Bundesliga,24,1997,4.5,7,5,1,4,2,4,6,66.7,2,6,2,4,0,7,5,0,Matches
771,Carlos Dominguez,es ESP,DF,Celta Vigo,es La Liga,21,2001,1.2,1,1,0,1,0,1,2,50.0,1,1,1,0,0,1,7,0,Matches
772,Nicolás Domínguez,ar ARG,MF,Bologna,it Serie A,24,1998,25.6,79,49,34,33,12,39,76,51.3,37,29,3,26,21,100,29,1,Matches
773,John Donald,es ESP,"MF,DF",Elche,es La Liga,21,2000,12.1,20,11,9,9,2,7,14,50.0,7,14,7,7,14,34,23,1,Matches
774,Giulio Donati,it ITA,DF,Monza,it Serie A,32,1990,4.7,4,1,1,1,2,3,6,50.0,3,3,1,2,4,8,11,0,Matches
775,Kyliane Dong,fr FRA,"MF,FW",Troyes,fr Ligue 1,17,2004,2.4,3,1,0,2,1,1,2,50.0,1,1,0,1,1,4,0,0,Matches
776,Jordan Dongmo,cm CMR,MF,Troyes,fr Ligue 1,21,2001,0.2,1,0,0,1,0,1,1,100.0,0,0,0,0,0,1,0,0,Matches
777,Gianluigi Donnarumma,it ITA,GK,Paris S-G,fr Ligue 1,23,1999,37.9,1,0,1,0,0,1,2,50.0,1,0,0,0,0,1,12,4,Matches
778,Niklas Dorsch,de GER,MF,Augsburg,de Bundesliga,24,1998,5.4,21,12,8,11,2,9,16,56.3,7,9,3,6,6,27,9,0,Matches
779,Jodel Dossou,bj BEN,"MF,DF",Clermont Foot,fr Ligue 1,30,1992,2.9,7,4,3,2,2,4,4,100.0,0,2,1,1,1,8,0,0,Matches
780,Lohann Doucet,fr FRA,"MF,FW",Nantes,fr Ligue 1,19,2002,1.0,3,0,2,0,1,3,4,75.0,1,2,0,2,2,5,4,0,Matches
781,Abdoulaye Doucouré,ml MLI,MF,Everton,eng Premier League,29,1993,17.0,31,20,9,15,7,12,37,32.4,25,26,3,23,13,44,11,0,Matches
782,Cheick Doucouré,ml MLI,MF,Crystal Palace,eng Premier League,22,2000,30.8,77,46,40,33,4,29,52,55.8,23,47,13,34,56,133,48,0,Matches
783,Siriné Doucouré,ml MLI,"FW,MF",Lorient,fr Ligue 1,20,2002,1.5,2,2,2,0,0,1,2,50.0,1,0,0,0,1,3,0,0,Matches
784,Désiré Doué,fr FRA,"MF,FW",Rennes,fr Ligue 1,17,2005,12.4,37,18,10,23,4,13,32,40.6,19,17,1,16,13,50,3,0,Matches
785,Guela Doué,ci CIV,"FW,MF",Rennes,fr Ligue 1,19,2002,0.1,0,0,0,0,0,0,0,,0,0,0,0,0,0,0,0,Matches
786,Ismaël Doukouré,fr FRA,"DF,MF",Strasbourg,fr Ligue 1,19,2003,25.5,48,24,23,21,4,20,34,58.8,14,26,8,18,27,75,54,0,Matches
787,Kamory Doumbia,ml MLI,MF,Reims,fr Ligue 1,19,2003,12.8,31,16,9,14,8,12,37,32.4,25,17,1,16,13,44,3,0,Matches
788,Souleyman Doumbia,ci CIV,"DF,FW",Angers,fr Ligue 1,25,1996,19.9,45,31,31,13,1,17,31,54.8,14,20,3,17,27,72,27,1,Matches
789,Flynn Downes,eng ENG,MF,West Ham,eng Premier League,23,1999,8.5,16,9,4,10,2,6,12,50.0,6,15,2,13,7,23,6,0,Matches
790,Kami Doyle,eng ENG,MF,Southampton,eng Premier League,16,2005,0.1,0,0,0,0,0,0,0,,0,0,0,0,0,0,0,0,Matches
791,Bartłomiej Drągowski,pl POL,GK,Spezia,it Serie A,24,1997,32.7,1,0,1,0,0,1,5,20.0,4,0,0,0,1,2,15,3,Matches
792,Cody Drameh,eng ENG,DF,Leeds United,eng Premier League,20,2001,0.8,5,4,0,4,1,2,3,66.7,1,0,0,0,1,6,1,0,Matches
793,Dion Drena Beljo,hr CRO,FW,Augsburg,de Bundesliga,20,2002,12.5,7,6,3,2,2,2,13,15.4,11,15,2,13,1,8,14,0,Matches
794,Dominick Drexler,de GER,"MF,FW",Schalke 04,de Bundesliga,32,1990,15.2,25,17,12,10,3,9,22,40.9,13,18,2,16,8,33,12,0,Matches
795,Domingos Duarte,pt POR,DF,Getafe,es La Liga,27,1995,29.5,26,18,21,5,0,19,26,73.1,7,29,23,6,39,65,145,0,Matches
796,Martin Dúbravka,sk SVK,GK,Newcastle Utd,eng Premier League,33,1989,1.7,0,0,0,0,0,0,1,0.0,1,0,0,0,0,0,1,0,Matches
797,Marvin Ducksch,de GER,FW,Werder Bremen,de Bundesliga,28,1994,31.7,8,3,2,4,2,3,16,18.8,13,13,2,11,9,17,41,1,Matches
798,Ondrej Duda,sk SVK,MF,Hellas Verona,it Serie A,27,1994,11.8,22,14,7,12,3,9,16,56.3,7,11,0,11,13,35,8,0,Matches
799,Ondrej Duda,sk SVK,MF,Köln,de Bundesliga,27,1994,7.7,9,8,2,5,2,4,11,36.4,7,7,1,6,2,11,3,0,Matches
800,Shane Duffy,ie IRL,"DF,FW",Fulham,eng Premier League,30,1992,0.2,0,0,0,0,0,0,0,,0,0,0,0,0,0,0,1,Matches
801,Rémy Dugimont,fr FRA,"FW,MF",Auxerre,fr Ligue 1,36,1986,1.3,2,1,0,1,1,1,2,50.0,1,3,0,3,0,2,5,0,Matches
802,Denzel Dumfries,nl NED,DF,Inter,it Serie A,26,1996,24.6,35,18,17,13,5,22,34,64.7,12,33,9,24,12,47,26,0,Matches
803,Alfred Duncan,gh GHA,MF,Fiorentina,it Serie A,29,1993,12.3,18,10,0,17,1,10,21,47.6,11,9,0,9,8,26,6,0,Matches
804,Lewis Dunk,eng ENG,DF,Brighton,eng Premier League,30,1991,36.0,30,19,19,9,2,18,41,43.9,23,37,27,10,34,64,81,1,Matches
805,Maxime Dupé,fr FRA,GK,Toulouse,fr Ligue 1,29,1993,38.0,0,0,0,0,0,0,0,,0,0,0,0,0,0,9,3,Matches
806,Jhon Durán,co COL,"FW,MF",Aston Villa,eng Premier League,18,2003,1.5,2,2,0,1,1,1,4,25.0,3,0,0,0,2,4,2,0,Matches
807,Pablo Durán,es ESP,"MF,DF",Celta Vigo,es La Liga,21,2001,0.4,0,0,0,0,0,0,0,,0,2,1,1,1,1,2,0,Matches
808,Julien Duranville,be BEL,MF,Dortmund,de Bundesliga,16,2006,0.3,1,1,0,1,0,1,1,100.0,0,0,0,0,0,1,0,0,Matches
809,Hugo Duro,es ESP,FW,Valencia,es La Liga,22,1999,15.4,15,12,2,6,7,7,17,41.2,10,11,1,10,2,17,7,1,Matches
810,Jean-Kevin Duverne,ht HAI,DF,Brest,fr Ligue 1,25,1997,27.9,72,38,44,24,4,42,73,57.5,31,33,5,28,28,100,65,1,Matches
811,Paulo Dybala,ar ARG,"MF,FW",Roma,it Serie A,28,1993,19.3,14,4,1,8,5,8,26,30.8,18,12,1,11,8,22,4,0,Matches
812,Edin Džeko,ba BIH,FW,Inter,it Serie A,36,1986,19.2,3,2,0,3,0,0,4,0.0,4,15,1,14,3,6,25,0,Matches
813,Malcolm Ebiowei,eng ENG,"MF,FW",Crystal Palace,eng Premier League,18,2003,0.4,1,1,1,0,0,0,1,0.0,1,2,0,2,0,1,0,0,Matches
814,Festy Ebosele,ie IRL,DF,Udinese,it Serie A,19,2002,4.6,15,10,8,7,0,4,10,40.0,6,5,0,5,2,17,5,0,Matches
815,Enzo Ebosse,cm CMR,DF,Udinese,it Serie A,23,1999,10.3,15,9,11,4,0,9,13,69.2,4,27,6,21,11,26,29,0,Matches
816,Tyronne Ebuehi,ng NGA,DF,Empoli,it Serie A,26,1995,21.4,22,14,11,7,4,9,13,69.2,4,23,12,11,12,34,79,1,Matches
817,Ederson,br BRA,GK,Manchester City,eng Premier League,28,1993,35.0,3,1,3,0,0,1,2,50.0,1,0,0,0,1,4,10,2,Matches
818,Éderson,br BRA,MF,Atalanta,it Serie A,23,1999,24.6,67,34,18,42,7,29,66,43.9,37,56,7,49,36,103,31,0,Matches
819,Odsonne Édouard,fr FRA,FW,Crystal Palace,eng Premier League,24,1998,20.0,25,13,7,12,6,7,13,53.8,6,17,5,12,3,28,22,0,Matches
820,Samuel Edozie,eng ENG,"FW,MF",Southampton,eng Premier League,19,2003,6.3,17,10,6,10,1,3,8,37.5,5,7,0,7,6,23,6,0,Matches
821,Maximilian Eggestein,de GER,MF,Freiburg,de Bundesliga,25,1996,27.2,51,29,21,24,6,17,35,48.6,18,37,8,29,36,87,27,0,Matches
822,Lilian Egloff,de GER,"MF,FW",Stuttgart,de Bundesliga,19,2002,2.7,12,10,4,5,3,4,6,66.7,2,2,0,2,1,13,1,0,Matches
823,Íñigo Eguaras,es ESP,MF,Almería,es La Liga,30,1992,10.7,11,8,4,6,1,5,18,27.8,13,9,3,6,6,17,15,0,Matches
824,Kingsley Ehizibue,nl NED,DF,Udinese,it Serie A,27,1995,17.1,47,31,28,13,6,29,45,64.4,16,21,3,18,10,57,42,1,Matches
825,Kingsley Ehizibue,nl NED,DF,Köln,de Bundesliga,27,1995,0.7,0,0,0,0,0,0,0,,0,1,0,1,2,2,1,0,Matches
826,Julian Eitschberger,de GER,FW,Hertha BSC,de Bundesliga,18,2004,0.0,0,0,0,0,0,0,0,,0,0,0,0,0,0,0,0,Matches
827,Chidera Ejuke,ng NGA,"FW,MF",Hertha BSC,de Bundesliga,24,1998,9.9,5,4,1,4,0,1,5,20.0,4,4,0,4,4,9,1,0,Matches
828,Albin Ekdal,se SWE,MF,Spezia,it Serie A,33,1989,19.3,37,20,14,20,3,19,45,42.2,26,24,2,22,26,63,36,0,Matches
829,Hugo Ekitike,fr FRA,FW,Paris S-G,fr Ligue 1,20,2002,12.8,12,4,1,10,1,4,12,33.3,8,12,0,12,9,21,3,0,Matches
830,Emmanuel Ekong,se SWE,"FW,MF",Empoli,it Serie A,20,2002,0.2,0,0,0,0,0,0,0,,0,0,0,0,0,0,0,0,Matches
831,Anthony Elanga,se SWE,FW,Manchester Utd,eng Premier League,20,2002,4.7,3,0,0,2,1,1,2,50.0,1,4,0,4,2,5,4,0,Matches
832,Alberth Elis,hn HON,"MF,FW",Brest,fr Ligue 1,26,1996,2.9,4,3,1,2,1,1,7,14.3,6,1,0,1,1,5,2,0,Matches
833,Mikael Ellertsson,is ISL,"MF,DF",Spezia,it Serie A,20,2002,1.9,4,2,1,3,0,0,3,0.0,3,2,1,1,2,6,0,0,Matches
834,Harvey Elliott,eng ENG,"MF,FW",Liverpool,eng Premier League,19,2003,17.9,27,18,6,12,9,9,37,24.3,28,26,1,25,15,42,8,0,Matches
835,Elif Elmas,mk MKD,"FW,MF",Napoli,it Serie A,22,1999,18.1,24,13,8,12,4,11,23,47.8,12,18,2,16,11,35,5,0,Matches
836,Mohamed Elneny,eg EGY,MF,Arsenal,eng Premier League,30,1992,1.3,1,1,1,0,0,1,1,100.0,0,0,0,0,0,1,0,0,Matches
837,Aritz Elustondo,es ESP,DF,Real Sociedad,es La Liga,28,1994,16.1,26,17,15,10,1,14,26,53.8,12,15,6,9,20,46,43,1,Matches
838,Nico Elvedi,ch SUI,DF,Gladbach,de Bundesliga,25,1996,31.4,46,24,32,12,2,27,41,65.9,14,31,16,15,35,81,149,3,Matches
839,Rodrigo Ely,br BRA,DF,Almería,es La Liga,28,1993,35.1,30,21,26,4,0,18,25,72.0,7,46,33,13,31,61,203,1,Matches
840,Mohamed Elyounoussi,no NOR,"MF,FW",Southampton,eng Premier League,27,1994,24.1,46,28,22,20,4,19,44,43.2,25,40,3,37,27,73,37,0,Matches
841,Adri Embarba,es ESP,"FW,MF",Almería,es La Liga,30,1992,16.4,50,27,21,26,3,22,46,47.8,24,23,0,23,9,59,9,0,Matches
842,Adri Embarba,es ESP,FW,Espanyol,es La Liga,30,1992,0.4,1,0,0,1,0,1,1,100.0,0,1,0,1,0,1,0,0,Matches
843,Breel Embolo,ch SUI,FW,Monaco,fr Ligue 1,25,1997,20.7,15,9,2,7,6,5,10,50.0,5,14,3,11,5,20,12,0,Matches
844,Emerson,br BRA,DF,Tottenham,eng Premier League,23,1999,19.3,54,33,38,12,4,27,40,67.5,13,17,3,14,18,72,75,0,Matches
845,Youssef En-Nesyri,ma MAR,FW,Sevilla,es La Liga,25,1997,18.5,16,8,3,7,6,4,14,28.6,10,6,2,4,4,20,16,0,Matches
846,Julio Enciso,py PAR,"FW,MF",Brighton,eng Premier League,18,2004,9.0,13,4,3,6,4,8,13,61.5,5,9,0,9,4,17,2,0,Matches
847,Wataru Endo,jp JPN,MF,Stuttgart,de Bundesliga,29,1993,32.5,70,37,30,31,9,38,85,44.7,47,44,6,38,26,96,63,0,Matches
848,Arne Engels,be BEL,MF,Augsburg,de Bundesliga,18,2003,16.0,20,9,9,10,1,8,19,42.1,11,17,5,12,15,35,12,1,Matches
849,Christian Eriksen,dk DEN,MF,Manchester Utd,eng Premier League,30,1992,22.8,22,18,10,7,5,10,33,30.3,23,23,9,14,11,33,20,1,Matches
850,Martin Erlic,hr CRO,DF,Sassuolo,it Serie A,24,1998,25.9,27,16,18,8,1,10,23,43.5,13,36,23,13,31,58,120,1,Matches
851,Tjark Ernst,de GER,GK,Hertha BSC,de Bundesliga,19,2003,1.0,0,0,0,0,0,0,0,,0,0,0,0,0,0,1,0,Matches
852,Gonzalo Escalante,ar ARG,MF,Cremonese,it Serie A,29,1993,6.2,16,8,8,8,0,10,13,76.9,3,7,1,6,10,26,4,0,Matches
853,Gonzalo Escalante,ar ARG,MF,Cádiz,es La Liga,29,1993,12.5,36,24,15,20,1,15,29,51.7,14,18,4,14,17,53,26,1,Matches
854,Sergio Escudero,es ESP,DF,Valladolid,es La Liga,32,1989,16.0,33,19,21,8,4,15,35,42.9,20,26,6,20,26,59,46,0,Matches
855,Alfonso Espino,uy URU,DF,Cádiz,es La Liga,30,1992,34.7,87,56,55,20,12,48,96,50.0,48,52,11,41,48,135,99,3,Matches
856,Bernardo Espinosa,co COL,DF,Girona,es La Liga,33,1989,13.6,6,2,2,4,0,3,9,33.3,6,17,10,7,12,18,70,2,Matches
857,Salvatore Esposito,it ITA,MF,Spezia,it Serie A,21,2000,10.8,15,12,8,5,2,5,21,23.8,16,9,1,8,11,26,18,0,Matches
858,Maxime Estève,fr FRA,DF,Montpellier,fr Ligue 1,20,2002,18.3,24,13,17,5,2,12,17,70.6,5,28,17,11,34,58,90,0,Matches
859,Pervis Estupiñán,ec ECU,DF,Brighton,eng Premier League,24,1998,29.7,61,31,36,19,6,35,60,58.3,25,30,8,22,37,98,37,1,Matches
860,Jonny Evans,nir NIR,DF,Leicester City,eng Premier League,34,1988,11.7,13,5,12,1,0,7,11,63.6,4,15,11,4,18,31,51,0,Matches
861,Edu Expósito,es ESP,MF,Espanyol,es La Liga,25,1996,12.9,34,20,16,15,3,13,23,56.5,10,7,0,7,12,46,20,0,Matches
862,Eberechi Eze,eng ENG,"MF,FW",Crystal Palace,eng Premier League,24,1998,29.3,42,24,17,18,7,18,38,47.4,20,22,0,22,13,55,10,0,Matches
863,Kimberly Ezekwem,de GER,DF,Freiburg,de Bundesliga,21,2001,0.1,0,0,0,0,0,0,0,,0,1,0,1,0,0,0,0,Matches
864,Nicolás Ezequiel Fernández,ar ARG,"MF,DF",Elche,es La Liga,22,2000,5.7,23,12,10,7,6,9,17,52.9,8,7,0,7,5,28,2,1,Matches
865,Abdessamad Ezzalzouli,ma MAR,"FW,MF",Osasuna,es La Liga,20,2001,16.7,29,19,13,12,4,13,23,56.5,10,20,0,20,4,33,6,0,Matches
866,Łukasz Fabiański,pl POL,GK,West Ham,eng Premier League,37,1985,34.6,2,0,2,0,0,1,2,50.0,1,1,0,1,0,2,10,1,Matches
867,Fabinho,br BRA,MF,Liverpool,eng Premier League,28,1993,29.7,65,38,18,40,7,24,62,38.7,38,38,11,27,37,102,40,0,Matches
868,Fábio,br BRA,"DF,MF",Nantes,fr Ligue 1,32,1990,2.5,4,2,1,2,1,4,6,66.7,2,2,0,2,3,7,11,0,Matches
869,Noah Fadiga,sn SEN,DF,Brest,fr Ligue 1,22,1999,14.5,30,21,18,9,3,14,26,53.8,12,17,7,10,26,56,18,0,Matches
870,Wout Faes,be BEL,DF,Leicester City,eng Premier League,24,1998,31.0,56,33,28,26,2,28,44,63.6,16,53,37,16,41,97,113,2,Matches
871,Wout Faes,be BEL,DF,Reims,fr Ligue 1,24,1998,3.0,1,1,1,0,0,1,2,50.0,1,6,3,3,7,8,19,0,Matches
872,Nicolò Fagioli,it ITA,MF,Juventus,it Serie A,21,2001,16.9,29,19,12,15,2,8,27,29.6,19,16,2,14,8,37,7,1,Matches
873,Ralf Fährmann,de GER,GK,Schalke 04,de Bundesliga,33,1988,11.4,1,0,1,0,0,1,1,100.0,0,0,0,0,0,1,10,2,Matches
874,Romain Faivre,fr FRA,"MF,FW",Lorient,fr Ligue 1,24,1998,13.8,13,8,5,4,4,5,25,20.0,20,11,0,11,1,14,4,0,Matches
875,Romain Faivre,fr FRA,MF,Lyon,fr Ligue 1,24,1998,3.3,6,3,2,2,2,1,3,33.3,2,3,0,3,0,6,0,0,Matches
876,Radamel Falcao,co COL,"FW,MF",Rayo Vallecano,es La Liga,36,1986,6.8,4,4,1,3,0,1,8,12.5,7,5,1,4,2,6,10,0,Matches
877,Wladimiro Falcone,it ITA,GK,Lecce,it Serie A,27,1995,38.0,2,0,2,0,0,2,2,100.0,0,0,0,0,2,4,21,3,Matches
878,Fali,es ESP,"DF,MF",Cádiz,es La Liga,28,1993,19.0,27,19,19,8,0,18,29,62.1,11,24,15,9,13,40,70,1,Matches
879,Fallou Fall,sn SEN,DF,Reims,fr Ligue 1,18,2004,0.4,0,0,0,0,0,0,1,0.0,1,3,3,0,0,0,4,0,Matches
880,Mamadou Fall,sn SEN,DF,Villarreal,es La Liga,19,2002,0.3,0,0,0,0,0,0,0,,0,1,0,1,0,0,1,0,Matches
881,Davide Faraoni,it ITA,DF,Hellas Verona,it Serie A,30,1991,16.5,34,24,19,13,2,16,41,39.0,25,30,11,19,15,49,37,0,Matches
882,Ansu Fati,es ESP,FW,Barcelona,es La Liga,19,2002,15.5,16,9,8,4,4,5,18,27.8,13,19,0,19,5,21,6,0,Matches
883,Khalil Fayad,fr FRA,MF,Montpellier,fr Ligue 1,18,2004,8.0,30,14,12,16,2,12,21,57.1,9,8,1,7,9,39,4,0,Matches
884,Cheikh Faye,sn SEN,FW,Montpellier,fr Ligue 1,23,1999,0.4,0,0,0,0,0,0,0,,0,0,0,0,1,1,0,0,Matches
885,Federico Fazio,ar ARG,DF,Salernitana,it Serie A,35,1987,11.9,15,12,8,7,0,4,11,36.4,7,9,4,5,28,43,61,0,Matches
886,Jacopo Fazzini,it ITA,MF,Empoli,it Serie A,19,2003,9.2,31,17,20,8,3,18,34,52.9,16,15,3,12,7,38,19,0,Matches
887,Zouhair Feddal,ma MAR,DF,Valladolid,es La Liga,33,1989,4.2,4,2,1,3,0,3,4,75.0,1,9,9,0,5,9,27,0,Matches
888,Nabil Fekir,fr FRA,MF,Betis,es La Liga,29,1993,10.7,11,5,3,3,5,2,9,22.2,7,6,2,4,1,12,0,0,Matches
889,Felipe,br BRA,DF,Nott'ham Forest,eng Premier League,33,1989,15.8,42,23,29,13,0,24,41,58.5,17,34,13,21,36,78,90,0,Matches
890,Felipe,br BRA,DF,Atlético Madrid,es La Liga,33,1989,2.2,3,2,1,2,0,2,4,50.0,2,2,2,0,0,3,7,0,Matches
891,Luiz Felipe,it ITA,DF,Betis,es La Liga,25,1997,19.6,34,23,23,11,0,18,34,52.9,16,43,24,19,28,62,106,0,Matches
892,João Félix,pt POR,"FW,MF",Chelsea,eng Premier League,22,1999,10.5,14,7,5,6,3,4,12,33.3,8,3,0,3,1,15,1,1,Matches
893,João Félix,pt POR,"FW,MF",Atlético Madrid,es La Liga,22,1999,7.2,10,7,2,3,5,1,6,16.7,5,1,0,1,3,13,2,0,Matches
894,Ohis Felix Uduokhai,de GER,DF,Augsburg,de Bundesliga,24,1997,16.1,30,20,14,13,3,15,29,51.7,14,27,14,13,29,59,61,1,Matches
895,Kiko Femenía,es ESP,DF,Villarreal,es La Liga,31,1991,12.6,18,9,14,3,1,13,18,72.2,5,15,6,9,20,38,22,0,Matches
896,Evan Ferguson,ie IRL,FW,Brighton,eng Premier League,17,2004,10.6,6,3,1,3,2,1,7,14.3,6,11,1,10,2,8,6,0,Matches
897,Lewis Ferguson,sct SCO,"MF,FW",Bologna,it Serie A,22,1999,25.7,44,25,16,20,8,20,40,50.0,20,22,7,15,19,63,25,0,Matches
898,Bruno Fernandes,pt POR,"MF,FW",Manchester Utd,eng Premier League,27,1994,36.8,68,42,24,25,19,30,71,42.3,41,37,5,32,25,93,40,1,Matches
899,Edimilson Fernandes,ch SUI,DF,Mainz 05,de Bundesliga,26,1996,27.1,35,25,26,5,4,18,34,52.9,16,37,16,21,54,89,87,2,Matches
900,Aitor Fernández,es ESP,GK,Osasuna,es La Liga,31,1991,21.0,1,1,1,0,0,0,1,0.0,1,0,0,0,2,3,17,0,Matches
901,Álex Fernández,es ESP,"MF,FW",Cádiz,es La Liga,29,1992,17.5,13,7,6,4,3,4,14,28.6,10,14,1,13,8,21,19,0,Matches
902,Álvaro Fernández,es ESP,GK,Espanyol,es La Liga,24,1998,11.0,0,0,0,0,0,0,0,,0,0,0,0,0,0,7,2,Matches
903,Carlos Fernández,es ESP,FW,Real Sociedad,es La Liga,26,1996,7.0,6,4,1,3,2,1,15,6.7,14,1,0,1,1,7,4,0,Matches
904,Enzo Fernández,ar ARG,MF,Chelsea,eng Premier League,21,2001,17.2,45,27,25,17,3,21,56,37.5,35,32,2,30,16,61,12,1,Matches
905,Federico Fernández,ar ARG,DF,Elche,es La Liga,33,1989,1.0,1,1,1,0,0,1,1,100.0,0,0,0,0,2,3,12,0,Matches
906,Joaquín Fernández,es ESP,DF,Valladolid,es La Liga,26,1996,24.0,35,28,20,11,4,19,30,63.3,11,31,22,9,27,62,98,1,Matches
907,Valery Fernández,es ESP,"MF,DF",Girona,es La Liga,22,1999,10.7,12,6,4,6,2,5,9,55.6,4,8,1,7,10,22,9,1,Matches
908,Fernando,es ESP,GK,Almería,es La Liga,32,1990,36.5,0,0,0,0,0,0,2,0.0,2,2,0,2,1,1,20,3,Matches
909,Fernando,br BRA,"MF,DF",Sevilla,es La Liga,35,1987,17.5,34,23,14,17,3,18,30,60.0,12,21,10,11,24,58,29,0,Matches
910,Alex Ferrari,it ITA,DF,Sampdoria,it Serie A,28,1994,9.6,9,5,7,2,0,4,8,50.0,4,21,10,11,19,28,25,0,Matches
911,Alex Ferrari,it ITA,DF,Cremonese,it Serie A,28,1994,11.2,40,23,32,7,1,28,42,66.7,14,19,4,15,25,65,45,1,Matches
912,Salvador Ferrer,es ESP,DF,Spezia,it Serie A,24,1998,1.5,4,2,2,2,0,1,3,33.3,2,3,1,2,1,5,4,0,Matches
913,Jordan Ferri,fr FRA,MF,Montpellier,fr Ligue 1,30,1992,30.4,55,35,32,19,4,30,89,33.7,59,22,6,16,26,81,21,0,Matches
914,Fidel,es ESP,"MF,FW",Elche,es La Liga,32,1989,19.0,15,10,8,5,2,4,38,10.5,34,9,0,9,5,20,8,0,Matches
915,Karol Fila,pl POL,DF,Strasbourg,fr Ligue 1,24,1998,0.5,0,0,0,0,0,0,0,,0,0,0,0,1,1,1,0,Matches
916,Vincenzo Fiorillo,it ITA,GK,Salernitana,it Serie A,32,1990,1.0,0,0,0,0,0,0,0,,0,0,0,0,0,0,0,0,Matches
917,Roberto Firmino,br BRA,"FW,MF",Liverpool,eng Premier League,30,1991,13.5,17,12,2,12,3,4,22,18.2,18,16,1,15,7,24,2,0,Matches
918,Junior Firpo,do DOM,DF,Leeds United,eng Premier League,25,1996,15.2,47,25,27,15,5,24,46,52.2,22,23,7,16,24,71,40,0,Matches
919,Kilian Fischer,de GER,"DF,FW",Wolfsburg,de Bundesliga,21,2000,5.6,9,6,3,4,2,6,11,54.5,5,6,0,6,5,14,18,0,Matches
920,Mark Flekken,nl NED,GK,Freiburg,de Bundesliga,29,1993,34.0,0,0,0,0,0,0,1,0.0,1,1,0,1,0,0,9,5,Matches
921,Florian Flick,de GER,MF,Schalke 04,de Bundesliga,22,2000,5.7,12,3,7,5,0,4,14,28.6,10,9,3,6,4,16,18,0,Matches
922,Alexis Flips,fr FRA,"FW,MF",Reims,fr Ligue 1,22,2000,22.0,51,30,18,17,16,27,64,42.2,37,35,5,30,24,75,12,0,Matches
923,Alessandro Florenzi,it ITA,DF,Milan,it Serie A,31,1991,2.3,6,4,3,2,1,4,7,57.1,3,1,0,1,4,10,2,0,Matches
924,Phil Foden,eng ENG,FW,Manchester City,eng Premier League,22,2000,20.5,16,10,9,5,2,8,19,42.1,11,25,2,23,5,21,12,0,Matches
925,Seko Fofana,ci CIV,MF,Lens,fr Ligue 1,27,1995,34.1,28,13,8,18,2,15,39,38.5,24,17,4,13,19,47,14,0,Matches
926,Wesley Fofana,fr FRA,DF,Leicester City,eng Premier League,21,2000,2.0,4,2,1,2,1,1,3,33.3,2,1,1,0,9,13,5,0,Matches
927,Wesley Fofana,fr FRA,DF,Chelsea,eng Premier League,21,2000,13.1,30,18,19,7,4,13,26,50.0,13,17,10,7,20,50,33,2,Matches
928,Yahia Fofana,ci CIV,GK,Angers,fr Ligue 1,21,2000,11.0,0,0,0,0,0,0,0,,0,0,0,0,1,1,4,1,Matches
929,Youssouf Fofana,fr FRA,MF,Monaco,fr Ligue 1,23,1999,34.3,81,41,31,42,8,38,74,51.4,36,50,6,44,56,137,32,1,Matches
930,Thomas Foket,be BEL,DF,Reims,fr Ligue 1,27,1994,22.0,35,22,18,11,6,17,46,37.0,29,21,7,14,33,68,29,2,Matches
931,José Fonte,pt POR,DF,Lille,fr Ligue 1,38,1983,28.8,23,17,18,4,1,10,21,47.6,11,27,14,13,25,48,112,2,Matches
932,Pablo Fornals,es ESP,"FW,MF",West Ham,eng Premier League,26,1996,16.7,30,15,9,12,9,13,34,38.2,21,16,2,14,14,44,9,0,Matches
933,Emil Forsberg,se SWE,"MF,FW",RB Leipzig,de Bundesliga,30,1991,16.5,16,11,1,8,7,6,20,30.0,14,25,2,23,3,19,7,0,Matches
934,Adam Forshaw,eng ENG,MF,Leeds United,eng Premier League,30,1991,5.3,12,9,5,7,0,7,17,41.2,10,9,1,8,4,16,2,0,Matches
935,Fraser Forster,eng ENG,GK,Tottenham,eng Premier League,34,1988,13.5,1,0,1,0,0,0,0,,0,1,0,1,0,1,3,1,Matches
936,Philipp Förster,de GER,MF,Bochum,de Bundesliga,27,1995,14.5,31,19,11,15,5,12,40,30.0,28,22,0,22,6,37,6,0,Matches
937,Steven Fortes,cv CPV,DF,Lens,fr Ligue 1,30,1992,0.1,0,0,0,0,0,0,0,,0,0,0,0,0,0,0,0,Matches
938,Timothy Fosu-Mensah,nl NED,DF,Leverkusen,de Bundesliga,24,1998,2.1,7,5,3,3,1,4,4,100.0,0,2,0,2,0,7,1,0,Matches
939,Dimitri Foulquier,fr FRA,DF,Valencia,es La Liga,29,1993,19.3,31,19,17,8,6,20,28,71.4,8,19,3,16,14,45,40,0,Matches
940,Juan Foyth,ar ARG,DF,Villarreal,es La Liga,24,1998,21.8,73,48,49,22,2,41,57,71.9,16,32,11,21,20,93,68,0,Matches
941,Raphael Framberger,de GER,"DF,FW",Augsburg,de Bundesliga,26,1995,2.0,10,6,6,4,0,3,5,60.0,2,2,1,1,2,12,5,0,Matches
942,Tyrese Francois,au AUS,FW,Fulham,eng Premier League,22,2000,0.0,0,0,0,0,0,0,1,0.0,1,0,0,0,0,0,1,0,Matches
943,Bartol Franjić,hr CRO,MF,Wolfsburg,de Bundesliga,22,2000,2.5,4,2,2,2,0,0,2,0.0,2,4,1,3,5,9,4,0,Matches
944,Przemysław Frankowski,pl POL,"DF,MF",Lens,fr Ligue 1,27,1995,31.5,77,51,37,31,9,39,80,48.8,41,38,6,32,41,118,42,2,Matches
945,Ryan Fraser,sct SCO,FW,Newcastle Utd,eng Premier League,28,1994,3.5,2,2,0,0,2,2,5,40.0,3,3,1,2,0,2,3,0,Matches
946,Davide Frattesi,it ITA,MF,Sassuolo,it Serie A,22,1999,31.9,63,36,24,29,10,25,44,56.8,19,27,6,21,16,79,42,0,Matches
947,Oscar Fraulo,dk DEN,"FW,MF",Gladbach,de Bundesliga,18,2003,0.1,0,0,0,0,0,0,0,,0,0,0,0,0,0,0,0,Matches
948,Fred,br BRA,MF,Manchester Utd,eng Premier League,29,1993,13.9,47,30,24,20,3,15,38,39.5,23,38,2,36,19,66,19,0,Matches
949,Ryan Fredericks,eng ENG,DF,Bournemouth,eng Premier League,29,1992,5.9,3,2,2,0,1,1,4,25.0,3,7,2,5,1,4,27,0,Matches
950,Iván Fresneda,es ESP,DF,Valladolid,es La Liga,17,2004,19.4,48,34,31,13,4,29,47,61.7,18,32,8,24,15,63,60,0,Matches
951,Remo Freuler,ch SUI,MF,Nott'ham Forest,eng Premier League,30,1992,24.0,43,23,23,15,5,19,43,44.2,24,36,9,27,29,72,45,0,Matches
952,Michael Frey,ch SUI,FW,Schalke 04,de Bundesliga,28,1994,9.6,13,5,2,8,3,4,13,30.8,9,6,0,6,2,15,1,0,Matches
953,Marco Friedl,at AUT,DF,Werder Bremen,de Bundesliga,24,1998,28.8,62,46,40,22,0,41,68,60.3,27,46,17,29,58,120,127,1,Matches
954,Marvin Friedrich,de GER,DF,Gladbach,de Bundesliga,26,1995,13.9,17,11,13,3,1,10,13,76.9,3,14,6,8,11,28,52,0,Matches
955,Jeremie Frimpong,nl NED,"DF,MF",Leverkusen,de Bundesliga,21,2000,30.1,53,27,22,26,5,23,44,52.3,21,24,3,21,16,69,40,0,Matches
956,Chris Führich,de GER,"FW,MF",Stuttgart,de Bundesliga,24,1998,20.9,36,14,15,14,7,24,44,54.5,20,29,2,27,7,43,13,0,Matches
957,Angelo Fulgini,fr FRA,"MF,FW",Lens,fr Ligue 1,25,1996,9.5,14,7,2,4,8,5,14,35.7,9,11,0,11,8,22,2,0,Matches
958,Angelo Fulgini,fr FRA,MF,Mainz 05,de Bundesliga,25,1996,5.8,6,5,2,3,1,5,12,41.7,7,5,0,5,5,11,7,0,Matches
959,Niclas Füllkrug,de GER,FW,Werder Bremen,de Bundesliga,29,1993,27.5,9,4,0,6,3,3,13,23.1,10,13,4,9,1,10,24,0,Matches
960,Matteo Gabbia,it ITA,DF,Milan,it Serie A,22,1999,6.8,17,10,12,5,0,6,8,75.0,2,8,3,5,5,22,29,0,Matches
961,Manolo Gabbiadini,it ITA,"FW,MF",Sampdoria,it Serie A,30,1991,26.2,23,15,8,9,6,9,23,39.1,14,16,2,14,6,29,25,0,Matches
962,Gianluca Gaetano,it ITA,MF,Napoli,it Serie A,22,2000,0.8,5,3,1,3,1,0,0,,0,1,0,1,1,6,0,0,Matches
963,Roberto Gagliardini,it ITA,MF,Inter,it Serie A,28,1994,8.7,16,6,9,6,1,10,21,47.6,11,14,5,9,4,20,15,0,Matches
964,Adolfo Gaich,ar ARG,FW,Hellas Verona,it Serie A,23,1999,8.1,5,3,0,3,2,1,6,16.7,5,7,2,5,3,8,7,1,Matches
965,Cody Gakpo,nl NED,"FW,MF",Liverpool,eng Premier League,23,1999,16.2,26,15,4,13,9,13,38,34.2,25,13,1,12,4,30,2,0,Matches
966,Javi Galán,es ESP,DF,Celta Vigo,es La Liga,27,1994,35.1,104,72,60,40,4,48,98,49.0,50,54,5,49,41,145,63,1,Matches
967,Iñigo Ruiz de Galarreta,es ESP,MF,Mallorca,es La Liga,28,1993,27.2,54,38,27,23,4,20,52,38.5,32,26,9,17,30,84,19,0,Matches
968,Pablo Galdames Millán,cl CHI,MF,Cremonese,it Serie A,25,1996,8.2,14,10,8,3,3,5,33,15.2,28,13,2,11,10,24,13,0,Matches
969,Conor Gallagher,eng ENG,MF,Chelsea,eng Premier League,22,2000,18.0,46,33,17,19,10,10,37,27.0,27,41,10,31,23,69,18,1,Matches
970,Antonino Gallo,it ITA,DF,Lecce,it Serie A,22,2000,27.6,56,36,35,12,9,38,57,66.7,19,37,6,31,13,69,71,0,Matches
971,Gauthier Gallon,fr FRA,GK,Troyes,fr Ligue 1,29,1993,29.6,2,2,2,0,0,2,4,50.0,2,0,0,0,2,4,17,0,Matches
972,Cristian Gamboa,cr CRC,DF,Bochum,de Bundesliga,32,1989,16.4,42,24,27,14,1,21,31,67.7,10,20,7,13,16,58,34,1,Matches
973,Kévin Gameiro,fr FRA,FW,Strasbourg,fr Ligue 1,35,1987,23.3,20,10,6,10,4,8,28,28.6,20,10,1,9,9,29,0,0,Matches
974,Idrissa Gana Gueye,sn SEN,MF,Everton,eng Premier League,32,1989,28.6,97,57,49,35,13,31,62,50.0,31,50,12,38,56,153,34,3,Matches
975,Ignatius Ganago,cm CMR,"FW,MF",Nantes,fr Ligue 1,23,1999,16.9,9,7,2,3,4,4,7,57.1,3,13,1,12,2,11,12,0,Matches
976,Ignatius Ganago,cm CMR,FW,Lens,fr Ligue 1,23,1999,0.7,0,0,0,0,0,0,0,,0,0,0,0,0,0,1,0,Matches
977,Silvère Ganvoula M'Boussy,cg CGO,"FW,MF",Bochum,de Bundesliga,26,1996,2.7,2,2,0,1,1,0,0,,0,0,0,0,0,2,3,0,Matches
978,Aleix García,es ESP,MF,Girona,es La Liga,25,1997,26.0,37,20,9,18,10,15,33,45.5,18,24,8,16,31,68,35,1,Matches
979,Álvaro García,es ESP,"FW,MF",Rayo Vallecano,es La Liga,29,1992,31.9,49,28,21,13,15,11,33,33.3,22,41,4,37,34,83,24,1,Matches
980,Borja García,es ESP,"MF,FW",Girona,es La Liga,31,1990,7.5,10,4,7,2,1,2,9,22.2,7,3,1,2,5,15,6,1,Matches
981,Carlos García,es ESP,DF,Cádiz,es La Liga,22,2000,0.3,0,0,0,0,0,0,0,,0,0,0,0,0,0,2,0,Matches
982,Dani García,es ESP,MF,Athletic Club,es La Liga,32,1990,16.5,46,27,17,25,4,29,47,61.7,18,21,6,15,19,65,21,1,Matches
983,David García,es ESP,DF,Osasuna,es La Liga,28,1994,29.8,34,20,22,12,0,19,22,86.4,3,28,13,15,45,79,151,0,Matches
984,Eric García,es ESP,"DF,MF",Barcelona,es La Liga,21,2001,15.7,24,16,16,5,3,9,20,45.0,11,23,10,13,19,43,36,1,Matches
985,Fran Garcia,es ESP,DF,Rayo Vallecano,es La Liga,22,1999,37.9,84,54,53,23,8,55,96,57.3,41,49,8,41,44,128,66,0,Matches
986,Joan García,es ESP,GK,Espanyol,es La Liga,21,2001,1.0,0,0,0,0,0,0,0,,0,0,0,0,0,0,0,0,Matches
987,Raúl García,es ESP,"FW,MF",Athletic Club,es La Liga,36,1986,10.7,12,8,3,4,5,5,15,33.3,10,13,1,12,6,18,9,0,Matches
988,Rubén García,es ESP,"FW,MF",Osasuna,es La Liga,29,1993,12.9,20,11,12,4,4,7,24,29.2,17,14,1,13,12,32,13,0,Matches
989,Unai García,es ESP,DF,Osasuna,es La Liga,30,1992,19.0,23,13,13,8,2,12,17,70.6,5,23,14,9,19,42,60,2,Matches
990,Alejandro Garnacho,ar ARG,"FW,MF",Manchester Utd,eng Premier League,18,2004,6.3,5,2,2,0,3,1,11,9.1,10,5,0,5,5,10,3,0,Matches
991,James Garner,eng ENG,"MF,DF",Everton,eng Premier League,21,2001,8.9,16,13,4,8,4,9,19,47.4,10,9,1,8,12,28,13,0,Matches
992,Felix Garreta,es ESP,DF,Betis,es La Liga,18,2004,1.0,1,0,0,1,0,0,0,,0,1,1,0,1,2,4,0,Matches
993,Aleix Garrido,es ESP,FW,Barcelona,es La Liga,18,2004,0.1,2,1,1,0,1,1,1,100.0,0,1,0,1,0,2,0,0,Matches
994,Sékou Gassama,sn SEN,FW,Valladolid,es La Liga,27,1995,0.4,0,0,0,0,0,0,0,,0,0,0,0,0,0,0,0,Matches
995,Johan Gastien,fr FRA,MF,Clermont Foot,fr Ligue 1,34,1988,28.9,62,34,30,23,9,38,111,34.2,73,37,7,30,36,98,25,1,Matches
996,Federico Gatti,it ITA,DF,Juventus,it Serie A,24,1998,16.1,15,11,9,4,2,9,15,60.0,6,20,14,6,21,36,54,2,Matches
997,Gavi,es ESP,"MF,FW",Barcelona,es La Liga,17,2004,28.1,47,31,7,30,10,21,55,38.2,34,32,5,27,18,65,22,0,Matches
998,Paulo Gazzaniga,ar ARG,GK,Girona,es La Liga,30,1992,28.0,0,0,0,0,0,0,1,0.0,1,0,0,0,1,1,9,5,Matches
999,David de Gea,es ESP,GK,Manchester Utd,eng Premier League,31,1990,38.0,0,0,0,0,0,0,1,0.0,1,0,0,0,1,1,15,3,Matches
1000,Dario Gebuhr,de GER,DF,Eint Frankfurt,de Bundesliga,19,2003,0.2,0,0,0,0,0,0,1,0.0,1,0,0,0,0,0,0,0,Matches
1001,Dennis Geiger,de GER,MF,Hoffenheim,de Bundesliga,24,1998,21.7,45,25,15,28,2,22,35,62.9,13,27,3,24,24,69,18,2,Matches
1002,Joe Gelhardt,eng ENG,FW,Leeds United,eng Premier League,20,2002,2.4,6,2,1,3,2,3,5,60.0,2,5,0,5,0,6,4,0,Matches
1003,Valentin Gendrey,fr FRA,DF,Lecce,it Serie A,22,2000,34.5,88,57,54,25,9,40,71,56.3,31,45,4,41,37,125,89,0,Matches
1004,Denis Genreau,au AUS,MF,Toulouse,fr Ligue 1,23,1999,7.3,35,13,16,12,7,13,31,41.9,18,16,1,15,8,43,9,0,Matches
1005,Yannick Gerhardt,de GER,MF,Wolfsburg,de Bundesliga,28,1994,20.7,29,15,10,11,8,12,30,40.0,18,26,5,21,7,36,24,0,Matches
1006,Valère Germain,fr FRA,"FW,MF",Montpellier,fr Ligue 1,32,1990,7.6,13,11,3,5,5,4,12,33.3,8,8,0,8,6,19,12,0,Matches
1007,Gerson,br BRA,MF,Marseille,fr Ligue 1,25,1997,4.6,6,4,1,4,1,3,5,60.0,2,5,0,5,2,8,4,0,Matches
1008,Ismaël Gharbi,es ESP,"MF,FW",Paris S-G,fr Ligue 1,18,2004,0.6,0,0,0,0,0,0,2,0.0,2,2,0,2,3,3,0,0,Matches
1009,Paolo Ghiglione,it ITA,DF,Cremonese,it Serie A,25,1997,7.9,16,11,10,3,3,10,23,43.5,13,9,4,5,4,20,12,0,Matches
1010,Saman Ghoddos,ir IRN,"MF,FW",Brentford,eng Premier League,28,1993,1.5,2,1,0,1,1,1,3,33.3,2,5,1,4,4,6,2,0,Matches
1011,Faouzi Ghoulam,dz ALG,DF,Angers,fr Ligue 1,31,1991,5.3,3,3,1,1,1,3,5,60.0,2,4,2,2,4,7,12,1,Matches
1012,Morgan Gibbs-White,eng ENG,"FW,MF",Wolves,eng Premier League,22,2000,2.0,3,1,3,0,0,2,4,50.0,2,2,0,2,1,4,3,0,Matches
1013,Morgan Gibbs-White,eng ENG,"MF,FW",Nott'ham Forest,eng Premier League,22,2000,33.0,26,14,7,7,12,11,33,33.3,22,23,4,19,14,40,15,0,Matches
1014,Niko Gießelmann,de GER,DF,Union Berlin,de Bundesliga,30,1991,14.5,21,11,9,9,3,13,31,41.9,18,17,5,12,9,30,28,0,Matches
1015,Samuel Gigot,fr FRA,DF,Marseille,fr Ligue 1,28,1993,20.9,46,24,22,21,3,12,15,80.0,3,24,7,17,45,91,85,1,Matches
1016,Rafał Gikiewicz,pl POL,GK,Augsburg,de Bundesliga,34,1987,23.0,2,2,2,0,0,2,3,66.7,1,0,0,0,0,2,15,5,Matches
1017,Bryan Gil,es ESP,"MF,FW",Tottenham,eng Premier League,21,2001,1.6,3,1,3,0,0,0,3,0.0,3,3,0,3,1,4,1,0,Matches
1018,Bryan Gil,es ESP,"FW,DF",Sevilla,es La Liga,21,2001,10.2,22,11,11,7,4,10,23,43.5,13,10,0,10,8,30,10,0,Matches
1019,David Gil,es ESP,GK,Cádiz,es La Liga,28,1994,4.0,0,0,0,0,0,0,0,,0,0,0,0,0,0,3,0,Matches
1020,Óscar Gil,es ESP,DF,Espanyol,es La Liga,25,1997,28.4,63,37,38,16,9,32,61,52.5,29,51,18,33,31,94,55,1,Matches
1021,Mario Gila,es ESP,DF,Lazio,it Serie A,21,2000,1.0,3,1,3,0,0,0,1,0.0,1,0,0,0,3,6,3,0,Matches
1022,Billy Gilmour,sct SCO,MF,Brighton,eng Premier League,21,2001,5.6,5,2,2,2,1,2,8,25.0,6,5,2,3,6,11,5,0,Matches
1023,Álvaro Giménez,es ESP,FW,Cádiz,es La Liga,31,1991,0.2,0,0,0,0,0,0,1,0.0,1,0,0,0,0,0,0,0,Matches
1024,Gvidas Gineitis,lt LTU,MF,Torino,it Serie A,18,2004,1.5,3,1,0,2,1,1,2,50.0,1,0,0,0,0,3,1,0,Matches
1025,Matthias Ginter,de GER,DF,Freiburg,de Bundesliga,28,1994,34.0,43,20,29,12,2,26,40,65.0,14,40,24,16,35,78,153,3,Matches
1026,Andrei Girotto,br BRA,"DF,MF",Nantes,fr Ligue 1,30,1992,35.0,122,73,71,45,6,74,132,56.1,58,55,24,31,73,195,176,1,Matches
1027,Olivier Giroud,fr FRA,FW,Milan,it Serie A,35,1986,23.8,8,5,2,4,2,2,10,20.0,8,11,3,8,3,11,23,0,Matches
1028,Serge Gnabry,de GER,"FW,MF",Bayern Munich,de Bundesliga,27,1995,21.6,35,23,11,14,10,17,43,39.5,26,24,1,23,11,46,5,1,Matches
1029,Wilfried Gnonto,it ITA,"FW,MF",Leeds United,eng Premier League,18,2003,15.0,27,17,7,15,5,10,30,33.3,20,24,1,23,5,32,7,0,Matches
1030,Ben Godfrey,eng ENG,DF,Everton,eng Premier League,24,1998,8.9,20,11,13,5,2,11,29,37.9,18,12,6,6,8,28,33,1,Matches
1031,Pierluigi Gollini,it ITA,GK,Fiorentina,it Serie A,27,1995,3.0,1,0,1,0,0,1,1,100.0,0,0,0,0,0,1,2,0,Matches
1032,Pierluigi Gollini,it ITA,GK,Napoli,it Serie A,27,1995,4.0,0,0,0,0,0,0,0,,0,0,0,0,0,0,1,0,Matches
1033,Aleksandr Golovin,ru RUS,"MF,FW",Monaco,fr Ligue 1,26,1996,27.4,62,36,19,32,11,28,72,38.9,44,28,1,27,37,99,10,0,Matches
1034,André Gomes,pt POR,MF,Lille,fr Ligue 1,29,1993,18.1,37,19,12,17,8,19,52,36.5,33,20,5,15,9,46,16,1,Matches
1035,Angel Gomes,eng ENG,MF,Lille,fr Ligue 1,21,2000,31.3,41,19,12,21,8,18,49,36.7,31,22,2,20,13,54,11,1,Matches
1036,João Gomes,br BRA,MF,Wolves,eng Premier League,21,2001,7.3,29,13,14,14,1,13,23,56.5,10,12,3,9,4,33,11,0,Matches
1037,Toti Gomes,pt POR,DF,Wolves,eng Premier League,23,1999,10.9,15,9,11,4,0,9,13,69.2,4,16,8,8,11,26,51,0,Matches
1038,Dani Gómez,es ESP,"MF,FW",Espanyol,es La Liga,24,1998,1.0,2,1,1,1,0,1,2,50.0,1,0,0,0,1,3,0,0,Matches
1039,Joe Gomez,eng ENG,DF,Liverpool,eng Premier League,25,1997,16.3,28,21,15,11,2,11,19,57.9,8,17,11,6,24,52,51,2,Matches
1040,Maxi Gómez,uy URU,FW,Valencia,es La Liga,25,1996,1.2,0,0,0,0,0,0,0,,0,0,0,0,0,0,2,0,Matches
1041,Moi Gómez,es ESP,"MF,FW",Osasuna,es La Liga,28,1994,27.3,26,17,9,14,3,15,32,46.9,17,15,3,12,10,36,5,1,Matches
1042,Papu Gómez,ar ARG,"FW,MF",Sevilla,es La Liga,34,1988,11.8,6,4,3,3,0,2,10,20.0,8,8,1,7,4,10,5,0,Matches
1043,Sergi Gómez,es ESP,DF,Espanyol,es La Liga,30,1992,26.0,29,16,20,9,0,18,22,81.8,4,33,19,14,27,56,125,1,Matches
1044,Sergio Gómez,es ESP,"DF,MF",Manchester City,eng Premier League,21,2000,3.9,9,4,6,1,2,5,8,62.5,3,5,3,2,2,11,9,1,Matches
1045,Antonio Gomis,es ESP,GK,Atlético Madrid,es La Liga,19,2003,0.1,0,0,0,0,0,0,0,,0,0,0,0,0,0,0,0,Matches
1046,Maxime Gonalons,fr FRA,MF,Clermont Foot,fr Ligue 1,33,1989,16.1,52,32,25,21,6,25,53,47.2,28,21,1,20,20,72,7,1,Matches
1047,Diego González,es ESP,DF,Elche,es La Liga,27,1995,10.6,12,7,9,3,0,7,11,63.6,4,14,12,2,7,19,50,1,Matches
1048,Édgar González,es ESP,DF,Betis,es La Liga,25,1997,19.7,28,19,18,7,3,14,27,51.9,13,12,9,3,21,49,120,0,Matches
1049,Giovanni González,uy URU,DF,Mallorca,es La Liga,27,1994,10.3,16,8,11,2,3,9,22,40.9,13,8,2,6,7,23,22,0,Matches
1050,Joan Gonzàlez,es ESP,MF,Lecce,it Serie A,20,2002,24.4,48,28,20,18,10,17,51,33.3,34,37,8,29,16,64,28,0,Matches
1051,Nicolás González,ar ARG,"FW,MF",Fiorentina,it Serie A,24,1998,15.0,17,10,3,10,4,5,16,31.3,11,14,0,14,4,21,6,0,Matches
1052,Nicolás González,es ESP,MF,Valencia,es La Liga,20,2002,15.6,27,15,11,13,3,9,25,36.0,16,21,7,14,19,46,16,0,Matches
1053,Oumar Gonzalez,cm CMR,DF,Ajaccio,fr Ligue 1,24,1998,28.6,51,28,34,13,4,23,37,62.2,14,32,11,21,52,103,82,0,Matches
1054,Roberto González,es ESP,"FW,MF",Betis,es La Liga,21,2001,0.6,0,0,0,0,0,0,1,0.0,1,0,0,0,1,1,0,0,Matches
1055,Jacek Góralski,pl POL,MF,Bochum,de Bundesliga,29,1992,1.6,6,3,3,3,0,4,6,66.7,2,4,0,4,3,9,5,0,Matches
1056,Anthony Gordon,eng ENG,"FW,MF",Newcastle Utd,eng Premier League,21,2001,5.4,14,12,5,7,2,9,20,45.0,11,9,1,8,2,16,1,1,Matches
1057,Anthony Gordon,eng ENG,FW,Everton,eng Premier League,21,2001,12.2,34,22,17,10,7,8,24,33.3,16,19,0,19,4,38,11,0,Matches
1058,Leon Goretzka,de GER,MF,Bayern Munich,de Bundesliga,27,1995,19.2,43,24,21,16,6,27,48,56.3,21,40,3,37,30,73,32,0,Matches
1059,Andoni Gorosabel,es ESP,DF,Real Sociedad,es La Liga,25,1996,19.0,41,25,23,9,9,26,43,60.5,17,21,2,19,17,58,23,0,Matches
1060,Robin Gosens,de GER,DF,Inter,it Serie A,28,1994,13.2,34,18,15,10,9,15,25,60.0,10,16,2,14,23,57,15,0,Matches
1061,Mario Götze,de GER,MF,Eint Frankfurt,de Bundesliga,30,1992,30.4,42,25,13,22,7,14,47,29.8,33,25,0,25,13,55,12,0,Matches
1062,Amine Gouiri,dz ALG,"FW,MF",Nice,fr Ligue 1,22,2000,2.5,1,1,1,0,0,0,1,0.0,1,1,0,1,0,1,3,0,Matches
1063,Amine Gouiri,dz ALG,"FW,MF",Rennes,fr Ligue 1,22,2000,28.0,42,25,14,16,12,14,33,42.4,19,21,0,21,12,54,10,0,Matches
1064,Jeffrey Gouweleeuw,nl NED,DF,Augsburg,de Bundesliga,31,1991,31.1,42,27,19,17,6,24,49,49.0,25,41,23,18,50,92,141,2,Matches
1065,Jonathan Gradit,fr FRA,DF,Lens,fr Ligue 1,29,1992,31.4,62,40,30,25,7,31,53,58.5,22,40,26,14,38,100,83,0,Matches
1066,José Gragera,es ESP,"MF,DF",Espanyol,es La Liga,21,2000,5.1,19,9,11,6,2,6,11,54.5,5,10,4,6,7,26,18,0,Matches
1067,Alberto Grassi,it ITA,MF,Empoli,it Serie A,27,1995,13.3,26,21,13,13,0,15,24,62.5,9,23,12,11,27,53,45,0,Matches
1068,Ryan Gravenberch,nl NED,MF,Bayern Munich,de Bundesliga,20,2002,6.4,17,8,4,10,3,7,13,53.8,6,9,1,8,9,26,10,0,Matches
1069,Andrew Gravillon,gp GLP,DF,Torino,it Serie A,24,1998,3.5,3,3,0,3,0,0,0,,0,4,2,2,9,12,16,0,Matches
1070,Andrew Gravillon,gp GLP,DF,Reims,fr Ligue 1,24,1998,11.5,16,8,9,6,1,8,13,61.5,5,18,9,9,21,37,36,0,Matches
1071,Demarai Gray,jm JAM,"FW,MF",Everton,eng Premier League,26,1996,27.9,33,24,9,14,10,17,31,54.8,14,23,3,20,13,46,18,0,Matches
1072,Adrian Grbić,at AUT,"MF,FW",Lorient,fr Ligue 1,25,1996,0.3,0,0,0,0,0,0,1,0.0,1,3,0,3,0,0,0,0,Matches
1073,Ivo Grbić,hr CRO,GK,Atlético Madrid,es La Liga,26,1996,10.2,0,0,0,0,0,0,0,,0,0,0,0,0,0,9,1,Matches
1074,Jack Grealish,eng ENG,FW,Manchester City,eng Premier League,26,1995,22.8,25,16,10,12,3,13,23,56.5,10,17,3,14,7,32,9,0,Matches
1075,Sam Greenwood,eng ENG,"MF,FW",Leeds United,eng Premier League,20,2002,4.7,15,7,7,8,0,8,21,38.1,13,10,2,8,1,16,1,0,Matches
1076,Michael Gregoritsch,at AUT,FW,Freiburg,de Bundesliga,28,1994,23.9,19,12,6,9,4,3,21,14.3,18,23,4,19,5,24,10,0,Matches
1077,Dominik Greif,sk SVK,GK,Mallorca,es La Liga,25,1997,1.0,0,0,0,0,0,0,0,,0,0,0,0,0,0,0,0,Matches
1078,Leo Greiml,at AUT,DF,Schalke 04,de Bundesliga,21,2001,4.0,10,5,4,5,1,5,12,41.7,7,7,3,4,3,13,16,0,Matches
1079,Clément Grenier,fr FRA,MF,Mallorca,es La Liga,31,1991,8.0,20,8,6,12,2,10,20,50.0,10,9,1,8,6,26,7,0,Matches
1080,Antoine Griezmann,fr FRA,"FW,MF",Atlético Madrid,es La Liga,31,1991,31.8,49,34,15,23,11,20,66,30.3,46,34,3,31,24,73,31,0,Matches
1081,Vincenzo Grifo,it ITA,"MF,FW",Freiburg,de Bundesliga,29,1993,26.8,29,16,6,15,8,13,31,41.9,18,18,1,17,19,48,19,0,Matches
1082,Lennart Grill,de GER,GK,Union Berlin,de Bundesliga,23,1999,5.0,0,0,0,0,0,0,1,0.0,1,0,0,0,0,0,1,1,Matches
1083,Christian Groß,de GER,MF,Werder Bremen,de Bundesliga,33,1989,21.0,56,25,20,34,2,29,60,48.3,31,20,5,15,23,79,38,1,Matches
1084,Pascal Groß,de GER,"MF,DF",Brighton,eng Premier League,31,1991,36.0,59,38,23,27,9,25,55,45.5,30,32,10,22,13,72,21,1,Matches
1085,Brajan Gruda,de GER,MF,Mainz 05,de Bundesliga,18,2004,0.0,0,0,0,0,0,0,0,,0,0,0,0,0,0,0,0,Matches
1086,Ilia Gruev,bg BUL,MF,Werder Bremen,de Bundesliga,22,2000,17.6,44,27,16,25,3,18,31,58.1,13,23,6,17,22,66,21,1,Matches
1087,Carlos Gruezo,ec ECU,MF,Augsburg,de Bundesliga,27,1995,10.7,21,12,12,9,0,9,16,56.3,7,13,4,9,10,31,15,0,Matches
1088,Vicente Guaita,es ESP,GK,Crystal Palace,eng Premier League,35,1987,27.0,0,0,0,0,0,0,0,,0,0,0,0,0,0,9,1,Matches
1089,Andrés Guardado,mx MEX,MF,Betis,es La Liga,35,1986,15.3,41,25,17,20,4,18,43,41.9,25,14,5,9,23,64,29,0,Matches
1090,Sergi Guardiola,es ESP,FW,Valladolid,es La Liga,31,1991,5.6,12,7,6,5,1,2,4,50.0,2,6,0,6,2,14,7,0,Matches
1091,Sergi Guardiola,es ESP,FW,Cádiz,es La Liga,31,1991,12.9,9,7,0,6,3,3,12,25.0,9,5,0,5,3,12,7,0,Matches
1092,Nemanja Gudelj,rs SRB,"DF,MF",Sevilla,es La Liga,30,1991,30.9,43,33,22,18,3,20,33,60.6,13,39,29,10,34,77,102,1,Matches
1093,Gabriel Gudmundsson,se SWE,"DF,FW",Lille,fr Ligue 1,23,1999,9.3,19,11,7,10,2,12,22,54.5,10,11,2,9,10,29,20,0,Matches
1094,Gonçalo Guedes,pt POR,"FW,MF",Wolves,eng Premier League,25,1996,7.9,8,6,4,3,1,5,8,62.5,3,4,0,4,1,9,2,0,Matches
1095,Axel Gueguin,fr FRA,"FW,MF",Montpellier,fr Ligue 1,17,2005,0.3,0,0,0,0,0,0,0,,0,1,0,1,0,0,0,0,Matches
1096,Marc Guéhi,eng ENG,DF,Crystal Palace,eng Premier League,22,2000,37.0,52,27,39,11,2,26,42,61.9,16,45,24,21,45,97,134,3,Matches
1097,Mattéo Guendouzi,fr FRA,MF,Marseille,fr Ligue 1,23,1999,23.4,39,18,9,21,9,14,38,36.8,24,12,5,7,21,60,18,0,Matches
1098,Javier Guerra,es ESP,MF,Valencia,es La Liga,19,2003,6.7,16,13,7,4,5,9,20,45.0,11,8,1,7,11,27,9,0,Matches
1099,Raphaël Guerreiro,pt POR,"DF,MF",Dortmund,de Bundesliga,28,1993,25.4,36,20,13,15,8,21,34,61.8,13,21,2,19,36,72,23,0,Matches
1100,Axel Guessand,fr FRA,DF,Udinese,it Serie A,17,2004,0.9,2,1,2,0,0,1,2,50.0,1,1,0,1,2,4,3,0,Matches
1101,Evann Guessand,fr FRA,"FW,MF",Nantes,fr Ligue 1,21,2001,14.0,24,16,8,13,3,6,12,50.0,6,17,1,16,9,33,6,0,Matches
1102,Ander Guevara,es ESP,MF,Real Sociedad,es La Liga,25,1997,2.5,5,2,2,2,1,1,4,25.0,3,6,1,5,2,7,3,0,Matches
1103,Pape Gueye,sn SEN,MF,Sevilla,es La Liga,23,1999,13.0,37,22,13,21,3,16,33,48.5,17,21,5,16,22,59,10,0,Matches
1104,Pape Gueye,sn SEN,"MF,DF",Marseille,fr Ligue 1,23,1999,5.5,18,7,10,7,1,7,15,46.7,8,9,2,7,9,27,2,0,Matches
1105,Josuha Guilavogui,fr FRA,"DF,MF",Wolfsburg,de Bundesliga,31,1990,13.1,18,11,7,10,1,6,17,35.3,11,19,13,6,23,41,52,0,Matches
1106,Frederic Guilbert,fr FRA,DF,Strasbourg,fr Ligue 1,27,1994,16.2,47,29,18,23,6,25,43,58.1,18,24,3,21,43,90,33,1,Matches
1107,Hugo Guillamón,es ESP,MF,Valencia,es La Liga,22,2000,18.1,20,12,10,8,2,8,24,33.3,16,14,2,12,19,39,30,2,Matches
1108,Bruno Guimarães,br BRA,MF,Newcastle Utd,eng Premier League,24,1997,30.3,78,40,27,46,5,38,65,58.5,27,28,4,24,36,114,22,1,Matches
1109,Serhou Guirassy,gn GUI,MF,Rennes,fr Ligue 1,26,1996,0.3,0,0,0,0,0,0,0,,0,0,0,0,0,0,0,0,Matches
1110,Serhou Guirassy,gn GUI,FW,Stuttgart,de Bundesliga,26,1996,18.3,4,1,2,2,0,1,2,50.0,1,7,2,5,0,4,14,0,Matches
1111,Rafik Guitane,fr FRA,FW,Reims,fr Ligue 1,23,1999,0.0,0,0,0,0,0,0,0,,0,0,0,0,0,0,1,0,Matches
1112,Péter Gulácsi,hu HUN,GK,RB Leipzig,de Bundesliga,32,1990,6.0,0,0,0,0,0,0,0,,0,0,0,0,0,0,2,0,Matches
1113,Manuel Gulde,de GER,DF,Freiburg,de Bundesliga,31,1991,7.1,14,8,10,4,0,2,4,50.0,2,5,1,4,19,33,25,0,Matches
1114,Gerard Gumbau,es ESP,MF,Elche,es La Liga,27,1994,30.4,44,25,17,23,4,18,51,35.3,33,32,8,24,28,72,40,0,Matches
1115,Robert Gumny,pl POL,DF,Augsburg,de Bundesliga,24,1998,22.4,34,24,13,15,6,11,27,40.7,16,21,7,14,26,60,62,1,Matches
1116,İlkay Gündoğan,de GER,MF,Manchester City,eng Premier League,31,1990,26.1,30,18,7,13,10,12,34,35.3,22,18,3,15,20,50,13,0,Matches
1117,Christian Günter,de GER,"DF,MF",Freiburg,de Bundesliga,29,1993,30.5,29,21,18,9,2,13,43,30.2,30,22,4,18,16,45,41,0,Matches
1118,Koray Günter,de GER,DF,Hellas Verona,it Serie A,27,1994,11.1,10,6,1,8,1,4,7,57.1,3,24,15,9,30,40,46,0,Matches
1119,Koray Günter,de GER,DF,Sampdoria,it Serie A,27,1994,8.6,10,8,6,4,0,6,9,66.7,3,10,5,5,11,21,46,0,Matches
1120,Gorka Guruzeta,es ESP,FW,Athletic Club,es La Liga,25,1996,15.8,24,20,6,12,6,11,24,45.8,13,23,2,21,4,28,8,0,Matches
1121,Malo Gusto,fr FRA,DF,Lyon,fr Ligue 1,19,2003,17.7,42,26,23,11,8,21,43,48.8,22,22,5,17,28,70,23,1,Matches
1122,Raúl Guti,es ESP,MF,Elche,es La Liga,25,1996,12.4,18,12,8,9,1,8,18,44.4,10,10,3,7,8,26,6,0,Matches
1123,Miguel Gutiérrez,es ESP,DF,Girona,es La Liga,21,2001,26.6,41,23,23,13,5,23,37,62.2,14,23,5,18,18,59,42,1,Matches
1124,Joško Gvardiol,hr CRO,DF,RB Leipzig,de Bundesliga,20,2002,24.1,23,17,15,8,0,9,22,40.9,13,34,17,17,34,57,76,1,Matches
1125,Darko Gyabi,eng ENG,FW,Leeds United,eng Premier League,18,2004,0.1,2,2,1,1,0,0,0,,0,2,0,2,0,2,0,0,Matches
1126,Emmanuel Gyasi,gh GHA,"FW,DF",Spezia,it Serie A,28,1994,31.2,24,15,11,10,3,9,36,25.0,27,24,6,18,8,32,26,0,Matches
1127,Norbert Gyömbér,sk SVK,DF,Salernitana,it Serie A,30,1992,19.3,32,23,25,6,1,16,24,66.7,8,33,22,11,35,67,92,0,Matches
1128,Christian Gytkjær,dk DEN,"FW,MF",Monza,it Serie A,32,1990,6.2,6,2,1,4,1,2,5,40.0,3,6,1,5,0,6,2,0,Matches
1129,Erling Haaland,no NOR,FW,Manchester City,eng Premier League,22,2000,30.8,3,2,0,2,1,1,5,20.0,4,12,4,8,3,6,14,0,Matches
1130,Nicolas Haas,ch SUI,MF,Empoli,it Serie A,26,1996,12.8,27,13,16,6,5,12,24,50.0,12,16,4,12,8,35,27,0,Matches
1131,Janik Haberer,de GER,MF,Union Berlin,de Bundesliga,28,1994,24.3,29,17,8,18,3,17,48,35.4,31,35,2,33,14,43,25,0,Matches
1132,Alexander Hack,de GER,DF,Mainz 05,de Bundesliga,28,1993,12.6,30,18,21,9,0,19,33,57.6,14,18,5,13,24,54,45,1,Matches
1133,Munir El Haddadi,ma MAR,"MF,FW",Getafe,es La Liga,26,1995,12.8,12,7,3,7,2,2,10,20.0,8,23,2,21,9,21,7,0,Matches
1134,Jaouen Hadjam,dz ALG,DF,Nantes,fr Ligue 1,19,2003,8.9,27,21,13,9,5,16,25,64.0,9,10,3,7,12,39,12,0,Matches
1135,Dennis Hadzikadunic,ba BIH,DF,Mallorca,es La Liga,24,1998,6.8,9,6,4,5,0,4,4,100.0,0,5,4,1,3,12,27,0,Matches
1136,André Hahn,de GER,"FW,MF",Augsburg,de Bundesliga,31,1990,4.3,9,5,4,4,1,8,12,66.7,4,9,2,7,4,13,14,0,Matches
1137,Amadou Haidara,ml MLI,MF,RB Leipzig,de Bundesliga,24,1998,15.9,25,11,15,10,0,13,34,38.2,21,26,6,20,26,51,20,0,Matches
1138,Massadio Haïdara,ml MLI,"DF,MF",Lens,fr Ligue 1,29,1992,18.6,24,16,9,9,6,12,24,50.0,12,26,9,17,36,60,39,1,Matches
1139,Achraf Hakimi,ma MAR,"DF,MF",Paris S-G,fr Ligue 1,23,1998,22.8,54,34,19,20,15,31,59,52.5,28,34,2,32,16,70,19,0,Matches
1140,Lewis Hall,eng ENG,DF,Chelsea,eng Premier League,17,2004,7.3,23,12,19,4,0,15,22,68.2,7,8,0,8,11,34,11,1,Matches
1141,Sébastien Haller,ci CIV,FW,Dortmund,de Bundesliga,28,1994,13.6,5,4,2,1,2,0,4,0.0,4,8,0,8,1,6,10,0,Matches
1142,Marcel Halstenberg,de GER,DF,RB Leipzig,de Bundesliga,30,1991,17.3,40,21,20,15,5,23,41,56.1,18,22,1,21,21,61,29,0,Matches
1143,Mathis Hamdi,fr FRA,DF,Troyes,fr Ligue 1,18,2003,0.8,0,0,0,0,0,0,1,0.0,1,0,0,0,1,1,1,0,Matches
1144,Ben Hamed Touré,ci CIV,FW,Ajaccio,fr Ligue 1,18,2003,2.3,4,4,2,2,0,1,5,20.0,4,2,0,2,1,5,4,0,Matches
1145,Romain Hamouma,fr FRA,"FW,MF",Ajaccio,fr Ligue 1,35,1987,12.0,8,3,3,3,2,3,6,50.0,3,8,0,8,2,10,2,0,Matches
1146,Saïd Hamulic,ba BIH,FW,Toulouse,fr Ligue 1,21,2000,1.2,0,0,0,0,0,0,0,,0,0,0,0,0,0,0,0,Matches
1147,Andreas Hanche-Olsen,no NOR,DF,Mainz 05,de Bundesliga,25,1997,16.6,35,23,24,7,4,22,39,56.4,17,16,8,8,33,68,77,2,Matches
1148,Samir Handanović,si SVN,GK,Inter,it Serie A,38,1984,13.7,0,0,0,0,0,0,0,,0,0,0,0,0,0,5,0,Matches
1149,Genki Haraguchi,jp JPN,MF,Stuttgart,de Bundesliga,31,1991,8.3,16,7,7,7,2,4,16,25.0,12,13,2,11,8,24,6,0,Matches
1150,Genki Haraguchi,jp JPN,MF,Union Berlin,de Bundesliga,31,1991,5.5,12,8,1,10,1,3,9,33.3,6,7,1,6,3,15,9,0,Matches
1151,Amine Harit,ma MAR,"MF,FW",Marseille,fr Ligue 1,25,1997,5.7,6,4,0,3,3,3,8,37.5,5,4,1,3,4,10,6,0,Matches
1152,Luke Harris,wls WAL,"MF,FW",Fulham,eng Premier League,17,2005,0.1,0,0,0,0,0,0,0,,0,0,0,0,0,0,0,0,Matches
1153,Jack Harrison,eng ENG,"FW,MF",Leeds United,eng Premier League,25,1996,30.1,41,17,5,15,21,12,52,23.1,40,47,2,45,22,63,25,0,Matches
1154,Abdou Harroui,nl NED,MF,Sassuolo,it Serie A,24,1998,7.2,17,6,6,7,4,2,7,28.6,5,6,1,5,2,19,10,0,Matches
1155,Makoto Hasebe,jp JPN,DF,Eint Frankfurt,de Bundesliga,38,1984,14.5,18,12,16,2,0,7,22,31.8,15,22,9,13,17,35,45,0,Matches
1156,Haissem Hassan,fr FRA,"FW,MF",Villarreal,es La Liga,20,2002,0.6,0,0,0,0,0,0,2,0.0,2,0,0,0,1,1,0,0,Matches
1157,Hans Hateboer,nl NED,DF,Atalanta,it Serie A,28,1994,15.5,21,13,11,8,2,11,27,40.7,16,23,4,19,12,33,25,0,Matches
1158,Kai Havertz,de GER,"FW,MF",Chelsea,eng Premier League,23,1999,28.5,34,16,4,20,10,10,30,33.3,20,28,0,28,7,41,41,0,Matches
1159,Eden Hazard,be BEL,FW,Real Madrid,es La Liga,31,1991,2.2,0,0,0,0,0,0,2,0.0,2,1,0,1,1,1,0,0,Matches
1160,Thorgan Hazard,be BEL,"FW,DF",Dortmund,de Bundesliga,29,1993,5.2,17,6,5,11,1,12,17,70.6,5,6,0,6,5,22,5,0,Matches
1161,Rhys Healey,wls WAL,FW,Toulouse,fr Ligue 1,27,1994,0.7,0,0,0,0,0,0,0,,0,0,0,0,0,0,0,0,Matches
1162,Jan Paul van Hecke,nl NED,DF,Brighton,eng Premier League,22,2000,3.3,8,6,3,4,1,5,5,100.0,0,8,5,3,6,14,9,0,Matches
1163,Jonas Hector,de GER,DF,Köln,de Bundesliga,32,1990,31.4,112,66,59,43,10,66,113,58.4,47,61,9,52,39,151,74,1,Matches
1164,Hwang Hee-chan,kr KOR,"FW,MF",Wolves,eng Premier League,26,1996,12.6,20,9,7,8,5,6,20,30.0,14,18,2,16,5,25,5,0,Matches
1165,Gauthier Hein,fr FRA,"MF,FW",Auxerre,fr Ligue 1,25,1996,20.8,27,20,13,11,3,18,48,37.5,30,10,0,10,6,33,10,0,Matches
1166,Dominique Heintz,de GER,DF,Bochum,de Bundesliga,28,1993,8.8,13,9,5,7,1,6,17,35.3,11,11,7,4,12,25,34,0,Matches
1167,Dean Henderson,eng ENG,GK,Nott'ham Forest,eng Premier League,25,1997,18.0,0,0,0,0,0,0,0,,0,0,0,0,0,0,12,1,Matches
1168,Jordan Henderson,eng ENG,MF,Liverpool,eng Premier League,32,1990,23.0,32,23,10,18,4,15,36,41.7,21,21,3,18,21,53,16,1,Matches
1169,Liam Henderson,sct SCO,MF,Empoli,it Serie A,26,1996,11.2,13,10,6,5,2,4,21,19.0,17,10,2,8,10,23,10,0,Matches
1170,Jack Hendry,sct SCO,DF,Cremonese,it Serie A,27,1995,2.4,0,0,0,0,0,0,1,0.0,1,2,1,1,1,1,7,0,Matches
1171,Wayne Hennessey,wls WAL,GK,Nott'ham Forest,eng Premier League,35,1987,3.0,1,0,1,0,0,1,1,100.0,0,0,0,0,0,1,2,0,Matches
1172,Benjamin Henrichs,de GER,"DF,MF",RB Leipzig,de Bundesliga,25,1997,24.3,73,46,41,29,3,43,66,65.2,23,48,4,44,35,108,46,0,Matches
1173,Henrique,br BRA,"DF,FW",Lyon,fr Ligue 1,28,1994,4.0,9,4,3,2,4,6,13,46.2,7,3,1,2,5,14,8,0,Matches
1174,Luiz Henrique,br BRA,FW,Betis,es La Liga,21,2001,20.1,48,34,27,15,6,20,44,45.5,24,22,0,22,14,62,17,0,Matches
1175,Matheus Henrique,br BRA,MF,Sassuolo,it Serie A,24,1997,21.6,26,12,9,11,6,12,24,50.0,12,15,4,11,12,38,10,0,Matches
1176,Rico Henry,eng ENG,DF,Brentford,eng Premier League,25,1997,36.0,57,31,20,28,9,22,41,53.7,19,29,8,21,30,87,84,1,Matches
1177,Thomas Henry,fr FRA,FW,Hellas Verona,it Serie A,27,1994,11.4,5,3,1,1,3,1,5,20.0,4,6,2,4,0,5,14,0,Matches
1178,Christophe Hérelle,mq MTQ,DF,Brest,fr Ligue 1,29,1992,11.8,10,4,7,2,1,4,13,30.8,9,16,11,5,20,30,48,0,Matches
1179,Mario Hermoso,es ESP,DF,Atlético Madrid,es La Liga,27,1995,23.4,22,15,14,6,2,9,30,30.0,21,19,9,10,19,41,85,1,Matches
1180,Javi Hernández ,es ESP,DF,Girona,es La Liga,24,1998,12.4,21,12,12,7,2,13,21,61.9,8,10,5,5,7,28,38,0,Matches
1181,Aridane Hernández,es ESP,DF,Osasuna,es La Liga,33,1989,19.9,21,15,17,4,0,12,25,48.0,13,34,21,13,28,49,96,1,Matches
1182,Lucas Hernández,fr FRA,DF,Bayern Munich,de Bundesliga,26,1996,5.3,6,4,3,3,0,5,6,83.3,1,2,1,1,5,11,7,0,Matches
1183,Luis Hernández,es ESP,DF,Cádiz,es La Liga,33,1989,35.0,33,21,25,7,1,22,36,61.1,14,31,24,7,31,64,145,0,Matches
1184,Mario Hernández,es ESP,DF,Rayo Vallecano,es La Liga,23,1999,1.1,3,2,2,1,0,3,7,42.9,4,2,0,2,2,5,0,0,Matches
1185,Theo Hernández,fr FRA,DF,Milan,it Serie A,24,1997,30.8,43,24,27,15,1,22,38,57.9,16,34,7,27,21,64,35,1,Matches
1186,Jorge Herrando,es ESP,DF,Osasuna,es La Liga,21,2001,0.3,0,0,0,0,0,0,0,,0,1,0,1,0,0,3,0,Matches
1187,Ander Herrera,es ESP,MF,Athletic Club,es La Liga,32,1989,7.7,18,10,8,7,3,6,18,33.3,12,12,3,9,11,29,12,0,Matches
1188,Sergio Herrera,es ESP,GK,Osasuna,es La Liga,29,1993,17.0,2,0,2,0,0,2,2,100.0,0,1,0,1,1,3,6,2,Matches
1189,Yangel Herrera,ve VEN,"MF,FW",Girona,es La Liga,24,1998,10.7,26,9,9,14,3,6,15,40.0,9,14,1,13,4,30,12,0,Matches
1190,Patrick Herrmann,de GER,"FW,MF",Gladbach,de Bundesliga,31,1991,1.8,6,2,4,1,1,2,4,50.0,2,2,0,2,2,8,1,0,Matches
1191,Son Heung-min,kr KOR,"MF,FW",Tottenham,eng Premier League,30,1992,32.1,24,12,7,8,9,9,30,30.0,21,23,2,21,13,37,6,0,Matches
1192,Aaron Hickey,sct SCO,DF,Brentford,eng Premier League,20,2002,21.3,38,26,27,11,0,18,32,56.3,14,18,7,11,17,55,32,1,Matches
1193,Isak Hien,se SWE,DF,Hellas Verona,it Serie A,23,1999,29.0,73,36,54,19,0,38,61,62.3,23,40,17,23,31,104,92,1,Matches
1194,Omar El Hilali,ma MAR,"DF,MF",Espanyol,es La Liga,18,2003,1.0,3,2,3,0,0,1,2,50.0,1,1,0,1,1,4,6,0,Matches
1195,Piero Hincapié,ec ECU,"DF,MF",Leverkusen,de Bundesliga,20,2002,27.3,51,34,28,20,3,25,38,65.8,13,41,20,21,31,82,83,1,Matches
1196,Jack Hinshelwood,eng ENG,FW,Brighton,eng Premier League,17,2005,0.0,1,0,1,0,0,0,0,,0,0,0,0,0,1,0,0,Matches
1197,Morten Hjulmand,dk DEN,MF,Lecce,it Serie A,23,1999,32.9,90,52,49,40,1,37,67,55.2,30,43,11,32,72,162,54,0,Matches
1198,Adam Hložek,cz CZE,"FW,MF",Leverkusen,de Bundesliga,20,2002,14.3,9,4,4,3,2,3,9,33.3,6,9,2,7,6,15,9,0,Matches
1199,Joseph Hodge,ie IRL,MF,Wolves,eng Premier League,19,2002,1.9,5,2,1,3,1,3,4,75.0,1,5,0,5,0,5,2,1,Matches
1200,Nicolas Höfler,de GER,MF,Freiburg,de Bundesliga,32,1990,31.3,66,35,28,35,3,27,61,44.3,34,40,13,27,58,124,49,0,Matches
1201,Jonas Hofmann,de GER,"FW,MF",Gladbach,de Bundesliga,30,1992,29.8,31,16,17,8,6,15,52,28.8,37,36,2,34,16,47,21,0,Matches
1202,Philipp Hofmann,de GER,FW,Bochum,de Bundesliga,29,1993,29.2,18,11,0,13,5,5,12,41.7,7,20,8,12,6,24,48,0,Matches
1203,Rob Holding,eng ENG,DF,Arsenal,eng Premier League,26,1995,6.3,8,5,4,4,0,3,6,50.0,3,6,5,1,3,11,27,1,Matches
1204,Lucas Höler,de GER,"FW,MF",Freiburg,de Bundesliga,28,1994,16.7,19,14,5,7,7,6,22,27.3,16,22,5,17,10,29,17,0,Matches
1205,Mason Holgate,eng ENG,DF,Everton,eng Premier League,25,1996,5.6,11,7,8,3,0,3,11,27.3,8,7,3,4,7,18,28,0,Matches
1206,Emil Holm,se SWE,DF,Spezia,it Serie A,22,2000,15.5,26,15,13,8,5,16,31,51.6,15,21,6,15,9,35,41,0,Matches
1207,Noah Holm,no NOR,"FW,MF",Reims,fr Ligue 1,21,2001,2.2,6,4,2,2,2,2,5,40.0,3,0,0,0,0,6,5,0,Matches
1208,Gerrit Holtmann,ph PHI,"FW,MF",Bochum,de Bundesliga,27,1995,10.5,14,7,6,7,1,12,21,57.1,9,15,1,14,2,16,4,0,Matches
1209,Martin Hongla,cm CMR,MF,Hellas Verona,it Serie A,24,1998,5.8,8,5,4,4,0,5,5,100.0,0,7,1,6,6,14,9,0,Matches
1210,Martin Hongla,cm CMR,"DF,MF",Valladolid,es La Liga,24,1998,14.5,18,13,13,5,0,11,21,52.4,10,15,12,3,8,26,46,1,Matches
1211,Franck Honorat,fr FRA,"FW,MF",Brest,fr Ligue 1,25,1996,28.2,41,29,20,8,13,19,34,55.9,15,22,2,20,21,62,18,0,Matches
1212,Jannes Horn,de GER,"DF,FW",Bochum,de Bundesliga,25,1997,0.7,2,1,1,1,0,1,1,100.0,0,1,0,1,3,5,2,0,Matches
1213,Cédric Hountondji,bj BEN,DF,Angers,fr Ligue 1,28,1994,34.4,50,36,31,17,2,19,29,65.5,10,44,22,22,59,109,132,1,Matches
1214,Ilyes Housni,fr FRA,FW,Paris S-G,fr Ligue 1,17,2005,0.1,1,1,1,0,0,1,1,100.0,0,0,0,0,0,1,0,0,Matches
1215,Lukáš Hrádecký,fi FIN,GK,Leverkusen,de Bundesliga,32,1989,33.0,0,0,0,0,0,0,0,,0,0,0,0,0,0,3,3,Matches
1216,Petko Hristov,bg BUL,DF,Spezia,it Serie A,23,1999,4.1,6,4,2,4,0,5,8,62.5,3,4,2,2,4,10,12,0,Matches
1217,Ajdin Hrustic,au AUS,MF,Hellas Verona,it Serie A,26,1996,2.5,2,1,1,1,0,1,2,50.0,1,2,0,2,0,2,2,1,Matches
1218,Timo Hübers,de GER,DF,Köln,de Bundesliga,26,1996,28.4,43,28,35,8,0,24,52,46.2,28,27,13,14,58,101,153,0,Matches
1219,Callum Hudson-Odoi,eng ENG,"FW,MF",Leverkusen,de Bundesliga,21,2000,6.7,5,3,4,0,1,1,1,100.0,0,0,0,0,2,7,4,0,Matches
1220,Will Hughes,eng ENG,MF,Crystal Palace,eng Premier League,27,1995,9.4,29,16,11,16,2,11,20,55.0,9,16,7,9,16,45,9,0,Matches
1221,Mats Hummels,de GER,DF,Dortmund,de Bundesliga,33,1988,22.4,62,34,38,22,2,32,55,58.2,23,30,16,14,33,95,100,1,Matches
1222,Adrien Hunou,fr FRA,"MF,FW",Angers,fr Ligue 1,28,1994,24.8,39,20,17,16,6,16,45,35.6,29,35,0,35,7,46,7,0,Matches
1223,Denis Huseinbasic,ba BIH,"MF,FW",Köln,de Bundesliga,21,2001,8.8,23,9,8,11,4,10,25,40.0,15,16,2,14,4,27,5,0,Matches
1224,Omari Hutchinson,eng ENG,FW,Chelsea,eng Premier League,18,2003,0.3,0,0,0,0,0,0,0,,0,0,0,0,1,1,0,0,Matches
1225,Elseid Hysaj,al ALB,DF,Lazio,it Serie A,28,1994,22.2,39,23,24,11,4,23,41,56.1,18,31,7,24,20,59,42,0,Matches
1226,Pierre Højbjerg,dk DEN,MF,Tottenham,eng Premier League,26,1995,34.8,56,30,28,22,6,26,67,38.8,41,46,17,29,49,105,64,1,Matches
1227,Rasmus Højlund,dk DEN,FW,Atalanta,it Serie A,19,2003,20.4,4,3,0,2,2,1,6,16.7,5,9,1,8,1,5,5,0,Matches
1228,Iago,br BRA,"DF,MF",Augsburg,de Bundesliga,25,1997,17.8,34,16,20,10,4,11,29,37.9,18,18,5,13,17,51,53,0,Matches
1229,Pablo Ibáñez,es ESP,MF,Osasuna,es La Liga,23,1998,11.8,29,13,7,17,5,12,35,34.3,23,19,2,17,8,37,24,0,Matches
1230,Roger Ibanez,br BRA,DF,Roma,it Serie A,23,1998,31.1,67,33,38,26,3,32,48,66.7,16,30,11,19,66,133,95,2,Matches
1231,Arijon Ibrahimović,de GER,MF,Bayern Munich,de Bundesliga,16,2005,0.2,1,1,1,0,0,0,0,,0,0,0,0,0,1,0,0,Matches
1232,Zlatan Ibrahimović,se SWE,FW,Milan,it Serie A,40,1981,1.6,0,0,0,0,0,0,0,,0,1,1,0,0,0,2,0,Matches
1233,Mounaim El Idrissy,fr FRA,FW,Ajaccio,fr Ligue 1,23,1999,27.7,32,19,5,20,7,10,36,27.8,26,22,0,22,13,45,20,0,Matches
1234,Antonio Iervolino,it ITA,MF,Salernitana,it Serie A,19,2003,0.1,0,0,0,0,0,0,1,0.0,1,0,0,0,0,0,0,0,Matches
1235,Iglesias,es ESP,"DF,MF",Getafe,es La Liga,24,1998,23.8,61,35,40,18,3,33,65,50.8,32,40,5,35,21,82,91,1,Matches
1236,Borja Iglesias,es ESP,FW,Betis,es La Liga,29,1993,26.3,8,4,3,3,2,2,13,15.4,11,9,1,8,1,9,17,0,Matches
1237,Igor,br BRA,DF,Fiorentina,it Serie A,24,1998,22.9,43,29,21,18,4,20,27,74.1,7,33,14,19,25,68,56,2,Matches
1238,Kelechi Iheanacho,ng NGA,"FW,MF",Leicester City,eng Premier League,25,1996,12.5,7,2,0,3,4,3,10,30.0,7,9,1,8,0,7,8,0,Matches
1239,Jonathan Ikone,fr FRA,FW,Fiorentina,it Serie A,24,1998,22.3,16,8,5,6,5,5,14,35.7,9,18,1,17,4,20,3,0,Matches
1240,Ivan Ilić,rs SRB,MF,Hellas Verona,it Serie A,21,2001,9.5,16,10,9,7,0,6,11,54.5,5,10,1,9,8,24,14,0,Matches
1241,Ivan Ilić,rs SRB,MF,Torino,it Serie A,21,2001,13.1,18,7,6,11,1,10,20,50.0,10,12,3,9,5,23,10,0,Matches
1242,Rareş Ilie,ro ROU,"MF,FW",Nice,fr Ligue 1,19,2003,1.6,3,3,0,1,2,2,4,50.0,2,2,0,2,1,4,1,0,Matches
1243,Samuel Iling-Junior,eng ENG,"DF,FW",Juventus,it Serie A,18,2003,3.5,7,2,3,1,3,4,9,44.4,5,5,1,4,2,9,6,0,Matches
1244,Emirhan İlkhan,tr TUR,MF,Torino,it Serie A,18,2004,1.0,1,1,0,1,0,1,1,100.0,0,3,1,2,2,3,2,0,Matches
1245,Emirhan İlkhan,tr TUR,MF,Sampdoria,it Serie A,18,2004,1.3,6,3,2,2,2,2,3,66.7,1,5,1,4,0,6,3,0,Matches
1246,Asier Illarramendi,es ESP,MF,Real Sociedad,es La Liga,32,1990,12.0,36,18,10,22,4,16,44,36.4,28,27,8,19,18,54,20,0,Matches
1247,Ciro Immobile,it ITA,FW,Lazio,it Serie A,32,1990,24.7,11,5,4,4,3,6,9,66.7,3,10,2,8,1,12,14,0,Matches
1248,Danny Ings,eng ENG,FW,West Ham,eng Premier League,30,1992,8.6,9,8,0,4,5,5,14,35.7,9,8,2,6,3,12,5,0,Matches
1249,Danny Ings,eng ENG,FW,Aston Villa,eng Premier League,30,1992,9.2,10,5,1,6,3,1,6,16.7,5,12,1,11,1,11,11,0,Matches
1250,Marcus Ingvartsen,dk DEN,"FW,MF",Mainz 05,de Bundesliga,26,1996,14.6,4,1,0,2,2,1,10,10.0,9,9,1,8,4,8,10,0,Matches
1251,Bonke Innocent,ng NGA,MF,Lorient,fr Ligue 1,26,1996,13.1,28,17,13,14,1,11,36,30.6,25,22,5,17,26,54,31,0,Matches
1252,Alexander Isak,se SWE,FW,Newcastle Utd,eng Premier League,22,1999,16.9,18,8,4,7,7,10,28,35.7,18,21,2,19,4,22,8,0,Matches
1253,Alexander Isak,se SWE,FW,Real Sociedad,es La Liga,22,1999,1.7,1,1,0,0,1,0,0,,0,0,0,0,0,1,2,0,Matches
1254,Isco,es ESP,"MF,FW",Sevilla,es La Liga,30,1992,8.9,15,9,6,5,4,8,14,57.1,6,3,0,3,10,25,3,0,Matches
1255,Ismaily,br BRA,DF,Lille,fr Ligue 1,32,1990,19.8,41,18,16,16,9,17,32,53.1,15,25,5,20,21,62,39,0,Matches
1256,Ardian Ismajli,al ALB,DF,Empoli,it Serie A,25,1996,23.3,40,32,25,15,0,18,24,75.0,6,47,31,16,27,67,120,0,Matches
1257,Ko Itakura,jp JPN,DF,Gladbach,de Bundesliga,25,1997,22.0,29,17,18,7,4,16,30,53.3,14,41,25,16,27,56,95,0,Matches
1258,Hiroki Ito,jp JPN,DF,Stuttgart,de Bundesliga,23,1999,28.5,40,29,24,14,2,18,35,51.4,17,38,17,21,40,80,94,0,Matches
1259,Junya Ito,jp JPN,FW,Reims,fr Ligue 1,29,1993,32.4,40,20,14,15,11,13,53,24.5,40,29,1,28,8,48,4,1,Matches
1260,Diego Iturralde,es ESP,DF,Sevilla,es La Liga,19,2003,0.5,1,0,1,0,0,0,2,0.0,2,0,0,0,0,1,1,0,Matches
1261,Andreas Ivan,ro ROU,MF,Schalke 04,de Bundesliga,27,1995,0.5,0,0,0,0,0,0,1,0.0,1,0,0,0,0,0,1,0,Matches
1262,Mihailo Ivanović,rs SRB,FW,Sampdoria,it Serie A,17,2004,0.0,0,0,0,0,0,0,0,,0,0,0,0,0,0,0,0,Matches
1263,Daniel Iversen,dk DEN,GK,Leicester City,eng Premier League,25,1997,12.0,0,0,0,0,0,0,0,,0,0,0,0,0,0,6,1,Matches
1264,Alex Iwobi,ng NGA,"MF,FW",Everton,eng Premier League,26,1996,37.5,69,37,37,28,4,33,65,50.8,32,41,2,39,25,94,29,0,Matches
1265,Armando Izzo,it ITA,DF,Monza,it Serie A,30,1992,27.4,73,50,44,27,2,29,45,64.4,16,29,17,12,50,123,87,1,Matches
1266,Nicolas Jackson,sn SEN,FW,Villarreal,es La Liga,21,2001,17.8,14,11,2,10,2,2,8,25.0,6,18,2,16,2,16,4,0,Matches
1267,Lee Jae-sung,kr KOR,MF,Mainz 05,de Bundesliga,29,1992,21.0,38,17,9,21,8,16,36,44.4,20,29,5,24,17,55,21,0,Matches
1268,Paul Jaeckel,de GER,DF,Union Berlin,de Bundesliga,24,1998,13.3,24,18,11,11,2,17,35,48.6,18,11,5,6,19,43,44,1,Matches
1269,Mato Jajalo,ba BIH,MF,Udinese,it Serie A,34,1988,0.7,0,0,0,0,0,0,1,0.0,1,0,0,0,0,0,2,0,Matches
1270,Kristijan Jakić,hr CRO,"DF,MF",Eint Frankfurt,de Bundesliga,25,1997,16.2,33,21,19,12,2,22,41,53.7,19,32,10,22,14,47,49,1,Matches
1271,Ismail Jakobs,sn SEN,"DF,FW",Monaco,fr Ligue 1,22,1999,12.4,11,5,7,3,1,5,12,41.7,7,9,1,8,9,20,18,0,Matches
1272,Marin Jakoliš,hr CRO,FW,Angers,fr Ligue 1,25,1996,0.3,1,1,0,0,1,0,0,,0,0,0,0,0,1,0,0,Matches
1273,Daniel James,wls WAL,FW,Leeds United,eng Premier League,24,1997,2.2,6,2,1,3,2,3,6,50.0,3,4,0,4,2,8,2,0,Matches
1274,Daniel James,wls WAL,FW,Fulham,eng Premier League,24,1997,6.9,10,6,4,5,1,4,9,44.4,5,5,1,4,1,11,5,0,Matches
1275,Reece James,eng ENG,"DF,MF",Chelsea,eng Premier League,22,1999,13.8,31,20,10,18,3,15,19,78.9,4,17,2,15,12,43,23,0,Matches
1276,Vitaly Janelt,de GER,"MF,DF",Brentford,eng Premier League,24,1998,24.5,54,27,20,24,10,21,49,42.9,28,29,9,20,29,83,26,0,Matches
1277,Saidy Janko,gm GAM,DF,Bochum,de Bundesliga,26,1995,12.6,23,15,13,8,2,12,20,60.0,8,24,10,14,11,34,33,1,Matches
1278,Pontus Jansson,se SWE,DF,Brentford,eng Premier League,31,1991,8.0,5,3,4,1,0,3,5,60.0,2,13,9,4,9,14,38,0,Matches
1279,Tony Jantschke,de GER,"DF,MF",Gladbach,de Bundesliga,32,1990,1.1,2,1,1,1,0,1,1,100.0,0,5,3,2,0,2,5,0,Matches
1280,Adnan Januzaj,be BEL,FW,Sevilla,es La Liga,27,1995,0.5,0,0,0,0,0,0,1,0.0,1,0,0,0,1,1,0,0,Matches
1281,Léo Jardim,br BRA,GK,Lille,fr Ligue 1,27,1995,6.0,0,0,0,0,0,0,1,0.0,1,0,0,0,0,0,0,1,Matches
1282,Luis Javier Suárez,co COL,FW,Almería,es La Liga,24,1997,16.6,17,11,5,6,6,6,26,23.1,20,13,3,10,3,20,10,0,Matches
1283,Luis Javier Suárez,co COL,FW,Marseille,fr Ligue 1,24,1997,3.3,4,1,1,2,1,1,4,25.0,3,1,0,1,3,7,6,0,Matches
1284,Dany Jean,ht HAI,"DF,MF",Strasbourg,fr Ligue 1,19,2002,0.1,0,0,0,0,0,0,1,0.0,1,1,0,1,0,0,0,0,Matches
1285,Julian Jeanvier,gn GUI,DF,Auxerre,fr Ligue 1,30,1992,19.6,32,17,24,8,0,13,22,59.1,9,24,17,7,27,59,96,1,Matches
1286,Jeffinho,br BRA,FW,Lyon,fr Ligue 1,22,1999,5.0,17,4,4,9,4,6,15,40.0,9,6,0,6,1,18,0,0,Matches
1287,Fredrik Jensen,fi FIN,"FW,MF",Augsburg,de Bundesliga,24,1997,10.3,15,10,8,3,4,5,10,50.0,5,12,5,7,4,19,12,0,Matches
1288,Mathias Jensen,dk DEN,MF,Brentford,eng Premier League,26,1996,31.1,70,35,28,30,12,34,97,35.1,63,54,5,49,32,102,24,1,Matches
1289,Moritz Jenz,de GER,DF,Schalke 04,de Bundesliga,23,1999,10.5,14,11,8,5,1,5,8,62.5,3,16,10,6,8,22,53,1,Matches
1290,Jesé,es ESP,FW,Sampdoria,it Serie A,29,1993,2.3,2,0,0,2,0,0,1,0.0,1,3,1,2,1,3,2,0,Matches
1291,Gabriel Jesus,br BRA,FW,Arsenal,eng Premier League,25,1997,22.9,33,25,16,8,9,15,31,48.4,16,27,3,24,11,44,15,1,Matches
1292,Juan Jesus,br BRA,DF,Napoli,it Serie A,31,1991,10.4,16,11,9,6,1,9,12,75.0,3,18,11,7,10,26,29,0,Matches
1293,Raúl Jiménez,mx MEX,FW,Wolves,eng Premier League,31,1991,9.4,9,6,3,5,1,3,6,50.0,3,9,0,9,0,9,8,0,Matches
1294,Joaquín,es ESP,"MF,FW",Betis,es La Liga,41,1981,5.5,3,3,2,1,0,1,3,33.3,2,7,2,5,4,7,5,0,Matches
1295,Joelinton,br BRA,"MF,FW",Newcastle Utd,eng Premier League,25,1996,29.6,70,49,36,26,8,26,62,41.9,36,52,7,45,48,118,39,0,Matches
1296,Þórir Jóhann Helgason,is ISL,MF,Lecce,it Serie A,21,2000,2.5,2,2,1,0,1,2,3,66.7,1,3,1,2,3,5,3,0,Matches
1297,Ben Johnson,eng ENG,DF,West Ham,eng Premier League,22,2000,9.6,20,14,12,4,4,12,18,66.7,6,12,4,8,9,29,28,1,Matches
1298,Brennan Johnson,wls WAL,"FW,MF",Nott'ham Forest,eng Premier League,21,2001,32.6,34,20,18,8,8,8,29,27.6,21,30,1,29,5,39,7,1,Matches
1299,Sam Johnstone,eng ENG,GK,Crystal Palace,eng Premier League,29,1993,9.0,0,0,0,0,0,0,0,,0,0,0,0,0,0,5,0,Matches
1300,Paul Joly,fr FRA,DF,Auxerre,fr Ligue 1,22,2000,9.6,33,21,21,10,2,19,35,54.3,16,13,2,11,24,57,29,2,Matches
1301,Curtis Jones,eng ENG,MF,Liverpool,eng Premier League,21,2001,11.5,34,17,8,12,14,18,31,58.1,13,12,2,10,3,37,9,0,Matches
1302,Frenkie de Jong,nl NED,MF,Barcelona,es La Liga,25,1997,28.2,46,26,16,21,9,17,41,41.5,24,11,1,10,35,81,22,1,Matches
1303,Joan Jordán,es ESP,MF,Sevilla,es La Liga,28,1994,17.7,32,17,13,17,2,16,38,42.1,22,14,7,7,16,48,14,2,Matches
1304,Jorginho,it ITA,MF,Arsenal,eng Premier League,30,1991,9.5,18,13,6,10,2,5,24,20.8,19,7,2,5,9,27,8,0,Matches
1305,Jorginho,it ITA,MF,Chelsea,eng Premier League,30,1991,14.2,42,23,22,14,6,22,46,47.8,24,18,3,15,21,63,7,0,Matches
1306,Josan,es ESP,"DF,MF",Elche,es La Liga,32,1989,12.0,25,20,20,5,0,14,27,51.9,13,8,0,8,7,32,15,1,Matches
1307,Willian José,br BRA,FW,Betis,es La Liga,30,1991,8.1,9,6,6,3,0,4,9,44.4,5,4,0,4,1,10,15,0,Matches
1308,Joselu,es ESP,FW,Espanyol,es La Liga,32,1990,33.2,13,11,3,4,6,4,17,23.5,13,25,4,21,8,21,43,0,Matches
1309,Mateo Joseph,es ESP,"FW,MF",Leeds United,eng Premier League,18,2003,0.3,0,0,0,0,0,0,0,,0,1,0,1,0,0,1,0,Matches
1310,Diogo Jota,pt POR,FW,Liverpool,eng Premier League,25,1996,12.6,23,15,8,8,7,12,37,32.4,25,5,0,5,3,26,11,0,Matches
1311,Stevan Jovetić,me MNE,"FW,MF",Hertha BSC,de Bundesliga,32,1989,9.9,3,2,2,1,0,1,11,9.1,10,2,1,1,2,5,10,0,Matches
1312,Luka Jović,rs SRB,"FW,MF",Fiorentina,it Serie A,24,1997,17.0,6,3,1,4,1,2,8,25.0,6,7,2,5,2,8,10,0,Matches
1313,Juanmi,es ESP,FW,Betis,es La Liga,29,1993,10.3,14,10,4,7,3,7,31,22.6,24,10,0,10,4,18,4,0,Matches
1314,Juanpe,es ESP,DF,Girona,es La Liga,31,1991,15.8,19,11,10,9,0,11,17,64.7,6,12,9,3,10,29,60,1,Matches
1315,Jubal,br BRA,DF,Auxerre,fr Ligue 1,28,1993,35.7,41,26,29,11,1,19,38,50.0,19,57,34,23,53,94,193,0,Matches
1316,Christopher Jullien,fr FRA,DF,Montpellier,fr Ligue 1,29,1993,29.9,46,28,29,14,3,28,51,54.9,23,35,18,17,43,89,114,1,Matches
1317,Anthony Jung,de GER,"DF,FW",Werder Bremen,de Bundesliga,30,1991,29.1,46,27,19,20,7,31,58,53.4,27,30,6,24,22,68,63,0,Matches
1318,Eli Junior Kroupi,fr FRA,"FW,MF",Lorient,fr Ligue 1,16,2006,0.1,0,0,0,0,0,0,1,0.0,1,0,0,0,1,1,0,0,Matches
1319,Lago Junior,ci CIV,"FW,MF",Mallorca,es La Liga,31,1990,0.6,1,0,0,1,0,1,1,100.0,0,0,0,0,0,1,0,0,Matches
1320,Hamed Junior Traorè,ci CIV,"FW,MF",Bournemouth,eng Premier League,22,2000,4.7,17,11,5,9,3,6,18,33.3,12,9,0,9,2,19,1,0,Matches
1321,Hamed Junior Traorè,ci CIV,"MF,FW",Sassuolo,it Serie A,22,2000,6.6,11,6,4,6,1,4,11,36.4,7,4,0,4,2,13,0,1,Matches
1322,Vinicius Júnior,br BRA,FW,Real Madrid,es La Liga,22,2000,31.4,30,21,10,12,8,14,39,35.9,25,24,1,23,6,36,1,0,Matches
1323,Josip Juranović,hr CRO,DF,Union Berlin,de Bundesliga,26,1995,10.4,9,7,5,2,2,7,18,38.9,11,9,3,6,6,15,22,1,Matches
1324,James Justin,eng ENG,DF,Leicester City,eng Premier League,24,1998,13.9,20,18,7,12,1,9,18,50.0,9,24,6,18,15,35,47,0,Matches
1325,Filip Jørgensen,dk DEN,GK,Villarreal,es La Liga,20,2002,2.0,0,0,0,0,0,0,1,0.0,1,0,0,0,0,0,0,0,Matches
1326,Mathias Jørgensen,dk DEN,DF,Brentford,eng Premier League,32,1990,12.3,17,8,9,8,0,9,21,42.9,12,19,12,7,16,33,39,1,Matches
1327,Ozan Kabak,tr TUR,DF,Hoffenheim,de Bundesliga,22,2000,26.5,51,34,27,21,3,17,30,56.7,13,35,23,12,45,96,83,0,Matches
1328,Issa Kaboré,bf BFA,DF,Marseille,fr Ligue 1,21,2001,11.4,33,19,10,18,5,21,32,65.6,11,11,1,10,12,45,21,1,Matches
1329,Abdoul Kader Bamba,fr FRA,"FW,MF",Nantes,fr Ligue 1,28,1994,0.9,0,0,0,0,0,0,2,0.0,2,3,1,2,0,0,1,0,Matches
1330,Pavel Kadeřábek,cz CZE,DF,Hoffenheim,de Bundesliga,30,1992,18.5,26,20,10,9,7,15,23,65.2,8,12,2,10,14,40,37,1,Matches
1331,Tino Kadewere,zw ZIM,"FW,MF",Mallorca,es La Liga,26,1996,6.0,6,3,3,3,0,4,9,44.4,5,6,2,4,2,8,1,0,Matches
1332,Kaiky,br BRA,DF,Almería,es La Liga,18,2004,6.5,5,5,5,0,0,3,7,42.9,4,18,10,8,11,16,28,0,Matches
1333,Florian Kainz,at AUT,"MF,FW",Köln,de Bundesliga,29,1992,26.0,21,10,7,12,2,8,26,30.8,18,27,6,21,32,53,30,1,Matches
1334,Gaël Kakuta,cd COD,FW,Lens,fr Ligue 1,31,1991,0.2,0,0,0,0,0,0,0,,0,0,0,0,0,0,1,0,Matches
1335,Sasa Kalajdzic,at AUT,FW,Wolves,eng Premier League,25,1997,0.5,0,0,0,0,0,0,0,,0,0,0,0,1,1,0,0,Matches
1336,Sasa Kalajdzic,at AUT,FW,Stuttgart,de Bundesliga,25,1997,2.6,3,2,0,1,2,1,3,33.3,2,1,0,1,0,3,0,0,Matches
1337,Arnaud Kalimuendo,fr FRA,FW,Rennes,fr Ligue 1,20,2002,20.5,15,8,3,6,6,5,20,25.0,15,15,2,13,2,17,9,0,Matches
1338,Yayah Kallon,sl SLE,"MF,FW",Hellas Verona,it Serie A,21,2001,9.6,14,10,5,4,5,7,12,58.3,5,10,0,10,8,22,5,0,Matches
1339,Gedeon Kalulu,cd COD,DF,Lorient,fr Ligue 1,24,1997,27.1,64,34,43,14,7,30,48,62.5,18,32,3,29,28,92,79,2,Matches
1340,Pierre Kalulu,fr FRA,DF,Milan,it Serie A,22,2000,28.3,57,39,33,21,3,28,42,66.7,14,41,17,24,41,98,56,1,Matches
1341,Justin-Noël Kalumba,fr FRA,DF,Angers,fr Ligue 1,17,2004,6.1,9,5,5,2,2,5,16,31.3,11,4,1,3,4,13,5,0,Matches
1342,Daichi Kamada,jp JPN,MF,Eint Frankfurt,de Bundesliga,25,1996,25.2,51,31,10,37,4,31,57,54.4,26,31,2,29,16,67,17,1,Matches
1343,Waren Kamanzi,no NOR,DF,Toulouse,fr Ligue 1,21,2000,7.4,16,9,9,5,2,13,19,68.4,6,8,2,6,8,24,9,0,Matches
1344,Bingourou Kamara,sn SEN,GK,Montpellier,fr Ligue 1,25,1996,4.5,0,0,0,0,0,0,0,,0,0,0,0,0,0,2,0,Matches
1345,Boubacar Kamara,fr FRA,MF,Aston Villa,eng Premier League,22,1999,19.7,58,25,25,23,10,27,56,48.2,29,38,12,26,19,77,24,3,Matches
1346,Jakub Kamiński,pl POL,"FW,DF",Wolfsburg,de Bundesliga,20,2002,22.9,36,25,15,13,8,20,40,50.0,20,37,2,35,8,44,15,0,Matches
1347,Marcin Kamiński,pl POL,DF,Schalke 04,de Bundesliga,30,1992,7.0,6,4,4,0,2,2,4,50.0,2,8,7,1,9,15,28,0,Matches
1348,Kevin Kampl,si SVN,MF,RB Leipzig,de Bundesliga,31,1990,15.2,21,11,6,14,1,6,27,22.2,21,26,9,17,22,43,11,0,Matches
1349,Nordine Kandil,fr FRA,"MF,FW",Strasbourg,fr Ligue 1,20,2001,1.1,3,2,1,2,0,0,3,0.0,3,2,0,2,1,4,1,0,Matches
1350,Harry Kane,eng ENG,FW,Tottenham,eng Premier League,29,1993,37.8,15,12,1,6,8,7,21,33.3,14,27,7,20,2,17,18,0,Matches
1351,Lee Kang-in,kr KOR,"MF,FW",Mallorca,es La Liga,21,2001,31.4,42,24,10,22,10,18,61,29.5,43,25,2,23,11,53,7,0,Matches
1352,Wilfried Kanga,ci CIV,FW,Hertha BSC,de Bundesliga,24,1998,15.7,5,4,2,1,2,2,4,50.0,2,14,3,11,2,7,13,0,Matches
1353,N'Golo Kanté,fr FRA,MF,Chelsea,eng Premier League,31,1991,5.8,16,10,4,10,2,4,8,50.0,4,11,0,11,6,22,2,0,Matches
1354,Kenan Karaman,tr TUR,FW,Schalke 04,de Bundesliga,28,1994,10.8,11,8,3,5,3,3,12,25.0,9,9,1,8,3,14,9,0,Matches
1355,Yann Karamoh,fr FRA,"MF,FW",Torino,it Serie A,24,1998,8.0,5,2,3,2,0,1,5,20.0,4,5,0,5,0,5,2,1,Matches
1356,Atakan Karazor,de GER,MF,Stuttgart,de Bundesliga,25,1996,21.8,49,30,18,25,6,24,47,51.1,23,39,11,28,31,80,44,0,Matches
1357,Ayman Kari,fr FRA,"MF,DF",Lorient,fr Ligue 1,17,2004,1.1,0,0,0,0,0,0,0,,0,4,0,4,3,3,0,0,Matches
1358,Jon Karrikaburu,es ESP,FW,Real Sociedad,es La Liga,19,2002,1.0,1,0,0,1,0,0,0,,0,2,0,2,0,1,0,0,Matches
1359,Rick Karsdorp,nl NED,DF,Roma,it Serie A,27,1995,7.9,21,13,11,7,3,13,22,59.1,9,0,0,0,7,28,15,1,Matches
1360,Denso Kasius,nl NED,DF,Bologna,it Serie A,19,2002,3.8,12,6,7,4,1,8,10,80.0,2,6,3,3,3,15,6,0,Matches
1361,Thomas Kastanaras,gr GRE,"FW,DF",Stuttgart,de Bundesliga,19,2003,0.8,0,0,0,0,0,0,0,,0,1,0,1,0,0,0,0,Matches
1362,Grigoris Kastanos,cy CYP,"MF,DF",Salernitana,it Serie A,24,1998,14.3,39,23,18,19,2,16,40,40.0,24,20,6,14,8,47,8,0,Matches
1363,Silas Katompa,cd COD,"FW,MF",Stuttgart,de Bundesliga,23,1998,22.1,25,17,5,14,6,6,20,30.0,14,17,2,15,8,33,1,0,Matches
1364,Moise Kean,it ITA,FW,Juventus,it Serie A,22,2000,11.1,8,6,2,5,1,3,7,42.9,4,4,0,4,5,13,2,0,Matches
1365,Michael Keane,eng ENG,DF,Everton,eng Premier League,29,1993,10.9,7,4,5,2,0,5,8,62.5,3,12,7,5,14,21,55,1,Matches
1366,Neeskens Kebano,cd COD,FW,Fulham,eng Premier League,30,1992,8.5,17,9,8,6,3,9,18,50.0,9,14,0,14,1,18,8,0,Matches
1367,Kévin Keben Biakolo,cm CMR,DF,Toulouse,fr Ligue 1,18,2004,4.0,3,2,2,0,1,0,4,0.0,4,1,0,1,5,8,9,0,Matches
1368,Thilo Kehrer,de GER,DF,West Ham,eng Premier League,25,1996,24.8,43,24,25,14,4,21,45,46.7,24,16,6,10,34,77,76,1,Matches
1369,Check Keita,fr FRA,DF,Reims,fr Ligue 1,19,2003,7.6,12,9,9,3,0,4,9,44.4,5,6,5,1,5,17,24,1,Matches
1370,Naby Keïta,gn GUI,MF,Liverpool,eng Premier League,27,1995,3.3,5,4,2,3,0,1,4,25.0,3,1,0,1,2,7,3,0,Matches
1371,Yannik Keitel,de GER,MF,Freiburg,de Bundesliga,22,2000,7.6,11,7,4,6,1,3,5,60.0,2,6,3,3,13,24,8,0,Matches
1372,Caoimhín Kelleher,ie IRL,GK,Liverpool,eng Premier League,23,1998,1.0,0,0,0,0,0,0,0,,0,0,0,0,0,0,0,0,Matches
1373,Lloyd Kelly,eng ENG,DF,Bournemouth,eng Premier League,23,1998,22.7,33,18,23,9,1,13,19,68.4,6,26,15,11,26,59,101,1,Matches
1374,Marc-Oliver Kempf,de GER,DF,Hertha BSC,de Bundesliga,27,1995,30.1,44,27,29,14,1,16,22,72.7,6,42,32,10,51,95,143,0,Matches
1375,Kenedy,br BRA,"FW,DF",Valladolid,es La Liga,26,1996,3.1,6,2,3,3,0,2,4,50.0,2,2,0,2,1,7,0,0,Matches
1376,Jonjoe Kenny,eng ENG,DF,Hertha BSC,de Bundesliga,25,1997,24.9,46,34,27,16,3,24,42,57.1,18,38,9,29,46,92,74,0,Matches
1377,Franck Kessié,ci CIV,MF,Barcelona,es La Liga,25,1996,11.0,15,9,6,6,3,8,18,44.4,10,10,2,8,12,27,11,2,Matches
1378,Saîf-Eddine Khaoui,tn TUN,MF,Clermont Foot,fr Ligue 1,27,1995,22.5,47,28,14,25,8,15,47,31.9,32,17,2,15,33,80,8,0,Matches
1379,Wahbi Khazri,tn TUN,"FW,MF",Montpellier,fr Ligue 1,31,1991,18.2,26,13,13,7,6,6,25,24.0,19,17,1,16,9,35,20,0,Matches
1380,Rani Khedira,de GER,MF,Union Berlin,de Bundesliga,28,1994,32.0,60,33,21,32,7,25,50,50.0,25,33,10,23,40,100,33,0,Matches
1381,Anthony Khelifa,fr FRA,DF,Ajaccio,fr Ligue 1,16,2005,0.1,0,0,0,0,0,0,0,,0,0,0,0,0,0,0,0,Matches
1382,Kiké,es ESP,FW,Osasuna,es La Liga,32,1989,11.3,6,3,0,4,2,2,5,40.0,3,6,1,5,1,7,13,0,Matches
1383,Luca Kilian,de GER,DF,Köln,de Bundesliga,22,1999,12.5,22,16,14,7,1,12,21,57.1,9,16,8,8,11,33,48,0,Matches
1384,Max Kilman,eng ENG,DF,Wolves,eng Premier League,25,1997,36.7,36,20,26,9,1,16,30,53.3,14,70,42,28,19,55,164,1,Matches
1385,Joshua Kimmich,de GER,MF,Bayern Munich,de Bundesliga,27,1995,31.2,78,49,24,46,8,38,72,52.8,34,36,7,29,41,119,39,2,Matches
1386,Presnel Kimpembe,fr FRA,DF,Paris S-G,fr Ligue 1,26,1995,8.1,17,8,9,6,2,9,13,69.2,4,12,7,5,13,30,9,1,Matches
1387,Jakub Kiwior,pl POL,DF,Arsenal,eng Premier League,22,2000,4.7,7,5,6,1,0,5,8,62.5,3,5,3,2,6,13,10,0,Matches
1388,Jakub Kiwior,pl POL,DF,Spezia,it Serie A,22,2000,16.0,22,17,15,7,0,6,24,25.0,18,26,18,8,24,46,71,1,Matches
1389,Simon Kjær,dk DEN,DF,Milan,it Serie A,33,1989,11.2,15,8,9,6,0,7,11,63.6,4,14,11,3,9,24,35,1,Matches
1390,Pascal Klemens,de GER,DF,Hertha BSC,de Bundesliga,17,2005,1.0,0,0,0,0,0,0,1,0.0,1,1,0,1,1,1,3,0,Matches
1391,Mateusz Klich,pl POL,"MF,FW",Leeds United,eng Premier League,32,1990,3.1,12,8,3,4,5,7,13,53.8,6,4,0,4,0,12,1,0,Matches
1392,Lukas Klostermann,de GER,DF,RB Leipzig,de Bundesliga,26,1996,10.1,16,8,7,9,0,8,15,53.3,7,6,3,3,13,29,31,0,Matches
1393,Justin Kluivert,nl NED,"FW,MF",Valencia,es La Liga,23,1999,16.1,17,14,7,4,6,6,12,50.0,6,4,0,4,7,24,4,0,Matches
1394,Ansgar Knauff,de GER,DF,Eint Frankfurt,de Bundesliga,20,2002,14.3,36,25,22,11,3,15,34,44.1,19,19,1,18,15,51,26,0,Matches
1395,Robin Knoche,de GER,DF,Union Berlin,de Bundesliga,30,1992,31.9,45,29,29,12,4,24,47,51.1,23,35,18,17,38,83,140,0,Matches
1396,Gregor Kobel,ch SUI,GK,Dortmund,de Bundesliga,24,1997,27.0,0,0,0,0,0,0,1,0.0,1,1,0,1,0,0,7,2,Matches
1397,Robin Koch,de GER,DF,Leeds United,eng Premier League,26,1996,35.3,53,30,32,16,5,24,56,42.9,32,44,21,23,43,96,152,1,Matches
1398,Samuel Koeberlé,fr FRA,MF,Reims,fr Ligue 1,17,2004,0.0,0,0,0,0,0,0,0,,0,0,0,0,0,0,0,0,Matches
1399,Rudy Kohon,fr FRA,DF,Troyes,fr Ligue 1,18,2004,0.7,4,3,4,0,0,2,2,100.0,0,1,0,1,1,5,2,0,Matches
1400,Dominik Kohr,de GER,MF,Mainz 05,de Bundesliga,28,1994,25.5,59,33,23,31,5,29,61,47.5,32,46,9,37,34,93,26,1,Matches
1401,Koke,es ESP,MF,Atlético Madrid,es La Liga,30,1992,28.3,55,38,23,25,7,28,72,38.9,44,35,13,22,20,75,19,0,Matches
1402,Sead Kolašinac,ba BIH,DF,Marseille,fr Ligue 1,29,1993,24.6,52,36,24,22,6,24,37,64.9,13,19,2,17,43,95,35,1,Matches
1403,Luca Koleosho,it ITA,"FW,DF",Espanyol,es La Liga,17,2004,0.7,2,2,0,0,2,1,2,50.0,1,1,0,1,0,2,0,0,Matches
1404,Randal Kolo Muani,fr FRA,FW,Eint Frankfurt,de Bundesliga,23,1998,29.2,14,10,3,3,8,1,9,11.1,8,19,2,17,3,17,13,0,Matches
1405,Timothée Kolodziejczak,fr FRA,DF,Schalke 04,de Bundesliga,30,1991,0.3,0,0,0,0,0,0,1,0.0,1,0,0,0,1,1,1,0,Matches
1406,Cheick Konaté,ml MLI,DF,Clermont Foot,fr Ligue 1,18,2004,6.4,19,12,10,7,2,13,22,59.1,9,7,1,6,13,32,8,1,Matches
1407,Ibrahima Konaté,fr FRA,DF,Liverpool,eng Premier League,23,1999,17.2,38,26,25,13,0,16,27,59.3,11,12,5,7,26,64,61,4,Matches
1408,Geoffrey Kondogbia,cf CTA,MF,Atlético Madrid,es La Liga,29,1993,11.2,40,23,19,20,1,17,25,68.0,8,9,1,8,26,66,12,1,Matches
1409,Ibrahima Koné,ml MLI,FW,Lorient,fr Ligue 1,23,1999,17.5,24,13,3,13,8,5,11,45.5,6,13,0,13,4,28,18,0,Matches
1410,Manu Koné,fr FRA,MF,Gladbach,de Bundesliga,21,2001,29.0,74,39,37,33,4,24,47,51.1,23,44,12,32,32,106,21,0,Matches
1411,Youssouf Koné,ml MLI,DF,Ajaccio,fr Ligue 1,27,1995,10.2,28,19,24,4,0,18,25,72.0,7,9,2,7,12,40,32,1,Matches
1412,Ezri Konsa,eng ENG,DF,Aston Villa,eng Premier League,24,1997,36.9,42,20,25,15,2,18,26,69.2,8,41,23,18,26,68,120,3,Matches
1413,Teun Koopmeiners,nl NED,MF,Atalanta,it Serie A,24,1998,31.8,46,26,15,24,7,28,55,50.9,27,41,5,36,19,65,36,2,Matches
1414,Odilon Kossonou,ci CIV,DF,Leverkusen,de Bundesliga,21,2001,16.9,21,14,12,7,2,8,16,50.0,8,26,11,15,24,45,58,1,Matches
1415,Filip Kostić,rs SRB,"DF,FW",Juventus,it Serie A,29,1992,28.5,41,26,17,20,4,21,47,44.7,26,30,4,26,16,57,32,0,Matches
1416,Filip Kostić,rs SRB,"DF,MF",Eint Frankfurt,de Bundesliga,29,1992,0.8,2,0,1,1,0,0,0,,0,0,0,0,1,3,0,0,Matches
1417,Christian Kouamé,ci CIV,FW,Fiorentina,it Serie A,24,1997,20.7,27,18,8,10,9,7,14,50.0,7,15,3,12,12,39,8,0,Matches
1418,Rominigue Kouamé,ml MLI,MF,Troyes,fr Ligue 1,25,1996,29.6,44,27,28,14,2,17,41,41.5,24,32,11,21,49,93,46,1,Matches
1419,Tomáš Koubek,cz CZE,GK,Augsburg,de Bundesliga,29,1992,11.0,0,0,0,0,0,0,0,,0,0,0,0,0,0,7,0,Matches
1420,Kalidou Koulibaly,sn SEN,DF,Chelsea,eng Premier League,31,1991,20.0,45,31,34,8,3,26,40,65.0,14,30,13,17,29,74,77,0,Matches
1421,Jules Koundé,fr FRA,DF,Barcelona,es La Liga,23,1998,27.0,37,23,18,13,6,21,31,67.7,10,24,9,15,19,56,61,3,Matches
1422,Boubakar Kouyaté,ml MLI,DF,Montpellier,fr Ligue 1,25,1997,14.0,31,18,18,11,2,19,35,54.3,16,24,14,10,34,65,73,1,Matches
1423,Cheikhou Kouyaté,sn SEN,MF,Nott'ham Forest,eng Premier League,32,1989,9.8,29,21,18,8,3,9,13,69.2,4,14,2,12,10,39,24,0,Matches
1424,Mateo Kovačić,hr CRO,MF,Chelsea,eng Premier League,28,1994,19.0,36,24,16,14,6,14,36,38.9,22,10,1,9,19,55,16,0,Matches
1425,Viktor Kovalenko,ua UKR,MF,Spezia,it Serie A,26,1996,6.1,9,5,1,6,2,5,8,62.5,3,11,2,9,4,13,7,0,Matches
1426,Soichiro Kozuki,jp JPN,"FW,MF",Schalke 04,de Bundesliga,21,2000,4.2,6,4,3,3,0,4,6,66.7,2,5,0,5,3,9,3,0,Matches
1427,Emil Krafth,se SWE,DF,Newcastle Utd,eng Premier League,27,1994,0.0,0,0,0,0,0,0,0,,0,0,0,0,0,0,0,0,Matches
1428,Alex Král,cz CZE,MF,Schalke 04,de Bundesliga,24,1998,26.2,34,24,10,22,2,17,37,45.9,20,31,6,25,17,51,53,0,Matches
1429,Andrej Kramarić,hr CRO,"MF,FW",Hoffenheim,de Bundesliga,31,1991,26.5,5,2,2,1,2,1,11,9.1,10,14,2,12,6,11,13,0,Matches
1430,Christoph Kramer,de GER,MF,Gladbach,de Bundesliga,31,1991,24.7,44,33,24,15,5,22,55,40.0,33,34,2,32,17,61,40,0,Matches
1431,Tom Krauß,de GER,MF,Schalke 04,de Bundesliga,21,2001,27.9,112,68,39,62,11,51,100,51.0,49,39,6,33,36,148,35,0,Matches
1432,Rasmus Kristensen,dk DEN,DF,Leeds United,eng Premier League,25,1997,21.8,62,35,35,21,6,42,76,55.3,34,32,14,18,35,97,61,0,Matches
1433,Julian Kristoffersen,no NOR,FW,Salernitana,it Serie A,25,1997,0.2,0,0,0,0,0,0,0,,0,1,0,1,0,0,0,0,Matches
1434,Raimonds Krollis,lv LVA,"FW,DF",Spezia,it Serie A,20,2001,0.4,1,1,0,0,1,0,1,0.0,1,0,0,0,0,1,0,0,Matches
1435,Toni Kroos,de GER,MF,Real Madrid,es La Liga,32,1990,23.9,51,32,16,33,2,23,69,33.3,46,23,4,19,24,75,11,0,Matches
1436,Rade Krunić,ba BIH,MF,Milan,it Serie A,28,1993,18.4,40,28,18,18,4,16,50,32.0,34,31,11,20,16,56,21,0,Matches
1437,Max Kruse,de GER,"MF,FW",Wolfsburg,de Bundesliga,34,1988,3.0,1,1,0,1,0,0,1,0.0,1,2,1,1,0,1,1,0,Matches
1438,Lukas Kübler,de GER,DF,Freiburg,de Bundesliga,29,1992,18.2,37,25,24,9,4,18,30,60.0,12,25,11,14,29,66,50,0,Matches
1439,Takefusa Kubo,jp JPN,"FW,MF",Real Sociedad,es La Liga,21,2001,27.1,44,26,18,16,10,16,38,42.1,22,29,1,28,9,53,4,0,Matches
1440,Dejan Kulusevski,se SWE,"MF,FW",Tottenham,eng Premier League,22,2000,23.0,38,15,23,7,8,16,44,36.4,28,19,0,19,13,51,7,0,Matches
1441,Sael Kumbedi,fr FRA,DF,Lyon,fr Ligue 1,17,2005,14.7,47,27,27,13,7,20,38,52.6,18,23,7,16,10,57,16,0,Matches
1442,Marash Kumbulla,al ALB,DF,Roma,it Serie A,22,2000,2.9,4,4,2,2,0,2,3,66.7,1,2,1,1,4,8,6,0,Matches
1443,Pierre Kunde,cm CMR,"MF,FW",Bochum,de Bundesliga,27,1995,4.2,12,6,3,8,1,6,14,42.9,8,7,1,6,7,19,9,0,Matches
1444,Alou Kuol,au AUS,FW,Stuttgart,de Bundesliga,21,2000,0.1,0,0,0,0,0,0,0,,0,0,0,0,0,0,0,0,Matches
1445,Layvin Kurzawa,fr FRA,DF,Fulham,eng Premier League,29,1992,1.5,3,2,1,1,1,3,3,100.0,0,1,1,0,2,5,4,0,Matches
1446,Khvicha Kvaratskhelia,ge GEO,FW,Napoli,it Serie A,21,2001,28.0,43,23,12,8,23,17,43,39.5,26,20,0,20,5,48,6,1,Matches
1447,Grejohn Kyei,fr FRA,FW,Clermont Foot,fr Ligue 1,26,1995,24.8,16,7,2,9,5,4,13,30.8,9,14,3,11,6,22,22,0,Matches
1448,Daniel Kyereh,gh GHA,"MF,FW",Freiburg,de Bundesliga,26,1996,6.2,6,4,2,4,0,3,6,50.0,3,4,0,4,2,8,6,0,Matches
1449,Giorgos Kyriakopoulos,gr GRE,"DF,FW",Bologna,it Serie A,26,1996,7.8,13,6,4,5,4,10,23,43.5,13,14,2,12,4,17,10,0,Matches
1450,Giorgos Kyriakopoulos,gr GRE,"FW,DF",Sassuolo,it Serie A,26,1996,8.5,21,8,7,9,5,10,14,71.4,4,7,1,6,11,32,12,1,Matches
1451,César de la Hoz,es ESP,MF,Almería,es La Liga,30,1992,18.6,37,20,17,18,2,19,37,51.4,18,26,6,20,13,50,37,0,Matches
1452,Luca de la Torre,us USA,MF,Celta Vigo,es La Liga,24,1998,16.5,28,19,11,14,3,12,32,37.5,20,22,1,21,9,37,6,0,Matches
1453,Rémy Labeau Lascary,gp GLP,"FW,MF",Lens,fr Ligue 1,19,2003,1.4,4,2,4,0,0,0,0,,0,4,0,4,1,5,0,0,Matches
1454,Gaëtan Laborde,fr FRA,FW,Nice,fr Ligue 1,28,1994,27.8,45,25,13,17,15,18,40,45.0,22,27,2,25,9,54,13,0,Matches
1455,Gaëtan Laborde,fr FRA,FW,Rennes,fr Ligue 1,28,1994,2.8,1,1,1,0,0,0,1,0.0,1,1,0,1,0,1,1,0,Matches
1456,Alexandre Lacazette,fr FRA,FW,Lyon,fr Ligue 1,31,1991,32.5,43,23,7,17,19,10,29,34.5,19,23,3,20,15,58,4,0,Matches
1457,Qazim Laçi,al ALB,MF,Ajaccio,fr Ligue 1,26,1996,2.4,6,3,2,3,1,4,9,44.4,5,5,0,5,2,8,3,0,Matches
1458,Maxence Lacroix,fr FRA,DF,Wolfsburg,de Bundesliga,22,2000,18.1,22,13,15,7,0,8,16,50.0,8,22,11,11,26,48,85,0,Matches
1459,Alban Lafont,fr FRA,GK,Nantes,fr Ligue 1,23,1999,37.0,0,0,0,0,0,0,1,0.0,1,0,0,0,0,0,20,4,Matches
1460,Aïssa Laïdouni,tn TUN,MF,Union Berlin,de Bundesliga,25,1996,9.7,14,7,6,8,0,5,17,29.4,12,22,4,18,9,23,3,0,Matches
1461,Konrad Laimer,at AUT,MF,RB Leipzig,de Bundesliga,25,1997,16.3,60,31,23,30,7,30,54,55.6,24,31,4,27,18,78,8,0,Matches
1462,Stefan Lainer,at AUT,DF,Gladbach,de Bundesliga,29,1992,9.1,16,8,10,5,1,10,23,43.5,13,8,1,7,14,30,34,1,Matches
1463,Kenny Lala,mg MAD,DF,Brest,fr Ligue 1,30,1991,15.7,36,19,19,15,2,22,38,57.9,16,15,5,10,21,57,28,0,Matches
1464,Adam Lallana,eng ENG,"MF,FW",Brighton,eng Premier League,34,1988,8.0,9,4,6,2,1,0,7,0.0,7,6,0,6,2,11,1,0,Matches
1465,Vassilis Lambropoulos,gr GRE,DF,Bochum,de Bundesliga,32,1990,7.0,10,8,7,3,0,6,9,66.7,3,5,3,2,13,23,41,0,Matches
1466,Érik Lamela,ar ARG,"FW,MF",Sevilla,es La Liga,30,1992,20.5,46,27,14,16,16,12,34,35.3,22,26,2,24,7,53,3,0,Matches
1467,Mohamed Lamine Bayo,gn GUI,"FW,MF",Lille,fr Ligue 1,24,1998,7.2,3,3,0,2,1,0,12,0.0,12,3,1,2,0,3,1,0,Matches
1468,Sam Lammers,nl NED,FW,Sampdoria,it Serie A,25,1997,12.2,12,5,2,7,3,6,15,40.0,9,10,3,7,6,18,11,0,Matches
1469,Sam Lammers,nl NED,FW,Empoli,it Serie A,25,1997,9.8,20,10,5,9,6,7,11,63.6,4,4,1,3,3,23,8,0,Matches
1470,Tariq Lamptey,gh GHA,DF,Brighton,eng Premier League,21,2000,5.0,11,6,6,4,1,5,7,71.4,2,7,3,4,7,18,2,0,Matches
1471,Manuel Lanzini,ar ARG,"MF,FW",West Ham,eng Premier League,29,1993,2.8,2,2,1,1,0,2,6,33.3,4,2,0,2,2,4,0,0,Matches
1472,Aymeric Laporte,es ESP,DF,Manchester City,eng Premier League,28,1994,11.0,11,8,6,4,1,7,11,63.6,4,10,4,6,3,14,30,1,Matches
1473,Julien Laporte,fr FRA,DF,Lorient,fr Ligue 1,28,1993,18.4,22,16,18,3,1,16,22,72.7,6,33,27,6,18,40,108,2,Matches
1474,Cyle Larin,ca CAN,FW,Valladolid,es La Liga,27,1995,16.3,9,3,2,4,3,3,7,42.9,4,6,3,3,0,9,15,0,Matches
1475,Juan Larios,es ESP,DF,Southampton,eng Premier League,18,2004,1.7,7,6,6,1,0,5,5,100.0,0,2,0,2,3,10,4,0,Matches
1476,Yasser Larouci,dz ALG,"DF,MF",Troyes,fr Ligue 1,21,2001,20.0,23,13,13,8,2,15,24,62.5,9,15,1,14,26,49,46,0,Matches
1477,Jordan Larsson,se SWE,"FW,MF",Schalke 04,de Bundesliga,25,1997,5.1,8,5,1,7,0,2,9,22.2,7,9,0,9,4,12,3,0,Matches
1478,Kevin Lasagna,it ITA,"FW,MF",Hellas Verona,it Serie A,29,1992,17.5,12,6,7,3,2,6,14,42.9,8,17,1,16,5,17,13,0,Matches
1479,Jamaal Lascelles,eng ENG,DF,Newcastle Utd,eng Premier League,28,1993,2.4,1,0,1,0,0,1,1,100.0,0,3,2,1,0,1,17,0,Matches
1480,Juanmi Latasa,es ESP,FW,Getafe,es La Liga,21,2001,5.0,5,4,2,0,3,1,1,100.0,0,3,1,2,1,6,8,0,Matches
1481,Toni Lato,es ESP,"DF,MF",Valencia,es La Liga,24,1997,10.2,23,11,9,12,2,9,21,42.9,12,10,1,9,6,29,14,0,Matches
1482,Danny Latza,de GER,MF,Schalke 04,de Bundesliga,32,1989,9.5,17,13,8,8,1,5,17,29.4,12,16,1,15,5,22,15,0,Matches
1483,Armand Lauriente,fr FRA,FW,Sassuolo,it Serie A,23,1998,24.2,21,15,5,7,9,8,21,38.1,13,20,0,20,12,33,8,0,Matches
1484,Armand Lauriente,fr FRA,FW,Lorient,fr Ligue 1,23,1998,3.0,8,7,3,4,1,3,7,42.9,4,5,1,4,4,12,1,0,Matches
1485,Roméo Lavia,be BEL,MF,Southampton,eng Premier League,18,2004,24.7,60,35,27,29,4,21,53,39.6,32,47,11,36,33,93,23,1,Matches
1486,Lázaro,br BRA,"FW,MF",Almería,es La Liga,20,2002,8.0,4,3,3,0,1,3,15,20.0,12,16,1,15,2,6,1,0,Matches
1487,Valentino Lazaro,at AUT,DF,Torino,it Serie A,26,1996,15.3,10,5,6,0,4,6,14,42.9,8,16,3,13,3,13,29,0,Matches
1488,Marko Lazetić,rs SRB,FW,Milan,it Serie A,18,2004,0.1,0,0,0,0,0,0,0,,0,0,0,0,0,0,0,0,Matches
1489,Darko Lazović,rs SRB,"MF,DF",Hellas Verona,it Serie A,31,1990,24.9,24,13,9,12,3,13,29,44.8,16,14,3,11,16,40,19,0,Matches
1490,Manuel Lazzari,it ITA,DF,Lazio,it Serie A,28,1993,20.9,33,21,13,14,6,21,36,58.3,15,20,6,14,18,51,36,1,Matches
1491,Théo Le Bris,fr FRA,"MF,DF",Lorient,fr Ligue 1,19,2002,16.1,31,19,17,11,3,15,33,45.5,18,21,2,19,18,49,31,0,Matches
1492,Julien Le Cardinal,fr FRA,DF,Lens,fr Ligue 1,24,1997,1.8,6,4,5,0,1,4,6,66.7,2,3,0,3,2,8,5,0,Matches
1493,Jérémy Le Douaron,fr FRA,"MF,FW",Brest,fr Ligue 1,24,1998,23.0,15,9,5,9,1,3,27,11.1,24,29,2,27,11,26,30,0,Matches
1494,Enzo Le Fée,fr FRA,MF,Lorient,fr Ligue 1,22,2000,33.6,108,64,52,40,16,43,113,38.1,70,50,5,45,34,142,38,1,Matches
1495,Vincent Le Goff,fr FRA,DF,Lorient,fr Ligue 1,32,1989,37.0,75,32,56,16,3,45,62,72.6,17,29,9,20,41,116,105,1,Matches
1496,Maxime Le Marchand,fr FRA,DF,Strasbourg,fr Ligue 1,32,1989,22.4,39,24,23,14,2,19,31,61.3,12,22,14,8,37,76,74,0,Matches
1497,Robin Le Normand,es ESP,DF,Real Sociedad,es La Liga,25,1996,31.1,36,23,25,9,2,14,27,51.9,13,22,14,8,33,69,93,0,Matches
1498,Rafael Leão,pt POR,"FW,MF",Milan,it Serie A,23,1999,26.9,8,7,2,3,3,6,14,42.9,8,9,2,7,15,23,8,0,Matches
1499,Paolo Lebas,fr FRA,MF,Ajaccio,fr Ligue 1,19,2003,0.6,0,0,0,0,0,0,0,,0,0,0,0,0,0,0,0,Matches
1500,Jean-Louis Leca,fr FRA,GK,Lens,fr Ligue 1,36,1985,1.0,0,0,0,0,0,0,0,,0,0,0,0,0,0,0,1,Matches
1501,Benjamin Lecomte,fr FRA,GK,Espanyol,es La Liga,31,1991,10.0,0,0,0,0,0,0,0,,0,0,0,0,0,0,3,2,Matches
1502,Benjamin Lecomte,fr FRA,GK,Montpellier,fr Ligue 1,31,1991,19.0,0,0,0,0,0,0,2,0.0,2,0,0,0,0,0,6,0,Matches
1503,Jeremías Ledesma,ar ARG,GK,Cádiz,es La Liga,29,1993,34.0,3,2,3,0,0,3,7,42.9,4,1,0,1,2,5,23,3,Matches
1504,Pierre Lees-Melou,fr FRA,MF,Brest,fr Ligue 1,29,1993,30.7,97,55,55,37,5,57,123,46.3,66,48,13,35,52,149,46,1,Matches
1505,Diogo Leite,pt POR,DF,Union Berlin,de Bundesliga,23,1999,25.0,35,20,21,14,0,21,34,61.8,13,23,14,9,26,61,99,1,Matches
1506,Maxim Leitsch,de GER,DF,Mainz 05,de Bundesliga,24,1998,7.4,9,7,6,3,0,4,5,80.0,1,7,4,3,18,27,26,1,Matches
1507,Florian Lejeune,fr FRA,DF,Rayo Vallecano,es La Liga,31,1991,28.5,28,17,19,8,1,17,25,68.0,8,24,16,8,15,43,123,0,Matches
1508,Iñigo Lekue,es ESP,DF,Athletic Club,es La Liga,29,1993,14.7,24,17,20,4,0,12,19,63.2,7,16,2,14,13,37,31,1,Matches
1509,Thomas Lemar,fr FRA,MF,Atlético Madrid,es La Liga,26,1995,13.9,30,18,10,13,7,10,28,35.7,18,12,3,9,7,37,12,0,Matches
1510,Félix Lemaréchal,fr FRA,MF,Brest,fr Ligue 1,18,2003,3.2,5,5,2,1,2,0,3,0.0,3,6,0,6,1,6,2,0,Matches
1511,Dexter Lembikisa,jm JAM,DF,Wolves,eng Premier League,18,2003,0.3,0,0,0,0,0,0,0,,0,0,0,0,0,0,0,0,Matches
1512,Mario Lemina,ga GAB,MF,Wolves,eng Premier League,28,1993,14.4,38,24,22,13,3,20,38,52.6,18,26,8,18,14,52,24,1,Matches
1513,Mario Lemina,ga GAB,"MF,DF",Nice,fr Ligue 1,28,1993,9.3,32,21,11,14,7,12,18,66.7,6,13,5,8,11,43,20,0,Matches
1514,Tim Lemperle,de GER,"FW,MF",Köln,de Bundesliga,20,2002,1.5,6,4,3,1,2,3,5,60.0,2,5,0,5,1,7,4,0,Matches
1515,Clément Lenglet,fr FRA,DF,Tottenham,eng Premier League,27,1995,22.4,38,23,18,15,5,16,34,47.1,18,26,11,15,18,56,68,2,Matches
1516,Bernd Leno,de GER,GK,Fulham,eng Premier League,30,1992,36.0,0,0,0,0,0,0,3,0.0,3,0,0,0,0,0,18,1,Matches
1517,Christopher Lenz,de GER,DF,Eint Frankfurt,de Bundesliga,27,1994,14.3,29,21,17,7,5,16,37,43.2,21,16,3,13,21,50,34,0,Matches
1518,Donovan Léon,gf GUF,GK,Auxerre,fr Ligue 1,29,1992,2.0,0,0,0,0,0,0,0,,0,0,0,0,0,0,1,0,Matches
1519,Sergio León,es ESP,FW,Valladolid,es La Liga,33,1989,14.8,6,4,0,4,2,3,6,50.0,3,6,0,6,0,6,4,0,Matches
1520,Johann Lepenant,fr FRA,MF,Lyon,fr Ligue 1,19,2002,21.5,58,34,24,27,7,32,86,37.2,54,29,5,24,28,86,17,3,Matches
1521,Mehdi Léris,dz ALG,"MF,DF",Sampdoria,it Serie A,24,1998,27.3,63,46,30,24,9,23,55,41.8,32,38,6,32,27,90,34,0,Matches
1522,Jefferson Lerma,co COL,MF,Bournemouth,eng Premier League,27,1994,36.1,50,30,23,23,4,20,45,44.4,25,32,15,17,47,97,91,2,Matches
1523,Benjamin Leroy,fr FRA,GK,Ajaccio,fr Ligue 1,33,1989,31.1,0,0,0,0,0,0,2,0.0,2,0,0,0,1,1,16,2,Matches
1524,Léo Leroy,fr FRA,MF,Montpellier,fr Ligue 1,22,2000,13.2,53,38,24,26,3,31,57,54.4,26,25,2,23,14,67,8,0,Matches
1525,Alexandre Letellier,fr FRA,GK,Paris S-G,fr Ligue 1,31,1990,0.1,0,0,0,0,0,0,0,,0,0,0,0,0,0,0,0,Matches
1526,Ruan Levine,br BRA,"MF,FW",Ajaccio,fr Ligue 1,23,1999,0.3,2,2,1,1,0,0,0,,0,1,0,1,2,4,0,0,Matches
1527,Robert Lewandowski,pl POL,FW,Barcelona,es La Liga,33,1988,31.6,17,11,2,5,10,7,14,50.0,7,20,0,20,2,19,14,0,Matches
1528,Jamie Leweling,de GER,"FW,MF",Union Berlin,de Bundesliga,21,2001,2.9,5,3,2,2,1,3,5,60.0,2,3,0,3,1,6,0,0,Matches
1529,Jamal Lewis,nir NIR,"DF,FW",Newcastle Utd,eng Premier League,24,1998,0.1,0,0,0,0,0,0,0,,0,0,0,0,0,0,0,0,Matches
1530,Rico Lewis,eng ENG,"DF,MF",Manchester City,eng Premier League,17,2004,10.0,16,9,9,5,2,6,11,54.5,5,8,4,4,6,22,13,1,Matches
1531,Keane Lewis-Potter,eng ENG,"FW,MF",Brentford,eng Premier League,21,2001,3.6,1,0,0,1,0,0,0,,0,5,1,4,0,1,2,0,Matches
1532,Dimitri Liénard,fr FRA,"DF,MF",Strasbourg,fr Ligue 1,34,1988,17.1,46,29,20,18,8,34,57,59.6,23,28,4,24,16,62,24,0,Matches
1533,Philipp Lienhart,at AUT,DF,Freiburg,de Bundesliga,26,1996,27.8,29,18,19,10,0,13,27,48.1,14,29,15,14,35,64,97,0,Matches
1534,Matthijs de Ligt,nl NED,DF,Bayern Munich,de Bundesliga,22,1999,26.7,32,23,15,16,1,15,24,62.5,9,31,20,11,23,55,85,0,Matches
1535,Dimitris Limnios,gr GRE,FW,Köln,de Bundesliga,24,1998,0.4,0,0,0,0,0,0,0,,0,0,0,0,1,1,0,0,Matches
1536,Victor Lindelöf,se SWE,DF,Manchester Utd,eng Premier League,28,1994,15.2,22,17,10,9,3,9,17,52.9,8,18,9,9,21,43,63,1,Matches
1537,Jesper Lindstrøm,dk DEN,"MF,FW",Eint Frankfurt,de Bundesliga,22,2000,18.7,26,11,15,7,4,7,22,31.8,15,25,3,22,9,35,9,0,Matches
1538,Karol Linetty,pl POL,MF,Torino,it Serie A,27,1995,21.0,32,17,7,22,3,13,25,52.0,12,28,8,20,19,51,25,0,Matches
1539,Jesse Lingard,eng ENG,"FW,MF",Nott'ham Forest,eng Premier League,29,1992,10.3,4,4,2,2,0,1,7,14.3,6,11,0,11,5,9,4,0,Matches
1540,Samuel Lino,br BRA,"FW,MF",Valencia,es La Liga,22,1999,32.1,66,43,17,37,12,26,72,36.1,46,34,0,34,18,84,16,0,Matches
1541,Pol Lirola,es ESP,DF,Elche,es La Liga,24,1997,7.0,13,6,9,3,1,8,13,61.5,5,3,2,1,7,20,16,0,Matches
1542,Mateusz Lis,pl POL,GK,Troyes,fr Ligue 1,25,1997,8.3,0,0,0,0,0,0,1,0.0,1,1,0,1,0,0,3,0,Matches
1543,Marcin Listkowski,pl POL,"MF,FW",Lecce,it Serie A,24,1998,0.9,0,0,0,0,0,0,0,,0,0,0,0,3,3,2,0,Matches
1544,Valentino Livramento,eng ENG,"DF,FW",Southampton,eng Premier League,19,2002,0.3,2,1,2,0,0,0,0,,0,0,0,0,2,4,3,0,Matches
1545,Dejan Ljubicic,at AUT,"MF,FW",Köln,de Bundesliga,24,1997,19.0,25,14,7,14,4,13,40,32.5,27,20,1,19,8,33,8,1,Matches
1546,Javier Llabrés,es ESP,FW,Mallorca,es La Liga,19,2002,0.2,0,0,0,0,0,0,0,,0,0,0,0,0,0,1,0,Matches
1547,Diego Llorente,es ESP,DF,Leeds United,eng Premier League,28,1993,7.2,13,10,8,5,0,4,8,50.0,4,6,2,4,15,28,24,2,Matches
1548,Diego Llorente,es ESP,DF,Roma,it Serie A,28,1993,6.4,10,5,6,4,0,5,12,41.7,7,4,2,2,11,21,20,0,Matches
1549,Marcos Llorente,es ESP,"MF,DF",Atlético Madrid,es La Liga,27,1995,18.9,32,15,16,10,6,17,30,56.7,13,26,2,24,17,49,19,0,Matches
1550,Hugo Lloris,fr FRA,GK,Tottenham,eng Premier League,35,1986,24.5,1,1,1,0,0,1,3,33.3,2,0,0,0,1,2,13,5,Matches
1551,Giovani Lo Celso,ar ARG,"MF,FW",Villarreal,es La Liga,26,1996,12.5,32,28,7,15,10,12,21,57.1,9,14,2,12,6,38,5,0,Matches
1552,Stanislav Lobotka,sk SVK,MF,Napoli,it Serie A,27,1994,34.5,83,44,35,35,13,43,73,58.9,30,29,7,22,23,106,16,0,Matches
1553,Manuel Locatelli,it ITA,MF,Juventus,it Serie A,24,1998,27.2,59,33,26,23,10,30,53,56.6,23,50,22,28,27,86,59,0,Matches
1554,Luka Lochoshvili,ge GEO,DF,Cremonese,it Serie A,24,1998,20.4,45,19,30,11,4,22,31,71.0,9,31,10,21,22,67,89,0,Matches
1555,Bradley Locko,fr FRA,DF,Reims,fr Ligue 1,20,2002,11.8,31,16,21,4,6,15,27,55.6,12,17,4,13,20,51,21,0,Matches
1556,Bradley Locko,fr FRA,DF,Brest,fr Ligue 1,20,2002,3.0,4,3,2,1,1,2,3,66.7,1,4,0,4,2,6,13,0,Matches
1557,Renan Lodi,br BRA,DF,Nott'ham Forest,eng Premier League,24,1998,24.6,52,39,38,8,6,33,66,50.0,33,25,6,19,33,85,74,0,Matches
1558,Ruben Loftus-Cheek,eng ENG,"MF,DF",Chelsea,eng Premier League,26,1996,17.1,25,14,8,14,3,12,22,54.5,10,15,2,13,12,37,23,0,Matches
1559,Sean Longstaff,eng ENG,MF,Newcastle Utd,eng Premier League,24,1997,28.0,42,21,16,20,6,20,52,38.5,32,35,8,27,16,58,23,0,Matches
1560,Ademola Lookman,ng NGA,"FW,MF",Atalanta,it Serie A,24,1997,19.2,13,5,2,6,5,3,15,20.0,12,18,0,18,4,17,1,0,Matches
1561,Anthony Lopes,pt POR,GK,Lyon,fr Ligue 1,31,1990,31.3,1,0,1,0,0,1,4,25.0,3,0,0,0,3,4,10,0,Matches
1562,Rony Lopes,pt POR,"MF,FW",Troyes,fr Ligue 1,26,1995,26.1,24,12,6,15,3,7,31,22.6,24,14,2,12,9,33,10,0,Matches
1563,David López,es ESP,DF,Girona,es La Liga,32,1989,18.4,31,18,17,13,1,19,27,70.4,8,29,19,10,14,45,64,1,Matches
1564,Diego López,es ESP,GK,Rayo Vallecano,es La Liga,40,1981,1.1,0,0,0,0,0,0,0,,0,0,0,0,0,0,0,1,Matches
1565,Diego López,es ESP,"FW,MF",Valencia,es La Liga,20,2002,5.0,2,2,1,1,0,2,15,13.3,13,9,0,9,3,5,5,0,Matches
1566,Maxime Lopez,fr FRA,MF,Sassuolo,it Serie A,24,1997,25.5,42,18,26,12,4,16,56,28.6,40,24,6,18,22,64,21,0,Matches
1567,Pau López,es ESP,GK,Marseille,fr Ligue 1,27,1994,32.5,0,0,0,0,0,0,1,0.0,1,0,0,0,0,0,5,1,Matches
1568,Unai López,es ESP,MF,Rayo Vallecano,es La Liga,26,1995,13.9,32,20,10,17,5,13,37,35.1,24,12,1,11,15,47,6,1,Matches
1569,Dion Lopy,sn SEN,MF,Reims,fr Ligue 1,20,2002,15.3,45,24,22,16,7,23,62,37.1,39,27,3,24,22,67,18,0,Matches
1570,Anthony Losilla,fr FRA,MF,Bochum,de Bundesliga,36,1986,30.2,76,49,32,34,10,38,77,49.4,39,39,12,27,37,113,67,0,Matches
1571,Jordan Lotomba,ch SUI,DF,Nice,fr Ligue 1,23,1998,27.3,65,38,33,24,8,31,48,64.6,17,38,11,27,32,97,53,0,Matches
1572,Matteo Lovato,it ITA,DF,Salernitana,it Serie A,22,2000,9.0,17,14,14,3,0,10,25,40.0,15,8,5,3,13,30,33,2,Matches
1573,Dejan Lovren,hr CRO,DF,Lyon,fr Ligue 1,33,1989,16.2,25,19,20,5,0,20,29,69.0,9,20,10,10,26,51,70,1,Matches
1574,Sandi Lovrić,si SVN,MF,Udinese,it Serie A,24,1998,25.9,40,18,16,16,8,25,43,58.1,18,25,2,23,26,66,21,0,Matches
1575,Jamal Lowe,jm JAM,"MF,FW",Bournemouth,eng Premier League,28,1994,0.1,0,0,0,0,0,0,0,,0,0,0,0,0,0,0,0,Matches
1576,Anthony Lozano,hn HON,FW,Cádiz,es La Liga,29,1993,16.0,6,4,1,4,1,1,7,14.3,6,12,1,11,3,9,17,0,Matches
1577,Hirving Lozano,mx MEX,FW,Napoli,it Serie A,27,1995,17.8,24,13,10,6,8,9,21,42.9,12,31,0,31,15,39,6,0,Matches
1578,Pol Lozano,es ESP,MF,Espanyol,es La Liga,22,1999,0.2,0,0,0,0,0,0,0,,0,1,0,1,0,0,1,0,Matches
1579,Jean Lucas,br BRA,MF,Monaco,fr Ligue 1,24,1998,3.2,9,5,3,5,1,6,12,50.0,6,2,1,1,4,13,2,0,Matches
1580,Jhon Lucumí,co COL,DF,Bologna,it Serie A,24,1998,32.2,53,37,39,13,1,24,43,55.8,19,43,26,17,35,88,100,1,Matches
1581,José Luis Gayà,es ESP,DF,Valencia,es La Liga,27,1995,30.1,80,46,61,16,3,43,74,58.1,31,28,9,19,23,103,48,0,Matches
1582,José Luis Morales,es ESP,"FW,MF",Villarreal,es La Liga,35,1987,13.5,7,6,1,2,4,5,17,29.4,12,12,1,11,2,9,2,0,Matches
1583,José Luis Palomino,ar ARG,DF,Atalanta,it Serie A,32,1990,8.4,23,14,16,7,0,11,19,57.9,8,11,4,7,28,51,20,0,Matches
1584,Douglas Luiz,br BRA,MF,Aston Villa,eng Premier League,24,1998,32.5,72,42,31,32,9,29,63,46.0,34,36,7,29,40,112,27,2,Matches
1585,Romelu Lukaku,be BEL,FW,Inter,it Serie A,29,1993,18.4,3,1,1,0,2,2,5,40.0,3,3,1,2,0,3,16,0,Matches
1586,Castello Lukeba,fr FRA,DF,Lyon,fr Ligue 1,19,2002,33.2,39,23,27,8,4,21,31,67.7,10,42,24,18,75,114,105,1,Matches
1587,Dodi Lukebakio,be BEL,"FW,MF",Hertha BSC,de Bundesliga,24,1997,26.6,18,11,7,8,3,6,27,22.2,21,23,5,18,13,31,17,0,Matches
1588,Saša Lukić,rs SRB,MF,Fulham,eng Premier League,25,1996,4.6,8,3,1,4,3,3,7,42.9,4,6,2,4,5,13,3,0,Matches
1589,Saša Lukić,rs SRB,MF,Torino,it Serie A,25,1996,13.3,21,14,10,10,1,9,15,60.0,6,17,7,10,13,34,10,0,Matches
1590,Andriy Lunin,ua UKR,GK,Real Madrid,es La Liga,23,1999,7.0,0,0,0,0,0,0,0,,0,0,0,0,0,0,1,0,Matches
1591,Andrey Lunyov,ru RUS,GK,Leverkusen,de Bundesliga,30,1991,1.0,0,0,0,0,0,0,0,,0,0,0,0,0,0,0,0,Matches
1592,Sebastiano Luperto,it ITA,DF,Empoli,it Serie A,25,1996,34.8,33,18,24,8,1,9,20,45.0,11,54,42,12,43,76,163,1,Matches
1593,Lyanco,br BRA,DF,Southampton,eng Premier League,25,1997,13.1,24,16,15,9,0,12,18,66.7,6,30,25,5,20,44,65,2,Matches
1594,Charalambos Lykogiannis,gr GRE,DF,Bologna,it Serie A,28,1993,12.3,16,8,5,6,5,5,13,38.5,8,9,4,5,15,31,30,0,Matches
1595,Youssouf M'Changama,km COM,MF,Auxerre,fr Ligue 1,31,1990,12.0,22,11,7,12,3,7,13,53.8,6,6,0,6,15,37,6,1,Matches
1596,Awer Mabil,au AUS,"MF,FW",Cádiz,es La Liga,26,1995,1.8,2,0,0,1,1,1,3,33.3,2,1,1,0,0,2,1,0,Matches
1597,Alexis Mac Allister,ar ARG,MF,Brighton,eng Premier League,23,1998,32.1,70,39,22,40,8,34,71,47.9,37,26,2,24,22,92,10,1,Matches
1598,Deiver Machado,co COL,"DF,MF",Lens,fr Ligue 1,28,1993,24.3,45,26,18,20,7,21,34,61.8,13,21,4,17,21,66,27,0,Matches
1599,Darwin Machís,ve VEN,FW,Valladolid,es La Liga,29,1993,6.7,3,2,0,2,1,1,8,12.5,7,5,0,5,3,6,4,0,Matches
1600,James Maddison,eng ENG,"MF,FW",Leicester City,eng Premier League,25,1996,27.6,51,26,25,19,7,19,50,38.0,31,19,1,18,13,64,6,1,Matches
1601,Noni Madueke,eng ENG,FW,Chelsea,eng Premier League,20,2002,7.1,12,8,5,4,3,6,13,46.2,7,13,2,11,4,16,7,0,Matches
1602,Pablo Maffeo,es ESP,DF,Mallorca,es La Liga,25,1997,33.1,75,46,54,16,5,45,78,57.7,33,38,11,27,26,101,76,0,Matches
1603,Gabriel Magalhães,br BRA,DF,Arsenal,eng Premier League,24,1997,37.9,48,30,29,15,4,18,27,66.7,9,49,26,23,32,80,125,3,Matches
1604,Lisandro Magallán,ar ARG,DF,Elche,es La Liga,28,1993,10.0,19,11,11,5,3,10,12,83.3,2,14,5,9,13,32,30,1,Matches
1605,Soungoutou Magassa,fr FRA,MF,Monaco,fr Ligue 1,18,2003,0.9,4,1,2,2,0,2,4,50.0,2,3,0,3,1,5,1,0,Matches
1606,Giulio Maggiore,it ITA,MF,Salernitana,it Serie A,24,1998,9.9,20,8,11,6,3,10,21,47.6,11,19,4,15,8,28,10,0,Matches
1607,Giangiacomo Magnani,it ITA,DF,Hellas Verona,it Serie A,26,1995,17.0,33,22,20,11,2,19,25,76.0,6,20,15,5,21,54,76,0,Matches
1608,Hugo Magnetti,fr FRA,MF,Brest,fr Ligue 1,24,1998,18.8,43,27,18,23,2,23,63,36.5,40,21,1,20,25,68,12,0,Matches
1609,Yohann Magnin,fr FRA,MF,Clermont Foot,fr Ligue 1,25,1997,26.7,89,54,37,45,7,54,106,50.9,52,50,12,38,25,114,46,0,Matches
1610,Harry Maguire,eng ENG,DF,Manchester Utd,eng Premier League,29,1993,8.5,8,6,6,1,1,4,5,80.0,1,18,11,7,13,21,41,0,Matches
1611,Jon Magunacelaya,es ESP,"MF,FW",Real Sociedad,es La Liga,22,2000,0.7,1,0,0,0,1,0,2,0.0,2,0,0,0,0,1,1,0,Matches
1612,Riyad Mahrez,dz ALG,"FW,MF",Manchester City,eng Premier League,31,1991,21.3,30,14,8,13,9,13,39,33.3,26,27,1,26,9,39,5,0,Matches
1613,Arne Maier,de GER,MF,Augsburg,de Bundesliga,23,1999,21.8,31,22,17,11,3,10,18,55.6,8,21,0,21,15,46,22,0,Matches
1614,Mike Maignan,fr FRA,GK,Milan,it Serie A,27,1995,22.0,1,0,1,0,0,1,1,100.0,0,0,0,0,1,2,10,1,Matches
1615,Linton Maina,de GER,"FW,MF",Köln,de Bundesliga,23,1999,24.9,18,12,5,11,2,7,30,23.3,23,19,0,19,5,23,9,0,Matches
1616,Kobbie Mainoo,eng ENG,MF,Manchester Utd,eng Premier League,17,2005,0.1,0,0,0,0,0,0,0,,0,1,1,0,0,0,0,0,Matches
1617,Ainsley Maitland-Niles,eng ENG,"DF,MF",Southampton,eng Premier League,24,1997,15.6,45,24,23,18,4,28,44,63.6,16,28,7,21,22,67,45,1,Matches
1618,Jordan Majchrzak,pl POL,FW,Roma,it Serie A,17,2004,0.2,0,0,0,0,0,0,0,,0,0,0,0,0,0,0,0,Matches
1619,Lovro Majer,hr CRO,"MF,FW",Rennes,fr Ligue 1,24,1998,18.5,34,23,16,13,5,8,29,27.6,21,21,1,20,21,55,5,1,Matches
1620,Jean-Victor Makengo,fr FRA,MF,Udinese,it Serie A,24,1998,8.9,16,13,7,7,2,5,9,55.6,4,8,2,6,9,25,3,0,Matches
1621,Jean-Victor Makengo,fr FRA,MF,Lorient,fr Ligue 1,24,1998,11.8,16,8,5,10,1,6,20,30.0,14,8,5,3,10,26,13,1,Matches
1622,Béni Makouana,cg CGO,"FW,MF",Montpellier,fr Ligue 1,19,2002,2.2,1,0,0,1,0,0,2,0.0,2,3,1,2,0,1,1,0,Matches
1623,Nemanja Maksimović,rs SRB,MF,Getafe,es La Liga,27,1995,22.8,41,30,17,18,6,19,32,59.4,13,36,14,22,34,75,27,0,Matches
1624,Tyrell Malacia,nl NED,DF,Manchester Utd,eng Premier League,22,1999,15.5,46,33,33,12,1,14,25,56.0,11,13,3,10,25,71,49,0,Matches
1625,Lorenzo Malagrida,it ITA,"MF,DF",Sampdoria,it Serie A,18,2003,1.2,1,0,0,0,1,1,3,33.3,2,1,0,1,0,1,1,0,Matches
1626,Daniel Maldini,it ITA,"FW,MF",Spezia,it Serie A,20,2001,7.0,12,5,3,4,5,4,11,36.4,7,9,0,9,1,13,8,0,Matches
1627,Youssef Maleh,ma MAR,MF,Fiorentina,it Serie A,23,1998,3.3,3,1,0,3,0,0,4,0.0,4,5,0,5,1,4,3,0,Matches
1628,Youssef Maleh,ma MAR,MF,Lecce,it Serie A,23,1998,7.5,17,8,3,7,7,6,14,42.9,8,20,1,19,5,22,10,0,Matches
1629,Donyell Malen,nl NED,FW,Dortmund,de Bundesliga,23,1999,19.0,13,5,3,4,6,5,12,41.7,7,14,1,13,4,17,11,0,Matches
1630,Ruslan Malinovskyi,ua UKR,"MF,FW",Atalanta,it Serie A,29,1993,6.1,14,8,5,6,3,6,17,35.3,11,8,1,7,5,19,2,0,Matches
1631,Ruslan Malinovskyi,ua UKR,"MF,FW",Marseille,fr Ligue 1,29,1993,13.6,21,11,3,12,6,10,26,38.5,16,13,1,12,3,24,9,0,Matches
1632,Hugo Mallo,es ESP,DF,Celta Vigo,es La Liga,31,1991,24.0,53,29,34,14,5,28,42,66.7,14,28,7,21,24,77,73,0,Matches
1633,Mickael Malsa,mq MTQ,MF,Valladolid,es La Liga,26,1995,0.8,2,2,1,1,0,1,4,25.0,3,1,1,0,2,4,3,0,Matches
1634,Giorgi Mamardashvili,ge GEO,GK,Valencia,es La Liga,21,2000,38.0,0,0,0,0,0,0,0,,0,0,0,0,1,1,11,4,Matches
1635,Hianga Mananga Mbock,fr FRA,MF,Brest,fr Ligue 1,22,1999,0.2,0,0,0,0,0,0,1,0.0,1,0,0,0,0,0,0,0,Matches
1636,Gianluca Mancini,it ITA,DF,Roma,it Serie A,26,1996,31.8,37,19,27,9,1,18,34,52.9,16,38,17,21,46,83,67,0,Matches
1637,Steve Mandanda,fr FRA,GK,Rennes,fr Ligue 1,37,1985,33.5,0,0,0,0,0,0,2,0.0,2,0,0,0,0,0,9,3,Matches
1638,Reinildo Mandava,mz MOZ,DF,Atlético Madrid,es La Liga,28,1994,20.6,66,43,46,19,1,38,49,77.6,11,27,12,15,30,96,59,0,Matches
1639,Aïssa Mandi,dz ALG,DF,Villarreal,es La Liga,30,1991,16.2,18,10,14,3,1,6,12,50.0,6,19,14,5,21,39,58,0,Matches
1640,Rolando Mandragora,it ITA,MF,Fiorentina,it Serie A,25,1997,21.7,42,24,12,22,8,23,52,44.2,29,25,3,22,16,58,21,0,Matches
1641,Sadio Mané,sn SEN,"FW,MF",Bayern Munich,de Bundesliga,30,1992,15.8,11,5,3,3,5,1,9,11.1,8,15,2,13,0,11,4,0,Matches
1642,Orel Mangala,be BEL,MF,Nott'ham Forest,eng Premier League,24,1998,17.2,28,20,16,10,2,12,29,41.4,17,21,7,14,23,51,15,0,Matches
1643,Thomas Mangani,fr FRA,MF,Ajaccio,fr Ligue 1,35,1987,14.8,32,17,14,15,3,18,47,38.3,29,22,3,19,24,56,22,1,Matches
1644,Vito Mannone,it ITA,GK,Lorient,fr Ligue 1,34,1988,17.9,0,0,0,0,0,0,0,,0,0,0,0,0,0,4,3,Matches
1645,Javier Manquillo,es ESP,DF,Newcastle Utd,eng Premier League,28,1994,0.4,3,2,2,1,0,2,2,100.0,0,1,0,1,1,4,1,0,Matches
1646,Myziane Maolida,km COM,"MF,FW",Reims,fr Ligue 1,23,1999,2.6,8,3,2,5,1,5,12,41.7,7,1,0,1,2,10,0,0,Matches
1647,Myziane Maolida,km COM,"FW,MF",Hertha BSC,de Bundesliga,23,1999,1.1,1,1,1,0,0,1,2,50.0,1,0,0,0,0,1,1,0,Matches
1648,Faitout Maouassa,fr FRA,"FW,DF",Montpellier,fr Ligue 1,24,1998,21.4,52,32,26,20,6,18,41,43.9,23,31,3,28,20,72,23,0,Matches
1649,Sekou Mara,fr FRA,"FW,MF",Southampton,eng Premier League,20,2002,6.2,14,10,5,8,1,3,9,33.3,6,11,0,11,1,15,5,0,Matches
1650,Marcão,br BRA,DF,Sevilla,es La Liga,26,1996,4.2,2,2,1,1,0,1,1,100.0,0,3,3,0,6,8,14,0,Matches
1651,Solly March,eng ENG,"FW,DF",Brighton,eng Premier League,28,1994,30.2,53,31,16,17,20,8,28,28.6,20,34,3,31,24,77,32,0,Matches
1652,Agustín Marchesín,ar ARG,GK,Celta Vigo,es La Liga,34,1988,19.0,0,0,0,0,0,0,1,0.0,1,0,0,0,0,0,7,0,Matches
1653,Federico Marchetti,it ITA,GK,Spezia,it Serie A,39,1983,0.7,0,0,0,0,0,0,0,,0,0,0,0,0,0,0,0,Matches
1654,Vincent Marchetti,fr FRA,MF,Ajaccio,fr Ligue 1,25,1997,27.2,55,26,29,19,7,25,68,36.8,43,23,3,20,19,74,31,0,Matches
1655,Riccardo Marchizza,it ITA,DF,Sassuolo,it Serie A,24,1998,3.1,2,2,1,1,0,2,4,50.0,2,2,0,2,2,4,8,0,Matches
1656,Gian Marco Ferrari,it ITA,DF,Sassuolo,it Serie A,30,1992,24.7,23,16,11,10,2,10,17,58.8,7,29,20,9,23,46,81,4,Matches
1657,Emiliano Marcondes,dk DEN,MF,Bournemouth,eng Premier League,27,1995,0.1,0,0,0,0,0,0,0,,0,0,0,0,0,0,1,0,Matches
1658,Óscar de Marcos,es ESP,DF,Athletic Club,es La Liga,33,1989,31.3,67,33,34,22,11,40,76,52.6,36,42,6,36,29,96,59,0,Matches
1659,Alberto Marí,es ESP,"FW,MF",Valencia,es La Liga,21,2001,1.0,0,0,0,0,0,0,2,0.0,2,0,0,0,0,0,1,0,Matches
1660,José Mari,es ESP,MF,Cádiz,es La Liga,34,1987,4.4,16,7,12,3,1,10,16,62.5,6,3,1,2,5,21,9,0,Matches
1661,Pablo Marí,es ESP,DF,Monza,it Serie A,28,1993,27.6,37,19,29,7,1,17,26,65.4,9,22,14,8,31,68,111,3,Matches
1662,José María Giménez,uy URU,DF,Atlético Madrid,es La Liga,27,1995,26.9,43,25,28,14,1,24,35,68.6,11,37,17,20,24,67,138,1,Matches
1663,Mariano,do DOM,FW,Real Madrid,es La Liga,28,1993,1.7,1,0,0,1,0,0,0,,0,1,0,1,0,1,0,0,Matches
1664,Pablo Marín,es ESP,"MF,FW",Real Sociedad,es La Liga,19,2003,4.0,10,5,5,4,1,2,7,28.6,5,1,0,1,4,14,2,0,Matches
1665,Răzvan Marin,ro ROU,MF,Empoli,it Serie A,26,1996,28.2,44,22,22,21,1,19,40,47.5,21,29,11,18,14,58,33,0,Matches
1666,Diego Mariño,es ESP,GK,Almería,es La Liga,32,1990,0.5,0,0,0,0,0,0,0,,0,0,0,0,0,0,0,0,Matches
1667,Guillermo Maripán,cl CHI,DF,Monaco,fr Ligue 1,28,1994,24.0,46,26,26,20,0,17,33,51.5,16,39,27,12,38,84,87,0,Matches
1668,Marlon,br BRA,DF,Monza,it Serie A,26,1995,17.7,35,21,20,14,1,15,29,51.7,14,13,4,9,18,53,50,0,Matches
1669,Omar Marmoush,eg EGY,FW,Wolfsburg,de Bundesliga,23,1999,16.4,16,10,8,2,6,4,16,25.0,12,21,1,20,7,23,4,0,Matches
1670,Marquinhos,br BRA,MF,Arsenal,eng Premier League,19,2003,0.0,0,0,0,0,0,0,0,,0,0,0,0,0,0,0,0,Matches
1671,Marquinhos,br BRA,DF,Paris S-G,fr Ligue 1,28,1994,30.2,33,25,18,12,3,18,26,69.2,8,43,27,16,23,56,83,2,Matches
1672,Luca Marrone,it ITA,DF,Monza,it Serie A,32,1990,1.5,0,0,0,0,0,0,2,0.0,2,2,2,0,0,0,4,1,Matches
1673,Eric Martel,de GER,MF,Köln,de Bundesliga,20,2002,22.4,66,41,29,30,7,30,60,50.0,30,29,9,20,33,99,49,0,Matches
1674,Roger Martí,es ESP,FW,Elche,es La Liga,31,1991,7.3,5,2,3,2,0,1,5,20.0,4,4,0,4,1,6,7,0,Matches
1675,Roger Martí,es ESP,FW,Cádiz,es La Liga,31,1991,7.1,6,4,2,3,1,1,8,12.5,7,7,0,7,2,8,7,0,Matches
1676,Anthony Martial,fr FRA,FW,Manchester Utd,eng Premier League,26,1995,10.9,5,3,0,2,3,1,4,25.0,3,11,2,9,1,6,4,0,Matches
1677,Aarón Martín,es ESP,DF,Mainz 05,de Bundesliga,25,1997,20.5,42,27,25,11,6,21,40,52.5,19,22,1,21,15,57,31,0,Matches
1678,Ander Martin,es ESP,"MF,FW",Real Sociedad,es La Liga,21,2000,0.5,2,2,1,1,0,1,4,25.0,3,0,0,0,0,2,1,0,Matches
1679,Andrés Martín,es ESP,"FW,MF",Rayo Vallecano,es La Liga,23,1999,2.3,4,2,2,1,1,3,5,60.0,2,2,0,2,1,5,2,0,Matches
1680,Carlos Martín,es ESP,"FW,MF",Atlético Madrid,es La Liga,20,2002,0.3,2,2,0,2,0,2,3,66.7,1,0,0,0,1,3,0,0,Matches
1681,Iván Martín,es ESP,MF,Girona,es La Liga,23,1999,17.6,9,7,4,4,1,8,23,34.8,15,12,0,12,9,18,12,0,Matches
1682,Jonas Martin,fr FRA,MF,Lille,fr Ligue 1,32,1990,3.1,9,7,4,5,0,5,14,35.7,9,3,1,2,7,16,3,0,Matches
1683,Gabriel Martinelli,br BRA,FW,Arsenal,eng Premier League,21,2001,31.0,31,18,13,12,6,9,22,40.9,13,24,1,23,9,40,14,0,Matches
1684,Arnau Martinez,es ESP,DF,Girona,es La Liga,19,2003,30.4,69,45,41,19,9,38,85,44.7,47,44,10,34,25,94,54,2,Matches
1685,Emiliano Martínez,ar ARG,GK,Aston Villa,eng Premier League,29,1992,34.9,0,0,0,0,0,0,2,0.0,2,0,0,0,1,1,23,1,Matches
1686,Iñigo Martínez,es ESP,DF,Athletic Club,es La Liga,31,1991,14.9,18,8,11,7,0,6,9,66.7,3,17,11,6,18,36,55,0,Matches
1687,Lautaro Martínez,ar ARG,FW,Inter,it Serie A,24,1997,28.6,25,14,3,15,7,7,23,30.4,16,31,1,30,13,38,16,1,Matches
1688,Lisandro Martínez,ar ARG,DF,Manchester Utd,eng Premier League,24,1998,23.5,54,28,33,18,3,30,43,69.8,13,51,27,24,33,87,103,0,Matches
1689,Lucas Martínez Quarta,ar ARG,DF,Fiorentina,it Serie A,26,1996,24.1,80,48,44,32,4,42,61,68.9,19,41,19,22,48,128,78,1,Matches
1690,Roger Martínez,es ESP,DF,Espanyol,es La Liga,18,2004,0.1,0,0,0,0,0,0,0,,0,0,0,0,0,0,0,0,Matches
1691,Gelson Martins,pt POR,"MF,FW",Monaco,fr Ligue 1,27,1995,3.8,15,8,6,4,5,4,13,30.8,9,4,1,3,3,18,2,0,Matches
1692,Adam Marušić,me MNE,DF,Lazio,it Serie A,29,1992,30.7,41,30,23,14,4,25,39,64.1,14,20,6,14,38,79,63,1,Matches
1693,Omar Mascarell,gq EQG,"MF,DF",Elche,es La Liga,29,1993,27.2,53,26,32,19,2,31,64,48.4,33,51,19,32,45,98,54,1,Matches
1694,Adam Masina,ma MAR,DF,Udinese,it Serie A,28,1994,8.8,10,7,7,3,0,6,15,40.0,9,11,4,7,10,20,28,1,Matches
1695,Jordi Masip,es ESP,GK,Valladolid,es La Liga,33,1989,27.9,0,0,0,0,0,0,2,0.0,2,0,0,0,1,1,3,2,Matches
1696,Erhan Mašović,rs SRB,"DF,MF",Bochum,de Bundesliga,23,1998,24.2,50,31,28,21,1,30,51,58.8,21,30,14,16,27,77,79,0,Matches
1697,Han-Noah Massengo,fr FRA,MF,Auxerre,fr Ligue 1,21,2001,12.4,27,15,10,15,2,7,16,43.8,9,12,3,9,14,41,7,0,Matches
1698,Yanis Massolin,fr FRA,MF,Clermont Foot,fr Ligue 1,19,2002,0.7,2,1,1,0,1,0,1,0.0,1,1,0,1,2,4,0,0,Matches
1699,Jaime Mata,es ESP,"FW,MF",Getafe,es La Liga,33,1988,4.9,13,10,4,5,4,7,22,31.8,15,7,2,5,3,16,6,0,Matches
1700,Pape Matar Sarr,sn SEN,"MF,FW",Tottenham,eng Premier League,19,2002,2.4,7,6,4,2,1,4,8,50.0,4,3,2,1,6,13,6,0,Matches
1701,Eliot Matazo,be BEL,MF,Monaco,fr Ligue 1,20,2002,13.1,26,12,11,13,2,11,26,42.3,15,18,4,14,15,41,11,1,Matches
1702,Jean-Philippe Mateta,fr FRA,FW,Crystal Palace,eng Premier League,25,1997,8.6,7,1,2,4,1,1,3,33.3,2,3,1,2,3,10,18,0,Matches
1703,Nemanja Matić,rs SRB,MF,Roma,it Serie A,33,1988,20.6,47,27,24,19,4,19,33,57.6,14,27,7,20,25,72,21,1,Matches
1704,Joël Matip,cm CMR,DF,Liverpool,eng Premier League,30,1991,12.1,14,8,12,2,0,11,23,47.8,12,8,3,5,21,35,45,3,Matches
1705,Henning Matriciani,de GER,DF,Schalke 04,de Bundesliga,22,2000,20.7,43,23,28,12,3,26,60,43.3,34,28,11,17,23,66,57,1,Matches
1706,Chrislain Matsima,fr FRA,"DF,MF",Lorient,fr Ligue 1,20,2002,2.5,0,0,0,0,0,0,0,,0,3,3,0,2,2,7,0,Matches
1707,Chrislain Matsima,fr FRA,DF,Monaco,fr Ligue 1,20,2002,5.0,11,6,7,2,2,4,7,57.1,3,5,5,0,9,20,16,0,Matches
1708,Jean Mattéo Bahoya,fr FRA,"FW,MF",Angers,fr Ligue 1,17,2005,3.0,7,3,1,3,3,4,7,57.1,3,4,0,4,0,7,0,0,Matches
1709,Azor Matusiwa,nl NED,MF,Reims,fr Ligue 1,24,1998,27.6,66,41,30,29,7,36,61,59.0,25,37,11,26,46,112,52,0,Matches
1710,Neal Maupay,fr FRA,FW,Everton,eng Premier League,25,1996,12.4,11,5,3,4,4,2,4,50.0,2,8,0,8,5,16,0,0,Matches
1711,Aïman Maurer,ma MAR,MF,Clermont Foot,fr Ligue 1,17,2004,5.6,2,1,1,1,0,1,10,10.0,9,1,0,1,3,5,5,0,Matches
1712,Stephy Mavididi,eng ENG,FW,Montpellier,fr Ligue 1,24,1998,14.3,24,19,12,8,4,13,27,48.1,14,21,1,20,4,28,10,0,Matches
1713,Konstantinos Mavropanos,gr GRE,DF,Stuttgart,de Bundesliga,24,1997,25.4,50,27,32,15,3,28,38,73.7,10,39,18,21,63,113,99,0,Matches
1714,Christian Mawissa,fr FRA,DF,Toulouse,fr Ligue 1,17,2005,1.1,2,0,1,1,0,1,3,33.3,2,0,0,0,3,5,1,0,Matches
1715,Philipp Max,de GER,DF,Eint Frankfurt,de Bundesliga,28,1993,7.7,12,9,4,7,1,5,16,31.3,11,10,2,8,3,15,11,0,Matches
1716,Eric Maxim Choupo-Moting,cm CMR,FW,Bayern Munich,de Bundesliga,33,1989,12.4,10,7,2,6,2,1,2,50.0,1,8,0,8,0,10,5,0,Matches
1717,Luís Maximiano,pt POR,GK,Lazio,it Serie A,23,1999,0.1,0,0,0,0,0,0,0,,0,0,0,0,0,0,0,0,Matches
1718,Keke Maximilian Topp,de GER,FW,Schalke 04,de Bundesliga,18,2004,0.2,0,0,0,0,0,0,0,,0,0,0,0,1,1,0,0,Matches
1719,Fernand Mayembo,cg CGO,DF,Ajaccio,fr Ligue 1,26,1996,7.9,8,5,6,2,0,4,9,44.4,5,2,0,2,11,19,36,0,Matches
1720,Borja Mayoral,es ESP,FW,Getafe,es La Liga,25,1997,30.7,9,4,7,2,0,5,31,16.1,26,18,0,18,3,12,10,0,Matches
1721,Ibrahim Maza,de GER,"MF,FW",Hertha BSC,de Bundesliga,16,2005,0.8,1,1,1,0,0,0,1,0.0,1,2,0,2,0,1,1,0,Matches
1722,Derek Mazou-Sacko,fr FRA,MF,Troyes,fr Ligue 1,17,2004,0.2,0,0,0,0,0,0,1,0.0,1,1,0,1,1,1,1,0,Matches
1723,Noussair Mazraoui,ma MAR,DF,Bayern Munich,de Bundesliga,24,1997,11.9,29,21,9,9,11,15,24,62.5,9,13,2,11,10,39,25,0,Matches
1724,Pasquale Mazzocchi,it ITA,DF,Salernitana,it Serie A,27,1995,21.8,32,18,21,5,6,17,37,45.9,20,10,2,8,10,42,37,2,Matches
1725,Kevin Mbabu,ch SUI,"DF,FW",Fulham,eng Premier League,27,1995,1.6,3,2,2,1,0,1,3,33.3,2,2,0,2,3,6,3,0,Matches
1726,Noah Mbamba,be BEL,MF,Leverkusen,de Bundesliga,17,2005,0.0,0,0,0,0,0,0,0,,0,0,0,0,0,0,0,0,Matches
1727,Kylian Mbappé,fr FRA,FW,Paris S-G,fr Ligue 1,23,1998,31.3,10,4,0,5,5,5,16,31.3,11,5,0,5,5,15,6,0,Matches
1728,Mamadou Mbaye,sn SEN,DF,Cádiz,es La Liga,24,1998,8.4,10,7,7,3,0,6,8,75.0,2,10,8,2,7,17,50,1,Matches
1729,Chancel Mbemba,cd COD,DF,Marseille,fr Ligue 1,27,1994,31.7,43,26,24,17,2,22,31,71.0,9,25,12,13,42,85,89,0,Matches
1730,Bryan Mbeumo,cm CMR,FW,Brentford,eng Premier League,22,1999,32.3,26,18,5,13,8,8,42,19.0,34,24,1,23,13,39,21,0,Matches
1731,Jason Mbock,fr FRA,"MF,FW",Angers,fr Ligue 1,22,1999,0.3,0,0,0,0,0,0,0,,0,0,0,0,0,0,0,0,Matches
1732,Jean-Manuel Mbom,de GER,MF,Werder Bremen,de Bundesliga,22,2000,0.1,0,0,0,0,0,0,1,0.0,1,0,0,0,0,0,0,0,Matches
1733,Nathanael Mbuku,fr FRA,"FW,MF",Reims,fr Ligue 1,20,2002,0.7,2,1,2,0,0,2,2,100.0,0,0,0,0,0,2,0,0,Matches
1734,Nathanael Mbuku,fr FRA,"MF,FW",Augsburg,de Bundesliga,20,2002,0.4,1,0,0,1,0,0,0,,0,0,0,0,0,1,0,0,Matches
1735,James McArthur,sct SCO,MF,Crystal Palace,eng Premier League,34,1987,0.6,1,1,1,0,0,1,1,100.0,0,2,1,1,1,2,2,0,Matches
1736,Alex McCarthy,eng ENG,GK,Southampton,eng Premier League,32,1989,6.0,0,0,0,0,0,0,1,0.0,1,0,0,0,1,1,3,1,Matches
1737,John McGinn,sct SCO,"MF,FW",Aston Villa,eng Premier League,27,1994,29.9,66,36,27,29,10,34,71,47.9,37,43,4,39,24,90,19,0,Matches
1738,Scott McKenna,sct SCO,DF,Nott'ham Forest,eng Premier League,25,1996,17.5,12,7,7,3,2,6,10,60.0,4,20,14,6,12,24,85,1,Matches
1739,Weston McKennie,us USA,MF,Leeds United,eng Premier League,23,1998,16.0,30,13,5,18,7,10,29,34.5,19,22,3,19,22,52,26,0,Matches
1740,Weston McKennie,us USA,"MF,DF",Juventus,it Serie A,23,1998,11.7,14,5,3,9,2,5,8,62.5,3,15,4,11,11,25,15,1,Matches
1741,Dwight McNeil,eng ENG,"FW,MF",Everton,eng Premier League,22,1999,27.8,64,41,35,14,15,27,65,41.5,38,46,7,39,31,95,41,0,Matches
1742,Scott McTominay,sct SCO,MF,Manchester Utd,eng Premier League,25,1996,12.9,32,19,16,10,6,13,22,59.1,9,15,6,9,14,46,45,1,Matches
1743,Gary Medel,cl CHI,"MF,DF",Bologna,it Serie A,34,1987,16.4,25,15,16,7,2,9,16,56.3,7,17,10,7,28,53,34,0,Matches
1744,Facundo Medina,ar ARG,DF,Lens,fr Ligue 1,23,1999,30.9,31,20,16,15,0,13,35,37.1,22,25,9,16,26,57,62,1,Matches
1745,Fernando Medrano,es ESP,DF,Celta Vigo,es La Liga,22,2000,0.1,2,1,2,0,0,1,1,100.0,0,0,0,0,1,3,1,0,Matches
1746,Ben Mee,eng ENG,DF,Brentford,eng Premier League,32,1989,36.3,45,24,28,13,4,20,37,54.1,17,54,42,12,48,93,122,2,Matches
1747,Bamo Meïté,ci CIV,DF,Lorient,fr Ligue 1,20,2001,16.7,18,8,13,4,1,7,16,43.8,9,33,23,10,16,34,70,0,Matches
1748,Soualiho Meïté,fr FRA,MF,Cremonese,it Serie A,28,1994,26.3,47,31,25,15,7,22,46,47.8,24,27,6,21,27,74,36,0,Matches
1749,Farid El Melali,dz ALG,"DF,FW",Angers,fr Ligue 1,25,1997,9.0,21,12,7,12,2,11,22,50.0,11,16,0,16,8,29,7,0,Matches
1750,Gonzalo Melero,es ESP,MF,Almería,es La Liga,28,1994,20.6,32,16,9,18,5,11,39,28.2,28,23,2,21,7,39,19,1,Matches
1751,Birger Meling,no NOR,DF,Rennes,fr Ligue 1,27,1994,13.4,24,15,9,12,3,12,25,48.0,13,18,2,16,23,47,26,0,Matches
1752,Memphis,nl NED,FW,Atlético Madrid,es La Liga,28,1994,3.0,1,0,0,0,1,0,1,0.0,1,0,0,0,0,1,0,0,Matches
1753,Memphis,nl NED,FW,Barcelona,es La Liga,28,1994,1.3,1,1,1,0,0,0,1,0.0,1,0,0,0,0,1,0,0,Matches
1754,Houboulang Mendes,gw GNB,DF,Almería,es La Liga,24,1998,9.8,19,11,16,3,0,11,27,40.7,16,12,2,10,7,26,23,1,Matches
1755,Nuno Mendes,pt POR,DF,Paris S-G,fr Ligue 1,20,2002,17.2,45,30,29,12,4,30,41,73.2,11,19,3,16,17,62,18,0,Matches
1756,Pedro Mendes,pt POR,DF,Montpellier,fr Ligue 1,31,1990,0.1,0,0,0,0,0,0,0,,0,0,0,0,0,0,0,1,Matches
1757,Thiago Mendes,br BRA,"MF,DF",Lyon,fr Ligue 1,30,1992,22.9,48,27,24,21,3,30,40,75.0,10,28,8,20,47,95,51,4,Matches
1758,Brais Méndez,es ESP,MF,Real Sociedad,es La Liga,25,1997,26.7,58,34,18,30,10,24,64,37.5,40,27,3,24,12,70,14,1,Matches
1759,Diego Méndez,es ESP,MF,Rayo Vallecano,es La Liga,18,2003,0.0,0,0,0,0,0,0,0,,0,0,0,0,1,1,0,0,Matches
1760,Antoine Mendy,fr FRA,DF,Nice,fr Ligue 1,18,2004,5.8,22,13,16,5,1,9,15,60.0,6,6,1,5,2,24,16,0,Matches
1761,Arial Mendy,sn SEN,DF,Clermont Foot,fr Ligue 1,27,1994,2.5,4,2,3,0,1,2,2,100.0,0,2,0,2,4,8,4,0,Matches
1762,Batista Mendy,fr FRA,"MF,DF",Angers,fr Ligue 1,22,2000,31.8,70,30,34,28,8,37,53,69.8,16,38,6,32,21,91,29,2,Matches
1763,Edouard Mendy,sn SEN,GK,Chelsea,eng Premier League,30,1992,9.5,0,0,0,0,0,0,0,,0,0,0,0,0,0,3,3,Matches
1764,Ferland Mendy,fr FRA,DF,Real Madrid,es La Liga,27,1995,15.0,21,12,14,6,1,12,20,60.0,8,7,2,5,14,35,16,0,Matches
1765,Nampalys Mendy,sn SEN,MF,Leicester City,eng Premier League,30,1992,8.4,13,9,7,6,0,8,15,53.3,7,20,4,16,13,26,2,0,Matches
1766,Gideon Mensah,gh GHA,DF,Auxerre,fr Ligue 1,24,1998,25.1,80,44,43,32,5,44,77,57.1,33,33,10,23,38,118,41,0,Matches
1767,Chris Mepham,wls WAL,DF,Bournemouth,eng Premier League,24,1997,24.4,45,22,37,8,0,19,30,63.3,11,40,27,13,30,75,152,0,Matches
1768,Jorge Meré,es ESP,DF,Cádiz,es La Liga,25,1997,6.7,11,7,9,2,0,5,8,62.5,3,9,6,3,6,17,32,0,Matches
1769,Alex Meret,it ITA,GK,Napoli,it Serie A,25,1997,34.0,0,0,0,0,0,0,0,,0,0,0,0,0,0,6,1,Matches
1770,Mikel Merino,es ESP,MF,Real Sociedad,es La Liga,26,1996,27.7,77,49,28,33,16,31,62,50.0,31,38,8,30,20,97,51,1,Matches
1771,Quentin Merlin,fr FRA,DF,Nantes,fr Ligue 1,20,2002,19.9,31,19,19,8,4,18,38,47.4,20,27,4,23,24,55,30,0,Matches
1772,Yıldırım Mert Çetin,tr TUR,DF,Lecce,it Serie A,25,1997,0.2,1,0,1,0,0,0,0,,0,0,0,0,1,2,1,0,Matches
1773,Roque Mesa,es ESP,MF,Valladolid,es La Liga,33,1989,18.0,27,15,16,10,1,12,38,31.6,26,16,4,12,13,40,18,0,Matches
1774,Illan Meslier,fr FRA,GK,Leeds United,eng Premier League,22,2000,34.0,2,1,2,0,0,2,4,50.0,2,0,0,0,1,3,30,3,Matches
1775,Lionel Messi,ar ARG,"FW,MF",Paris S-G,fr Ligue 1,35,1987,31.5,26,18,1,13,12,11,27,40.7,16,11,0,11,2,28,0,0,Matches
1776,Junior Messias,br BRA,"FW,DF",Milan,it Serie A,31,1991,16.6,24,18,9,9,6,5,19,26.3,14,20,4,16,7,31,28,0,Matches
1777,Amine Messoussa,fr FRA,FW,Lille,fr Ligue 1,17,2004,0.0,0,0,0,0,0,0,0,,0,0,0,0,0,0,0,0,Matches
1778,Thomas Meunier,be BEL,DF,Dortmund,de Bundesliga,30,1991,6.5,16,7,8,5,3,10,17,58.8,7,7,2,5,9,25,16,0,Matches
1779,Alexander Meyer,de GER,GK,Dortmund,de Bundesliga,31,1991,7.0,0,0,0,0,0,0,1,0.0,1,0,0,0,0,0,1,0,Matches
1780,Sven Michel,de GER,"FW,MF",Union Berlin,de Bundesliga,32,1990,5.5,9,5,1,5,3,4,8,50.0,4,5,1,4,0,9,4,0,Matches
1781,Alex Mighten,eng ENG,FW,Nott'ham Forest,eng Premier League,20,2002,0.1,0,0,0,0,0,0,1,0.0,1,0,0,0,0,0,0,0,Matches
1782,Tommaso Milanese,it ITA,MF,Cremonese,it Serie A,20,2002,0.3,0,0,0,0,0,0,0,,0,1,1,0,0,0,0,0,Matches
1783,Nikola Milenković,rs SRB,DF,Fiorentina,it Serie A,24,1997,23.7,40,25,20,17,3,18,27,66.7,9,27,14,13,22,62,72,0,Matches
1784,Lewis Miley,eng ENG,MF,Newcastle Utd,eng Premier League,16,2006,0.2,0,0,0,0,0,0,0,,0,1,0,1,0,0,0,0,Matches
1785,Arkadiusz Milik,pl POL,FW,Juventus,it Serie A,28,1994,17.6,12,8,2,8,2,2,8,25.0,6,10,1,9,1,13,14,0,Matches
1786,Arkadiusz Milik,pl POL,FW,Marseille,fr Ligue 1,28,1994,1.4,1,1,0,0,1,0,1,0.0,1,0,0,0,0,1,2,0,Matches
1787,Sergej Milinković-Savić,rs SRB,MF,Lazio,it Serie A,27,1995,33.6,58,35,22,23,13,24,67,35.8,43,50,12,38,28,86,49,0,Matches
1788,Vanja Milinković-Savić,rs SRB,GK,Torino,it Serie A,25,1997,38.0,2,1,2,0,0,2,2,100.0,0,0,0,0,1,3,19,1,Matches
1789,Éder Militão,br BRA,DF,Real Madrid,es La Liga,24,1998,30.0,46,32,25,18,3,26,33,78.8,7,67,39,28,42,88,104,2,Matches
1790,Luka Milivojević,rs SRB,MF,Crystal Palace,eng Premier League,31,1991,5.7,13,7,7,4,2,7,10,70.0,3,13,4,9,12,25,10,1,Matches
1791,Luis Milla,es ESP,MF,Getafe,es La Liga,27,1994,20.6,48,30,21,18,9,19,44,43.2,25,13,1,12,32,80,25,1,Matches
1792,Pere Milla,es ESP,"FW,MF",Elche,es La Liga,29,1992,20.5,31,20,18,8,5,14,41,34.1,27,18,3,15,9,40,19,1,Matches
1793,Enzo Millot,fr FRA,MF,Stuttgart,de Bundesliga,20,2002,9.9,23,16,9,10,4,12,19,63.2,7,20,3,17,12,35,7,0,Matches
1794,James Milner,eng ENG,"MF,DF",Liverpool,eng Premier League,36,1986,10.1,26,16,11,11,4,15,34,44.1,19,14,2,12,12,38,15,0,Matches
1795,Marko Milovanović,rs SRB,FW,Almería,es La Liga,18,2003,0.2,0,0,0,0,0,0,0,,0,0,0,0,0,0,0,0,Matches
1796,Kim Min-jae,kr KOR,DF,Napoli,it Serie A,25,1996,33.9,55,30,32,22,1,25,29,86.2,4,36,26,10,41,96,123,1,Matches
1797,Yerry Mina,co COL,DF,Everton,eng Premier League,27,1994,6.6,15,8,9,6,0,9,11,81.8,2,7,4,3,6,21,28,0,Matches
1798,Takumi Minamino,jp JPN,"MF,FW",Monaco,fr Ligue 1,27,1995,8.0,15,8,5,7,3,7,35,20.0,28,14,0,14,6,21,4,0,Matches
1799,Tyrone Mings,eng ENG,DF,Aston Villa,eng Premier League,29,1993,35.0,15,7,10,5,0,9,20,45.0,11,40,21,19,54,69,163,2,Matches
1800,Óscar Mingueza,es ESP,DF,Celta Vigo,es La Liga,23,1999,14.3,37,21,27,9,1,25,32,78.1,7,10,4,6,12,49,25,0,Matches
1801,Rafa Mir,es ESP,FW,Sevilla,es La Liga,25,1997,14.4,8,2,2,4,2,2,5,40.0,3,5,1,4,4,12,11,0,Matches
1802,Aleksei Miranchuk,ru RUS,MF,Torino,it Serie A,26,1995,23.2,11,5,3,4,4,3,11,27.3,8,11,0,11,2,13,5,0,Matches
1803,Juan Miranda,es ESP,DF,Betis,es La Liga,22,2000,16.4,23,16,16,6,1,14,29,48.3,15,20,7,13,20,43,63,0,Matches
1804,Antonio Mirante,it ITA,GK,Milan,it Serie A,39,1983,0.0,0,0,0,0,0,0,0,,0,0,0,0,0,0,0,0,Matches
1805,Fabio Miretti,it ITA,"MF,FW",Juventus,it Serie A,18,2003,13.7,24,11,15,6,3,12,29,41.4,17,20,1,19,4,28,11,0,Matches
1806,Filippo Missori,it ITA,DF,Roma,it Serie A,18,2004,2.0,4,3,3,0,1,3,6,50.0,3,0,0,0,3,7,5,0,Matches
1807,Tyrick Mitchell,eng ENG,DF,Crystal Palace,eng Premier League,22,1999,32.1,71,49,43,23,5,30,53,56.6,23,48,11,37,42,113,78,0,Matches
1808,Kaoru Mitoma,jp JPN,"FW,MF",Brighton,eng Premier League,25,1997,25.8,44,27,15,16,13,20,41,48.8,21,25,0,25,17,61,10,0,Matches
1809,Aleksandar Mitrović,rs SRB,FW,Fulham,eng Premier League,27,1994,22.3,14,7,8,4,2,5,12,41.7,7,22,5,17,3,17,20,1,Matches
1810,Stefan Mitrović,rs SRB,DF,Getafe,es La Liga,32,1990,18.7,14,6,12,2,0,7,11,63.6,4,12,10,2,17,31,90,2,Matches
1811,Maximilian Mittelstädt,de GER,"DF,MF",Hertha BSC,de Bundesliga,25,1997,9.4,39,20,31,6,2,17,39,43.6,22,13,2,11,26,65,27,0,Matches
1812,Henrikh Mkhitaryan,am ARM,MF,Inter,it Serie A,33,1989,22.1,41,26,13,22,6,14,41,34.1,27,27,4,23,21,62,18,0,Matches
1813,Anthony Modeste,fr FRA,FW,Dortmund,de Bundesliga,34,1988,9.0,4,4,2,0,2,2,5,40.0,3,7,0,7,2,6,22,0,Matches
1814,Luka Modrić,hr CRO,MF,Real Madrid,es La Liga,36,1985,19.4,19,9,6,6,7,10,25,40.0,15,15,5,10,10,29,7,0,Matches
1815,Terem Moffi,ng NGA,FW,Nice,fr Ligue 1,23,1999,14.8,12,6,0,6,6,2,12,16.7,10,3,0,3,2,14,5,0,Matches
1816,Terem Moffi,ng NGA,FW,Lorient,fr Ligue 1,23,1999,15.4,8,5,1,4,3,3,5,60.0,2,11,3,8,3,11,10,0,Matches
1817,Mostafa Mohamed,eg EGY,FW,Nantes,fr Ligue 1,24,1997,21.5,18,13,5,7,6,9,20,45.0,11,23,1,22,10,28,33,0,Matches
1818,Tobias Mohr,de GER,"DF,MF",Schalke 04,de Bundesliga,26,1995,9.3,8,5,3,5,0,2,7,28.6,5,14,5,9,8,16,19,0,Matches
1819,Johan Mojica,co COL,DF,Villarreal,es La Liga,29,1992,7.1,13,9,9,3,1,5,9,55.6,4,8,3,5,4,17,14,1,Matches
1820,Johan Mojica,co COL,"DF,MF",Elche,es La Liga,29,1992,3.0,6,3,5,1,0,2,3,66.7,1,3,2,1,4,10,5,0,Matches
1821,Clinton Mola,eng ENG,DF,Stuttgart,de Bundesliga,21,2001,0.2,3,1,2,1,0,1,1,100.0,0,1,1,0,1,4,2,0,Matches
1822,Nahuel Molina,ar ARG,DF,Atlético Madrid,es La Liga,24,1998,31.9,69,43,38,18,13,39,91,42.9,52,38,7,31,18,87,63,1,Matches
1823,Salvatore Molina,it ITA,DF,Monza,it Serie A,30,1992,2.5,6,5,2,4,0,4,5,80.0,1,4,2,2,1,7,2,0,Matches
1824,Florent Mollet,fr FRA,MF,Nantes,fr Ligue 1,30,1991,12.1,14,6,5,4,5,7,24,29.2,17,12,1,11,10,24,11,0,Matches
1825,Florent Mollet,fr FRA,MF,Schalke 04,de Bundesliga,30,1991,4.6,4,1,0,4,0,2,7,28.6,5,7,1,6,1,5,1,0,Matches
1826,Jon Moncayola,es ESP,"MF,DF",Osasuna,es La Liga,24,1998,27.2,55,39,24,22,9,30,76,39.5,46,37,5,32,17,72,32,2,Matches
1827,Monchu,es ESP,MF,Valladolid,es La Liga,22,1999,22.6,50,29,20,21,9,19,46,41.3,27,28,11,17,18,68,22,1,Matches
1828,César Montes,mx MEX,DF,Espanyol,es La Liga,25,1997,17.7,17,9,10,7,0,10,18,55.6,8,19,12,7,14,31,101,0,Matches
1829,Daniele Montevago,it ITA,FW,Sampdoria,it Serie A,19,2003,2.6,1,0,0,0,1,0,1,0.0,1,2,1,1,0,1,1,0,Matches
1830,Gonzalo Montiel,ar ARG,DF,Sevilla,es La Liga,25,1997,16.9,26,15,12,14,0,15,29,51.7,14,25,7,18,19,45,38,0,Matches
1831,Lorenzo Montipò,it ITA,GK,Hellas Verona,it Serie A,26,1996,37.0,1,0,1,0,0,0,3,0.0,3,1,0,1,0,1,26,3,Matches
1832,Martín Montoya,es ESP,DF,Betis,es La Liga,31,1991,5.0,13,8,9,4,0,10,12,83.3,2,6,1,5,9,22,14,1,Matches
1833,Kieffer Moore,wls WAL,FW,Bournemouth,eng Premier League,29,1992,14.2,14,11,2,9,3,5,16,31.3,11,12,5,7,1,15,26,0,Matches
1834,Andrew Moran,ie IRL,FW,Brighton,eng Premier League,18,2003,0.1,0,0,0,0,0,0,0,,0,1,0,1,0,0,0,0,Matches
1835,Álvaro Morata,es ESP,FW,Atlético Madrid,es La Liga,29,1992,21.1,16,11,4,8,4,3,8,37.5,5,11,3,8,0,16,23,0,Matches
1836,Jon Morcillo,es ESP,"FW,MF",Athletic Club,es La Liga,23,1998,0.8,1,0,1,0,0,0,1,0.0,1,0,0,0,1,2,0,0,Matches
1837,Alberto Moreno,es ESP,DF,Villarreal,es La Liga,30,1992,14.4,23,12,10,10,3,11,24,45.8,13,12,1,11,23,46,26,0,Matches
1838,Álex Moreno,es ESP,DF,Aston Villa,eng Premier League,29,1993,14.8,23,14,15,5,3,13,36,36.1,23,18,3,15,7,30,37,2,Matches
1839,Álex Moreno,es ESP,DF,Betis,es La Liga,29,1993,15.0,29,22,19,10,0,18,36,50.0,18,17,4,13,17,46,39,0,Matches
1840,Diego Moreno,es ESP,DF,Osasuna,es La Liga,21,2001,7.1,4,4,2,2,0,3,8,37.5,5,7,4,3,5,9,21,0,Matches
1841,Gerard Moreno,es ESP,FW,Villarreal,es La Liga,30,1992,13.7,11,6,0,6,5,3,6,50.0,3,6,2,4,5,16,10,0,Matches
1842,Marlos Moreno,co COL,"MF,DF",Troyes,fr Ligue 1,25,1996,0.1,2,2,2,0,0,2,3,66.7,1,1,1,0,0,2,0,0,Matches
1843,Tete Morente,es ESP,"MF,DF",Elche,es La Liga,25,1996,23.0,33,21,18,13,2,15,36,41.7,21,23,3,20,25,58,28,0,Matches
1844,Ilaix Moriba,gn GUI,MF,Valencia,es La Liga,19,2003,11.2,35,16,14,17,4,14,24,58.3,10,11,1,10,4,39,12,0,Matches
1845,Manu Morlanes,es ESP,MF,Villarreal,es La Liga,23,1999,1.8,3,2,2,1,0,3,3,100.0,0,3,2,1,1,4,2,0,Matches
1846,Manu Morlanes,es ESP,MF,Mallorca,es La Liga,23,1999,7.8,22,9,12,8,2,13,24,54.2,11,10,5,5,5,27,9,0,Matches
1847,Nikola Moro,hr CRO,MF,Bologna,it Serie A,24,1998,13.6,32,21,11,15,6,14,36,38.9,22,15,2,13,8,40,18,0,Matches
1848,Loren Morón,es ESP,FW,Betis,es La Liga,28,1993,0.2,2,2,0,1,1,0,0,,0,0,0,0,0,2,1,0,Matches
1849,Cristhian Mosquera,co COL,DF,Valencia,es La Liga,18,2004,1.6,4,2,3,1,0,4,5,80.0,1,1,0,1,1,5,5,0,Matches
1850,Dany Mota,pt POR,"FW,MF",Monza,it Serie A,24,1998,21.2,8,7,1,3,4,2,10,20.0,8,5,1,4,6,14,25,0,Matches
1851,Lebo Mothiba,za RSA,"FW,MF",Strasbourg,fr Ligue 1,26,1996,4.8,1,0,1,0,0,0,1,0.0,1,6,1,5,0,1,4,0,Matches
1852,Youssoufa Moukoko,de GER,FW,Dortmund,de Bundesliga,17,2004,12.7,13,7,3,6,4,3,6,50.0,3,9,0,9,2,15,1,0,Matches
1853,Steve Mounié,bj BEN,FW,Brest,fr Ligue 1,27,1994,18.4,13,5,1,7,5,5,14,35.7,9,18,7,11,3,16,20,0,Matches
1854,Mason Mount,eng ENG,"MF,FW",Chelsea,eng Premier League,23,1999,18.3,33,19,6,16,11,14,27,51.9,13,24,6,18,8,41,9,0,Matches
1855,Lucas Moura,br BRA,"MF,DF",Tottenham,eng Premier League,29,1992,1.7,8,5,1,3,4,1,4,25.0,3,0,0,0,2,10,1,1,Matches
1856,Bevic Moussiti-Oko,cg CGO,FW,Ajaccio,fr Ligue 1,27,1995,7.8,3,1,1,1,1,1,2,50.0,1,5,3,2,2,5,8,0,Matches
1857,João Moutinho,pt POR,MF,Wolves,eng Premier League,35,1986,19.8,51,30,24,21,6,19,46,41.3,27,22,6,16,18,69,20,0,Matches
1858,João Moutinho,pt POR,"DF,FW",Spezia,it Serie A,24,1998,0.6,7,1,5,1,1,3,4,75.0,1,1,1,0,0,7,0,0,Matches
1859,Samuel Moutoussamy,cd COD,MF,Nantes,fr Ligue 1,25,1996,26.7,64,34,27,28,9,26,76,34.2,50,23,2,21,24,88,15,0,Matches
1860,Divin Mubama,eng ENG,FW,West Ham,eng Premier League,17,2004,0.4,1,1,1,0,0,0,0,,0,0,0,0,0,1,0,0,Matches
1861,Mykhailo Mudryk,ua UKR,"FW,MF",Chelsea,eng Premier League,21,2001,7.3,11,9,2,4,5,4,13,30.8,9,7,1,6,0,11,3,0,Matches
1862,François Mughe,cm CMR,MF,Marseille,fr Ligue 1,18,2004,0.1,0,0,0,0,0,0,0,,0,0,0,0,0,0,0,0,Matches
1863,Nordi Mukiele,fr FRA,DF,Paris S-G,fr Ligue 1,24,1997,12.6,31,23,16,6,9,19,29,65.5,10,22,9,13,14,45,16,0,Matches
1864,Mert Müldür,tr TUR,"FW,DF",Sassuolo,it Serie A,23,1999,0.1,0,0,0,0,0,0,0,,0,0,0,0,0,0,0,0,Matches
1865,Florian Müller,de GER,GK,Stuttgart,de Bundesliga,24,1997,19.0,0,0,0,0,0,0,0,,0,0,0,0,0,0,7,4,Matches
1866,Thomas Müller,de GER,"FW,MF",Bayern Munich,de Bundesliga,32,1989,18.5,21,12,5,9,7,6,16,37.5,10,19,3,16,4,25,16,0,Matches
1867,Abdul Mumin,gh GHA,DF,Rayo Vallecano,es La Liga,24,1998,10.2,11,9,5,6,0,3,7,42.9,4,13,5,8,9,20,36,2,Matches
1868,Marshall Munetsi,zw ZIM,MF,Reims,fr Ligue 1,26,1996,30.0,58,27,13,31,14,20,48,41.7,28,37,11,26,26,84,41,1,Matches
1869,Iker Muniain,es ESP,"MF,FW",Athletic Club,es La Liga,29,1992,18.8,21,16,7,11,3,6,17,35.3,11,10,1,9,4,25,2,0,Matches
1870,Aihen Muñoz,es ESP,DF,Real Sociedad,es La Liga,24,1997,19.5,38,23,17,17,4,22,47,46.8,25,26,5,21,9,47,38,0,Matches
1871,Álvaro Muñoz,uy URU,FW,Real Madrid,es La Liga,18,2004,0.9,2,1,1,0,1,1,1,100.0,0,0,0,0,0,2,1,0,Matches
1872,Iker Muñoz,es ESP,MF,Osasuna,es La Liga,19,2002,2.8,1,0,0,1,0,0,3,0.0,3,2,1,1,3,4,8,0,Matches
1873,Pablo Muñoz,es ESP,MF,Rayo Vallecano,es La Liga,18,2003,0.1,0,0,0,0,0,0,1,0.0,1,0,0,0,0,0,0,0,Matches
1874,Luis Muriel,co COL,"FW,MF",Atalanta,it Serie A,31,1991,11.9,9,6,2,3,4,5,16,31.3,11,9,0,9,2,11,2,0,Matches
1875,Jeison Murillo,co COL,DF,Sampdoria,it Serie A,30,1992,11.7,22,11,16,6,0,17,26,65.4,9,22,14,8,8,30,39,0,Matches
1876,Vedat Muriqi,xk KVX,FW,Mallorca,es La Liga,28,1994,32.6,12,7,4,7,1,3,13,23.1,10,19,7,12,12,24,73,0,Matches
1877,Jacob Murphy,eng ENG,FW,Newcastle Utd,eng Premier League,27,1995,13.9,15,7,3,8,4,8,20,40.0,12,17,0,17,7,22,3,0,Matches
1878,Nicola Murru,it ITA,DF,Sampdoria,it Serie A,27,1994,8.7,24,14,15,8,1,7,13,53.8,6,17,7,10,10,34,21,0,Matches
1879,Yunus Musah,us USA,MF,Valencia,es La Liga,19,2002,23.4,48,35,17,23,8,20,30,66.7,10,20,1,19,11,59,16,2,Matches
1880,Jamal Musiala,de GER,"MF,FW",Bayern Munich,de Bundesliga,19,2003,24.4,34,23,9,16,9,13,35,37.1,22,30,3,27,19,53,3,0,Matches
1881,Juan Musso,ar ARG,GK,Atalanta,it Serie A,28,1994,23.1,1,1,1,0,0,1,1,100.0,0,0,0,0,0,1,11,1,Matches
1882,Marlon Mustapha,at AUT,"FW,MF",Mainz 05,de Bundesliga,21,2001,0.8,2,2,0,2,0,0,0,,0,4,0,4,0,2,0,0,Matches
1883,Yvon Mvogo,ch SUI,GK,Lorient,fr Ligue 1,28,1994,20.1,0,0,0,0,0,0,0,,0,0,0,0,2,2,6,3,Matches
1884,Enock Mwepu,zm ZAM,"FW,MF",Brighton,eng Premier League,24,1998,2.4,10,5,1,6,3,3,4,75.0,1,3,1,2,1,11,1,0,Matches
1885,Francisco Mwepu,zm ZAM,FW,Cádiz,es La Liga,22,2000,0.2,1,0,0,1,0,0,0,,0,0,0,0,0,1,0,0,Matches
1886,Vitaliy Mykolenko,ua UKR,DF,Everton,eng Premier League,23,1999,29.5,58,34,36,19,3,28,51,54.9,23,50,16,34,46,104,99,0,Matches
1887,Joakim Mæhle,dk DEN,"DF,MF",Atalanta,it Serie A,25,1997,24.5,32,18,12,7,13,22,39,56.4,17,29,6,23,24,56,26,0,Matches
1888,Obite N'Dicka,ci CIV,DF,Eint Frankfurt,de Bundesliga,22,1999,29.9,25,18,10,11,4,18,32,56.3,14,47,19,28,31,56,150,0,Matches
1889,Nathan N'Goumou,fr FRA,FW,Toulouse,fr Ligue 1,22,2000,1.0,3,2,2,1,0,1,1,100.0,0,2,0,2,2,5,0,0,Matches
1890,Nathan N'Goumou,fr FRA,FW,Gladbach,de Bundesliga,22,2000,7.7,11,5,5,5,1,7,13,53.8,6,9,0,9,1,12,4,0,Matches
1891,Stanley N'Soki,fr FRA,DF,Hoffenheim,de Bundesliga,23,1999,14.3,22,13,14,7,1,12,22,54.5,10,22,5,17,24,46,34,0,Matches
1892,Herculano Nabian,pt POR,MF,Empoli,it Serie A,18,2004,0.0,0,0,0,0,0,0,0,,0,0,0,0,0,0,0,0,Matches
1893,Nacho,es ESP,DF,Real Madrid,es La Liga,32,1990,18.2,24,16,17,5,2,12,29,41.4,17,11,6,5,18,42,37,0,Matches
1894,Nikolas Nartey,dk DEN,"DF,MF",Stuttgart,de Bundesliga,22,2000,5.3,11,6,7,3,1,5,9,55.6,4,9,0,9,4,15,12,0,Matches
1895,Juanjo Narváez,co COL,"MF,FW",Valladolid,es La Liga,27,1995,1.6,1,1,1,0,0,1,1,100.0,0,2,0,2,0,1,0,0,Matches
1896,Matija Nastasić,rs SRB,DF,Mallorca,es La Liga,29,1993,10.1,10,8,7,1,2,3,6,50.0,3,11,4,7,18,28,43,1,Matches
1897,Roberto Navarro,es ESP,"MF,FW",Real Sociedad,es La Liga,20,2002,3.9,5,4,4,0,1,1,2,50.0,1,7,0,7,2,7,2,0,Matches
1898,Jesús Navas,es ESP,"DF,FW",Sevilla,es La Liga,36,1985,22.0,19,12,8,3,8,11,22,50.0,11,18,7,11,22,41,52,1,Matches
1899,Keylor Navas,cr CRC,GK,Nott'ham Forest,eng Premier League,35,1986,17.0,0,0,0,0,0,0,0,,0,0,0,0,1,1,11,2,Matches
1900,Michel Ndary Adopo,fr FRA,"MF,DF",Torino,it Serie A,22,2000,2.9,7,2,4,2,1,1,3,33.3,2,2,2,0,1,8,4,0,Matches
1901,Youssouf Ndayishimiye,bi BDI,"MF,DF",Nice,fr Ligue 1,23,1998,6.3,13,9,8,5,0,6,11,54.5,5,8,5,3,12,25,22,1,Matches
1902,Papa Ndiaga Yade,mr MTN,"DF,MF",Troyes,fr Ligue 1,22,2000,6.3,10,6,6,2,2,7,22,31.8,15,10,2,8,8,18,10,0,Matches
1903,Wilfred Ndidi,ng NGA,MF,Leicester City,eng Premier League,25,1996,18.7,61,42,34,24,3,17,43,39.5,26,32,14,18,38,99,48,3,Matches
1904,Tanguy Ndombele,fr FRA,MF,Napoli,it Serie A,25,1996,9.0,14,8,4,8,2,4,7,57.1,3,10,1,9,7,21,7,1,Matches
1905,Álvaro Negredo,es ESP,FW,Cádiz,es La Liga,36,1985,8.4,5,4,1,2,2,2,2,100.0,0,4,1,3,0,5,8,0,Matches
1906,Reiss Nelson,eng ENG,FW,Arsenal,eng Premier League,22,1999,2.4,4,1,2,1,1,2,4,50.0,2,3,0,3,0,4,4,0,Matches
1907,Ilija Nestorovski,mk MKD,"FW,MF",Udinese,it Serie A,32,1990,7.1,7,3,2,1,4,5,11,45.5,6,6,1,5,2,9,10,0,Matches
1908,Neto,br BRA,GK,Bournemouth,eng Premier League,33,1989,26.5,3,1,3,0,0,3,3,100.0,0,0,0,0,0,3,10,3,Matches
1909,Pedro Neto,pt POR,"FW,MF",Wolves,eng Premier League,22,2000,10.7,11,6,4,2,5,7,17,41.2,10,5,1,4,4,15,4,0,Matches
1910,Luca Netz,de GER,DF,Gladbach,de Bundesliga,19,2003,7.8,25,13,19,3,3,19,32,59.4,13,5,1,4,6,31,27,0,Matches
1911,Manuel Neuer,de GER,GK,Bayern Munich,de Bundesliga,36,1986,12.0,0,0,0,0,0,0,0,,0,0,0,0,0,0,4,1,Matches
1912,Florian Neuhaus,de GER,MF,Gladbach,de Bundesliga,25,1997,15.6,19,9,9,5,5,8,27,29.6,19,20,3,17,12,31,5,0,Matches
1913,Rúben Neves,pt POR,MF,Wolves,eng Premier League,25,1997,33.5,79,43,31,33,15,32,76,42.1,44,59,22,37,50,129,85,1,Matches
1914,Neymar,br BRA,"MF,FW",Paris S-G,fr Ligue 1,30,1992,17.2,22,14,6,9,7,9,19,47.4,10,7,1,6,4,26,1,1,Matches
1915,Jessic Ngankam,de GER,"FW,MF",Hertha BSC,de Bundesliga,22,2000,9.2,14,9,7,4,3,6,14,42.9,8,6,1,5,1,15,4,0,Matches
1916,Cyril Ngonge,be BEL,"MF,FW",Hellas Verona,it Serie A,22,2000,8.3,7,3,2,2,3,3,11,27.3,8,7,0,7,6,13,4,0,Matches
1917,Moussa Niakhate,sn SEN,DF,Nott'ham Forest,eng Premier League,26,1996,12.9,18,9,15,3,0,11,22,50.0,11,18,8,10,19,37,60,0,Matches
1918,Ibrahima Niane,sn SEN,FW,Angers,fr Ligue 1,23,1999,12.6,6,2,1,4,1,1,6,16.7,5,8,2,6,1,7,9,0,Matches
1919,M'Baye Niang,sn SEN,FW,Auxerre,fr Ligue 1,27,1994,16.5,13,7,1,8,4,3,13,23.1,10,22,1,21,1,14,20,0,Matches
1920,Tanguy Nianzou,fr FRA,DF,Sevilla,es La Liga,20,2002,15.2,20,15,10,9,1,8,11,72.7,3,8,5,3,16,36,44,3,Matches
1921,Rasmus Nicolaisen,dk DEN,DF,Toulouse,fr Ligue 1,25,1997,33.3,48,21,34,14,0,29,46,63.0,17,58,45,13,50,98,152,0,Matches
1922,Hans Nicolussi Caviglia,it ITA,MF,Salernitana,it Serie A,22,2000,6.5,15,6,5,8,2,9,15,60.0,6,9,0,9,7,22,7,1,Matches
1923,Florian Niederlechner,de GER,"FW,MF",Augsburg,de Bundesliga,31,1990,10.1,10,5,5,4,1,4,7,57.1,3,16,2,14,1,11,9,0,Matches
1924,Florian Niederlechner,de GER,FW,Hertha BSC,de Bundesliga,31,1990,8.7,9,7,2,4,3,2,8,25.0,6,7,0,7,3,12,10,0,Matches
1925,Saúl Ñíguez,es ESP,"MF,DF",Atlético Madrid,es La Liga,27,1994,12.2,42,27,18,18,6,22,37,59.5,15,27,5,22,15,57,29,0,Matches
1926,Dimitris Nikolaou,gr GRE,DF,Spezia,it Serie A,23,1998,32.9,45,32,31,10,4,25,37,67.6,12,41,26,15,27,72,82,0,Matches
1927,Fernando Niño,es ESP,"MF,FW",Villarreal,es La Liga,21,2000,0.2,0,0,0,0,0,0,0,,0,0,0,0,0,0,0,0,Matches
1928,Justin Njinmah,de GER,FW,Dortmund,de Bundesliga,21,2000,0.2,0,0,0,0,0,0,0,,0,0,0,0,0,0,0,0,Matches
1929,Eddie Nketiah,eng ENG,FW,Arsenal,eng Premier League,23,1999,12.1,13,9,6,2,5,2,10,20.0,8,7,1,6,1,14,7,0,Matches
1930,Christopher Nkunku,fr FRA,"FW,MF",RB Leipzig,de Bundesliga,24,1997,21.1,6,4,2,1,3,1,6,16.7,5,8,3,5,8,14,11,0,Matches
1931,Felix Nmecha,de GER,MF,Wolfsburg,de Bundesliga,21,2000,20.4,41,24,11,23,7,16,34,47.1,18,26,10,16,25,66,31,0,Matches
1932,Lukas Nmecha,de GER,FW,Wolfsburg,de Bundesliga,23,1998,10.0,5,3,0,2,3,3,3,100.0,0,5,1,4,3,8,4,0,Matches
1933,Arnaud Nordin,fr FRA,FW,Montpellier,fr Ligue 1,24,1998,26.7,26,14,10,12,4,12,28,42.9,16,19,1,18,14,40,7,0,Matches
1934,Riad Nouri,fr FRA,"MF,FW",Ajaccio,fr Ligue 1,37,1985,18.8,21,12,7,10,4,12,29,41.4,17,8,1,7,15,36,11,0,Matches
1935,Hugo Novoa,es ESP,"DF,FW",RB Leipzig,de Bundesliga,19,2003,2.0,8,2,1,3,4,4,7,57.1,3,4,0,4,1,9,0,0,Matches
1936,Samuel Ntanda,be BEL,MF,Sampdoria,it Serie A,17,2005,0.0,0,0,0,0,0,0,0,,0,0,0,0,0,0,0,0,Matches
1937,Randy Nteka,ao ANG,"FW,MF",Elche,es La Liga,24,1997,8.1,15,10,7,6,2,2,11,18.2,9,15,3,12,4,19,9,0,Matches
1938,Randy Nteka,ao ANG,"FW,MF",Rayo Vallecano,es La Liga,24,1997,1.3,4,2,2,2,0,1,1,100.0,0,2,0,2,2,6,3,0,Matches
1939,Alexander Nübel,de GER,GK,Monaco,fr Ligue 1,25,1996,38.0,0,0,0,0,0,0,1,0.0,1,0,0,0,1,1,10,3,Matches
1940,Matheus Nunes,pt POR,MF,Wolves,eng Premier League,23,1998,27.4,67,43,36,22,9,28,61,45.9,33,35,4,31,16,83,35,2,Matches
1941,Darwin Núñez,uy URU,FW,Liverpool,eng Premier League,23,1999,18.8,11,5,2,4,5,4,17,23.5,13,10,0,10,3,14,13,0,Matches
1942,Unai Núñez,es ESP,DF,Celta Vigo,es La Liga,25,1997,35.0,47,35,29,15,3,18,34,52.9,16,27,17,10,72,119,135,1,Matches
1943,Bram Nuytinck,nl NED,DF,Udinese,it Serie A,32,1990,4.3,7,4,3,4,0,4,8,50.0,4,6,6,0,5,12,22,0,Matches
1944,Bram Nuytinck,nl NED,DF,Sampdoria,it Serie A,32,1990,16.6,54,38,33,21,0,23,34,67.6,11,36,21,15,23,77,84,0,Matches
1945,Ethan Nwaneri,eng ENG,FW,Arsenal,eng Premier League,15,2007,0.0,0,0,0,0,0,0,0,,0,1,0,1,0,0,0,0,Matches
1946,Gerzino Nyamsi,fr FRA,DF,Strasbourg,fr Ligue 1,25,1997,17.5,28,20,14,12,2,10,12,83.3,2,19,11,8,10,38,63,1,Matches
1947,Ørjan Nyland,no NOR,GK,RB Leipzig,de Bundesliga,31,1990,2.0,0,0,0,0,0,0,0,,0,0,0,0,0,0,0,0,Matches
1948,M'Bala Nzola,ao ANG,FW,Spezia,it Serie A,25,1996,29.5,12,5,0,6,6,3,9,33.3,6,20,6,14,7,19,21,0,Matches
1949,Christian Nørgaard,dk DEN,MF,Brentford,eng Premier League,28,1994,19.6,52,30,21,29,2,18,48,37.5,30,32,9,23,34,86,41,2,Matches
1950,Lewis O'Brien,eng ENG,MF,Nott'ham Forest,eng Premier League,23,1998,6.5,16,9,4,11,1,6,12,50.0,6,13,2,11,5,21,9,0,Matches
1951,Pedro Obiang,gq EQG,MF,Sassuolo,it Serie A,30,1992,9.7,26,17,12,12,2,10,18,55.6,8,12,2,10,8,34,15,0,Matches
1952,Jan Oblak,si SVN,GK,Atlético Madrid,es La Liga,29,1993,27.7,0,0,0,0,0,0,0,,0,0,0,0,1,1,8,0,Matches
1953,Brian Ocampo,uy URU,"MF,FW",Cádiz,es La Liga,23,1999,12.4,18,15,12,5,1,8,21,38.1,13,13,0,13,3,21,3,0,Matches
1954,Lucas Ocampos,ar ARG,"FW,MF",Sevilla,es La Liga,28,1994,12.9,22,14,9,9,4,8,31,25.8,23,17,2,15,8,30,5,0,Matches
1955,Guillermo Ochoa,mx MEX,GK,Salernitana,it Serie A,37,1985,20.0,0,0,0,0,0,0,2,0.0,2,0,0,0,0,0,9,1,Matches
1956,Wilson Odobert,fr FRA,"MF,FW",Troyes,fr Ligue 1,17,2004,19.6,20,14,10,7,3,9,25,36.0,16,11,0,11,15,35,5,0,Matches
1957,Álvaro Odriozola,es ESP,DF,Real Madrid,es La Liga,26,1995,0.4,0,0,0,0,0,0,0,,0,0,0,0,0,0,0,0,Matches
1958,Tim Oermann,de GER,DF,Bochum,de Bundesliga,18,2003,2.2,2,1,2,0,0,1,1,100.0,0,3,2,1,1,3,8,1,Matches
1959,Odeluga Offiah,eng ENG,DF,Brighton,eng Premier League,19,2002,0.3,1,1,1,0,0,0,2,0.0,2,0,0,0,0,1,1,0,Matches
1960,Angelo Ogbonna,it ITA,DF,West Ham,eng Premier League,34,1988,13.7,11,4,7,4,0,5,10,50.0,5,11,7,4,17,28,74,1,Matches
1961,Florent Ogier,fr FRA,DF,Clermont Foot,fr Ligue 1,33,1989,18.9,33,16,20,12,1,22,39,56.4,17,22,13,9,18,51,64,1,Matches
1962,Marios Oikonomou,gr GRE,DF,Sampdoria,it Serie A,29,1992,2.4,3,2,3,0,0,1,3,33.3,2,5,4,1,4,7,13,0,Matches
1963,David Okereke,ng NGA,"FW,MF",Cremonese,it Serie A,24,1997,25.2,12,8,4,5,3,3,16,18.8,13,23,3,20,10,22,12,0,Matches
1964,Caleb Okoli,it ITA,DF,Atalanta,it Serie A,21,2001,10.7,21,17,14,6,1,10,25,40.0,15,10,5,5,30,51,44,3,Matches
1965,Olasagasti,es ESP,"MF,DF",Real Sociedad,es La Liga,21,2000,0.7,4,4,1,2,1,1,2,50.0,1,2,0,2,0,4,1,0,Matches
1966,Lucas Olaza,uy URU,DF,Valladolid,es La Liga,28,1994,16.6,24,14,12,10,2,17,26,65.4,9,20,8,12,14,38,34,0,Matches
1967,Finn Ole Becker,de GER,MF,Hoffenheim,de Bundesliga,22,2000,5.7,10,2,4,6,0,4,7,57.1,3,4,0,4,5,15,8,0,Matches
1968,Mathias Olesen,lu LUX,MF,Köln,de Bundesliga,21,2001,5.3,10,5,4,4,2,5,8,62.5,3,6,1,5,2,12,3,0,Matches
1969,Michael Olise,fr FRA,"FW,MF",Crystal Palace,eng Premier League,20,2001,30.5,58,34,28,26,4,25,60,41.7,35,46,1,45,26,84,17,0,Matches
1970,Brian Oliván,es ESP,DF,Espanyol,es La Liga,28,1994,26.7,47,27,30,12,5,17,26,65.4,9,26,6,20,22,69,67,0,Matches
1971,Lucas Oliveira Rosa,br BRA,DF,Valladolid,es La Liga,22,2000,10.3,39,18,23,10,6,12,20,60.0,8,12,2,10,15,54,24,0,Matches
1972,Mathías Olivera,uy URU,DF,Napoli,it Serie A,24,1997,18.3,39,23,16,16,7,22,43,51.2,21,28,2,26,22,61,26,0,Matches
1973,Dani Olmo,es ESP,"MF,FW",RB Leipzig,de Bundesliga,24,1998,14.2,15,9,1,10,4,6,14,42.9,8,15,0,15,6,21,6,0,Matches
1974,Jan Olschowsky,de GER,GK,Gladbach,de Bundesliga,20,2001,4.0,0,0,0,0,0,0,1,0.0,1,1,0,1,0,0,1,0,Matches
1975,Robin Olsen,se SWE,GK,Aston Villa,eng Premier League,32,1990,3.1,0,0,0,0,0,0,2,0.0,2,0,0,0,0,0,1,0,Matches
1976,Warmed Omari,fr FRA,DF,Rennes,fr Ligue 1,22,2000,15.1,20,11,14,6,0,14,28,50.0,14,13,7,6,17,37,43,1,Matches
1977,Jonas Omlin,ch SUI,GK,Montpellier,fr Ligue 1,28,1994,13.0,1,0,1,0,0,0,0,,0,0,0,0,0,1,8,1,Matches
1978,Jonas Omlin,ch SUI,GK,Gladbach,de Bundesliga,28,1994,14.3,1,1,1,0,0,1,3,33.3,2,1,0,1,0,1,9,1,Matches
1979,Ado Onaiwu,jp JPN,FW,Toulouse,fr Ligue 1,26,1995,12.0,11,6,4,4,3,5,13,38.5,8,5,1,4,2,13,5,0,Matches
1980,Amadou Onana,be BEL,MF,Everton,eng Premier League,20,2001,27.6,72,43,24,42,6,30,42,71.4,12,25,6,19,37,109,39,0,Matches
1981,André Onana,cm CMR,GK,Inter,it Serie A,26,1996,24.0,0,0,0,0,0,0,1,0.0,1,0,0,0,0,0,5,0,Matches
1982,Jean Onana,cm CMR,"MF,DF",Lens,fr Ligue 1,22,2000,9.0,28,17,8,17,3,10,22,45.5,12,15,5,10,18,46,20,0,Matches
1983,Karim Onisiwo,at AUT,"FW,MF",Mainz 05,de Bundesliga,30,1992,28.2,19,12,3,10,6,4,21,19.0,17,19,0,19,2,21,7,0,Matches
1984,Josh Onomah,eng ENG,MF,Fulham,eng Premier League,25,1997,0.2,1,0,1,0,0,0,0,,0,1,0,1,0,1,0,0,Matches
1985,Paul Onuachu,ng NGA,FW,Southampton,eng Premier League,28,1994,4.5,3,2,1,1,1,1,3,33.3,2,4,1,3,0,3,4,0,Matches
1986,Frank Onyeka,ng NGA,MF,Brentford,eng Premier League,24,1998,9.4,19,14,11,7,1,10,25,40.0,15,16,3,13,10,29,16,0,Matches
1987,Loïs Openda,be BEL,FW,Lens,fr Ligue 1,22,2000,28.0,11,9,2,6,3,2,13,15.4,11,9,0,9,2,13,6,0,Matches
1988,Willi Orban,hu HUN,DF,RB Leipzig,de Bundesliga,29,1992,32.8,51,30,33,18,0,26,43,60.5,17,42,24,18,39,90,129,1,Matches
1989,Ivan Ordets,ua UKR,DF,Bochum,de Bundesliga,30,1992,27.2,31,19,21,9,1,16,28,57.1,12,34,17,17,57,88,139,0,Matches
1990,Divock Origi,be BEL,FW,Milan,it Serie A,27,1995,11.4,10,5,4,3,3,5,10,50.0,5,6,2,4,0,10,13,0,Matches
1991,Aimar Oroz,es ESP,"MF,FW",Osasuna,es La Liga,20,2001,22.4,26,14,8,10,8,8,30,26.7,22,24,1,23,24,50,6,0,Matches
1992,Mislav Oršić,hr CRO,MF,Southampton,eng Premier League,29,1992,0.1,1,1,1,0,0,0,0,,0,0,0,0,0,1,0,0,Matches
1993,Riccardo Orsolini,it ITA,FW,Bologna,it Serie A,25,1997,23.6,30,19,15,10,5,17,41,41.5,24,29,3,26,8,38,18,0,Matches
1994,Stefan Ortega,de GER,GK,Manchester City,eng Premier League,29,1992,3.0,0,0,0,0,0,0,0,,0,0,0,0,0,0,0,0,Matches
1995,Pedro Ortiz,es ESP,MF,Sevilla,es La Liga,21,2000,0.0,0,0,0,0,0,0,0,,0,0,0,0,0,0,0,0,Matches
1996,Jordi Osei-Tutu,eng ENG,"DF,FW",Bochum,de Bundesliga,23,1998,8.3,23,18,13,5,5,12,23,52.2,11,12,5,7,10,33,8,0,Matches
1997,Victor Osimhen,ng NGA,FW,Napoli,it Serie A,23,1998,28.5,10,6,1,2,7,0,7,0.0,7,6,1,5,6,16,29,0,Matches
1998,Patrick Osterhage,de GER,MF,Bochum,de Bundesliga,22,2000,11.4,20,17,8,10,2,11,16,68.8,5,17,6,11,12,32,25,0,Matches
1999,Paulo Otávio,br BRA,DF,Wolfsburg,de Bundesliga,27,1994,22.7,72,46,46,17,9,44,66,66.7,22,42,6,36,30,102,70,1,Matches
2000,Dango Ouattara,bf BFA,"MF,FW",Bournemouth,eng Premier League,20,2002,13.8,28,15,20,6,2,13,32,40.6,19,20,3,17,13,41,29,1,Matches
2001,Dango Ouattara,bf BFA,"FW,MF",Lorient,fr Ligue 1,20,2002,17.2,41,26,20,11,10,15,28,53.6,13,24,6,18,19,60,21,0,Matches
2002,Remi Oudin,fr FRA,"FW,MF",Lecce,it Serie A,25,1996,14.7,25,13,9,12,4,10,23,43.5,13,16,2,14,29,54,23,0,Matches
2003,Zinédine Ould Khaled,fr FRA,"MF,FW",Angers,fr Ligue 1,22,2000,0.6,1,1,0,1,0,0,1,0.0,1,0,0,0,2,3,0,0,Matches
2004,Azzedine Ounahi,ma MAR,"MF,FW",Marseille,fr Ligue 1,22,2000,1.3,2,1,1,1,0,0,2,0.0,2,1,0,1,0,2,0,0,Matches
2005,Azzedine Ounahi,ma MAR,"MF,FW",Angers,fr Ligue 1,22,2000,12.5,19,8,5,13,1,10,20,50.0,10,8,0,8,15,34,4,1,Matches
2006,Adam Ounas,dz ALG,FW,Napoli,it Serie A,25,1996,0.2,0,0,0,0,0,0,0,,0,0,0,0,1,1,0,0,Matches
2007,Adam Ounas,dz ALG,"FW,MF",Lille,fr Ligue 1,25,1996,11.8,20,11,4,10,6,8,13,61.5,5,16,0,16,7,27,5,0,Matches
2008,Thomas Ouwejan,nl NED,DF,Schalke 04,de Bundesliga,25,1996,10.0,20,8,13,5,2,6,10,60.0,4,17,4,13,13,33,27,0,Matches
2009,Reece Oxford,eng ENG,DF,Augsburg,de Bundesliga,23,1998,1.0,1,1,1,0,0,0,0,,0,4,3,1,1,2,5,0,Matches
2010,Alex Oxlade-Chamberlain,eng ENG,"FW,MF",Liverpool,eng Premier League,28,1993,3.7,5,4,1,2,2,1,5,20.0,4,5,2,3,1,6,4,0,Matches
2011,Mikel Oyarzabal,es ESP,"FW,MF",Real Sociedad,es La Liga,25,1997,13.5,13,7,5,3,5,5,19,26.3,14,14,4,10,3,16,5,0,Matches
2012,Salih Özcan,tr TUR,MF,Dortmund,de Bundesliga,24,1998,17.5,31,18,10,16,5,16,39,41.0,23,24,2,22,28,59,19,1,Matches
2013,Cenk Özkacar,tr TUR,DF,Valencia,es La Liga,21,2000,15.2,27,20,17,10,0,14,19,73.7,5,14,2,12,12,39,47,4,Matches
2014,David Ozoh,eng ENG,FW,Crystal Palace,eng Premier League,17,2005,0.0,0,0,0,0,0,0,0,,0,0,0,0,0,0,0,0,Matches
2015,Levin Öztunalı,de GER,MF,Union Berlin,de Bundesliga,26,1996,0.1,0,0,0,0,0,0,1,0.0,1,0,0,0,0,0,0,0,Matches
2016,Fernando Pacheco,es ESP,GK,Almería,es La Liga,30,1992,1.0,0,0,0,0,0,0,0,,0,0,0,0,0,0,1,0,Matches
2017,Fernando Pacheco,es ESP,GK,Espanyol,es La Liga,30,1992,16.0,0,0,0,0,0,0,1,0.0,1,0,0,0,1,1,11,0,Matches
2018,Jon Pacheco,es ESP,DF,Real Sociedad,es La Liga,21,2001,13.3,16,10,10,6,0,6,10,60.0,4,9,6,3,12,28,37,1,Matches
2019,Gonçalo Paciência,pt POR,"FW,MF",Celta Vigo,es La Liga,27,1994,7.4,8,5,0,5,3,2,7,28.6,5,9,1,8,0,8,4,0,Matches
2020,Simone Pafundi,it ITA,"MF,FW",Udinese,it Serie A,16,2006,0.9,8,5,1,5,2,2,4,50.0,2,0,0,0,1,9,0,0,Matches
2021,Exequiel Palacios,ar ARG,MF,Leverkusen,de Bundesliga,23,1998,18.4,59,36,20,33,6,29,48,60.4,19,29,2,27,33,92,28,0,Matches
2022,Helibelton Palacios,co COL,DF,Elche,es La Liga,29,1993,21.3,38,20,21,15,2,19,26,73.1,7,26,12,14,20,58,55,0,Matches
2023,Ante Palaversa,hr CRO,MF,Troyes,fr Ligue 1,22,2000,0.3,1,1,1,0,0,0,0,,0,0,0,0,1,2,0,0,Matches
2024,Isaac Palazón Camacho,es ESP,"FW,MF",Rayo Vallecano,es La Liga,27,1994,32.9,45,30,11,23,11,24,66,36.4,42,42,3,39,17,62,30,0,Matches
2025,João Palhinha,pt POR,MF,Fulham,eng Premier League,27,1995,34.5,148,83,59,65,24,71,135,52.6,64,48,5,43,46,194,61,2,Matches
2026,Nicolas Pallois,fr FRA,DF,Nantes,fr Ligue 1,34,1987,24.6,69,44,51,16,2,42,70,60.0,28,35,18,17,30,99,131,2,Matches
2027,Cole Palmer,eng ENG,"MF,FW",Manchester City,eng Premier League,20,2002,4.1,5,1,0,3,2,3,5,60.0,2,2,1,1,1,6,2,0,Matches
2028,Erik Palmer-Brown,us USA,DF,Troyes,fr Ligue 1,25,1997,35.5,42,27,31,10,1,18,33,54.5,15,56,29,27,26,68,166,1,Matches
2029,Emerson Palmieri,it ITA,DF,West Ham,eng Premier League,27,1994,14.7,26,14,9,15,2,12,24,50.0,12,17,4,13,15,41,36,0,Matches
2030,Miloš Pantović,rs SRB,MF,Union Berlin,de Bundesliga,26,1996,2.3,4,2,4,0,0,3,5,60.0,2,3,0,3,0,4,5,0,Matches
2031,Flavio Paoletti,it ITA,MF,Sampdoria,it Serie A,19,2003,3.2,2,2,0,2,0,1,5,20.0,4,1,0,1,5,7,9,0,Matches
2032,Antonios Papadopoulos,de GER,DF,Dortmund,de Bundesliga,22,1999,0.1,0,0,0,0,0,0,0,,0,0,0,0,1,1,0,0,Matches
2033,Lucas Paquetá,br BRA,MF,West Ham,eng Premier League,24,1997,23.9,71,53,23,36,12,27,68,39.7,41,41,4,37,16,87,31,0,Matches
2034,Lucas Paquetá,br BRA,MF,Lyon,fr Ligue 1,24,1997,1.8,5,4,0,5,0,1,3,33.3,2,2,0,2,1,6,3,0,Matches
2035,Aitor Paredes,es ESP,DF,Athletic Club,es La Liga,22,2000,9.5,7,6,4,2,1,6,11,54.5,5,11,7,4,14,21,26,0,Matches
2036,Kevin Paredes,us USA,"FW,MF",Wolfsburg,de Bundesliga,19,2003,5.9,13,9,6,3,4,9,12,75.0,3,7,0,7,6,19,8,0,Matches
2037,Leandro Paredes,ar ARG,MF,Juventus,it Serie A,28,1994,10.9,19,13,7,11,1,10,22,45.5,12,8,0,8,17,36,22,0,Matches
2038,Leandro Paredes,ar ARG,MF,Paris S-G,fr Ligue 1,28,1994,0.6,1,1,1,0,0,1,1,100.0,0,2,1,1,1,2,0,0,Matches
2039,Daniel Parejo,es ESP,MF,Villarreal,es La Liga,33,1989,36.5,71,40,32,23,16,30,75,40.0,45,40,12,28,29,100,31,2,Matches
2040,Fabiano Parisi,it ITA,DF,Empoli,it Serie A,21,2000,31.4,65,35,37,21,7,30,72,41.7,42,51,16,35,41,106,91,0,Matches
2041,Moises Parra Gutierrez,es ESP,FW,Getafe,es La Liga,20,2002,0.1,1,0,0,1,0,0,0,,0,0,0,0,0,1,0,0,Matches
2042,Raúl Parra,es ESP,DF,Cádiz,es La Liga,22,1999,3.4,4,2,4,0,0,4,9,44.4,5,5,3,2,1,5,9,0,Matches
2043,Thomas Partey,gh GHA,MF,Arsenal,eng Premier League,29,1993,27.6,70,40,20,35,15,25,52,48.1,27,26,5,21,28,98,41,1,Matches
2044,Marco Pašalić,hr CRO,MF,Dortmund,de Bundesliga,21,2000,0.1,0,0,0,0,0,0,0,,0,0,0,0,0,0,0,0,Matches
2045,Mario Pašalić,hr CRO,"MF,FW",Atalanta,it Serie A,27,1995,19.7,22,10,6,14,2,6,23,26.1,17,22,4,18,21,43,13,0,Matches
2046,Pascu,es ESP,"DF,FW",Villarreal,es La Liga,19,2003,0.1,0,0,0,0,0,0,0,,0,0,0,0,0,0,0,0,Matches
2047,Felix Passlack,de GER,DF,Dortmund,de Bundesliga,24,1998,0.7,4,3,0,4,0,1,1,100.0,0,1,1,0,0,4,1,0,Matches
2048,Javier Pastore,ar ARG,MF,Elche,es La Liga,33,1989,0.1,0,0,0,0,0,0,0,,0,0,0,0,0,0,0,0,Matches
2049,Patric,es ESP,DF,Lazio,it Serie A,29,1993,15.7,17,11,12,3,2,11,16,68.8,5,17,12,5,11,28,53,1,Matches
2050,Rui Patrício,pt POR,GK,Roma,it Serie A,34,1988,35.0,1,1,1,0,0,1,1,100.0,0,0,0,0,2,3,6,3,Matches
2051,Nathan Patterson,sct SCO,"DF,MF",Everton,eng Premier League,20,2001,14.2,49,24,32,13,4,29,54,53.7,25,24,4,20,15,64,45,0,Matches
2052,Paulinho,br BRA,FW,Leverkusen,de Bundesliga,22,2000,0.9,0,0,0,0,0,0,0,,0,1,0,1,0,0,2,0,Matches
2053,Gabriel Paulista,br BRA,DF,Valencia,es La Liga,31,1990,16.7,17,9,13,4,0,13,19,68.4,6,22,14,8,32,49,79,2,Matches
2054,Benjamin Pavard,fr FRA,DF,Bayern Munich,de Bundesliga,26,1996,27.0,70,41,36,26,8,36,48,75.0,12,35,16,19,44,114,83,0,Matches
2055,Jiří Pavlenka,cz CZE,GK,Werder Bremen,de Bundesliga,30,1992,32.3,1,0,1,0,0,1,5,20.0,4,1,0,1,3,4,21,1,Matches
2056,Dimitri Payet,fr FRA,"MF,FW",Marseille,fr Ligue 1,35,1987,9.3,6,4,2,2,2,3,10,30.0,7,4,0,4,0,6,4,0,Matches
2057,Ben Pearson,eng ENG,MF,Bournemouth,eng Premier League,27,1995,3.2,7,3,3,3,1,1,3,33.3,2,4,0,4,2,9,6,0,Matches
2058,Kristian Pedersen,dk DEN,DF,Köln,de Bundesliga,27,1994,3.1,5,4,4,1,0,0,2,0.0,2,3,0,3,6,11,17,0,Matches
2059,Mads Pedersen,dk DEN,"DF,MF",Augsburg,de Bundesliga,25,1996,20.4,44,23,31,11,2,22,33,66.7,11,32,9,23,20,64,41,1,Matches
2060,Alfonso Pedraza,es ESP,DF,Villarreal,es La Liga,26,1996,18.1,35,26,20,10,5,19,29,65.5,10,19,1,18,18,53,31,0,Matches
2061,Pedri,es ESP,MF,Barcelona,es La Liga,19,2002,22.0,39,22,15,17,7,13,45,28.9,32,27,0,27,13,52,8,1,Matches
2062,Pedro,es ESP,FW,Lazio,it Serie A,35,1987,21.1,35,24,14,10,11,11,30,36.7,19,18,2,16,6,41,4,1,Matches
2063,Adrià Pedrosa,es ESP,"DF,MF",Espanyol,es La Liga,24,1998,2.5,5,1,5,0,0,4,7,57.1,3,1,1,0,5,10,3,0,Matches
2064,Jordan Pefok,us USA,FW,Union Berlin,de Bundesliga,26,1996,15.1,15,7,3,4,8,2,17,11.8,15,17,5,12,4,19,15,0,Matches
2065,Gianluca Pegolo,it ITA,GK,Sassuolo,it Serie A,41,1981,2.0,0,0,0,0,0,0,1,0.0,1,0,0,0,0,0,1,0,Matches
2066,Dženan Pejčinović,de GER,FW,Wolfsburg,de Bundesliga,17,2005,0.1,0,0,0,0,0,0,0,,0,0,0,0,0,0,0,0,Matches
2067,Peter Pekarík,sk SVK,DF,Hertha BSC,de Bundesliga,35,1986,2.3,4,3,4,0,0,4,6,66.7,2,6,2,4,4,8,7,0,Matches
2068,Pietro Pellegri,it ITA,FW,Torino,it Serie A,21,2001,5.2,6,2,1,3,2,2,3,66.7,1,5,1,4,0,6,4,0,Matches
2069,Lorenzo Pellegrini,it ITA,MF,Roma,it Serie A,26,1996,28.3,52,29,24,24,4,22,48,45.8,26,27,4,23,26,78,22,0,Matches
2070,Luca Pellegrini,it ITA,DF,Lazio,it Serie A,23,1999,2.0,1,0,0,1,0,1,4,25.0,3,3,0,3,7,8,4,0,Matches
2071,Luca Pellegrini,it ITA,DF,Eint Frankfurt,de Bundesliga,23,1999,6.2,13,8,10,3,0,8,8,100.0,0,8,2,6,7,20,11,1,Matches
2072,Théo Pellenard,fr FRA,DF,Auxerre,fr Ligue 1,28,1994,1.1,1,0,1,0,0,1,1,100.0,0,3,1,2,2,3,2,0,Matches
2073,Facundo Pellistri,uy URU,"FW,MF",Manchester Utd,eng Premier League,20,2001,0.7,1,1,0,1,0,0,0,,0,0,0,0,0,1,3,0,Matches
2074,Timothee Pembele,fr FRA,DF,Paris S-G,fr Ligue 1,19,2002,2.9,5,5,3,1,1,2,4,50.0,2,2,0,2,4,9,2,0,Matches
2075,Iñaki Peña ,es ESP,GK,Barcelona,es La Liga,23,1999,0.8,0,0,0,0,0,0,0,,0,0,0,0,0,0,0,1,Matches
2076,Rubén Peña,es ESP,"DF,MF",Osasuna,es La Liga,31,1991,14.2,32,18,10,18,4,20,41,48.8,21,23,8,15,17,49,31,0,Matches
2077,Patrick Pentz,at AUT,GK,Reims,fr Ligue 1,25,1997,7.0,0,0,0,0,0,0,0,,0,0,0,0,0,0,1,0,Matches
2078,Nicolas Pépé,ci CIV,"FW,MF",Nice,fr Ligue 1,27,1995,16.6,25,13,14,5,6,11,25,44.0,14,17,0,17,3,28,1,0,Matches
2079,Ricardo Pepi,us USA,FW,Augsburg,de Bundesliga,19,2003,1.1,1,1,1,0,0,1,1,100.0,0,1,0,1,0,1,1,0,Matches
2080,Pepín,gq EQG,MF,Monza,it Serie A,25,1996,12.5,28,19,10,11,7,9,27,33.3,18,14,3,11,13,41,17,0,Matches
2081,Alberto Perea,es ESP,MF,Cádiz,es La Liga,31,1990,0.5,2,0,2,0,0,0,0,,0,2,0,2,0,2,0,0,Matches
2082,Juan Perea,co COL,FW,Stuttgart,de Bundesliga,22,2000,4.6,5,4,0,2,3,2,4,50.0,2,2,1,1,1,6,3,0,Matches
2083,Andreas Pereira,br BRA,MF,Fulham,eng Premier League,26,1996,29.9,18,9,3,6,9,8,34,23.5,26,21,3,18,6,24,8,0,Matches
2084,Brayann Pereira,fr FRA,DF,Auxerre,fr Ligue 1,19,2003,2.0,6,5,5,1,0,1,5,20.0,4,2,2,0,2,8,8,1,Matches
2085,Danilo Pereira,pt POR,"DF,MF",Paris S-G,fr Ligue 1,30,1991,26.8,32,17,15,14,3,19,26,73.1,7,26,19,7,36,68,59,1,Matches
2086,Mathias Pereira Lage,pt POR,"MF,FW",Brest,fr Ligue 1,25,1996,14.0,20,7,5,14,1,11,29,37.9,18,10,1,9,14,34,12,0,Matches
2087,Ricardo Pereira,pt POR,"DF,MF",Leicester City,eng Premier League,28,1993,5.0,11,7,8,3,0,7,17,41.2,10,8,2,6,4,15,20,0,Matches
2088,Roberto Pereyra,ar ARG,"DF,MF",Udinese,it Serie A,31,1991,31.3,36,20,21,12,3,16,44,36.4,28,20,5,15,16,52,28,0,Matches
2089,Ayoze Pérez,es ESP,"MF,FW",Leicester City,eng Premier League,29,1993,4.2,11,8,5,4,2,8,19,42.1,11,6,0,6,2,13,3,0,Matches
2090,Ayoze Pérez,es ESP,"FW,MF",Betis,es La Liga,29,1993,15.4,31,15,9,16,6,10,40,25.0,30,22,0,22,13,44,5,0,Matches
2091,Carles Pérez,es ESP,"MF,FW",Celta Vigo,es La Liga,24,1998,23.8,39,23,12,17,10,22,66,33.3,44,29,3,26,6,45,9,0,Matches
2092,Francisco Perez,es ESP,"FW,MF",Valencia,es La Liga,19,2002,1.6,1,1,1,0,0,0,3,0.0,3,0,0,0,0,1,1,0,Matches
2093,Kike Pérez,es ESP,MF,Valladolid,es La Liga,25,1997,25.6,67,33,30,32,5,25,68,36.8,43,26,7,19,20,87,28,0,Matches
2094,Lucas Pérez,es ESP,FW,Cádiz,es La Liga,33,1988,7.0,3,2,2,1,0,1,3,33.3,2,2,0,2,1,4,3,0,Matches
2095,Luis Pérez,es ESP,DF,Valladolid,es La Liga,27,1995,13.5,44,24,26,12,6,27,38,71.1,11,13,4,9,16,60,29,0,Matches
2096,Nehuén Pérez,ar ARG,DF,Udinese,it Serie A,22,2000,31.3,77,40,54,20,3,39,55,70.9,16,53,23,30,35,112,106,1,Matches
2097,Simone Perilli,it ITA,GK,Hellas Verona,it Serie A,27,1995,1.0,0,0,0,0,0,0,0,,0,0,0,0,0,0,0,0,Matches
2098,Mattia Perin,it ITA,GK,Juventus,it Serie A,29,1992,10.5,0,0,0,0,0,0,0,,0,0,0,0,0,0,0,0,Matches
2099,Samuele Perisan,it ITA,GK,Empoli,it Serie A,24,1997,7.0,0,0,0,0,0,0,0,,0,0,0,0,0,0,2,0,Matches
2100,Ivan Perišić,hr CRO,"DF,MF",Tottenham,eng Premier League,33,1989,23.4,42,24,25,10,7,27,47,57.4,20,29,7,22,22,64,49,1,Matches
2101,Romain Perraud,fr FRA,DF,Southampton,eng Premier League,24,1997,20.4,54,33,23,23,8,28,52,53.8,24,24,6,18,20,74,42,0,Matches
2102,Gaëtan Perrin,fr FRA,"MF,FW",Auxerre,fr Ligue 1,26,1996,15.5,17,8,5,6,6,8,30,26.7,22,15,0,15,10,27,9,0,Matches
2103,Lucas Perrin,fr FRA,DF,Strasbourg,fr Ligue 1,23,1998,19.6,44,27,28,14,2,25,49,51.0,24,13,5,8,36,80,53,0,Matches
2104,Máximo Perrone,ar ARG,MF,Manchester City,eng Premier League,19,2003,0.2,0,0,0,0,0,0,0,,0,1,0,1,0,0,0,0,Matches
2105,Matteo Pessina,it ITA,MF,Monza,it Serie A,25,1997,32.6,57,36,28,21,8,26,62,41.9,36,50,15,35,37,94,33,1,Matches
2106,Andrea Petagna,it ITA,FW,Monza,it Serie A,27,1995,18.5,7,5,2,3,2,3,6,50.0,3,16,4,12,3,10,18,0,Matches
2107,Nils Petersen,de GER,FW,Freiburg,de Bundesliga,33,1988,3.1,6,4,0,3,3,2,5,40.0,3,11,2,9,1,7,6,0,Matches
2108,Lukas Petkov,bg BUL,"MF,FW",Augsburg,de Bundesliga,21,2000,1.6,5,1,4,1,0,2,3,66.7,1,4,1,3,1,6,0,0,Matches
2109,Cameron Peupion,au AUS,MF,Brighton,eng Premier League,19,2002,0.1,0,0,0,0,0,0,0,,0,0,0,0,0,0,0,0,Matches
2110,Germán Pezzella,ar ARG,DF,Betis,es La Liga,31,1991,27.9,41,28,32,9,0,26,38,68.4,12,32,15,17,50,91,129,1,Matches
2111,Giuseppe Pezzella,it ITA,DF,Lecce,it Serie A,24,1997,10.2,21,9,16,2,3,9,16,56.3,7,11,3,8,8,29,31,1,Matches
2112,Luca Pfeiffer,de GER,FW,Stuttgart,de Bundesliga,25,1996,7.8,1,1,1,0,0,0,1,0.0,1,4,0,4,1,2,5,0,Matches
2113,Maximilian Philipp,de GER,FW,Wolfsburg,de Bundesliga,28,1994,1.3,2,1,1,1,0,1,1,100.0,0,1,0,1,0,2,0,0,Matches
2114,Maximilian Philipp,de GER,"FW,MF",Werder Bremen,de Bundesliga,28,1994,4.9,6,5,3,2,1,1,9,11.1,8,7,1,6,3,9,4,0,Matches
2115,Kalvin Phillips,eng ENG,MF,Manchester City,eng Premier League,26,1995,3.3,6,4,3,3,0,2,10,20.0,8,7,3,4,5,11,10,0,Matches
2116,Nathaniel Phillips,eng ENG,DF,Liverpool,eng Premier League,25,1997,0.7,2,1,0,2,0,2,2,100.0,0,0,0,0,2,4,1,0,Matches
2117,Krzysztof Piątek,pl POL,FW,Salernitana,it Serie A,27,1995,23.8,18,11,3,9,6,5,21,23.8,16,17,4,13,2,20,39,0,Matches
2118,Roberto Piccoli,it ITA,FW,Hellas Verona,it Serie A,21,2001,2.1,1,0,1,0,0,0,2,0.0,2,2,0,2,0,1,2,0,Matches
2119,Roberto Piccoli,it ITA,FW,Empoli,it Serie A,21,2001,5.7,1,1,1,0,0,0,3,0.0,3,4,1,3,1,2,9,0,Matches
2120,Charles Pickel,cd COD,MF,Cremonese,it Serie A,25,1997,27.6,55,23,25,26,4,32,57,56.1,25,37,5,32,24,79,36,1,Matches
2121,Jordan Pickford,eng ENG,GK,Everton,eng Premier League,28,1994,37.0,0,0,0,0,0,0,1,0.0,1,0,0,0,4,4,15,3,Matches
2122,Amos Pieper,de GER,DF,Werder Bremen,de Bundesliga,24,1998,21.7,46,28,25,19,2,24,40,60.0,16,23,11,12,30,76,94,1,Matches
2123,Ronaël Pierre-Gabriel,fr FRA,DF,Espanyol,es La Liga,24,1998,2.6,17,9,12,4,1,5,11,45.5,6,5,2,3,9,26,11,0,Matches
2124,Ronaël Pierre-Gabriel,fr FRA,DF,Strasbourg,fr Ligue 1,24,1998,7.3,25,18,11,12,2,15,17,88.2,2,16,3,13,9,34,22,0,Matches
2125,Andrea Pinamonti,it ITA,FW,Sassuolo,it Serie A,23,1999,24.0,10,7,0,5,5,3,7,42.9,4,19,2,17,2,12,11,0,Matches
2126,Ethan Pinnock,jm JAM,DF,Brentford,eng Premier League,29,1993,30.0,52,28,33,12,7,18,24,75.0,6,41,31,10,35,87,215,2,Matches
2127,Yeremi Pino,es ESP,"FW,MF",Villarreal,es La Liga,19,2002,27.2,62,38,25,20,17,21,56,37.5,35,41,4,37,15,77,36,0,Matches
2128,Gerard Piqué,es ESP,DF,Barcelona,es La Liga,35,1987,4.3,5,4,1,4,0,4,4,100.0,0,2,1,1,2,7,19,0,Matches
2129,Lorenzo Pirola,it ITA,DF,Salernitana,it Serie A,20,2002,21.6,33,29,18,14,1,19,27,70.4,8,50,35,15,30,63,85,1,Matches
2130,Niccolò Pisilli,it ITA,MF,Roma,it Serie A,17,2004,0.0,0,0,0,0,0,0,0,,0,0,0,0,0,0,0,0,Matches
2131,Marko Pjaca,hr CRO,"MF,FW",Empoli,it Serie A,27,1995,5.8,4,3,3,1,0,3,5,60.0,2,3,0,3,3,7,3,0,Matches
2132,Óscar Plano,es ESP,"FW,MF",Valladolid,es La Liga,31,1991,22.6,40,25,9,17,14,12,37,32.4,25,26,2,24,29,69,23,0,Matches
2133,Gonzalo Plata,ec ECU,FW,Valladolid,es La Liga,21,2000,25.6,66,35,31,24,11,23,70,32.9,47,40,0,40,12,78,10,1,Matches
2134,Marvin Plattenhardt,de GER,DF,Hertha BSC,de Bundesliga,30,1992,26.7,43,33,24,15,4,29,47,61.7,18,25,11,14,15,58,82,0,Matches
2135,Alassane Pléa,fr FRA,FW,Gladbach,de Bundesliga,29,1993,19.7,16,8,5,7,4,8,26,30.8,18,23,3,20,12,28,14,0,Matches
2136,Tommaso Pobega,it ITA,MF,Milan,it Serie A,23,1999,9.8,27,16,8,15,4,13,20,65.0,7,12,4,8,9,36,11,0,Matches
2137,Daniel Podence,pt POR,"FW,MF",Wolves,eng Premier League,26,1995,19.7,27,17,13,9,5,6,32,18.8,26,19,0,19,7,34,6,0,Matches
2138,Paul Pogba,fr FRA,"MF,FW",Juventus,it Serie A,29,1993,1.2,0,0,0,0,0,0,1,0.0,1,0,0,0,0,0,2,0,Matches
2139,Joel Pohjanpalo,fi FIN,"FW,MF",Leverkusen,de Bundesliga,27,1994,0.0,0,0,0,0,0,0,0,,0,0,0,0,0,0,0,0,Matches
2140,Matteo Politano,it ITA,FW,Napoli,it Serie A,28,1993,13.0,18,9,9,5,4,11,25,44.0,14,6,0,6,7,25,7,0,Matches
2141,Sebastian Polter,de GER,FW,Schalke 04,de Bundesliga,31,1991,7.0,4,3,0,4,0,1,4,25.0,3,4,0,4,1,5,6,0,Matches
2142,Ezequiel Ponce,ar ARG,"FW,MF",Elche,es La Liga,25,1997,12.5,9,7,0,6,3,0,7,0.0,7,6,1,5,1,10,13,0,Matches
2143,Julien Ponceau,fr FRA,MF,Lorient,fr Ligue 1,21,2000,18.4,28,19,10,14,4,10,32,31.3,22,27,3,24,14,42,12,0,Matches
2144,Marin Pongračić,hr CRO,DF,Lecce,it Serie A,24,1997,8.8,16,14,8,7,1,5,7,71.4,2,4,3,1,16,32,31,0,Matches
2145,Nick Pope,eng ENG,GK,Newcastle Utd,eng Premier League,30,1992,36.2,1,0,1,0,0,1,3,33.3,2,0,0,0,0,1,27,2,Matches
2146,Łukasz Poręba,pl POL,MF,Lens,fr Ligue 1,22,2000,2.9,5,4,2,1,2,2,3,66.7,1,3,0,3,4,9,2,0,Matches
2147,Jackson Porozo,ec ECU,DF,Troyes,fr Ligue 1,21,2000,18.0,32,20,24,7,1,13,31,41.9,18,24,17,7,33,65,75,0,Matches
2148,Pedro Porro,es ESP,"DF,MF",Tottenham,eng Premier League,22,1999,12.6,25,16,8,15,2,14,39,35.9,25,25,2,23,15,40,24,1,Matches
2149,Francisco Portillo,es ESP,"MF,FW",Almería,es La Liga,32,1990,8.0,13,6,4,5,4,3,16,18.8,13,7,1,6,7,20,8,0,Matches
2150,Portu,es ESP,"MF,DF",Getafe,es La Liga,30,1992,19.7,28,21,14,10,4,18,42,42.9,24,23,3,20,17,45,20,1,Matches
2151,Stefan Posch,at AUT,DF,Bologna,it Serie A,25,1997,28.1,81,43,41,29,11,44,75,58.7,31,44,15,29,35,116,69,0,Matches
2152,Stefan Posch,at AUT,DF,Hoffenheim,de Bundesliga,25,1997,0.2,0,0,0,0,0,0,0,,0,0,0,0,0,0,0,0,Matches
2153,Yussuf Poulsen,dk DEN,FW,RB Leipzig,de Bundesliga,28,1994,4.6,6,4,1,4,1,2,5,40.0,3,3,1,2,0,6,5,0,Matches
2154,José Pozo,es ESP,"MF,FW",Rayo Vallecano,es La Liga,26,1996,1.0,2,2,0,2,0,0,0,,0,0,0,0,1,3,1,0,Matches
2155,Manuel Pozo,es ESP,FW,Valladolid,es La Liga,20,2001,0.2,0,0,0,0,0,0,0,,0,2,0,2,2,2,0,0,Matches
2156,Alejandro Pozo Pozo,es ESP,DF,Almería,es La Liga,23,1999,20.9,37,19,17,17,3,27,53,50.9,26,30,5,25,26,63,45,1,Matches
2157,Dennis Praet,be BEL,"MF,FW",Leicester City,eng Premier League,28,1994,7.2,12,9,5,6,1,6,11,54.5,5,12,2,10,5,17,6,0,Matches
2158,Abdón Prats,es ESP,"FW,MF",Mallorca,es La Liga,29,1992,4.6,1,0,1,0,0,0,0,,0,5,0,5,0,1,2,0,Matches
2159,Sanjin Prcić,ba BIH,MF,Strasbourg,fr Ligue 1,28,1993,18.1,27,12,6,16,5,19,31,61.3,12,22,7,15,25,52,22,0,Matches
2160,Isaac Price,nir NIR,MF,Everton,eng Premier League,18,2003,0.4,0,0,0,0,0,0,1,0.0,1,1,1,0,0,0,0,0,Matches
2161,Grischa Prömel,de GER,MF,Hoffenheim,de Bundesliga,27,1995,16.2,27,19,14,11,2,9,25,36.0,16,22,4,18,8,35,23,0,Matches
2162,Ivan Provedel,it ITA,GK,Lazio,it Serie A,28,1994,37.9,1,0,1,0,0,0,0,,0,0,0,0,0,1,15,1,Matches
2163,Javi Puado,es ESP,"FW,MF",Espanyol,es La Liga,24,1998,26.0,20,11,12,5,3,12,28,42.9,16,12,2,10,10,30,14,0,Matches
2164,Mehdi Puch Herrantz,fr FRA,MF,Ajaccio,fr Ligue 1,18,2004,0.5,2,2,0,1,1,1,2,50.0,1,1,0,1,3,5,0,0,Matches
2165,Tymoteusz Puchacz,pl POL,DF,Union Berlin,de Bundesliga,23,1999,0.6,1,0,1,0,0,0,0,,0,0,0,0,0,1,1,0,Matches
2166,Arnau Puigmal,es ESP,"MF,FW",Almería,es La Liga,21,2001,8.5,22,14,10,7,5,12,17,70.6,5,7,0,7,11,33,6,0,Matches
2167,Christian Pulisic,us USA,"FW,DF",Chelsea,eng Premier League,23,1998,9.1,11,6,3,6,2,3,5,60.0,2,8,1,7,4,15,4,0,Matches
2168,Ignacio Pussetto,ar ARG,"MF,DF",Sampdoria,it Serie A,26,1995,1.7,6,3,2,3,1,3,4,75.0,1,4,0,4,0,6,3,0,Matches
2169,Niklas Pyyhtiä,fi FIN,MF,Bologna,it Serie A,18,2003,1.2,1,0,0,1,0,0,1,0.0,1,1,1,0,1,2,4,0,Matches
2170,Fabio Quagliarella,it ITA,FW,Sampdoria,it Serie A,39,1983,8.9,2,1,1,1,0,1,7,14.3,6,5,1,4,0,2,9,0,Matches
2171,Giacomo Quagliata,it ITA,DF,Cremonese,it Serie A,22,2000,7.8,10,8,7,1,2,5,11,45.5,6,7,2,5,11,21,8,0,Matches
2172,Eduardo Quaresma,pt POR,DF,Hoffenheim,de Bundesliga,20,2002,1.0,5,3,3,2,0,1,3,33.3,2,3,2,1,0,5,3,0,Matches
2173,Joshua Quarshie,de GER,MF,Hoffenheim,de Bundesliga,18,2004,0.0,0,0,0,0,0,0,0,,0,0,0,0,0,0,0,0,Matches
2174,Ghjuvanni Quilichini,fr FRA,GK,Ajaccio,fr Ligue 1,19,2002,0.9,0,0,0,0,0,0,0,,0,0,0,0,0,0,1,0,Matches
2175,Domingos Quina,pt POR,MF,Elche,es La Liga,22,1999,3.1,3,2,2,1,0,1,3,33.3,2,5,0,5,3,6,1,0,Matches
2176,Rubén Quintanilla,es ESP,DF,Mallorca,es La Liga,20,2002,0.0,0,0,0,0,0,0,0,,0,1,0,1,0,0,0,0,Matches
2177,Adrien Rabiot,fr FRA,MF,Juventus,it Serie A,27,1995,30.5,65,35,31,23,11,30,57,52.6,27,37,7,30,26,91,44,1,Matches
2178,Nemanja Radonjić,rs SRB,"MF,FW",Torino,it Serie A,26,1996,16.2,2,1,2,0,0,0,4,0.0,4,3,0,3,2,4,4,0,Matches
2179,Ivan Radovanović,rs SRB,"MF,DF",Salernitana,it Serie A,33,1988,7.5,12,4,8,4,0,4,10,40.0,6,9,3,6,7,19,9,1,Matches
2180,Ionuț Radu,ro ROU,GK,Cremonese,it Serie A,25,1997,9.0,0,0,0,0,0,0,0,,0,0,0,0,0,0,1,3,Matches
2181,Ionuț Radu,ro ROU,GK,Auxerre,fr Ligue 1,25,1997,17.0,0,0,0,0,0,0,0,,0,0,0,0,0,0,3,3,Matches
2182,Ștefan Radu,ro ROU,FW,Lazio,it Serie A,35,1986,0.0,0,0,0,0,0,0,0,,0,0,0,0,0,0,0,0,Matches
2183,Antonio Raillo,es ESP,DF,Mallorca,es La Liga,30,1991,30.7,34,21,23,11,0,10,15,66.7,5,38,29,9,31,65,158,1,Matches
2184,Antonio Raimondo,it ITA,FW,Bologna,it Serie A,18,2004,0.2,0,0,0,0,0,0,0,,0,0,0,0,0,0,1,0,Matches
2185,Predrag Rajković,rs SRB,GK,Mallorca,es La Liga,26,1995,36.0,0,0,0,0,0,0,2,0.0,2,0,0,0,0,0,16,1,Matches
2186,Ivan Rakitić,hr CRO,MF,Sevilla,es La Liga,34,1988,19.9,37,26,10,18,9,19,40,47.5,21,21,1,20,27,64,20,0,Matches
2187,Diant Ramaj,de GER,GK,Eint Frankfurt,de Bundesliga,20,2001,1.0,0,0,0,0,0,0,0,,0,0,0,0,0,0,1,0,Matches
2188,Largie Ramazani,be BEL,"FW,MF",Almería,es La Liga,21,2001,15.6,15,9,6,3,6,8,27,29.6,19,11,0,11,15,30,10,0,Matches
2189,Simon Ramet,fr FRA,DF,Lille,fr Ligue 1,19,2003,0.0,0,0,0,0,0,0,0,,0,0,0,0,0,0,0,0,Matches
2190,Adil Rami,fr FRA,DF,Troyes,fr Ligue 1,36,1985,17.7,19,14,13,5,1,17,32,53.1,15,23,16,7,25,44,75,3,Matches
2191,Chris Ramos,es ESP,FW,Cádiz,es La Liga,25,1997,7.9,12,9,2,7,3,4,11,36.4,7,8,3,5,1,13,19,0,Matches
2192,Sergio Ramos,es ESP,DF,Paris S-G,fr Ligue 1,36,1986,30.0,34,26,14,18,2,23,44,52.3,21,29,13,16,34,68,93,3,Matches
2193,Aaron Ramsdale,eng ENG,GK,Arsenal,eng Premier League,24,1998,38.0,1,1,1,0,0,1,1,100.0,0,0,0,0,0,1,20,6,Matches
2194,Aaron Ramsey,wls WAL,MF,Nice,fr Ligue 1,31,1990,17.6,47,25,18,19,10,16,39,41.0,23,25,4,21,17,64,18,1,Matches
2195,Jacob Ramsey,eng ENG,"MF,FW",Aston Villa,eng Premier League,21,2001,29.3,69,39,23,35,11,32,69,46.4,37,48,8,40,23,92,34,0,Matches
2196,Luca Ranieri,it ITA,DF,Fiorentina,it Serie A,23,1999,5.6,9,4,6,3,0,6,9,66.7,3,5,3,2,11,20,15,1,Matches
2197,Andrea Ranocchia,it ITA,DF,Monza,it Serie A,34,1988,0.5,3,1,1,2,0,3,4,75.0,1,5,5,0,0,3,7,0,Matches
2198,Filippo Ranocchia,it ITA,MF,Monza,it Serie A,21,2001,5.9,11,6,5,4,2,4,12,33.3,8,5,1,4,4,15,7,0,Matches
2199,Lilian Raolisoa,fr FRA,"DF,MF",Angers,fr Ligue 1,22,2000,1.9,11,9,6,3,2,7,10,70.0,3,3,1,2,3,14,5,0,Matches
2200,Raphinha,br BRA,FW,Barcelona,es La Liga,25,1996,23.0,29,19,10,7,12,11,31,35.5,20,33,1,32,14,43,11,1,Matches
2201,Nicolai Rapp,de GER,"MF,DF",Werder Bremen,de Bundesliga,25,1996,0.8,3,1,3,0,0,0,3,0.0,3,0,0,0,0,3,1,0,Matches
2202,Elba Rashani,xk KVX,"MF,FW",Clermont Foot,fr Ligue 1,29,1993,24.0,39,26,13,19,7,13,39,33.3,26,27,2,25,21,60,19,0,Matches
2203,Marcus Rashford,eng ENG,FW,Manchester Utd,eng Premier League,24,1997,32.0,20,10,7,8,5,9,24,37.5,15,31,4,27,7,27,14,0,Matches
2204,Giacomo Raspadori,it ITA,FW,Sassuolo,it Serie A,22,2000,0.5,0,0,0,0,0,0,0,,0,0,0,0,0,0,0,0,Matches
2205,Giacomo Raspadori,it ITA,"FW,MF",Napoli,it Serie A,22,2000,10.1,10,8,0,6,4,4,10,40.0,6,9,0,9,4,14,4,0,Matches
2206,Rafael Ratão,br BRA,"FW,MF",Toulouse,fr Ligue 1,26,1995,20.6,52,36,29,16,7,27,73,37.0,46,34,0,34,21,73,7,0,Matches
2207,David Raum,de GER,"DF,MF",RB Leipzig,de Bundesliga,24,1998,18.7,39,25,23,12,4,17,29,58.6,12,24,6,18,16,55,26,1,Matches
2208,Nicola Ravaglia,it ITA,GK,Sampdoria,it Serie A,33,1988,9.0,0,0,0,0,0,0,1,0.0,1,0,0,0,0,0,7,0,Matches
2209,Rayan Raveloson,mg MAD,"DF,MF",Auxerre,fr Ligue 1,25,1997,27.0,38,23,21,16,1,23,33,69.7,10,43,12,31,39,77,70,0,Matches
2210,David Raya,es ESP,GK,Brentford,eng Premier League,26,1995,38.0,0,0,0,0,0,0,2,0.0,2,1,0,1,1,1,10,3,Matches
2211,Tim Ream,us USA,DF,Fulham,eng Premier League,34,1987,32.2,30,16,15,12,3,13,26,50.0,13,45,24,21,41,71,116,3,Matches
2212,Ante Rebić,hr CRO,"FW,MF",Milan,it Serie A,28,1993,10.9,10,8,1,3,6,3,11,27.3,8,6,1,5,1,11,5,0,Matches
2213,Arkadiusz Reca,pl POL,DF,Spezia,it Serie A,27,1995,24.1,44,28,22,12,10,19,32,59.4,13,21,5,16,24,68,54,0,Matches
2214,Nathan Redmond,eng ENG,DF,Southampton,eng Premier League,28,1994,0.0,0,0,0,0,0,0,0,,0,0,0,0,0,0,0,0,Matches
2215,Harrison Reed,eng ENG,MF,Fulham,eng Premier League,27,1995,31.8,44,27,17,21,6,16,51,31.4,35,54,12,42,19,63,36,0,Matches
2216,Sergio Reguilón,es ESP,DF,Atlético Madrid,es La Liga,25,1996,3.4,7,5,5,2,0,5,7,71.4,2,3,0,3,2,9,4,0,Matches
2217,Bobby Reid,jm JAM,"FW,DF",Fulham,eng Premier League,29,1993,27.5,42,24,14,14,14,16,36,44.4,20,25,3,22,20,62,28,1,Matches
2218,Pepe Reina,es ESP,GK,Villarreal,es La Liga,39,1982,22.0,0,0,0,0,0,0,1,0.0,1,0,0,0,1,1,4,4,Matches
2219,Jeff Reine-Adélaïde,fr FRA,MF,Troyes,fr Ligue 1,24,1998,2.6,3,2,2,1,0,1,2,50.0,1,2,0,2,2,5,1,0,Matches
2220,Jeff Reine-Adélaïde,fr FRA,MF,Lyon,fr Ligue 1,24,1998,3.7,8,5,1,5,2,5,9,55.6,4,4,0,4,6,14,0,0,Matches
2221,Reinier,br BRA,"MF,FW",Girona,es La Liga,20,2002,7.2,12,10,7,3,2,2,8,25.0,6,6,0,6,5,17,4,0,Matches
2222,Rocco Reitz,de GER,MF,Gladbach,de Bundesliga,20,2002,0.0,0,0,0,0,0,0,0,,0,0,0,0,0,0,0,0,Matches
2223,Karim Rekik,nl NED,DF,Sevilla,es La Liga,27,1994,13.1,11,5,8,3,0,4,5,80.0,1,12,5,7,10,21,24,0,Matches
2224,Álex Remiro,es ESP,GK,Real Sociedad,es La Liga,27,1995,38.0,1,1,1,0,0,1,3,33.3,2,0,0,0,0,1,17,3,Matches
2225,Panagiotis Retsos,gr GRE,DF,Hellas Verona,it Serie A,23,1998,1.4,5,4,2,2,1,3,3,100.0,0,4,1,3,2,7,3,0,Matches
2226,Marco Reus,de GER,"MF,FW",Dortmund,de Bundesliga,33,1989,15.0,30,17,12,14,4,7,24,29.2,17,12,4,8,8,38,8,0,Matches
2227,Alejandro Revuelta Montero,es ESP,DF,Getafe,es La Liga,22,2000,0.0,0,0,0,0,0,0,0,,0,0,0,0,0,0,1,0,Matches
2228,Elvis Rexhbeçaj,de GER,MF,Augsburg,de Bundesliga,24,1997,28.0,51,30,18,24,9,29,59,49.2,30,40,13,27,17,68,40,0,Matches
2229,Gio Reyna,us USA,"FW,MF",Dortmund,de Bundesliga,19,2002,6.9,14,7,2,5,7,5,10,50.0,5,8,2,6,3,17,5,0,Matches
2230,Chadi Riad,ma MAR,MF,Barcelona,es La Liga,19,2003,0.0,0,0,0,0,0,0,0,,0,0,0,0,0,0,0,0,Matches
2231,Nico Ribaudo,es ESP,"MF,FW",Espanyol,es La Liga,21,2001,13.9,18,13,5,9,4,11,30,36.7,19,19,1,18,5,23,1,0,Matches
2232,Alexsandro Ribeiro,br BRA,DF,Lille,fr Ligue 1,22,1999,17.9,32,18,24,7,1,19,28,67.9,9,11,2,9,25,57,59,1,Matches
2233,Franck Ribéry,fr FRA,MF,Salernitana,it Serie A,39,1983,0.4,0,0,0,0,0,0,0,,0,1,0,1,0,0,0,0,Matches
2234,Samuele Ricci,it ITA,MF,Torino,it Serie A,20,2001,23.0,32,21,17,10,5,18,23,78.3,5,20,5,15,17,49,29,1,Matches
2235,Declan Rice,eng ENG,MF,West Ham,eng Premier League,23,1999,36.4,79,38,44,31,4,31,50,62.0,19,45,15,30,63,142,58,0,Matches
2236,Chris Richards,us USA,DF,Crystal Palace,eng Premier League,22,2000,5.0,9,6,8,1,0,5,7,71.4,2,10,1,9,8,17,31,0,Matches
2237,Richarlison,br BRA,"MF,FW",Tottenham,eng Premier League,25,1997,11.2,21,16,13,5,3,12,27,44.4,15,14,1,13,5,26,10,0,Matches
2238,Marco Richter,de GER,"MF,FW",Hertha BSC,de Bundesliga,24,1997,20.4,43,23,18,17,8,19,48,39.6,29,29,2,27,24,67,25,0,Matches
2239,Diego Rico,es ESP,DF,Real Sociedad,es La Liga,29,1993,18.3,35,21,17,11,7,12,27,44.4,15,18,5,13,20,55,51,1,Matches
2240,Jaïro Riedewald,nl NED,"DF,MF",Crystal Palace,eng Premier League,25,1996,0.7,2,1,2,0,0,0,1,0.0,1,2,0,2,0,2,4,0,Matches
2241,Manuel Riemann,de GER,GK,Bochum,de Bundesliga,33,1988,34.0,3,2,3,0,0,3,5,60.0,2,1,0,1,5,8,23,7,Matches
2242,Tomás Rincón,ve VEN,MF,Sampdoria,it Serie A,34,1988,28.4,56,27,22,26,8,29,61,47.5,32,37,7,30,30,86,18,0,Matches
2243,Rémy Riou,fr FRA,GK,Lyon,fr Ligue 1,34,1987,6.7,1,0,1,0,0,1,1,100.0,0,0,0,0,0,1,3,0,Matches
2244,Renaud Ripart,fr FRA,"FW,MF",Troyes,fr Ligue 1,29,1993,14.7,40,23,14,20,6,19,52,36.5,33,29,2,27,7,47,5,0,Matches
2245,Rodrigo Riquelme,es ESP,"MF,FW",Girona,es La Liga,22,2000,24.2,20,8,8,8,4,9,35,25.7,26,16,0,16,11,31,5,0,Matches
2246,Matt Ritchie,sct SCO,"FW,MF",Newcastle Utd,eng Premier League,32,1989,0.4,1,1,0,1,0,1,3,33.3,2,0,0,0,1,2,0,0,Matches
2247,Sergi Roberto,es ESP,"DF,MF",Barcelona,es La Liga,30,1992,14.5,22,15,12,6,4,7,18,38.9,11,15,7,8,11,33,16,0,Matches
2248,Lucas Robertone,ar ARG,MF,Almería,es La Liga,25,1997,31.6,50,28,20,21,9,28,64,43.8,36,45,7,38,46,96,46,1,Matches
2249,Andrew Robertson,sct SCO,DF,Liverpool,eng Premier League,28,1994,28.7,38,21,12,16,10,21,41,51.2,20,32,5,27,18,56,50,3,Matches
2250,Antonee Robinson,us USA,DF,Fulham,eng Premier League,24,1997,34.3,62,38,43,15,4,44,65,67.7,21,49,13,36,53,115,83,3,Matches
2251,Joel Robles,es ESP,GK,Leeds United,eng Premier League,32,1990,4.0,0,0,0,0,0,0,1,0.0,1,0,0,0,0,0,2,1,Matches
2252,Joel Roca,es ESP,"MF,FW",Girona,es La Liga,17,2005,0.9,2,2,2,0,0,2,5,40.0,3,1,1,0,0,2,1,0,Matches
2253,Marc Roca,es ESP,MF,Leeds United,eng Premier League,25,1996,25.7,66,40,27,34,5,20,65,30.8,45,34,10,24,23,89,24,2,Matches
2254,Enzo Roco,cl CHI,DF,Elche,es La Liga,29,1992,18.4,33,13,23,10,0,15,24,62.5,9,22,15,7,17,50,63,1,Matches
2255,Marek Rodák,sk SVK,GK,Fulham,eng Premier League,25,1996,2.0,0,0,0,0,0,0,0,,0,0,0,0,0,0,1,1,Matches
2256,Sebastian Rode,de GER,MF,Eint Frankfurt,de Bundesliga,31,1990,15.7,38,24,7,28,3,14,45,31.1,31,18,2,16,16,54,12,0,Matches
2257,Joe Rodon,wls WAL,DF,Rennes,fr Ligue 1,24,1997,15.7,11,7,9,2,0,4,10,40.0,6,16,12,4,9,20,54,1,Matches
2258,Rodri,es ESP,MF,Manchester City,eng Premier League,26,1996,32.3,67,41,28,28,11,26,53,49.1,27,40,14,26,33,100,43,1,Matches
2259,Rodri,es ESP,"FW,MF",Betis,es La Liga,22,2000,17.8,16,11,5,9,2,8,17,47.1,9,10,0,10,13,29,2,0,Matches
2260,Rodrigo,es ESP,"FW,MF",Leeds United,eng Premier League,31,1991,21.5,24,10,2,15,7,8,19,42.1,11,16,4,12,6,30,21,1,Matches
2261,Ángel Rodríguez,es ESP,"FW,MF",Mallorca,es La Liga,35,1987,4.4,1,1,0,1,0,0,2,0.0,2,3,0,3,1,2,1,0,Matches
2262,Óscar Rodríguez Arnaiz,es ESP,MF,Celta Vigo,es La Liga,24,1998,19.7,32,25,12,15,5,13,28,46.4,15,16,2,14,24,56,15,0,Matches
2263,Dani Rodríguez,es ESP,MF,Mallorca,es La Liga,34,1988,23.3,42,23,18,22,2,21,46,45.7,25,31,8,23,21,63,14,0,Matches
2264,Guido Rodríguez,ar ARG,MF,Betis,es La Liga,28,1994,31.9,115,75,59,50,6,54,101,53.5,47,58,14,44,42,157,76,1,Matches
2265,Miguel Rodríguez,es ESP,"MF,FW",Celta Vigo,es La Liga,19,2003,2.8,7,5,4,3,0,4,11,36.4,7,6,0,6,1,8,3,0,Matches
2266,Pablo Rodríguez,es ESP,"FW,MF",Lecce,it Serie A,20,2001,0.6,2,1,2,0,0,0,2,0.0,2,3,0,3,0,2,0,0,Matches
2267,Ricardo Rodríguez,ch SUI,DF,Torino,it Serie A,29,1992,29.7,54,33,30,17,7,28,42,66.7,14,30,15,15,38,92,61,0,Matches
2268,Rodrygo,br BRA,"FW,MF",Real Madrid,es La Liga,21,2001,26.4,17,10,3,7,7,4,23,17.4,19,23,0,23,8,25,5,0,Matches
2269,Mads Roerslev,dk DEN,DF,Brentford,eng Premier League,23,1999,12.3,22,12,19,3,0,16,33,48.5,17,14,5,9,9,31,38,0,Matches
2270,Agustín Rogel,uy URU,DF,Hertha BSC,de Bundesliga,24,1997,15.8,18,9,13,5,0,11,17,64.7,6,15,8,7,11,29,74,1,Matches
2271,Rogério,br BRA,DF,Sassuolo,it Serie A,24,1998,33.3,37,21,22,8,7,17,35,48.6,18,32,9,23,37,74,70,0,Matches
2272,Merlin Röhl,de GER,"MF,FW",Freiburg,de Bundesliga,20,2002,0.6,1,0,1,0,0,0,0,,0,0,0,0,0,1,1,0,Matches
2273,Tony Rölke,de GER,FW,Hertha BSC,de Bundesliga,19,2003,0.2,0,0,0,0,0,0,0,,0,1,0,1,0,0,1,0,Matches
2274,Filippo Romagna,it ITA,DF,Sassuolo,it Serie A,25,1997,0.5,0,0,0,0,0,0,0,,0,1,1,0,0,0,2,0,Matches
2275,Alessio Romagnoli,it ITA,DF,Lazio,it Serie A,27,1995,32.5,33,15,19,14,0,11,22,50.0,11,33,26,7,38,71,108,0,Matches
2276,Simone Romagnoli,it ITA,DF,Lecce,it Serie A,32,1990,1.9,6,5,3,3,0,2,2,100.0,0,4,1,3,1,7,11,0,Matches
2277,Leonardo Román,es ESP,GK,Mallorca,es La Liga,22,2000,1.0,0,0,0,0,0,0,0,,0,0,0,0,0,0,0,0,Matches
2278,Cristian Romero,ar ARG,DF,Tottenham,eng Premier League,24,1998,26.3,68,36,42,24,2,29,46,63.0,17,40,18,22,44,112,102,3,Matches
2279,Iván Romero,es ESP,MF,Sevilla,es La Liga,21,2001,0.1,0,0,0,0,0,0,0,,0,0,0,0,0,0,0,0,Matches
2280,Luka Romero,ar ARG,FW,Lazio,it Serie A,17,2004,1.7,0,0,0,0,0,0,3,0.0,3,4,0,4,3,3,1,0,Matches
2281,Oriol Romeu,es ESP,MF,Southampton,eng Premier League,30,1991,0.8,1,0,0,1,0,0,0,,0,1,0,1,1,2,1,0,Matches
2282,Oriol Romeu,es ESP,MF,Girona,es La Liga,30,1991,32.8,70,38,36,26,8,26,51,51.0,25,48,10,38,37,107,54,0,Matches
2283,Cristiano Ronaldo,pt POR,FW,Manchester Utd,eng Premier League,37,1985,5.8,2,2,1,0,1,1,2,50.0,1,0,0,0,1,3,9,0,Matches
2284,Connor Ronan,ie IRL,MF,Wolves,eng Premier League,24,1998,0.0,0,0,0,0,0,0,0,,0,0,0,0,0,0,0,0,Matches
2285,Salomón Rondón,ve VEN,FW,Everton,eng Premier League,32,1989,1.2,0,0,0,0,0,0,0,,0,1,1,0,0,0,0,0,Matches
2286,Valentin Rongier,fr FRA,MF,Marseille,fr Ligue 1,27,1994,33.7,93,59,33,47,13,41,77,53.2,36,50,11,39,54,147,38,1,Matches
2287,Marten de Roon,nl NED,MF,Atalanta,it Serie A,31,1991,32.9,77,39,37,35,5,37,81,45.7,44,37,4,33,36,113,58,0,Matches
2288,Pablo Rosario,nl NED,"MF,DF",Nice,fr Ligue 1,25,1997,19.6,46,26,22,20,4,18,34,52.9,16,15,5,10,23,69,32,1,Matches
2289,Francesco Rossi,it ITA,GK,Atalanta,it Serie A,31,1991,0.0,0,0,0,0,0,0,0,,0,0,0,0,0,0,0,0,Matches
2290,Tom Rothe,de GER,DF,Dortmund,de Bundesliga,17,2004,0.3,1,1,0,1,0,1,1,100.0,0,0,0,0,1,2,2,0,Matches
2291,Joe Rothwell,eng ENG,MF,Bournemouth,eng Premier League,27,1995,11.3,20,13,7,12,1,7,21,33.3,14,14,3,11,9,29,7,0,Matches
2292,Anthony Rouault,fr FRA,DF,Toulouse,fr Ligue 1,21,2001,36.8,66,37,54,10,2,30,58,51.7,28,52,26,26,56,122,126,4,Matches
2293,Jérôme Roussillon,fr FRA,"MF,DF",Wolfsburg,de Bundesliga,29,1993,0.2,0,0,0,0,0,0,0,,0,0,0,0,0,0,0,0,Matches
2294,Jérôme Roussillon,fr FRA,DF,Union Berlin,de Bundesliga,29,1993,10.6,16,9,6,8,2,8,12,66.7,4,7,2,5,4,20,22,0,Matches
2295,Nicolò Rovella,it ITA,MF,Monza,it Serie A,20,2001,19.3,45,29,22,21,2,13,36,36.1,23,20,1,19,40,85,17,0,Matches
2296,Nicolò Rovella,it ITA,MF,Juventus,it Serie A,20,2001,0.3,1,1,0,1,0,1,1,100.0,0,0,0,0,0,1,0,0,Matches
2297,Amir Rrahmani,xk KVX,DF,Napoli,it Serie A,28,1994,27.2,33,18,20,13,0,17,26,65.4,9,36,20,16,14,47,79,1,Matches
2298,Ruan,br BRA,DF,Sassuolo,it Serie A,23,1999,19.0,38,26,25,12,1,19,29,65.5,10,29,17,12,24,62,80,3,Matches
2299,Rubén,es ESP,"DF,MF",Espanyol,es La Liga,21,2001,9.9,30,15,18,9,3,20,29,69.0,9,14,4,10,18,48,18,0,Matches
2300,Antonio Rüdiger,de GER,DF,Real Madrid,es La Liga,29,1993,26.8,18,16,12,5,1,14,23,60.9,9,23,13,10,19,37,74,0,Matches
2301,Sebastian Rudy,de GER,MF,Hoffenheim,de Bundesliga,32,1990,8.8,26,12,10,16,0,13,27,48.1,14,27,7,20,11,37,13,0,Matches
2302,Daniele Rugani,it ITA,DF,Juventus,it Serie A,28,1994,6.3,7,0,6,1,0,4,4,100.0,0,7,5,2,7,14,32,0,Matches
2303,Matteo Ruggeri,it ITA,"DF,MF",Atalanta,it Serie A,20,2002,9.2,17,12,5,9,3,8,16,50.0,8,14,3,11,12,29,16,0,Matches
2304,Mário Rui,pt POR,DF,Napoli,it Serie A,31,1991,19.4,34,22,17,13,4,20,41,48.8,21,17,4,13,15,49,24,1,Matches
2305,Aitor Ruibal,es ESP,"DF,FW",Betis,es La Liga,26,1996,16.2,47,29,35,9,3,31,58,53.4,27,17,2,15,24,71,41,0,Matches
2306,Kays Ruiz,ma MAR,MF,Auxerre,fr Ligue 1,19,2002,0.7,1,1,1,0,0,0,1,0.0,1,2,1,1,3,4,0,0,Matches
2307,Fabián Ruiz Peña,es ESP,MF,Paris S-G,fr Ligue 1,26,1996,21.0,62,28,25,30,7,43,79,54.4,36,24,1,23,18,80,23,1,Matches
2308,Víctor Ruiz,es ESP,DF,Betis,es La Liga,33,1989,6.2,5,3,3,2,0,3,3,100.0,0,10,7,3,6,11,34,0,Matches
2309,Gerónimo Rulli,ar ARG,GK,Villarreal,es La Liga,30,1992,14.0,0,0,0,0,0,0,0,,0,1,0,1,1,1,6,2,Matches
2310,Alessandro Russo,it ITA,GK,Sassuolo,it Serie A,21,2001,1.0,0,0,0,0,0,0,0,,0,0,0,0,0,0,1,1,Matches
2311,Franco Russo,ar ARG,DF,Mallorca,es La Liga,27,1994,1.6,2,1,2,0,0,0,1,0.0,1,5,0,5,3,5,5,0,Matches
2312,Georginio Rutter,fr FRA,"FW,MF",Leeds United,eng Premier League,20,2002,3.0,10,9,5,3,2,5,8,62.5,3,5,0,5,3,13,3,0,Matches
2313,Georginio Rutter,fr FRA,FW,Hoffenheim,de Bundesliga,20,2002,11.2,7,4,1,4,2,1,3,33.3,2,10,2,8,5,12,6,0,Matches
2314,Julian Ryerson,no NOR,DF,Union Berlin,de Bundesliga,24,1997,11.5,28,17,17,10,1,15,25,60.0,10,15,3,12,12,40,19,0,Matches
2315,Julian Ryerson,no NOR,DF,Dortmund,de Bundesliga,24,1997,15.7,27,15,17,7,3,19,37,51.4,18,13,2,11,8,35,28,0,Matches
2316,Frederik Rønnow,dk DEN,GK,Union Berlin,de Bundesliga,29,1992,29.0,0,0,0,0,0,0,5,0.0,5,0,0,0,0,0,9,1,Matches
2317,José Sá,pt POR,GK,Wolves,eng Premier League,29,1993,36.0,1,0,1,0,0,1,1,100.0,0,0,0,0,0,1,10,6,Matches
2318,Youssouf Sabaly,sn SEN,DF,Betis,es La Liga,29,1993,18.7,45,23,29,14,2,22,33,66.7,11,35,8,27,19,64,52,1,Matches
2319,Halid Šabanović,ba BIH,DF,Angers,fr Ligue 1,22,1999,7.1,8,6,7,1,0,6,8,75.0,2,8,2,6,8,16,12,0,Matches
2320,Abdelhamid Sabiri,ma MAR,"MF,FW",Sampdoria,it Serie A,25,1996,11.9,18,7,5,9,4,4,13,30.8,9,18,4,14,2,20,5,0,Matches
2321,Marcel Sabitzer,at AUT,MF,Manchester Utd,eng Premier League,28,1994,7.0,12,8,3,8,1,2,11,18.2,9,6,2,4,8,20,11,0,Matches
2322,Marcel Sabitzer,at AUT,MF,Bayern Munich,de Bundesliga,28,1994,7.0,27,14,11,10,6,10,17,58.8,7,3,0,3,10,37,9,0,Matches
2323,Falaye Sacko,ml MLI,DF,Montpellier,fr Ligue 1,27,1995,28.7,46,25,25,15,6,32,51,62.7,19,43,14,29,33,79,75,1,Matches
2324,Umar Sadiq,ng NGA,FW,Almería,es La Liga,25,1997,2.7,0,0,0,0,0,0,1,0.0,1,2,0,2,0,0,3,0,Matches
2325,Umar Sadiq,ng NGA,FW,Real Sociedad,es La Liga,25,1997,0.9,1,1,0,0,1,0,1,0.0,1,2,0,2,0,1,0,0,Matches
2326,Alexis Saelemaekers,be BEL,"FW,DF",Milan,it Serie A,23,1999,15.6,31,20,12,16,3,19,41,46.3,22,13,1,12,19,50,11,0,Matches
2327,Wesley Saïd,fr FRA,"FW,MF",Lens,fr Ligue 1,27,1995,7.2,4,1,1,2,1,2,6,33.3,4,4,0,4,1,5,2,0,Matches
2328,Allan Saint-Maximin,fr FRA,FW,Newcastle Utd,eng Premier League,25,1997,12.4,10,3,3,6,1,2,11,18.2,9,4,0,4,5,15,2,0,Matches
2329,Théo Sainte-Luce,fr FRA,DF,Montpellier,fr Ligue 1,23,1998,5.9,13,11,8,5,0,7,14,50.0,7,7,2,5,10,23,11,0,Matches
2330,Samuel Sáiz,es ESP,MF,Girona,es La Liga,31,1991,2.7,2,2,0,2,0,1,2,50.0,1,3,0,3,0,2,1,1,Matches
2331,Bukayo Saka,eng ENG,FW,Arsenal,eng Premier League,20,2001,35.3,63,34,22,15,26,20,44,45.5,24,38,0,38,14,77,19,0,Matches
2332,Hamza Sakhi,fr FRA,MF,Auxerre,fr Ligue 1,26,1996,18.4,44,22,22,17,5,22,42,52.4,20,16,1,15,25,69,9,0,Matches
2333,Mamadou Sakho,fr FRA,DF,Montpellier,fr Ligue 1,32,1990,8.5,9,5,4,5,0,3,5,60.0,2,17,12,5,8,17,35,1,Matches
2334,Jacopo Sala,it ITA,MF,Spezia,it Serie A,30,1991,1.2,1,0,1,0,0,0,2,0.0,2,2,0,2,1,2,2,0,Matches
2335,Ibrahim Salah,ma MAR,"FW,MF",Rennes,fr Ligue 1,20,2001,2.5,8,1,5,3,0,2,15,13.3,13,3,0,3,2,10,0,0,Matches
2336,Mohamed Salah,eg EGY,FW,Liverpool,eng Premier League,30,1992,36.6,21,12,4,5,12,10,26,38.5,16,21,0,21,6,27,4,0,Matches
2337,Amine Salama,fr FRA,"FW,MF",Angers,fr Ligue 1,22,2000,13.9,11,9,3,7,1,2,12,16.7,10,8,2,6,10,21,2,0,Matches
2338,Kike Salas,es ESP,DF,Sevilla,es La Liga,20,2002,4.1,1,1,1,0,0,0,0,,0,4,3,1,5,6,23,0,Matches
2339,William Saliba,fr FRA,DF,Arsenal,eng Premier League,21,2001,26.8,34,20,23,9,2,15,18,83.3,3,13,10,3,19,53,85,4,Matches
2340,Dikeni-Rafid Salifou,tg TOG,MF,Werder Bremen,de Bundesliga,19,2003,0.0,0,0,0,0,0,0,0,,0,0,0,0,0,0,0,0,Matches
2341,Mohammed Salisu,gh GHA,DF,Southampton,eng Premier League,23,1999,21.9,51,29,33,16,2,24,34,70.6,10,56,25,31,31,82,122,1,Matches
2342,Roland Sallai,hu HUN,"MF,FW",Freiburg,de Bundesliga,25,1997,11.1,11,8,4,3,4,4,10,40.0,6,7,1,6,2,13,11,0,Matches
2343,Yoann Salmier,gf GUF,DF,Troyes,fr Ligue 1,29,1992,29.4,51,29,34,12,5,21,35,60.0,14,34,19,15,39,90,124,0,Matches
2344,Salvi,es ESP,"FW,MF",Rayo Vallecano,es La Liga,31,1991,5.4,13,8,5,5,3,2,8,25.0,6,0,0,0,2,15,2,0,Matches
2345,Lazar Samardzic,rs SRB,MF,Udinese,it Serie A,20,2002,20.5,33,16,9,20,4,17,43,39.5,26,13,0,13,11,44,16,0,Matches
2346,Diadie Samassékou,ml MLI,"MF,FW",Hoffenheim,de Bundesliga,26,1996,0.4,1,0,0,1,0,0,1,0.0,1,0,0,0,0,1,0,0,Matches
2347,Mama Samba Baldé,gw GNB,FW,Troyes,fr Ligue 1,26,1995,29.6,46,21,14,21,11,13,28,46.4,15,30,3,27,10,56,13,0,Matches
2348,Brice Samba,fr FRA,GK,Lens,fr Ligue 1,28,1994,37.0,1,0,1,0,0,1,2,50.0,1,1,0,1,0,1,12,2,Matches
2349,Albert Sambi Lokonga,be BEL,MF,Arsenal,eng Premier League,22,1999,2.2,1,1,0,0,1,0,2,0.0,2,1,0,1,5,6,2,0,Matches
2350,Albert Sambi Lokonga,be BEL,MF,Crystal Palace,eng Premier League,22,1999,6.0,13,10,7,4,2,8,12,66.7,4,8,3,5,7,20,10,0,Matches
2351,Junior Sambia,fr FRA,DF,Salernitana,it Serie A,25,1996,7.7,12,5,7,4,1,6,10,60.0,4,9,3,6,8,20,16,1,Matches
2352,Fede San Emeterio,es ESP,MF,Cádiz,es La Liga,25,1997,20.5,41,22,23,16,2,22,46,47.8,24,34,14,20,17,58,28,0,Matches
2353,Antonio Sanabria,py PAR,FW,Torino,it Serie A,26,1996,27.0,11,5,3,3,5,1,7,14.3,6,9,2,7,4,15,7,0,Matches
2354,Leandro Sanca,gw GNB,"FW,MF",Spezia,it Serie A,22,2000,0.4,1,1,0,0,1,1,1,100.0,0,0,0,0,0,1,0,0,Matches
2355,Oihan Sancet,es ESP,MF,Athletic Club,es La Liga,22,2000,28.1,27,16,2,19,6,11,37,29.7,26,10,0,10,4,31,9,1,Matches
2356,Renato Sanches,pt POR,MF,Paris S-G,fr Ligue 1,24,1997,8.0,8,1,1,3,4,5,14,35.7,9,13,3,10,9,17,4,0,Matches
2357,Alexis Sánchez,cl CHI,"FW,MF",Marseille,fr Ligue 1,33,1988,29.8,27,17,5,16,6,3,24,12.5,21,14,0,14,5,32,6,0,Matches
2358,Antonio Sánchez,es ESP,"MF,DF",Mallorca,es La Liga,25,1997,12.0,19,8,13,4,2,10,34,29.4,24,18,0,18,22,41,14,1,Matches
2359,Davinson Sánchez,co COL,DF,Tottenham,eng Premier League,26,1996,9.5,24,11,17,6,1,14,20,70.0,6,16,10,6,12,36,41,0,Matches
2360,Iván Sánchez,es ESP,"MF,FW",Valladolid,es La Liga,29,1992,12.8,20,14,8,8,4,10,27,37.0,17,14,1,13,8,28,4,0,Matches
2361,Javi Sánchez,es ESP,DF,Valladolid,es La Liga,25,1997,26.6,43,26,27,15,1,17,26,65.4,9,32,22,10,46,89,116,0,Matches
2362,Manu Sánchez,es ESP,DF,Osasuna,es La Liga,21,2000,23.6,51,35,35,9,7,33,63,52.4,30,33,5,28,14,65,51,0,Matches
2363,Robert Sánchez,es ESP,GK,Brighton,eng Premier League,24,1997,23.0,1,0,1,0,0,0,0,,0,0,0,0,3,4,9,2,Matches
2364,Jadon Sancho,eng ENG,"FW,MF",Manchester Utd,eng Premier League,22,2000,18.7,16,10,7,5,4,8,28,28.6,20,25,2,23,7,23,6,0,Matches
2365,Alex Sandro,br BRA,DF,Juventus,it Serie A,31,1991,19.9,35,20,16,16,3,15,22,68.2,7,27,10,17,15,50,64,1,Matches
2366,Leroy Sané,de GER,"MF,FW",Bayern Munich,de Bundesliga,26,1996,22.3,38,30,11,19,8,18,36,50.0,18,11,1,10,3,41,1,2,Matches
2367,Sidi Sané,de GER,FW,Schalke 04,de Bundesliga,19,2003,0.3,1,1,1,0,0,1,1,100.0,0,0,0,0,0,1,0,0,Matches
2368,Morgan Sanson,fr FRA,MF,Aston Villa,eng Premier League,27,1994,0.1,2,1,1,1,0,1,1,100.0,0,0,0,0,0,2,0,0,Matches
2369,Morgan Sanson,fr FRA,MF,Strasbourg,fr Ligue 1,27,1994,15.8,36,25,10,16,10,17,56,30.4,39,21,1,20,22,58,9,0,Matches
2370,Nicola Sansone,it ITA,FW,Bologna,it Serie A,30,1991,8.2,12,4,6,4,2,5,10,50.0,5,0,0,0,0,12,4,0,Matches
2371,Baptiste Santamaria,fr FRA,MF,Rennes,fr Ligue 1,27,1995,20.1,41,22,13,23,5,21,41,51.2,20,21,5,16,21,62,23,0,Matches
2372,Riccardo Saponara,it ITA,FW,Fiorentina,it Serie A,30,1991,13.4,10,5,3,6,1,5,9,55.6,4,7,1,6,5,15,9,1,Matches
2373,Pablo Sarabia,es ESP,"FW,MF",Wolves,eng Premier League,30,1992,8.5,12,6,4,5,3,6,15,40.0,9,7,0,7,2,14,4,0,Matches
2374,Pablo Sarabia,es ESP,"FW,MF",Paris S-G,fr Ligue 1,30,1992,4.1,5,4,2,2,1,1,7,14.3,6,3,0,3,2,7,0,0,Matches
2375,Jeremy Sarmiento,ec ECU,MF,Brighton,eng Premier League,20,2002,2.0,6,3,4,1,1,2,5,40.0,3,2,0,2,1,7,0,0,Matches
2376,Amin Sarr,se SWE,FW,Lyon,fr Ligue 1,21,2001,6.0,9,6,1,4,4,1,4,25.0,3,2,0,2,0,9,4,0,Matches
2377,Bouna Sarr,sn SEN,FW,Bayern Munich,de Bundesliga,30,1992,0.0,0,0,0,0,0,0,0,,0,0,0,0,0,0,0,0,Matches
2378,Malang Sarr,fr FRA,DF,Monaco,fr Ligue 1,23,1999,8.0,6,3,5,1,0,1,5,20.0,4,11,7,4,15,21,29,2,Matches
2379,Mamadou Sarr,fr FRA,MF,Lyon,fr Ligue 1,16,2005,0.1,0,0,0,0,0,0,0,,0,0,0,0,0,0,0,0,Matches
2380,Mouhamadou Sarr,sn SEN,GK,Cremonese,it Serie A,25,1997,2.0,0,0,0,0,0,0,0,,0,0,0,0,0,0,2,0,Matches
2381,Martin Satriano,uy URU,FW,Empoli,it Serie A,21,2001,18.9,13,8,5,6,2,6,14,42.9,8,5,0,5,3,16,22,0,Matches
2382,Téji Savanier,fr FRA,MF,Montpellier,fr Ligue 1,30,1991,28.3,46,30,16,19,11,23,70,32.9,47,30,2,28,30,76,12,1,Matches
2383,Esteban Saveljich,me MNE,FW,Rayo Vallecano,es La Liga,31,1991,0.0,0,0,0,0,0,0,0,,0,0,0,0,0,0,0,0,Matches
2384,Stefan Savić,me MNE,DF,Atlético Madrid,es La Liga,31,1991,21.6,39,26,29,7,3,26,39,66.7,13,17,8,9,33,72,67,2,Matches
2385,Joe Scally,us USA,DF,Gladbach,de Bundesliga,19,2002,24.5,31,20,25,5,1,24,31,77.4,7,17,6,11,8,39,61,0,Matches
2386,Giorgio Scalvini,it ITA,DF,Atalanta,it Serie A,18,2003,25.9,54,29,30,18,6,29,55,52.7,26,36,13,23,56,110,57,2,Matches
2387,Gianluca Scamacca,it ITA,FW,West Ham,eng Premier League,23,1999,10.3,10,5,1,3,6,2,2,100.0,0,3,0,3,4,14,5,0,Matches
2388,Gustavo Scarpa,br BRA,"MF,FW",Nott'ham Forest,eng Premier League,28,1994,2.0,5,2,3,1,1,2,5,40.0,3,4,0,4,0,5,3,0,Matches
2389,Kevin Schade,de GER,FW,Brentford,eng Premier League,20,2001,8.1,12,8,7,2,3,5,10,50.0,5,7,0,7,4,16,6,0,Matches
2390,Kevin Schade,de GER,"FW,MF",Freiburg,de Bundesliga,20,2001,2.0,6,4,3,2,1,3,5,60.0,2,0,0,0,0,6,2,0,Matches
2391,András Schäfer,hu HUN,MF,Union Berlin,de Bundesliga,23,1999,9.6,21,9,7,12,2,6,14,42.9,8,12,2,10,4,25,11,0,Matches
2392,Fabian Schär,ch SUI,DF,Newcastle Utd,eng Premier League,30,1991,35.6,47,22,31,13,3,24,39,61.5,15,34,19,15,52,99,139,0,Matches
2393,Derry Scherhant,de GER,"FW,MF",Hertha BSC,de Bundesliga,19,2002,3.2,7,6,3,3,1,4,8,50.0,4,3,0,3,0,7,5,0,Matches
2394,Patrik Schick,cz CZE,FW,Leverkusen,de Bundesliga,26,1996,10.5,0,0,0,0,0,0,1,0.0,1,4,1,3,1,1,7,0,Matches
2395,Kingsley Schindler,gh GHA,"DF,MF",Köln,de Bundesliga,29,1993,12.1,23,12,13,8,2,18,28,64.3,10,14,2,12,15,38,24,0,Matches
2396,Xaver Schlager,at AUT,MF,RB Leipzig,de Bundesliga,24,1997,16.7,41,24,13,26,2,20,43,46.5,23,19,2,17,17,58,23,0,Matches
2397,Keven Schlotterbeck,de GER,DF,Freiburg,de Bundesliga,25,1997,0.2,0,0,0,0,0,0,0,,0,1,1,0,2,2,2,0,Matches
2398,Keven Schlotterbeck,de GER,DF,Bochum,de Bundesliga,25,1997,8.2,17,9,12,5,0,9,11,81.8,2,11,5,6,14,31,49,0,Matches
2399,Nico Schlotterbeck,de GER,DF,Dortmund,de Bundesliga,22,1999,25.0,59,34,34,24,1,37,53,69.8,16,38,21,17,32,91,71,1,Matches
2400,Jeffrey Schlupp,gh GHA,"MF,FW",Crystal Palace,eng Premier League,29,1992,28.1,66,46,28,29,9,22,43,51.2,21,39,8,31,23,89,38,0,Matches
2401,Kasper Schmeichel,dk DEN,GK,Nice,fr Ligue 1,35,1986,36.0,1,0,1,0,0,1,4,25.0,3,1,0,1,1,2,11,1,Matches
2402,Jonathan Schmid,fr FRA,DF,Freiburg,de Bundesliga,32,1990,0.5,1,1,1,0,0,0,0,,0,1,0,1,1,2,1,1,Matches
2403,Romano Schmid,at AUT,"MF,FW",Werder Bremen,de Bundesliga,22,2000,16.9,24,15,5,13,6,10,22,45.5,12,21,3,18,7,31,12,0,Matches
2404,Kenneth Schmidt,de GER,DF,Freiburg,de Bundesliga,20,2002,2.8,6,3,4,2,0,5,6,83.3,1,4,2,2,0,6,2,0,Matches
2405,Niklas Schmidt,de GER,MF,Werder Bremen,de Bundesliga,24,1998,12.1,25,10,12,11,2,13,28,46.4,15,10,0,10,5,30,12,0,Matches
2406,Benno Schmitz,de GER,DF,Köln,de Bundesliga,27,1994,26.9,64,42,31,28,5,42,82,51.2,40,34,4,30,26,90,57,0,Matches
2407,Jerdy Schouten,nl NED,MF,Bologna,it Serie A,25,1997,27.9,63,38,28,33,2,27,49,55.1,22,40,17,23,40,103,43,1,Matches
2408,Perr Schuurs,nl NED,DF,Torino,it Serie A,22,1999,25.8,51,25,29,17,5,14,26,53.8,12,28,16,12,28,79,102,0,Matches
2409,Marvin Schwäbe,de GER,GK,Köln,de Bundesliga,27,1995,34.0,1,0,1,0,0,1,1,100.0,0,0,0,0,2,3,8,2,Matches
2410,Alexander Schwolow,de GER,GK,Schalke 04,de Bundesliga,30,1992,22.6,0,0,0,0,0,0,2,0.0,2,0,0,0,1,1,6,3,Matches
2411,Manuel Sebastián,es ESP,MF,Sevilla,es La Liga,18,2004,1.7,7,4,3,3,1,5,8,62.5,3,0,0,0,0,7,2,0,Matches
2412,Demba Seck,sn SEN,"MF,FW",Torino,it Serie A,21,2001,5.8,5,2,3,2,0,2,3,66.7,1,3,1,2,1,6,1,0,Matches
2413,Haris Seferović,ch SUI,FW,Celta Vigo,es La Liga,30,1992,9.9,6,3,1,4,1,3,8,37.5,5,7,1,6,1,7,6,1,Matches
2414,Telasco Segovia,ve VEN,MF,Sampdoria,it Serie A,19,2003,0.0,0,0,0,0,0,0,0,,0,0,0,0,0,0,0,0,Matches
2415,Jacopo Segre,it ITA,DF,Torino,it Serie A,25,1997,0.2,0,0,0,0,0,0,0,,0,0,0,0,0,0,0,0,Matches
2416,Paul Seguin,de GER,MF,Union Berlin,de Bundesliga,27,1995,7.7,17,8,9,4,4,8,18,44.4,10,6,0,6,6,23,7,0,Matches
2417,Alidu Seidu,gh GHA,DF,Clermont Foot,fr Ligue 1,22,2000,27.3,52,31,35,14,3,31,51,60.8,20,28,14,14,52,104,50,2,Matches
2418,Davie Selke,de GER,FW,Hertha BSC,de Bundesliga,27,1995,3.1,2,1,1,1,0,0,1,0.0,1,3,1,2,1,3,5,0,Matches
2419,Davie Selke,de GER,FW,Köln,de Bundesliga,27,1995,9.7,0,0,0,0,0,0,4,0.0,4,4,1,3,0,0,11,0,Matches
2420,Matz Sels,be BEL,GK,Strasbourg,fr Ligue 1,30,1992,38.0,4,3,4,0,0,4,4,100.0,0,0,0,0,4,8,23,0,Matches
2421,Nélson Semedo,pt POR,DF,Wolves,eng Premier League,28,1993,29.2,71,42,48,19,4,33,64,51.6,31,42,15,27,29,100,83,2,Matches
2422,Vivaldo Semedo,pt POR,"FW,MF",Udinese,it Serie A,17,2005,0.4,0,0,0,0,0,0,0,,0,1,0,1,0,0,1,0,Matches
2423,Antoine Semenyo,gh GHA,"FW,MF",Bournemouth,eng Premier League,22,2000,2.9,1,0,0,0,1,1,6,16.7,5,10,1,9,2,3,4,0,Matches
2424,Marvin Senaya,tg TOG,DF,Strasbourg,fr Ligue 1,21,2001,0.1,0,0,0,0,0,0,1,0.0,1,1,0,1,0,0,1,0,Matches
2425,Marcos Senesi,ar ARG,DF,Bournemouth,eng Premier League,25,1997,27.7,50,35,28,22,0,23,44,52.3,21,38,20,18,43,93,146,2,Matches
2426,Stefano Sensi,it ITA,MF,Monza,it Serie A,26,1995,18.0,41,26,25,13,3,18,48,37.5,30,13,3,10,20,61,4,0,Matches
2427,Jaime Seoane,es ESP,"MF,FW",Getafe,es La Liga,25,1997,3.6,10,4,3,4,3,2,8,25.0,6,7,3,4,1,11,2,0,Matches
2428,Luigi Sepe,it ITA,GK,Salernitana,it Serie A,31,1991,17.0,0,0,0,0,0,0,1,0.0,1,0,0,0,0,0,0,0,Matches
2429,Suat Serdar,de GER,MF,Hertha BSC,de Bundesliga,25,1997,22.5,51,23,14,30,7,20,41,48.8,21,48,12,36,29,80,24,0,Matches
2430,Leonardo Sernicola,it ITA,DF,Cremonese,it Serie A,25,1997,25.7,45,33,25,13,7,29,43,67.4,14,23,6,17,38,83,55,0,Matches
2431,Ryan Sessegnon,eng ENG,DF,Tottenham,eng Premier League,22,2000,9.0,16,11,9,7,0,6,12,50.0,6,8,1,7,6,22,17,1,Matches
2432,Stephan El Shaarawy,it ITA,"DF,MF",Roma,it Serie A,29,1992,16.9,21,9,8,10,3,6,22,27.3,16,11,1,10,15,36,11,0,Matches
2433,Eniss Shabani,al ALB,MF,Mainz 05,de Bundesliga,19,2003,0.1,0,0,0,0,0,0,0,,0,0,0,0,0,0,0,0,Matches
2434,Luke Shaw,eng ENG,DF,Manchester Utd,eng Premier League,27,1995,28.4,55,36,31,22,2,32,46,69.6,14,51,17,34,36,91,55,2,Matches
2435,Jonjo Shelvey,eng ENG,MF,Newcastle Utd,eng Premier League,30,1992,0.4,1,0,1,0,0,0,1,0.0,1,1,0,1,0,1,0,0,Matches
2436,Jonjo Shelvey,eng ENG,MF,Nott'ham Forest,eng Premier League,30,1992,6.0,2,1,0,1,1,1,9,11.1,8,7,2,5,5,7,10,1,Matches
2437,Eldor Shomurodov,uz UZB,FW,Spezia,it Serie A,27,1995,9.0,5,5,3,1,1,2,11,18.2,9,5,1,4,3,8,4,0,Matches
2438,Eldor Shomurodov,uz UZB,FW,Roma,it Serie A,27,1995,1.3,1,0,1,0,0,0,2,0.0,2,1,0,1,1,2,0,0,Matches
2439,Kaj Sierhuis,nl NED,"FW,MF",Reims,fr Ligue 1,24,1998,2.4,3,3,1,0,2,0,5,0.0,5,3,1,2,1,4,2,0,Matches
2440,Vincent Sierro,ch SUI,MF,Toulouse,fr Ligue 1,26,1995,7.4,19,11,9,9,1,11,29,37.9,18,12,3,9,4,23,11,1,Matches
2441,Kiliann Sildillia,fr FRA,"DF,MF",Freiburg,de Bundesliga,20,2002,22.0,33,20,10,19,4,18,30,60.0,12,24,9,15,21,54,47,1,Matches
2442,André Silva,pt POR,FW,RB Leipzig,de Bundesliga,26,1995,19.3,12,6,2,5,5,3,8,37.5,5,11,1,10,3,15,3,0,Matches
2443,Bernardo Silva,pt POR,"MF,FW",Manchester City,eng Premier League,27,1994,24.5,44,23,11,25,8,18,45,40.0,27,23,6,17,16,60,6,0,Matches
2444,Caio Henrique Oliveira Silva,br BRA,DF,Monaco,fr Ligue 1,25,1997,32.2,74,51,42,28,4,44,76,57.9,32,28,8,20,26,100,68,1,Matches
2445,David Silva,es ESP,MF,Real Sociedad,es La Liga,36,1986,21.5,36,21,11,18,7,11,19,57.9,8,17,2,15,15,51,16,0,Matches
2446,Rui Silva,pt POR,GK,Betis,es La Liga,28,1994,26.0,4,1,4,0,0,4,4,100.0,0,0,0,0,0,4,12,1,Matches
2447,Thiago Silva,br BRA,DF,Chelsea,eng Premier League,37,1984,26.1,41,27,24,17,0,21,31,67.7,10,38,29,9,34,75,111,3,Matches
2448,Marco Silvestri,it ITA,GK,Udinese,it Serie A,31,1991,38.0,2,1,2,0,0,2,3,66.7,1,0,0,0,1,3,15,1,Matches
2449,Abdallah Sima,sn SEN,FW,Angers,fr Ligue 1,21,2001,20.4,22,13,4,15,3,7,19,36.8,12,8,0,8,4,26,19,0,Matches
2450,Mohamed Simakan,fr FRA,DF,RB Leipzig,de Bundesliga,22,2000,16.2,21,14,12,5,4,14,21,66.7,7,21,4,17,16,37,55,0,Matches
2451,Giovanni Simeone,ar ARG,FW,Napoli,it Serie A,27,1995,4.5,12,3,3,5,4,3,8,37.5,5,2,1,1,1,13,4,0,Matches
2452,Ellis Simms,eng ENG,FW,Everton,eng Premier League,21,2001,2.5,0,0,0,0,0,0,0,,0,0,0,0,0,0,1,0,Matches
2453,Simo,es ESP,DF,Espanyol,es La Liga,17,2005,1.6,3,1,3,0,0,2,3,66.7,1,5,4,1,0,3,3,0,Matches
2454,Moses Simon,ng NGA,"FW,MF",Nantes,fr Ligue 1,27,1995,26.1,18,9,6,7,5,7,15,46.7,8,14,1,13,11,29,3,0,Matches
2455,Unai Simón,es ESP,GK,Athletic Club,es La Liga,25,1997,30.5,2,0,2,0,0,1,1,100.0,0,1,0,1,0,2,9,3,Matches
2456,Lassine Sinayoko,ml MLI,"MF,FW",Auxerre,fr Ligue 1,22,1999,17.4,33,15,14,12,7,21,40,52.5,19,12,0,12,18,51,17,0,Matches
2457,Wilfried Singo,ci CIV,DF,Torino,it Serie A,21,2000,22.7,27,17,14,10,3,12,19,63.2,7,15,2,13,12,39,33,1,Matches
2458,Luis Sinisterra,co COL,FW,Leeds United,eng Premier League,23,1999,9.6,21,14,8,9,4,11,18,61.1,7,11,1,10,8,29,2,0,Matches
2459,Daley Sinkgraven,nl NED,"DF,MF",Leverkusen,de Bundesliga,27,1995,3.8,10,7,7,3,0,7,9,77.8,2,8,4,4,5,15,7,0,Matches
2460,Tobias Sippel,de GER,GK,Gladbach,de Bundesliga,34,1988,5.7,0,0,0,0,0,0,0,,0,0,0,0,0,0,1,1,Matches
2461,Hugo Siquet,be BEL,DF,Freiburg,de Bundesliga,20,2002,0.2,2,2,2,0,0,2,2,100.0,0,1,0,1,0,2,0,0,Matches
2462,Salvatore Sirigu,it ITA,GK,Fiorentina,it Serie A,35,1987,1.0,0,0,0,0,0,0,0,,0,0,0,0,0,0,1,0,Matches
2463,Ibrahima Sissoko,ml MLI,MF,Strasbourg,fr Ligue 1,24,1997,14.6,40,22,18,17,5,22,42,52.4,20,20,6,14,10,50,19,0,Matches
2464,Moussa Sissoko,fr FRA,MF,Nantes,fr Ligue 1,32,1989,21.3,26,16,16,7,3,12,18,66.7,6,22,5,17,16,42,17,0,Matches
2465,Tim Skarke,de GER,"DF,MF",Union Berlin,de Bundesliga,25,1996,0.6,1,1,0,0,1,0,0,,0,1,0,1,0,1,0,0,Matches
2466,Tim Skarke,de GER,"FW,MF",Schalke 04,de Bundesliga,25,1996,4.9,13,7,3,8,2,8,11,72.7,3,5,0,5,0,13,4,0,Matches
2467,Ellyes Skhiri,tn TUN,MF,Köln,de Bundesliga,27,1995,31.7,79,44,29,42,8,26,66,39.4,40,52,12,40,56,135,48,0,Matches
2468,Oliver Skipp,eng ENG,MF,Tottenham,eng Premier League,21,2000,16.6,34,17,18,15,1,16,33,48.5,17,17,8,9,17,51,19,1,Matches
2469,Leo Skiri Østigård,no NOR,DF,Napoli,it Serie A,22,1999,4.7,4,1,3,1,0,1,1,100.0,0,3,3,0,6,10,18,1,Matches
2470,Łukasz Skorupski,pl POL,GK,Bologna,it Serie A,31,1991,37.0,2,1,2,0,0,1,2,50.0,1,0,0,0,0,2,19,2,Matches
2471,Robert Skov,dk DEN,DF,Hoffenheim,de Bundesliga,26,1996,15.0,22,11,14,7,1,10,26,38.5,16,22,8,14,8,30,20,2,Matches
2472,Milan Škriniar,sk SVK,DF,Inter,it Serie A,27,1995,19.7,29,18,14,11,4,18,32,56.3,14,18,13,5,13,42,46,3,Matches
2473,Naatan Skyttä,fi FIN,MF,Toulouse,fr Ligue 1,20,2002,0.3,0,0,0,0,0,0,0,,0,0,0,0,1,1,0,0,Matches
2474,Islam Slimani,dz ALG,FW,Brest,fr Ligue 1,34,1988,11.0,5,3,2,2,1,0,3,0.0,3,2,0,2,1,6,11,0,Matches
2475,Chris Smalling,eng ENG,DF,Roma,it Serie A,32,1989,31.2,26,15,16,10,0,13,21,61.9,8,51,36,15,43,69,123,0,Matches
2476,Adam Smith,eng ENG,DF,Bournemouth,eng Premier League,31,1991,32.7,49,29,27,19,3,29,60,48.3,31,30,13,17,25,74,81,1,Matches
2477,Emile Smith Rowe,eng ENG,"MF,FW",Arsenal,eng Premier League,22,2000,1.9,1,1,1,0,0,1,3,33.3,2,1,0,1,0,1,2,0,Matches
2478,Hrvoje Smolčić,hr CRO,DF,Eint Frankfurt,de Bundesliga,21,2000,5.2,8,7,6,2,0,5,10,50.0,5,11,4,7,6,14,38,0,Matches
2479,Cédric Soares,pt POR,DF,Arsenal,eng Premier League,30,1991,0.3,0,0,0,0,0,0,1,0.0,1,1,0,1,0,0,1,0,Matches
2480,Cédric Soares,pt POR,DF,Fulham,eng Premier League,30,1991,2.2,8,5,4,3,1,3,3,100.0,0,3,1,2,1,9,5,0,Matches
2481,Danilo Soares,br BRA,DF,Bochum,de Bundesliga,30,1991,19.6,72,46,42,23,7,43,72,59.7,29,29,6,23,30,102,56,1,Matches
2482,Eduard Sobol,ua UKR,DF,Strasbourg,fr Ligue 1,27,1995,9.7,19,10,10,6,3,9,13,69.2,4,10,1,9,8,27,19,0,Matches
2483,Rubén Sobrino,es ESP,"MF,FW",Cádiz,es La Liga,30,1992,27.4,55,37,29,17,9,23,56,41.1,33,33,3,30,24,79,20,1,Matches
2484,Alex Sola,es ESP,DF,Real Sociedad,es La Liga,23,1999,3.9,18,9,14,3,1,7,10,70.0,3,7,2,5,7,25,10,0,Matches
2485,Dominic Solanke,eng ENG,"FW,MF",Bournemouth,eng Premier League,24,1997,31.8,15,9,8,3,4,5,22,22.7,17,26,7,19,6,21,46,0,Matches
2486,Augusto Solari,ar ARG,MF,Celta Vigo,es La Liga,30,1992,2.9,10,6,6,3,1,3,11,27.3,8,5,0,5,4,14,3,0,Matches
2487,Ola Solbakken,no NOR,"MF,FW",Roma,it Serie A,23,1998,5.6,2,2,1,1,0,2,7,28.6,5,2,0,2,2,4,8,0,Matches
2488,Nikola Soldo,hr CRO,DF,Köln,de Bundesliga,21,2001,6.6,15,9,8,7,0,7,11,63.6,4,7,6,1,7,22,28,0,Matches
2489,Carlos Soler,es ESP,MF,Valencia,es La Liga,25,1997,2.7,2,0,0,1,1,2,3,66.7,1,1,0,1,0,2,2,0,Matches
2490,Carlos Soler,es ESP,MF,Paris S-G,fr Ligue 1,25,1997,13.2,20,12,6,10,4,10,19,52.6,9,12,4,8,4,24,6,0,Matches
2491,François-Joseph Sollacaro,fr FRA,GK,Ajaccio,fr Ligue 1,28,1994,6.0,0,0,0,0,0,0,0,,0,0,0,0,0,0,2,2,Matches
2492,Manor Solomon,il ISR,FW,Fulham,eng Premier League,23,1999,6.4,20,12,12,6,2,9,16,56.3,7,8,0,8,5,25,3,0,Matches
2493,Yann Sommer,ch SUI,GK,Gladbach,de Bundesliga,33,1988,10.0,1,0,1,0,0,1,1,100.0,0,0,0,0,0,1,8,0,Matches
2494,Yann Sommer,ch SUI,GK,Bayern Munich,de Bundesliga,33,1988,19.0,0,0,0,0,0,0,0,,0,0,0,0,1,1,5,1,Matches
2495,Brandon Soppy,fr FRA,DF,Udinese,it Serie A,20,2002,1.0,1,1,0,1,0,0,0,,0,4,0,4,1,2,1,0,Matches
2496,Brandon Soppy,fr FRA,DF,Atalanta,it Serie A,20,2002,7.1,8,5,4,4,0,3,9,33.3,6,10,0,10,3,11,7,0,Matches
2497,David Soria,es ESP,GK,Getafe,es La Liga,29,1993,38.0,0,0,0,0,0,0,1,0.0,1,0,0,0,1,1,20,4,Matches
2498,Roberto Soriano,it ITA,"FW,MF",Bologna,it Serie A,31,1991,14.7,31,16,9,16,6,13,25,52.0,12,23,2,21,6,37,14,0,Matches
2499,Borna Sosa,hr CRO,DF,Stuttgart,de Bundesliga,24,1998,21.7,27,21,18,8,1,21,32,65.6,11,20,5,15,19,46,37,0,Matches
2500,Joaquin Sosa,uy URU,DF,Bologna,it Serie A,20,2002,7.6,6,2,5,1,0,4,18,22.2,14,5,3,2,6,12,31,0,Matches
2501,Hugo Sotelo,es ESP,MF,Celta Vigo,es La Liga,18,2003,0.2,0,0,0,0,0,0,0,,0,0,0,0,0,0,0,0,Matches
2502,Florian Sotoca,fr FRA,"MF,FW",Lens,fr Ligue 1,31,1990,33.9,39,19,11,17,11,15,40,37.5,25,41,2,39,29,68,51,0,Matches
2503,Riccardo Sottil,it ITA,FW,Fiorentina,it Serie A,23,1999,9.3,4,3,2,0,2,2,5,40.0,3,2,0,2,0,4,0,0,Matches
2504,Tomáš Souček,cz CZE,MF,West Ham,eng Premier League,27,1995,31.3,77,37,41,29,7,28,58,48.3,30,42,17,25,53,130,71,3,Matches
2505,Matìas Soulé,ar ARG,"MF,FW",Juventus,it Serie A,19,2003,4.7,7,4,3,2,2,5,7,71.4,2,7,1,6,3,10,3,0,Matches
2506,Moussa Soumano,fr FRA,FW,Ajaccio,fr Ligue 1,17,2005,5.5,2,2,0,1,1,0,6,0.0,6,2,0,2,0,2,0,0,Matches
2507,Adama Soumaoro,fr FRA,DF,Bologna,it Serie A,30,1992,20.7,25,17,11,12,2,5,7,71.4,2,18,13,5,15,40,75,1,Matches
2508,Boubakary Soumaré,fr FRA,MF,Leicester City,eng Premier League,23,1999,18.1,57,34,29,26,2,23,44,52.3,21,15,4,11,33,90,27,1,Matches
2509,Arnaud Souquet,fr FRA,"DF,FW",Montpellier,fr Ligue 1,30,1992,4.0,22,16,13,7,2,11,14,78.6,3,8,3,5,4,26,4,0,Matches
2510,Dyego Sousa,pt POR,FW,Almería,es La Liga,32,1989,5.9,10,6,5,4,1,4,5,80.0,1,4,2,2,1,11,14,0,Matches
2511,Harry Souttar,au AUS,DF,Leicester City,eng Premier League,23,1998,11.0,15,9,10,5,0,7,18,38.9,11,16,12,4,12,27,45,0,Matches
2512,Vinicius Souza,br BRA,MF,Espanyol,es La Liga,23,1999,27.0,99,66,41,45,13,33,59,55.9,26,31,14,17,48,147,50,1,Matches
2513,Djibril Sow,ch SUI,MF,Eint Frankfurt,de Bundesliga,25,1997,29.4,41,25,13,25,3,22,44,50.0,22,22,4,18,28,69,23,0,Matches
2514,Çağlar Söyüncü,tr TUR,DF,Leicester City,eng Premier League,26,1996,5.9,14,9,10,4,0,7,10,70.0,3,9,8,1,7,21,30,0,Matches
2515,Kevin Spadanuda,ch SUI,"MF,FW",Ajaccio,fr Ligue 1,25,1997,11.8,29,18,15,9,5,12,33,36.4,21,18,0,18,11,40,5,0,Matches
2516,Djed Spence,eng ENG,"FW,DF",Tottenham,eng Premier League,21,2000,0.1,0,0,0,0,0,0,0,,0,0,0,0,0,0,0,0,Matches
2517,Djed Spence,eng ENG,DF,Rennes,fr Ligue 1,21,2000,6.4,14,6,8,2,4,11,18,61.1,7,10,3,7,4,18,15,0,Matches
2518,Stijn Spierings,nl NED,MF,Toulouse,fr Ligue 1,26,1996,34.7,95,67,37,49,9,43,101,42.6,58,49,11,38,53,148,44,0,Matches
2519,Leonardo Spinazzola,it ITA,DF,Roma,it Serie A,29,1993,18.4,15,8,7,6,2,8,23,34.8,15,13,3,10,9,24,25,0,Matches
2520,Marco Sportiello,it ITA,GK,Atalanta,it Serie A,30,1992,14.9,1,0,1,0,0,1,3,33.3,2,0,0,0,0,1,2,0,Matches
2521,Jack Stacey,eng ENG,DF,Bournemouth,eng Premier League,26,1996,3.3,5,4,3,1,1,2,5,40.0,3,3,1,2,5,10,15,0,Matches
2522,Anton Stach,de GER,MF,Mainz 05,de Bundesliga,23,1998,23.0,27,21,10,15,2,16,38,42.1,22,28,2,26,41,68,25,0,Matches
2523,Kostas Stafylidis,gr GRE,"DF,MF",Bochum,de Bundesliga,28,1993,11.6,27,16,13,8,6,10,24,41.7,14,21,8,13,20,47,31,1,Matches
2524,Jens Stage,dk DEN,MF,Werder Bremen,de Bundesliga,25,1996,20.6,34,17,15,18,1,10,37,27.0,27,34,11,23,16,50,37,0,Matches
2525,Veit Stange,de GER,MF,Hertha BSC,de Bundesliga,18,2004,0.1,1,1,1,0,0,1,1,100.0,0,0,0,0,0,1,0,0,Matches
2526,Josip Stanišić,hr CRO,DF,Bayern Munich,de Bundesliga,22,2000,6.4,19,11,14,2,3,12,17,70.6,5,9,1,8,7,26,11,3,Matches
2527,Junior Stanislas,eng ENG,MF,Bournemouth,eng Premier League,32,1989,0.7,0,0,0,0,0,0,0,,0,2,1,1,0,0,0,0,Matches
2528,Jay Stansfield,eng ENG,FW,Fulham,eng Premier League,19,2002,1.0,0,0,0,0,0,0,2,0.0,2,4,1,3,1,1,1,0,Matches
2529,Niklas Stark,de GER,DF,Werder Bremen,de Bundesliga,27,1995,23.1,56,36,29,24,3,27,42,64.3,15,24,13,11,37,93,110,0,Matches
2530,Jason Steele,eng ENG,GK,Brighton,eng Premier League,31,1990,15.0,0,0,0,0,0,0,1,0.0,1,0,0,0,0,0,6,1,Matches
2531,Calvin Stengs,nl NED,FW,Nice,fr Ligue 1,23,1998,2.4,2,2,1,0,1,1,2,50.0,1,0,0,0,0,2,0,0,Matches
2532,Pascal Stenzel,de GER,DF,Stuttgart,de Bundesliga,26,1996,3.7,12,8,8,4,0,5,9,55.6,4,9,2,7,5,17,6,0,Matches
2533,Jack Stephens,eng ENG,DF,Southampton,eng Premier League,28,1994,0.5,2,2,2,0,0,1,1,100.0,0,1,1,0,1,3,2,0,Matches
2534,Jack Stephens,eng ENG,DF,Bournemouth,eng Premier League,28,1994,13.0,15,11,10,4,1,6,10,60.0,4,23,16,7,16,31,53,0,Matches
2535,Raheem Sterling,eng ENG,"FW,MF",Chelsea,eng Premier League,27,1994,21.0,18,10,5,4,9,8,14,57.1,6,17,0,17,2,20,5,0,Matches
2536,Angelo Stiller,de GER,MF,Hoffenheim,de Bundesliga,21,2001,7.8,26,12,9,13,4,8,12,66.7,4,12,2,10,10,36,14,0,Matches
2537,Lars Stindl,de GER,"FW,MF",Gladbach,de Bundesliga,33,1988,19.3,24,14,4,17,3,10,28,35.7,18,24,5,19,11,35,19,0,Matches
2538,Kevin Stöger,at AUT,MF,Bochum,de Bundesliga,28,1993,28.9,84,45,38,32,14,31,94,33.0,63,27,4,23,26,110,21,1,Matches
2539,Petar Stojanović,si SVN,DF,Empoli,it Serie A,26,1995,17.0,42,22,28,10,4,26,43,60.5,17,17,5,12,11,53,55,0,Matches
2540,John Stones,eng ENG,"DF,MF",Manchester City,eng Premier League,28,1994,20.5,23,13,11,8,4,7,10,70.0,3,17,10,7,9,32,40,0,Matches
2541,Jørgen Strand Larsen,no NOR,FW,Celta Vigo,es La Liga,22,2000,18.9,15,7,3,5,7,7,30,23.3,23,14,5,9,3,18,24,0,Matches
2542,Tony Strata,fr FRA,"MF,DF",Ajaccio,fr Ligue 1,17,2004,1.5,4,3,4,0,0,4,5,80.0,1,2,0,2,1,5,7,0,Matches
2543,Gabriel Strefezza,br BRA,"FW,MF",Lecce,it Serie A,25,1997,27.1,50,24,18,20,12,27,53,50.9,26,36,3,33,16,66,15,0,Matches
2544,Dávid Strelec,sk SVK,FW,Spezia,it Serie A,21,2001,1.9,2,2,0,1,1,2,2,100.0,0,0,0,0,0,2,0,0,Matches
2545,Pascal Struijk,nl NED,DF,Leeds United,eng Premier League,22,1999,24.4,84,57,43,31,10,49,75,65.3,26,32,12,20,32,116,70,1,Matches
2546,Cristhian Stuani,uy URU,FW,Girona,es La Liga,35,1986,12.1,13,6,2,7,4,5,14,35.7,9,10,0,10,2,15,5,0,Matches
2547,Damián Suárez,uy URU,"DF,MF",Getafe,es La Liga,34,1988,21.6,49,33,23,19,7,26,48,54.2,22,40,0,40,15,64,36,0,Matches
2548,Denis Suárez,es ESP,"MF,FW",Espanyol,es La Liga,28,1994,10.5,26,20,12,12,2,13,45,28.9,32,11,1,10,5,31,4,0,Matches
2549,Mario Suárez,es ESP,"MF,DF",Rayo Vallecano,es La Liga,35,1987,0.1,0,0,0,0,0,0,0,,0,1,0,1,0,0,0,0,Matches
2550,Gabriel Suazo,cl CHI,DF,Toulouse,fr Ligue 1,24,1997,14.0,38,22,20,15,3,29,63,46.0,34,21,5,16,22,60,24,1,Matches
2551,Isaac Success,ng NGA,FW,Udinese,it Serie A,26,1996,20.2,8,4,2,5,1,3,8,37.5,5,13,2,11,4,12,18,0,Matches
2552,Niklas Süle,de GER,DF,Dortmund,de Bundesliga,26,1995,23.5,25,19,18,3,4,14,23,60.9,9,28,19,9,17,42,53,0,Matches
2553,Ibrahim Sulemana,gh GHA,MF,Hellas Verona,it Serie A,19,2003,7.2,19,13,10,7,2,6,12,50.0,6,8,2,6,14,33,15,0,Matches
2554,Kamaldeen Sulemana,gh GHA,"FW,MF",Southampton,eng Premier League,20,2002,10.7,15,9,4,7,4,4,14,28.6,10,16,0,16,6,21,6,0,Matches
2555,Kamaldeen Sulemana,gh GHA,"FW,MF",Rennes,fr Ligue 1,20,2002,3.6,6,3,1,4,1,1,5,20.0,4,2,0,2,4,10,2,0,Matches
2556,Crysencio Summerville,nl NED,FW,Leeds United,eng Premier League,20,2001,15.8,30,20,14,14,2,11,23,47.8,12,20,2,18,13,43,11,0,Matches
2557,Ivan Šunjić,hr CRO,MF,Hertha BSC,de Bundesliga,25,1996,11.0,38,20,16,21,1,16,24,66.7,8,17,5,12,13,51,19,1,Matches
2558,Sam Surridge,eng ENG,FW,Nott'ham Forest,eng Premier League,24,1998,3.6,5,0,1,3,1,1,4,25.0,3,5,2,3,0,5,7,0,Matches
2559,Suso,es ESP,"MF,FW",Sevilla,es La Liga,28,1993,11.8,16,10,5,7,4,10,22,45.5,12,7,1,6,2,18,3,0,Matches
2560,Yuito Suzuki,jp JPN,"FW,MF",Strasbourg,fr Ligue 1,20,2001,0.4,0,0,0,0,0,0,0,,0,3,0,3,0,0,0,0,Matches
2561,Mattias Svanberg,se SWE,"MF,FW",Wolfsburg,de Bundesliga,23,1999,20.4,25,16,8,16,1,10,30,33.3,20,27,5,22,21,46,25,1,Matches
2562,Mile Svilar,rs SRB,GK,Roma,it Serie A,22,1999,3.0,0,0,0,0,0,0,0,,0,0,0,0,0,0,1,0,Matches
2563,Williot Swedberg,se SWE,MF,Celta Vigo,es La Liga,18,2004,0.6,3,1,1,0,2,0,0,,0,2,0,2,0,3,1,0,Matches
2564,Issiaga Sylla,gn GUI,DF,Montpellier,fr Ligue 1,28,1994,14.5,28,16,19,8,1,15,31,48.4,16,19,3,16,32,60,35,0,Matches
2565,Issiaga Sylla,gn GUI,DF,Toulouse,fr Ligue 1,28,1994,15.2,28,15,14,9,5,15,34,44.1,19,15,5,10,38,66,38,0,Matches
2566,Wojciech Szczęsny,pl POL,GK,Juventus,it Serie A,32,1990,27.5,1,0,1,0,0,0,1,0.0,1,0,0,0,0,1,7,0,Matches
2567,Dominik Szoboszlai,hu HUN,"MF,FW",RB Leipzig,de Bundesliga,21,2000,27.2,45,28,12,20,13,17,42,40.5,25,43,2,41,17,62,27,0,Matches
2568,Alexander Sørloth,no NOR,FW,Real Sociedad,es La Liga,26,1995,26.5,18,9,3,6,9,7,14,50.0,7,15,1,14,2,20,26,1,Matches
2569,Alexander Sørloth,no NOR,FW,RB Leipzig,de Bundesliga,26,1995,0.1,0,0,0,0,0,0,0,,0,0,0,0,0,0,0,0,Matches
2570,Nicolás Tagliafico,ar ARG,DF,Lyon,fr Ligue 1,29,1992,33.2,91,53,36,41,14,50,78,64.1,28,45,11,34,57,148,47,0,Matches
2571,Jonathan Tah,de GER,DF,Leverkusen,de Bundesliga,26,1996,27.6,25,12,21,4,0,12,18,66.7,6,30,18,12,40,65,118,0,Matches
2572,Benjamin Tahirovic,ba BIH,MF,Roma,it Serie A,19,2003,3.9,8,5,5,2,1,4,12,33.3,8,9,4,5,3,11,3,0,Matches
2573,Waniss Taibi,fr FRA,MF,Angers,fr Ligue 1,20,2002,2.1,9,5,4,4,1,2,4,50.0,2,1,0,1,2,11,2,0,Matches
2574,Flavien Tait,fr FRA,MF,Rennes,fr Ligue 1,29,1993,18.7,30,15,8,17,5,19,42,45.2,23,16,4,12,20,50,12,0,Matches
2575,Montassar Talbi,tn TUN,DF,Lorient,fr Ligue 1,24,1998,38.0,53,25,40,13,0,22,35,62.9,13,55,34,21,40,93,190,3,Matches
2576,Thibault Tamas,fr FRA,DF,Montpellier,fr Ligue 1,21,2001,0.1,0,0,0,0,0,0,0,,0,0,0,0,1,1,0,0,Matches
2577,Adrien Tameze,cm CMR,MF,Hellas Verona,it Serie A,28,1994,33.7,51,30,21,26,4,28,63,44.4,35,51,14,37,37,88,55,2,Matches
2578,Japhet Tanganga,eng ENG,DF,Tottenham,eng Premier League,23,1999,1.6,3,2,3,0,0,1,5,20.0,4,1,0,1,2,5,8,0,Matches
2579,Renato Tapia,pe PER,"MF,DF",Celta Vigo,es La Liga,27,1995,16.1,47,25,21,21,5,18,37,48.6,19,29,11,18,19,66,37,0,Matches
2580,Edmond Tapsoba,bf BFA,DF,Leverkusen,de Bundesliga,23,1999,31.9,51,30,35,12,4,30,42,71.4,12,40,17,23,36,87,109,1,Matches
2581,Florian Tardieu,fr FRA,MF,Troyes,fr Ligue 1,30,1992,11.2,31,20,19,12,0,12,31,38.7,19,19,4,15,23,54,15,0,Matches
2582,Matt Targett,eng ENG,DF,Newcastle Utd,eng Premier League,26,1995,6.8,13,10,8,3,2,9,24,37.5,15,8,3,5,9,22,16,0,Matches
2583,James Tarkowski,eng ENG,DF,Everton,eng Premier League,29,1992,38.0,51,26,36,13,2,20,39,51.3,19,99,78,21,51,102,201,3,Matches
2584,Ciprian Tătărușanu,ro ROU,GK,Milan,it Serie A,36,1986,16.0,0,0,0,0,0,0,0,,0,0,0,0,1,1,2,0,Matches
2585,Niklas Tauer,de GER,"DF,MF",Mainz 05,de Bundesliga,21,2001,1.0,2,1,2,0,0,1,3,33.3,2,2,1,1,2,4,4,0,Matches
2586,Nuno Tavares,pt POR,"DF,MF",Marseille,fr Ligue 1,22,2000,26.1,56,30,19,24,13,28,55,50.9,27,32,4,28,15,71,25,0,Matches
2587,Marcus Tavernier,eng ENG,"MF,FW",Bournemouth,eng Premier League,23,1999,19.4,33,22,19,11,3,11,33,33.3,22,25,4,21,9,42,23,0,Matches
2588,Enzo Tchato,cm CMR,DF,Montpellier,fr Ligue 1,19,2002,12.2,26,17,14,11,1,13,22,59.1,9,17,2,15,7,33,33,0,Matches
2589,Aurélien Tchouaméni,fr FRA,MF,Real Madrid,es La Liga,22,2000,23.5,64,40,23,36,5,23,38,60.5,15,20,6,14,49,113,50,0,Matches
2590,Mathys Tel,fr FRA,FW,Bayern Munich,de Bundesliga,17,2005,4.6,2,2,0,1,1,1,1,100.0,0,5,1,4,0,2,2,0,Matches
2591,Semir Telalovic,de GER,"MF,FW",Gladbach,de Bundesliga,22,1999,0.1,0,0,0,0,0,0,0,,0,0,0,0,0,0,0,0,Matches
2592,Alex Telles,br BRA,DF,Sevilla,es La Liga,29,1992,15.9,21,13,15,6,0,13,25,52.0,12,17,5,12,20,41,38,0,Matches
2593,Marc-André ter Stegen,de GER,GK,Barcelona,es La Liga,30,1992,37.2,0,0,0,0,0,0,0,,0,0,0,0,1,1,7,3,Matches
2594,Simon Terodde,de GER,FW,Schalke 04,de Bundesliga,34,1988,20.3,15,8,4,7,4,3,14,21.4,11,6,2,4,6,21,9,0,Matches
2595,Filippo Terracciano,it ITA,"DF,MF",Hellas Verona,it Serie A,19,2003,9.1,20,13,11,7,2,15,20,75.0,5,7,4,3,10,30,14,0,Matches
2596,Pietro Terracciano,it ITA,GK,Fiorentina,it Serie A,32,1990,29.0,2,1,2,0,0,2,3,66.7,1,0,0,0,1,3,14,0,Matches
2597,Ramón Terrats,es ESP,MF,Villarreal,es La Liga,21,2000,9.1,15,10,3,8,4,9,17,52.9,8,11,4,7,8,23,6,2,Matches
2598,Ramón Terrats,es ESP,MF,Girona,es La Liga,21,2000,2.4,4,2,1,3,0,2,6,33.3,4,6,2,4,3,7,3,1,Matches
2599,Martin Terrier,fr FRA,"FW,MF",Rennes,fr Ligue 1,25,1997,14.7,25,11,7,9,9,13,24,54.2,11,15,2,13,14,39,6,0,Matches
2600,Aleksa Terzić,rs SRB,DF,Fiorentina,it Serie A,22,1999,10.4,16,9,9,4,3,11,21,52.4,10,13,4,9,5,21,16,0,Matches
2601,Tetê,br BRA,FW,Leicester City,eng Premier League,22,2000,8.2,14,8,5,7,2,6,21,28.6,15,9,0,9,2,16,3,0,Matches
2602,Tetê,br BRA,"FW,MF",Lyon,fr Ligue 1,22,2000,12.3,21,10,8,5,8,10,19,52.6,9,9,0,9,13,34,2,0,Matches
2603,Kenny Tete,nl NED,DF,Fulham,eng Premier League,26,1995,28.5,83,46,41,29,13,38,51,74.5,13,48,17,31,52,135,81,1,Matches
2604,Florian Thauvin,fr FRA,"FW,MF",Udinese,it Serie A,29,1993,6.1,2,1,0,2,0,2,13,15.4,11,5,0,5,2,4,2,0,Matches
2605,Arthur Theate,be BEL,DF,Rennes,fr Ligue 1,22,2000,34.7,29,19,17,8,4,17,30,56.7,13,26,14,12,30,59,114,3,Matches
2606,Malick Thiaw,de GER,DF,Milan,it Serie A,20,2001,15.1,31,26,22,9,0,11,20,55.0,9,11,5,6,12,43,65,1,Matches
2607,Malick Thiaw,de GER,DF,Schalke 04,de Bundesliga,20,2001,3.0,3,1,2,1,0,1,2,50.0,1,4,3,1,9,12,24,1,Matches
2608,Jan Thielmann,de GER,FW,Köln,de Bundesliga,20,2002,9.7,9,8,3,4,2,2,11,18.2,9,16,3,13,9,18,7,0,Matches
2609,Sada Thioub,sn SEN,"DF,FW",Angers,fr Ligue 1,27,1995,11.8,19,10,9,8,2,8,17,47.1,9,13,0,13,7,26,5,1,Matches
2610,Luke Thomas,eng ENG,DF,Leicester City,eng Premier League,21,2001,11.9,23,19,15,5,3,15,32,46.9,17,20,4,16,27,50,35,0,Matches
2611,Adrien Thomasson,fr FRA,MF,Strasbourg,fr Ligue 1,28,1993,10.4,19,9,8,6,5,9,30,30.0,21,18,0,18,3,22,2,0,Matches
2612,Adrien Thomasson,fr FRA,"MF,FW",Lens,fr Ligue 1,28,1993,14.2,24,17,8,11,5,12,45,26.7,33,25,2,23,4,28,17,0,Matches
2613,Morten Thorsby,no NOR,MF,Union Berlin,de Bundesliga,26,1996,9.3,22,10,9,11,2,13,21,61.9,8,11,5,6,3,25,20,0,Matches
2614,Kristian Thorstvedt,no NOR,MF,Sassuolo,it Serie A,23,1999,12.6,16,7,4,9,3,6,17,35.3,11,19,5,14,14,30,13,0,Matches
2615,Khéphren Thuram,fr FRA,MF,Nice,fr Ligue 1,21,2001,28.3,51,25,22,23,6,19,43,44.2,24,33,13,20,38,89,34,0,Matches
2616,Marcus Thuram,fr FRA,FW,Gladbach,de Bundesliga,24,1997,27.9,14,7,3,6,5,6,13,46.2,7,20,3,17,6,20,22,0,Matches
2617,Alexis Tibidi,fr FRA,"FW,MF",Troyes,fr Ligue 1,18,2003,0.8,1,1,1,0,0,0,0,,0,0,0,0,0,1,0,0,Matches
2618,Youri Tielemans,be BEL,MF,Leicester City,eng Premier League,25,1997,26.0,66,39,27,30,9,23,62,37.1,39,35,8,27,28,94,24,1,Matches
2619,Kieran Tierney,sct SCO,DF,Arsenal,eng Premier League,25,1997,8.8,20,11,9,9,2,12,16,75.0,4,8,2,6,11,31,25,0,Matches
2620,Steffen Tigges,de GER,FW,Köln,de Bundesliga,24,1998,17.7,12,7,1,8,3,4,14,28.6,10,13,2,11,8,20,17,0,Matches
2621,Jean-Clair Todibo,fr FRA,DF,Nice,fr Ligue 1,22,1999,31.9,76,48,54,19,3,41,56,73.2,15,41,19,22,41,117,110,2,Matches
2622,Harry Toffolo,eng ENG,DF,Nott'ham Forest,eng Premier League,26,1995,10.4,17,8,10,4,3,10,14,71.4,4,16,8,8,10,27,33,0,Matches
2623,Umut Tohumcu,de GER,"MF,DF",Hoffenheim,de Bundesliga,17,2004,3.0,10,5,4,5,1,3,9,33.3,6,4,0,4,2,12,8,0,Matches
2624,Karl Toko Ekambi,cm CMR,"FW,MF",Rennes,fr Ligue 1,29,1992,10.8,3,1,1,1,1,3,9,33.3,6,5,0,5,9,12,3,0,Matches
2625,Karl Toko Ekambi,cm CMR,"FW,MF",Lyon,fr Ligue 1,29,1992,15.0,9,9,2,4,3,4,15,26.7,11,12,2,10,9,18,6,0,Matches
2626,Corentin Tolisso,fr FRA,MF,Lyon,fr Ligue 1,27,1994,22.6,44,27,16,23,5,25,66,37.9,41,25,5,20,24,68,23,1,Matches
2627,Jeremy Toljan,de GER,DF,Sassuolo,it Serie A,27,1994,29.7,36,23,17,14,5,22,33,66.7,11,31,14,17,18,54,60,1,Matches
2628,Rafael Tolói,it ITA,DF,Atalanta,it Serie A,31,1990,30.9,69,44,37,32,0,35,64,54.7,29,42,18,24,57,126,88,1,Matches
2629,Raúl de Tomás,es ESP,FW,Rayo Vallecano,es La Liga,27,1994,8.9,3,2,0,1,2,2,6,33.3,4,4,0,4,0,3,6,0,Matches
2630,Tiago Tomás,pt POR,"FW,MF",Stuttgart,de Bundesliga,20,2002,14.3,10,4,2,4,4,8,13,61.5,5,9,2,7,1,11,5,0,Matches
2631,Takehiro Tomiyasu,jp JPN,DF,Arsenal,eng Premier League,23,1998,7.4,27,18,12,10,5,13,18,72.2,5,7,0,7,14,41,15,1,Matches
2632,James Tomkins,eng ENG,DF,Crystal Palace,eng Premier League,33,1989,3.8,4,2,2,1,1,1,3,33.3,2,3,2,1,5,9,19,0,Matches
2633,Fikayo Tomori,eng ENG,DF,Milan,it Serie A,24,1997,30.7,70,34,44,25,1,22,34,64.7,12,46,25,21,29,99,88,1,Matches
2634,Sandro Tonali,it ITA,MF,Milan,it Serie A,22,2000,30.1,64,41,35,24,5,27,44,61.4,17,34,9,25,25,89,26,1,Matches
2635,Lorenzo Tonelli,it ITA,DF,Empoli,it Serie A,32,1990,0.2,0,0,0,0,0,0,1,0.0,1,0,0,0,0,0,0,0,Matches
2636,Ivan Toney,eng ENG,FW,Brentford,eng Premier League,26,1996,32.8,23,13,4,9,10,7,23,30.4,16,24,9,15,14,37,36,0,Matches
2637,Pablo Torre,es ESP,"FW,MF",Barcelona,es La Liga,19,2003,1.6,2,1,0,1,1,2,4,50.0,2,1,0,1,2,4,1,0,Matches
2638,David Torres,es ESP,DF,Valladolid,es La Liga,19,2003,4.3,1,1,0,1,0,1,1,100.0,0,4,2,2,3,4,8,0,Matches
2639,Ferrán Torres,es ESP,"FW,MF",Barcelona,es La Liga,22,2000,15.5,13,7,4,5,4,5,20,25.0,15,11,2,9,3,16,5,0,Matches
2640,Óliver Torres,es ESP,"MF,FW",Sevilla,es La Liga,27,1994,23.7,39,23,12,13,14,18,59,30.5,41,26,5,21,10,49,10,0,Matches
2641,Pau Torres,es ESP,DF,Villarreal,es La Liga,25,1997,33.9,43,25,25,13,5,23,36,63.9,13,36,27,9,13,56,146,3,Matches
2642,Roberto Torres,es ESP,"FW,MF",Osasuna,es La Liga,33,1989,0.1,0,0,0,0,0,0,0,,0,0,0,0,0,0,0,0,Matches
2643,Lucas Torró,es ESP,MF,Osasuna,es La Liga,28,1994,27.5,48,32,28,15,5,18,42,42.9,24,24,3,21,42,90,64,1,Matches
2644,Nabil Touaizi,ma MAR,MF,Espanyol,es La Liga,21,2001,0.0,0,0,0,0,0,0,0,,0,0,0,0,0,0,0,0,Matches
2645,Almamy Touré,ml MLI,DF,Eint Frankfurt,de Bundesliga,26,1996,4.4,13,7,7,5,1,5,9,55.6,4,9,2,7,10,23,8,0,Matches
2646,Birama Touré,ml MLI,MF,Auxerre,fr Ligue 1,30,1992,37.8,80,47,35,35,10,34,93,36.6,59,54,9,45,67,147,49,0,Matches
2647,Mohamed Toure,au AUS,"FW,MF",Reims,fr Ligue 1,18,2004,0.3,0,0,0,0,0,0,0,,0,0,0,0,0,0,0,0,Matches
2648,Souleymane Touré,fr FRA,DF,Marseille,fr Ligue 1,19,2003,0.8,2,1,1,1,0,1,2,50.0,1,1,0,1,0,2,5,0,Matches
2649,Souleymane Touré,fr FRA,DF,Auxerre,fr Ligue 1,19,2003,17.6,29,13,19,9,1,16,20,80.0,4,32,12,20,26,55,56,1,Matches
2650,Lucas Tousart,fr FRA,MF,Hertha BSC,de Bundesliga,25,1997,32.7,73,38,35,28,10,27,60,45.0,33,42,6,36,48,121,75,1,Matches
2651,Yoann Touzghar,tn TUN,FW,Ajaccio,fr Ligue 1,35,1986,5.0,3,2,0,2,1,0,1,0.0,1,0,0,0,0,3,1,0,Matches
2652,Adama Traoré,es ESP,"FW,MF",Wolves,eng Premier League,26,1996,16.6,14,7,7,4,3,4,9,44.4,5,8,1,7,3,17,17,0,Matches
2653,Bertrand Traoré,bf BFA,"FW,MF",Aston Villa,eng Premier League,26,1995,2.6,1,1,1,0,0,1,4,25.0,3,5,0,5,2,3,0,0,Matches
2654,Boubacar Traoré,ml MLI,MF,Wolves,eng Premier League,20,2001,4.6,12,5,4,5,3,3,7,42.9,4,4,2,2,7,19,1,0,Matches
2655,Charles Traore,ml MLI,DF,Nantes,fr Ligue 1,30,1992,5.4,8,5,5,2,1,5,7,71.4,2,9,2,7,10,18,12,0,Matches
2656,Hamari Traoré,ml MLI,DF,Rennes,fr Ligue 1,30,1992,28.1,48,32,26,15,7,28,52,53.8,24,33,7,26,38,86,64,0,Matches
2657,Kevin Trapp,de GER,GK,Eint Frankfurt,de Bundesliga,32,1990,33.0,1,1,1,0,0,0,2,0.0,2,2,0,2,0,1,10,0,Matches
2658,Mark Travers,ie IRL,GK,Bournemouth,eng Premier League,23,1999,11.5,0,0,0,0,0,0,0,,0,1,0,1,0,0,6,0,Matches
2659,Óscar Trejo,ar ARG,"MF,FW",Rayo Vallecano,es La Liga,34,1988,23.8,48,32,12,23,13,9,44,20.5,35,31,3,28,8,56,8,1,Matches
2660,Manu Trigueros,es ESP,MF,Villarreal,es La Liga,30,1991,9.2,20,14,9,5,6,9,22,40.9,13,9,2,7,5,25,4,0,Matches
2661,Christopher Trimmel,at AUT,DF,Union Berlin,de Bundesliga,35,1987,20.1,31,16,16,12,3,20,31,64.5,11,14,1,13,25,56,48,0,Matches
2662,Théo Trinker,fr FRA,MF,Nice,fr Ligue 1,21,2001,0.0,0,0,0,0,0,0,0,,0,0,0,0,0,0,0,0,Matches
2663,Kieran Trippier,eng ENG,DF,Newcastle Utd,eng Premier League,31,1990,37.1,71,49,36,27,8,46,90,51.1,44,45,15,30,43,114,84,2,Matches
2664,William Troost-Ekong,ng NGA,DF,Salernitana,it Serie A,28,1993,4.9,11,3,7,4,0,6,7,85.7,1,7,4,3,6,17,10,0,Matches
2665,Leandro Trossard,be BEL,FW,Arsenal,eng Premier League,27,1994,10.3,12,7,4,2,6,6,18,33.3,12,18,0,18,6,18,3,1,Matches
2666,Leandro Trossard,be BEL,"FW,MF",Brighton,eng Premier League,27,1994,14.6,10,6,7,1,2,1,8,12.5,7,17,0,17,6,16,1,0,Matches
2667,Adrien Truffert,fr FRA,DF,Rennes,fr Ligue 1,20,2001,21.7,62,32,36,17,9,31,46,67.4,15,32,8,24,22,84,55,0,Matches
2668,Frank Tsadjout,it ITA,FW,Cremonese,it Serie A,23,1999,11.7,10,8,3,6,1,3,9,33.3,6,7,1,6,8,18,9,0,Matches
2669,Kostas Tsimikas,gr GRE,DF,Liverpool,eng Premier League,26,1996,8.6,14,9,10,2,2,10,16,62.5,6,8,1,7,12,26,15,0,Matches
2670,Theocharis Tsingaras,gr GRE,MF,Toulouse,fr Ligue 1,21,2000,0.1,0,0,0,0,0,0,0,,0,0,0,0,0,0,0,0,Matches
2671,Viktor Tsyhankov,ua UKR,MF,Girona,es La Liga,24,1997,16.5,8,8,5,1,2,1,14,7.1,13,13,2,11,7,15,12,0,Matches
2672,Alessandro Tuia,it ITA,DF,Lecce,it Serie A,32,1990,5.7,10,6,6,4,0,3,9,33.3,6,3,1,2,15,25,29,0,Matches
2673,Martin Turk,si SVN,GK,Sampdoria,it Serie A,18,2003,4.0,0,0,0,0,0,0,0,,0,0,0,0,0,0,1,0,Matches
2674,Beñat Turrientes,es ESP,"MF,FW",Real Sociedad,es La Liga,20,2002,1.2,3,3,3,0,0,1,5,20.0,4,2,0,2,0,3,3,0,Matches
2675,Tuta,br BRA,DF,Eint Frankfurt,de Bundesliga,23,1999,30.2,53,35,27,19,7,33,57,57.9,24,47,14,33,49,102,134,2,Matches
2676,Destiny Udogie,it ITA,DF,Udinese,it Serie A,19,2002,30.0,71,45,42,24,5,34,59,57.6,25,34,6,28,36,107,25,0,Matches
2677,Ike Ugbo,ca CAN,"FW,MF",Troyes,fr Ligue 1,23,1998,9.9,5,2,2,2,1,3,11,27.3,8,8,2,6,2,7,4,0,Matches
2678,Lesley Ugochukwu,fr FRA,MF,Rennes,fr Ligue 1,18,2004,14.8,36,19,13,20,3,16,24,66.7,8,24,10,14,21,57,16,0,Matches
2679,Samir Ujkani,xk KVX,GK,Empoli,it Serie A,34,1988,0.1,0,0,0,0,0,0,0,,0,0,0,0,0,0,0,0,Matches
2680,Sven Ulreich,de GER,GK,Bayern Munich,de Bundesliga,33,1988,3.0,1,1,1,0,0,1,1,100.0,0,0,0,0,0,1,0,1,Matches
2681,Lauren Ulrich,de GER,MF,Stuttgart,de Bundesliga,17,2005,0.1,1,1,0,0,1,0,0,,0,0,0,0,0,1,0,0,Matches
2682,Samuel Umtiti,fr FRA,DF,Lecce,it Serie A,28,1993,23.5,52,34,25,25,2,18,26,69.2,8,26,14,12,26,78,79,0,Matches
2683,Enes Ünal,tr TUR,FW,Getafe,es La Liga,25,1997,33.0,26,14,5,19,2,7,25,28.0,18,19,2,17,6,32,35,0,Matches
2684,Deniz Undav,de GER,"FW,MF",Brighton,eng Premier League,26,1996,7.0,7,4,2,2,3,2,8,25.0,6,4,1,3,0,7,1,0,Matches
2685,Cengiz Ünder,tr TUR,"MF,DF",Marseille,fr Ligue 1,25,1997,27.7,37,19,15,13,9,13,34,38.2,21,18,2,16,18,55,13,0,Matches
2686,Dayot Upamecano,fr FRA,DF,Bayern Munich,de Bundesliga,23,1998,26.1,65,37,43,22,0,28,45,62.2,17,26,6,20,27,92,71,4,Matches
2687,Filip Uremović,hr CRO,DF,Hertha BSC,de Bundesliga,25,1997,19.2,38,23,29,8,1,14,22,63.6,8,18,13,5,36,74,88,2,Matches
2688,Oscar Ureña,es ESP,MF,Girona,es La Liga,19,2003,1.1,4,2,2,2,0,2,3,66.7,1,2,0,2,1,5,0,0,Matches
2689,Jere Uronen,fi FIN,DF,Brest,fr Ligue 1,28,1994,3.3,8,5,4,4,0,7,12,58.3,5,6,2,4,7,15,5,0,Matches
2690,Jere Uronen,fi FIN,DF,Schalke 04,de Bundesliga,28,1994,7.5,14,10,6,6,2,6,10,60.0,4,5,2,3,8,22,13,0,Matches
2691,Mark Uth,de GER,"MF,FW",Köln,de Bundesliga,30,1991,0.5,0,0,0,0,0,0,0,,0,0,0,0,0,0,0,0,Matches
2692,Josha Vagnoman,de GER,DF,Stuttgart,de Bundesliga,21,2000,16.4,26,15,12,11,3,15,27,55.6,12,20,2,18,8,34,29,1,Matches
2693,Diego Valencia,cl CHI,"MF,FW",Salernitana,it Serie A,22,2000,2.6,8,5,4,2,2,2,9,22.2,7,10,1,9,1,9,2,0,Matches
2694,Óscar Valentín,es ESP,MF,Rayo Vallecano,es La Liga,27,1994,28.4,92,51,29,50,13,46,121,38.0,75,60,9,51,44,136,30,0,Matches
2695,Emanuele Valeri,it ITA,DF,Cremonese,it Serie A,23,1998,30.9,54,27,29,21,4,29,69,42.0,40,17,3,14,22,76,44,1,Matches
2696,Yan Valery,tn TUN,DF,Southampton,eng Premier League,23,1999,0.5,0,0,0,0,0,0,0,,0,1,0,1,0,0,3,0,Matches
2697,Yan Valery,tn TUN,DF,Angers,fr Ligue 1,23,1999,27.7,54,39,28,20,6,20,37,54.1,17,35,15,20,34,88,82,0,Matches
2698,Martin Valjent,sk SVK,DF,Mallorca,es La Liga,26,1995,29.5,35,27,22,12,1,19,28,67.9,9,39,21,18,29,64,137,0,Matches
2699,Jesús Vallejo,es ESP,DF,Real Madrid,es La Liga,25,1997,0.2,0,0,0,0,0,0,0,,0,0,0,0,0,0,0,0,Matches
2700,Manu Vallejo,es ESP,"FW,MF",Girona,es La Liga,25,1997,2.3,4,1,1,2,1,1,6,16.7,5,2,0,2,1,5,3,0,Matches
2701,Mattia Valoti,it ITA,"MF,FW",Monza,it Serie A,28,1993,5.0,17,10,7,9,1,5,16,31.3,11,13,3,10,3,20,6,0,Matches
2702,Federico Valverde,uy URU,"MF,FW",Real Madrid,es La Liga,24,1998,27.8,31,20,14,11,6,13,26,50.0,13,31,4,27,17,48,15,0,Matches
2703,Virgil van Dijk,nl NED,DF,Liverpool,eng Premier League,31,1991,31.5,27,14,13,11,3,8,19,42.1,11,24,16,8,31,58,138,3,Matches
2704,Vanderson,br BRA,"DF,MF",Monaco,fr Ligue 1,21,2001,24.6,84,48,36,34,14,44,75,58.7,31,36,9,27,48,132,36,1,Matches
2705,Raphaël Varane,fr FRA,DF,Manchester Utd,eng Premier League,29,1993,21.2,24,9,18,6,0,7,17,41.2,10,24,17,7,11,35,91,0,Matches
2706,Jamie Vardy,eng ENG,FW,Leicester City,eng Premier League,35,1987,20.6,9,5,4,2,3,1,8,12.5,7,17,3,14,2,11,30,0,Matches
2707,Ruben Vargas,ch SUI,"MF,FW",Augsburg,de Bundesliga,23,1998,12.6,15,7,6,7,2,5,11,45.5,6,8,2,6,6,21,16,1,Matches
2708,Johan Vásquez,mx MEX,DF,Cremonese,it Serie A,23,1998,20.1,41,26,34,7,0,18,39,46.2,21,27,20,7,45,86,93,1,Matches
2709,Jesus Vazquez,es ESP,"DF,MF",Valencia,es La Liga,19,2003,3.4,13,8,9,1,3,6,11,54.5,5,4,0,4,1,14,8,0,Matches
2710,Kevin Vázquez,es ESP,"DF,MF",Celta Vigo,es La Liga,29,1993,4.9,13,8,5,7,1,8,12,66.7,4,4,1,3,2,15,8,0,Matches
2711,Lucas Vázquez,es ESP,DF,Real Madrid,es La Liga,31,1991,12.7,34,23,22,10,2,20,28,71.4,8,10,0,10,7,41,13,0,Matches
2712,Matías Vecino,uy URU,MF,Lazio,it Serie A,30,1991,18.8,47,27,13,23,11,23,48,47.9,25,33,10,23,16,63,39,1,Matches
2713,Gabriel Veiga,es ESP,MF,Celta Vigo,es La Liga,20,2002,25.5,43,19,14,25,4,16,52,30.8,36,30,3,27,21,64,6,0,Matches
2714,Renato Veiga,pt POR,DF,Augsburg,de Bundesliga,19,2003,7.1,9,6,4,3,2,7,9,77.8,2,20,6,14,7,16,29,1,Matches
2715,Miloš Veljković,rs SRB,DF,Werder Bremen,de Bundesliga,26,1995,25.2,30,19,17,13,0,18,29,62.1,11,32,16,16,33,63,103,0,Matches
2716,Miguel Veloso,pt POR,MF,Hellas Verona,it Serie A,36,1986,12.9,33,10,20,12,1,16,26,61.5,10,26,6,20,6,39,14,0,Matches
2717,Joël Veltman,nl NED,DF,Brighton,eng Premier League,30,1992,24.3,62,32,44,14,4,37,57,64.9,20,27,8,19,19,81,51,0,Matches
2718,Micky van de Ven,nl NED,DF,Wolfsburg,de Bundesliga,21,2001,33.0,45,30,26,18,1,28,39,71.8,11,42,24,18,26,71,108,2,Matches
2719,Unai Vencedor Paris,es ESP,MF,Athletic Club,es La Liga,21,2000,2.1,3,1,0,3,0,1,6,16.7,5,5,0,5,1,4,1,0,Matches
2720,Lorenzo Venuti,it ITA,DF,Fiorentina,it Serie A,27,1995,10.3,18,7,6,11,1,11,18,61.1,7,7,2,5,5,23,17,2,Matches
2721,Daniele Verde,it ITA,"FW,MF",Spezia,it Serie A,26,1996,11.1,4,4,3,0,1,3,7,42.9,4,6,0,6,8,12,4,0,Matches
2722,Simone Verdi,it ITA,"MF,FW",Hellas Verona,it Serie A,30,1992,12.2,15,10,7,5,3,6,17,35.3,11,8,1,7,0,15,2,0,Matches
2723,Gonzalo Verdú,es ESP,DF,Elche,es La Liga,33,1988,7.8,10,5,8,2,0,4,8,50.0,4,8,6,2,10,20,33,0,Matches
2724,Jordan Veretout,fr FRA,MF,Marseille,fr Ligue 1,29,1993,31.8,56,35,17,32,7,25,53,47.2,28,22,7,15,36,92,40,2,Matches
2725,Marco Verratti,it ITA,MF,Paris S-G,fr Ligue 1,29,1992,24.4,76,49,34,36,6,38,89,42.7,51,42,6,36,27,103,11,3,Matches
2726,Valerio Verre,it ITA,MF,Sampdoria,it Serie A,28,1994,7.5,14,7,6,5,3,8,17,47.1,9,9,1,8,9,23,3,0,Matches
2727,Mikel Vesga,es ESP,MF,Athletic Club,es La Liga,29,1993,28.6,57,35,21,31,5,25,68,36.8,43,39,8,31,36,93,39,3,Matches
2728,Guglielmo Vicario,it ITA,GK,Empoli,it Serie A,25,1996,30.9,1,1,1,0,0,1,2,50.0,1,0,0,0,0,1,15,2,Matches
2729,João Victor,br BRA,DF,Nantes,fr Ligue 1,24,1998,9.4,19,11,9,7,3,12,22,54.5,10,11,1,10,15,34,30,0,Matches
2730,Aleix Vidal,es ESP,"MF,FW",Espanyol,es La Liga,32,1989,11.4,11,5,6,3,2,4,22,18.2,18,21,2,19,15,26,14,0,Matches
2731,Clément Vidal,fr FRA,"DF,MF",Ajaccio,fr Ligue 1,22,2000,21.1,25,15,14,11,0,18,38,47.4,20,27,16,11,27,52,73,1,Matches
2732,Nacho Vidal,es ESP,DF,Osasuna,es La Liga,27,1995,13.9,27,14,16,6,5,17,32,53.1,15,17,4,13,19,46,33,1,Matches
2733,Gabriel Vidovic,hr CRO,FW,Bayern Munich,de Bundesliga,18,2003,0.2,0,0,0,0,0,0,0,,0,0,0,0,0,0,0,0,Matches
2734,Fabio Vieira,pt POR,"MF,FW",Arsenal,eng Premier League,22,2000,5.7,6,4,3,0,3,3,5,60.0,2,5,0,5,4,10,2,0,Matches
2735,Ronaldo Vieira,eng ENG,MF,Torino,it Serie A,24,1998,0.2,1,0,0,1,0,1,1,100.0,0,0,0,0,0,1,2,0,Matches
2736,Ronaldo Vieira,eng ENG,MF,Sampdoria,it Serie A,24,1998,9.1,18,10,4,12,2,10,13,76.9,3,15,5,10,13,31,10,2,Matches
2737,Emanuel Vignato,it ITA,"MF,FW",Bologna,it Serie A,21,2000,2.7,4,4,2,2,0,2,4,50.0,2,2,0,2,3,7,0,0,Matches
2738,Emanuel Vignato,it ITA,"MF,FW",Empoli,it Serie A,21,2000,0.6,2,0,2,0,0,0,0,,0,0,0,0,0,2,1,0,Matches
2739,Samuele Vignato,it ITA,"MF,FW",Monza,it Serie A,18,2004,0.7,0,0,0,0,0,0,0,,0,1,0,1,0,0,0,0,Matches
2740,Tonny Vilhena,nl NED,MF,Salernitana,it Serie A,27,1995,25.2,44,22,16,23,5,20,50,40.0,30,17,7,10,18,62,21,0,Matches
2741,Toni Villa,es ESP,MF,Valladolid,es La Liga,27,1995,1.0,6,3,2,3,1,4,9,44.4,5,0,0,0,0,6,0,0,Matches
2742,Toni Villa,es ESP,"MF,FW",Girona,es La Liga,27,1995,9.9,25,18,9,11,5,10,23,43.5,13,8,0,8,8,33,3,0,Matches
2743,Asier Villalibre,es ESP,FW,Athletic Club,es La Liga,24,1997,1.1,0,0,0,0,0,0,0,,0,0,0,0,0,0,1,0,Matches
2744,Gonzalo Villar,es ESP,MF,Sampdoria,it Serie A,24,1998,7.7,13,7,4,8,1,7,15,46.7,8,11,3,8,4,17,9,1,Matches
2745,Gonzalo Villar,es ESP,MF,Getafe,es La Liga,24,1998,5.1,10,5,1,6,3,6,14,42.9,8,9,2,7,6,16,5,0,Matches
2746,Iván Villar,es ESP,GK,Celta Vigo,es La Liga,25,1997,19.0,0,0,0,0,0,0,1,0.0,1,0,0,0,0,0,7,0,Matches
2747,Matías Viña,uy URU,DF,Bournemouth,eng Premier League,24,1997,5.1,19,11,9,8,2,14,30,46.7,16,13,1,12,4,23,22,0,Matches
2748,Matías Viña,uy URU,DF,Roma,it Serie A,24,1997,0.6,3,1,1,1,1,1,3,33.3,2,5,1,4,2,5,5,0,Matches
2749,Rúben Vinagre,pt POR,"DF,MF",Everton,eng Premier League,23,1999,0.3,2,2,1,1,0,1,2,50.0,1,0,0,0,0,2,1,0,Matches
2750,Carlos Vinícius,br BRA,FW,Fulham,eng Premier League,27,1995,12.3,4,1,0,2,2,0,4,0.0,4,7,0,7,0,4,10,0,Matches
2751,Alan Virginius,fr FRA,FW,Lille,fr Ligue 1,19,2003,2.9,3,2,1,1,1,0,4,0.0,4,0,0,0,2,5,1,0,Matches
2752,Mattia Viti,it ITA,DF,Nice,fr Ligue 1,20,2002,7.0,4,2,1,1,2,2,5,40.0,3,9,3,6,8,12,22,0,Matches
2753,Vitinha,pt POR,FW,Marseille,fr Ligue 1,22,2000,5.2,15,7,0,6,9,3,11,27.3,8,3,0,3,2,17,6,0,Matches
2754,Vitinha,pt POR,MF,Paris S-G,fr Ligue 1,22,2000,27.2,58,25,21,27,10,27,83,32.5,56,27,4,23,25,83,15,0,Matches
2755,Daniel Vivian,es ESP,DF,Athletic Club,es La Liga,23,1999,26.4,57,32,36,16,5,36,45,80.0,9,27,14,13,24,81,90,3,Matches
2756,Dušan Vlahović,rs SRB,FW,Juventus,it Serie A,22,2000,21.4,11,6,0,7,4,4,10,40.0,6,10,3,7,3,14,8,1,Matches
2757,Nikola Vlašić,hr CRO,"MF,FW",Torino,it Serie A,24,1997,30.3,32,21,9,16,7,15,34,44.1,19,25,2,23,10,42,14,0,Matches
2758,Joel Voelkerling Persson,se SWE,"FW,MF",Lecce,it Serie A,19,2003,1.1,1,1,0,0,1,0,1,0.0,1,1,0,1,0,1,0,0,Matches
2759,Kevin Vogt,de GER,DF,Hoffenheim,de Bundesliga,30,1991,19.7,15,10,10,5,0,9,22,40.9,13,18,11,7,26,41,67,0,Matches
2760,Mërgim Vojvoda,xk KVX,DF,Torino,it Serie A,27,1995,19.1,22,12,15,6,1,12,24,50.0,12,14,2,12,10,32,31,1,Matches
2761,Kevin Volland,de GER,"FW,MF",Monaco,fr Ligue 1,30,1992,7.1,8,4,1,5,2,2,8,25.0,6,8,0,8,2,10,0,0,Matches
2762,Cristian Volpato,it ITA,MF,Roma,it Serie A,18,2003,2.5,3,2,1,1,1,0,2,0.0,2,2,0,2,2,5,0,0,Matches
2763,Lukáš Vorlický,cz CZE,"MF,FW",Atalanta,it Serie A,20,2002,0.3,0,0,0,0,0,0,0,,0,0,0,0,1,1,0,0,Matches
2764,Aster Vranckx,be BEL,MF,Milan,it Serie A,19,2002,2.7,3,2,0,2,1,2,7,28.6,5,3,1,2,2,5,1,0,Matches
2765,Aster Vranckx,be BEL,MF,Wolfsburg,de Bundesliga,19,2002,0.1,0,0,0,0,0,0,0,,0,0,0,0,0,0,1,0,Matches
2766,Stefan de Vrij,nl NED,DF,Inter,it Serie A,30,1992,21.6,28,18,19,9,0,8,14,57.1,6,18,10,8,40,68,80,0,Matches
2767,Robert Wagner,de GER,MF,Freiburg,de Bundesliga,19,2003,0.4,0,0,0,0,0,0,0,,0,2,0,2,0,0,2,0,Matches
2768,Elye Wahi,fr FRA,FW,Montpellier,fr Ligue 1,19,2003,27.9,9,3,2,3,4,5,14,35.7,9,14,2,12,3,12,5,0,Matches
2769,Walace,br BRA,MF,Udinese,it Serie A,27,1995,35.4,82,39,42,31,9,41,90,45.6,49,47,12,35,51,133,51,1,Matches
2770,Theo Walcott,eng ENG,"FW,MF",Southampton,eng Premier League,33,1989,12.5,13,6,8,4,1,8,27,29.6,19,8,1,7,9,22,7,0,Matches
2771,Luca Waldschmidt,de GER,"FW,MF",Wolfsburg,de Bundesliga,26,1996,5.8,5,2,2,1,2,2,10,20.0,8,6,0,6,3,8,5,0,Matches
2772,Kyle Walker,eng ENG,DF,Manchester City,eng Premier League,32,1990,21.8,13,9,8,5,0,4,24,16.7,20,12,2,10,18,31,22,0,Matches
2773,Kyle Walker-Peters,eng ENG,DF,Southampton,eng Premier League,25,1997,29.4,61,32,34,24,3,22,43,51.2,21,47,8,39,27,88,52,0,Matches
2774,Sebastian Walukiewicz,pl POL,DF,Empoli,it Serie A,22,2000,6.7,9,6,7,2,0,4,6,66.7,2,10,9,1,7,16,30,0,Matches
2775,Aaron Wan-Bissaka,eng ENG,DF,Manchester Utd,eng Premier League,24,1997,15.9,40,25,20,17,3,23,25,92.0,2,24,8,16,22,62,41,0,Matches
2776,Paul Wanner,de GER,MF,Bayern Munich,de Bundesliga,16,2005,0.3,3,1,1,2,0,1,1,100.0,0,0,0,0,0,3,1,0,Matches
2777,Danny Ward,wls WAL,GK,Leicester City,eng Premier League,29,1993,26.0,1,1,1,0,0,1,3,33.3,2,0,0,0,0,1,14,2,Matches
2778,Joel Ward,eng ENG,DF,Crystal Palace,eng Premier League,32,1989,25.1,50,36,30,11,9,30,41,73.2,11,32,16,16,25,75,80,1,Matches
2779,James Ward-Prowse,eng ENG,MF,Southampton,eng Premier League,27,1994,37.5,65,37,31,27,7,21,61,34.4,40,30,10,20,55,120,48,0,Matches
2780,Ollie Watkins,eng ENG,FW,Aston Villa,eng Premier League,26,1995,34.7,19,13,3,13,3,10,27,37.0,17,21,4,17,10,29,39,0,Matches
2781,Timothy Weah,us USA,"DF,FW",Lille,fr Ligue 1,22,2000,19.4,24,14,13,9,2,16,29,55.2,13,17,3,14,23,47,18,0,Matches
2782,Adam Webster,eng ENG,DF,Brighton,eng Premier League,27,1995,22.1,22,12,10,9,3,11,19,57.9,8,30,19,11,19,41,55,4,Matches
2783,Wout Weghorst,nl NED,"FW,MF",Manchester Utd,eng Premier League,29,1992,8.9,11,5,6,1,4,2,9,22.2,7,7,2,5,7,18,9,0,Matches
2784,Julian Weigl,de GER,MF,Gladbach,de Bundesliga,26,1995,21.0,43,16,21,21,1,23,41,56.1,18,23,2,21,18,61,32,0,Matches
2785,Nelson Weiper,de GER,"FW,DF",Mainz 05,de Bundesliga,17,2005,1.1,2,0,0,0,2,1,3,33.3,2,2,0,2,0,2,1,0,Matches
2786,Mitchell Weiser,de GER,"DF,FW",Werder Bremen,de Bundesliga,28,1994,28.0,71,43,38,24,9,38,75,50.7,37,50,7,43,28,99,38,1,Matches
2787,Noah Weißhaupt,de GER,"MF,DF",Freiburg,de Bundesliga,20,2001,4.7,11,6,3,7,1,2,7,28.6,5,4,0,4,6,17,8,0,Matches
2788,Shon Weissman,il ISR,FW,Valladolid,es La Liga,26,1996,8.3,2,1,1,1,0,0,4,0.0,4,8,0,8,1,3,7,0,Matches
2789,Danny Welbeck,eng ENG,FW,Brighton,eng Premier League,31,1990,20.6,15,7,0,7,8,4,11,36.4,7,24,2,22,5,20,20,0,Matches
2790,Marcel Wenig,de GER,MF,Eint Frankfurt,de Bundesliga,18,2004,0.0,0,0,0,0,0,0,0,,0,0,0,0,0,0,0,0,Matches
2791,Axel Werner,ar ARG,GK,Elche,es La Liga,26,1996,2.0,0,0,0,0,0,0,1,0.0,1,0,0,0,0,0,0,0,Matches
2792,Timo Werner,de GER,"FW,MF",RB Leipzig,de Bundesliga,26,1996,21.5,10,5,4,3,3,4,12,33.3,8,12,0,12,7,17,5,0,Matches
2793,Ben White,eng ENG,DF,Arsenal,eng Premier League,24,1997,33.9,60,31,23,30,7,42,70,60.0,28,47,11,36,22,82,79,1,Matches
2794,Harvey White,eng ENG,MF,Tottenham,eng Premier League,20,2001,0.1,0,0,0,0,0,0,1,0.0,1,0,0,0,0,0,0,0,Matches
2795,Joseph Whitworth,eng ENG,GK,Crystal Palace,eng Premier League,18,2004,2.0,0,0,0,0,0,0,0,,0,0,0,0,0,0,1,0,Matches
2796,Silvan Widmer,ch SUI,DF,Mainz 05,de Bundesliga,29,1993,18.8,26,17,15,10,1,20,39,51.3,19,22,8,14,31,57,28,0,Matches
2797,Mateusz Wieteska,pl POL,DF,Clermont Foot,fr Ligue 1,25,1997,34.6,41,23,28,13,0,19,33,57.6,14,44,28,16,56,97,97,4,Matches
2798,Georginio Wijnaldum,nl NED,MF,Roma,it Serie A,31,1990,8.5,4,3,1,3,0,0,2,0.0,2,7,1,6,2,6,3,0,Matches
2799,Iñaki Williams,gh GHA,FW,Athletic Club,es La Liga,28,1994,31.5,22,16,5,14,3,9,24,37.5,15,18,3,15,7,29,34,0,Matches
2800,Neco Williams,wls WAL,DF,Nott'ham Forest,eng Premier League,21,2001,20.9,72,47,49,17,6,38,71,53.5,33,33,8,25,33,105,48,0,Matches
2801,Nico Williams,es ESP,FW,Athletic Club,es La Liga,20,2002,29.5,31,16,10,15,6,19,41,46.3,22,40,2,38,8,39,14,1,Matches
2802,Willian,br BRA,FW,Fulham,eng Premier League,33,1988,23.6,13,8,8,3,2,7,25,28.0,18,13,0,13,9,22,9,0,Matches
2803,Joe Willock,eng ENG,MF,Newcastle Utd,eng Premier League,22,1999,28.4,51,30,13,26,12,25,58,43.1,33,54,8,46,25,76,17,0,Matches
2804,Callum Wilson,eng ENG,FW,Newcastle Utd,eng Premier League,30,1992,20.9,9,3,0,8,1,0,3,0.0,3,8,0,8,1,10,5,0,Matches
2805,Harry Wilson,wls WAL,FW,Fulham,eng Premier League,25,1997,12.2,21,13,9,9,3,8,18,44.4,10,17,2,15,6,27,14,0,Matches
2806,Patrick Wimmer,at AUT,"FW,MF",Wolfsburg,de Bundesliga,21,2001,18.3,39,26,18,11,10,12,38,31.6,26,27,2,25,15,54,15,0,Matches
2807,Jonas Wind,dk DEN,FW,Wolfsburg,de Bundesliga,23,1999,14.3,14,6,2,7,5,5,10,50.0,5,14,4,10,1,15,10,0,Matches
2808,Harry Winks,eng ENG,MF,Sampdoria,it Serie A,26,1996,19.1,27,12,7,18,2,14,43,32.6,29,14,8,6,24,51,24,0,Matches
2809,Frederik Winther,dk DEN,DF,Augsburg,de Bundesliga,21,2001,1.0,2,2,1,1,0,0,2,0.0,2,1,1,0,0,2,7,0,Matches
2810,Florian Wirtz,de GER,"FW,MF",Leverkusen,de Bundesliga,19,2003,12.1,18,10,9,7,2,8,16,50.0,8,15,1,14,1,19,6,0,Matches
2811,Przemysław Wiśniewski,pl POL,DF,Spezia,it Serie A,24,1998,11.1,13,6,7,6,0,6,18,33.3,12,16,8,8,11,24,66,0,Matches
2812,Yoane Wissa,cd COD,FW,Brentford,eng Premier League,25,1996,17.8,17,12,4,7,6,6,13,46.2,7,10,0,10,6,23,15,0,Matches
2813,Axel Witsel,be BEL,"DF,MF",Atlético Madrid,es La Liga,33,1989,25.1,36,22,22,11,3,17,31,54.8,14,20,11,9,23,59,76,0,Matches
2814,Maximilian Wöber,at AUT,DF,Leeds United,eng Premier League,24,1998,14.1,25,18,9,15,1,16,24,66.7,8,32,14,18,27,52,67,1,Matches
2815,Hannes Wolf,at AUT,FW,Gladbach,de Bundesliga,23,1999,5.0,11,8,4,5,2,5,13,38.5,8,3,0,3,3,14,9,0,Matches
2816,Marius Wolf,de GER,DF,Dortmund,de Bundesliga,27,1995,17.4,25,18,9,12,4,16,29,55.2,13,40,10,30,18,43,22,1,Matches
2817,Jeong Woo-yeong,kr KOR,"MF,FW",Freiburg,de Bundesliga,22,1999,7.3,7,3,4,2,1,2,5,40.0,3,7,1,6,1,8,7,0,Matches
2818,Chris Wood,nz NZL,FW,Newcastle Utd,eng Premier League,30,1991,5.0,5,4,0,3,2,3,5,60.0,2,2,2,0,1,6,7,0,Matches
2819,Chris Wood,nz NZL,FW,Nott'ham Forest,eng Premier League,30,1991,4.1,0,0,0,0,0,0,1,0.0,1,2,1,1,1,1,2,0,Matches
2820,Christopher Wooh,cm CMR,DF,Rennes,fr Ligue 1,20,2001,11.2,16,7,8,8,0,9,11,81.8,2,11,5,6,6,22,49,0,Matches
2821,Christopher Wooh,cm CMR,MF,Lens,fr Ligue 1,20,2001,0.0,0,0,0,0,0,0,1,0.0,1,0,0,0,0,0,1,0,Matches
2822,Joe Worrall,eng ENG,DF,Nott'ham Forest,eng Premier League,25,1997,24.7,53,25,39,12,2,25,35,71.4,10,33,23,10,26,79,111,1,Matches
2823,Xeka,pt POR,MF,Rennes,fr Ligue 1,27,1994,6.1,10,3,6,3,1,7,16,43.8,9,11,2,9,6,16,8,0,Matches
2824,Granit Xhaka,ch SUI,MF,Arsenal,eng Premier League,29,1992,33.3,34,27,11,18,5,16,41,39.0,25,28,10,18,15,49,45,1,Matches
2825,Lamine Yamal,es ESP,FW,Barcelona,es La Liga,15,2007,0.1,0,0,0,0,0,0,0,,0,0,0,0,0,0,0,0,Matches
2826,Jawad El Yamiq,ma MAR,DF,Valladolid,es La Liga,30,1992,17.9,17,11,10,7,0,6,11,54.5,5,27,19,8,37,54,101,0,Matches
2827,Ryan Yates,eng ENG,MF,Nott'ham Forest,eng Premier League,24,1997,20.4,38,19,19,16,3,14,22,63.6,8,26,8,18,10,48,44,0,Matches
2828,Yusuf Yazıcı,tr TUR,MF,Lille,fr Ligue 1,25,1997,2.2,0,0,0,0,0,0,0,,0,2,0,2,0,0,1,0,Matches
2829,Kelvin Yeboah,it ITA,"FW,MF",Augsburg,de Bundesliga,22,2000,3.9,6,4,2,4,0,2,5,40.0,3,7,0,7,1,7,2,0,Matches
2830,Gerard Yepes,es ESP,MF,Sampdoria,it Serie A,19,2002,2.2,5,3,2,3,0,1,3,33.3,2,3,0,3,4,9,3,0,Matches
2831,Darlin Yongwa,cm CMR,DF,Lorient,fr Ligue 1,21,2000,8.7,13,11,7,5,1,4,15,26.7,11,13,1,12,5,18,11,0,Matches
2832,Leny Yoro,fr FRA,DF,Lille,fr Ligue 1,16,2005,8.5,11,5,8,3,0,4,9,44.4,5,6,1,5,18,29,27,1,Matches
2833,Maya Yoshida,jp JPN,DF,Schalke 04,de Bundesliga,33,1988,28.4,34,22,19,13,2,18,29,62.1,11,40,29,11,46,80,132,2,Matches
2834,Ashley Young,eng ENG,DF,Aston Villa,eng Premier League,37,1985,22.6,50,27,34,15,1,37,50,74.0,13,25,11,14,21,71,65,0,Matches
2835,Mohamed Youssouf,km COM,DF,Ajaccio,fr Ligue 1,34,1988,27.3,72,44,41,24,7,38,61,62.3,23,32,8,24,65,137,70,0,Matches
2836,Illia Zabarnyi,ua UKR,DF,Bournemouth,eng Premier League,19,2002,3.3,4,2,4,0,0,3,7,42.9,4,7,2,5,3,7,14,0,Matches
2837,Mattia Zaccagni,it ITA,FW,Lazio,it Serie A,27,1995,30.8,42,28,16,18,8,14,38,36.8,24,37,3,34,21,63,10,1,Matches
2838,Dan-Axel Zagadou,fr FRA,DF,Stuttgart,de Bundesliga,23,1999,14.1,14,9,10,4,0,5,14,35.7,9,19,16,3,21,35,81,1,Matches
2839,Wilfried Zaha,ci CIV,"FW,MF",Crystal Palace,eng Premier League,29,1992,25.4,32,20,12,12,8,8,21,38.1,13,21,1,20,16,48,9,0,Matches
2840,Warren Zaïre-Emery,fr FRA,"MF,DF",Paris S-G,fr Ligue 1,16,2006,10.3,17,10,5,10,2,8,29,27.6,21,11,0,11,12,29,17,0,Matches
2841,Denis Zakaria,ch SUI,MF,Chelsea,eng Premier League,25,1996,4.6,9,5,5,2,2,2,8,25.0,6,4,1,3,3,12,10,0,Matches
2842,Denis Zakaria,ch SUI,MF,Juventus,it Serie A,25,1996,1.4,6,3,1,4,1,2,2,100.0,0,2,0,2,2,8,1,0,Matches
2843,Rodrigo Zalazar,uy URU,"MF,FW",Schalke 04,de Bundesliga,22,1999,14.7,16,8,5,9,2,9,24,37.5,15,16,1,15,7,23,13,0,Matches
2844,Joseba Zaldúa,es ESP,DF,Cádiz,es La Liga,30,1992,7.1,15,8,10,4,1,7,10,70.0,3,4,2,2,11,26,22,0,Matches
2845,Nicola Zalewski,pl POL,DF,Roma,it Serie A,20,2002,24.4,45,26,25,15,5,22,71,31.0,49,27,1,26,31,76,23,0,Matches
2846,Andre-Frank Zambo Anguissa,cm CMR,MF,Napoli,it Serie A,26,1995,33.9,53,32,16,29,8,16,64,25.0,48,50,4,46,49,102,25,0,Matches
2847,Oliver Zandén,se SWE,"DF,MF",Toulouse,fr Ligue 1,20,2001,1.6,2,1,1,0,1,2,5,40.0,3,0,0,0,1,3,7,0,Matches
2848,Luca Zanimacchia,it ITA,"MF,FW",Cremonese,it Serie A,24,1998,8.3,21,13,11,6,4,8,21,38.1,13,9,0,9,9,30,5,0,Matches
2849,Nicolò Zaniolo,it ITA,"MF,FW",Roma,it Serie A,23,1999,9.9,7,5,2,4,1,2,7,28.6,5,11,0,11,2,9,0,0,Matches
2850,Alessandro Zanoli,it ITA,DF,Sampdoria,it Serie A,21,2000,17.1,22,14,14,6,2,8,17,47.1,9,19,15,4,12,34,39,0,Matches
2851,Alessandro Zanoli,it ITA,DF,Napoli,it Serie A,21,2000,0.1,1,0,0,1,0,0,0,,0,0,0,0,0,1,1,0,Matches
2852,Mattia Zanotti,it ITA,DF,Inter,it Serie A,19,2003,0.3,0,0,0,0,0,0,1,0.0,1,2,0,2,0,0,0,0,Matches
2853,Duván Zapata,co COL,FW,Atalanta,it Serie A,31,1991,15.4,8,4,1,3,4,3,5,60.0,2,6,2,4,4,12,17,1,Matches
2854,Davide Zappacosta,it ITA,DF,Atalanta,it Serie A,30,1992,16.3,34,18,17,12,5,15,22,68.2,7,23,2,21,9,43,16,0,Matches
2855,Oier Zarraga,es ESP,MF,Athletic Club,es La Liga,23,1999,9.5,14,9,5,7,2,8,20,40.0,12,7,0,7,10,24,5,0,Matches
2856,Akim Zedadka,dz ALG,DF,Auxerre,fr Ligue 1,27,1995,17.8,35,21,21,10,4,18,32,56.3,14,17,3,14,23,58,51,1,Matches
2857,Akim Zedadka,dz ALG,"DF,MF",Lille,fr Ligue 1,27,1995,3.9,1,1,1,0,0,0,2,0.0,2,3,0,3,2,3,6,0,Matches
2858,Karim Zedadka,fr FRA,FW,Napoli,it Serie A,22,2000,0.2,0,0,0,0,0,0,0,,0,0,0,0,0,0,1,0,Matches
2859,Deyovaisio Zeefuik,nl NED,DF,Hellas Verona,it Serie A,24,1998,0.1,1,1,0,1,0,0,0,,0,0,0,0,0,1,0,0,Matches
2860,Marvin Zeegelaar,nl NED,DF,Udinese,it Serie A,31,1990,3.9,8,4,6,2,0,3,4,75.0,1,2,0,2,3,11,5,0,Matches
2861,Mehdi Zeffane,dz ALG,"DF,MF",Clermont Foot,fr Ligue 1,30,1992,7.3,12,7,5,7,0,4,21,19.0,17,14,6,8,22,34,12,0,Matches
2862,Aaron Zehnter,de GER,DF,Augsburg,de Bundesliga,17,2004,0.0,0,0,0,0,0,0,1,0.0,1,0,0,0,1,1,0,0,Matches
2863,Jordan Zemura,zw ZIM,DF,Bournemouth,eng Premier League,22,1999,16.2,39,24,24,14,1,23,44,52.3,21,31,9,22,16,55,32,0,Matches
2864,Arber Zeneli,xk KVX,"FW,MF",Reims,fr Ligue 1,27,1995,11.1,9,3,3,3,3,5,12,41.7,7,8,0,8,2,11,2,0,Matches
2865,Robin Zentner,de GER,GK,Mainz 05,de Bundesliga,27,1994,26.0,0,0,0,0,0,0,4,0.0,4,0,0,0,0,0,17,1,Matches
2866,Alessio Zerbin,it ITA,FW,Napoli,it Serie A,23,1999,2.2,10,5,4,5,1,4,8,50.0,4,2,0,2,2,12,2,0,Matches
2867,Michael Zetterer,de GER,GK,Werder Bremen,de Bundesliga,27,1995,1.7,0,0,0,0,0,0,0,,0,0,0,0,0,0,1,0,Matches
2868,Nathan Zeze,fr FRA,DF,Nantes,fr Ligue 1,17,2005,0.7,3,2,2,1,0,1,1,100.0,0,0,0,0,0,3,1,0,Matches
2869,Edon Zhegrova,xk KVX,"FW,MF",Lille,fr Ligue 1,23,1999,11.7,18,12,6,7,5,12,20,60.0,8,9,0,9,2,20,2,0,Matches
2870,Piotr Zieliński,pl POL,MF,Napoli,it Serie A,28,1994,25.4,17,10,1,11,5,12,25,48.0,13,16,5,11,14,31,7,0,Matches
2871,David Zima,cz CZE,DF,Torino,it Serie A,21,2000,4.5,9,5,5,4,0,3,4,75.0,1,7,2,5,9,18,11,2,Matches
2872,Oleksandr Zinchenko,ua UKR,DF,Arsenal,eng Premier League,25,1996,23.5,40,18,14,17,9,21,40,52.5,19,20,2,18,22,62,38,2,Matches
2873,Joshua Zirkzee,nl NED,FW,Bologna,it Serie A,21,2001,9.1,4,2,1,1,2,2,7,28.6,5,4,1,3,4,8,4,0,Matches
2874,Hakim Ziyech,ma MAR,"FW,MF",Chelsea,eng Premier League,29,1993,7.3,20,12,12,5,3,4,9,44.4,5,8,0,8,5,25,5,1,Matches
2875,Jeroen Zoet,nl NED,GK,Spezia,it Serie A,31,1991,3.7,1,1,1,0,0,1,1,100.0,0,0,0,0,0,1,1,0,Matches
2876,Simon Zoller,de GER,FW,Bochum,de Bundesliga,31,1991,16.2,11,4,2,8,1,4,12,33.3,8,14,1,13,6,17,21,0,Matches
2877,Nadir Zortea,it ITA,"DF,MF",Atalanta,it Serie A,23,1999,2.5,10,5,3,7,0,3,4,75.0,1,4,0,4,0,10,4,0,Matches
2878,Nadir Zortea,it ITA,DF,Sassuolo,it Serie A,23,1999,7.3,15,8,12,2,1,9,14,64.3,5,10,4,6,4,19,21,0,Matches
2879,Tanguy Zoukrou,fr FRA,DF,Troyes,fr Ligue 1,19,2003,5.7,14,7,8,6,0,10,14,71.4,4,18,11,7,2,16,24,0,Matches
2880,Kurt Zouma,fr FRA,DF,West Ham,eng Premier League,27,1994,22.1,9,4,4,5,0,5,8,62.5,3,17,14,3,30,39,120,1,Matches
2881,Petar Zovko,ba BIH,GK,Spezia,it Serie A,20,2002,0.8,1,0,1,0,0,1,1,100.0,0,0,0,0,0,1,0,0,Matches
2882,Igor Zubeldia,es ESP,DF,Real Sociedad,es La Liga,25,1997,28.2,35,18,28,7,0,25,35,71.4,10,23,17,6,21,56,93,0,Matches
2883,Martín Zubimendi,es ESP,MF,Real Sociedad,es La Liga,23,1999,34.5,59,33,23,30,6,24,45,53.3,21,44,17,27,37,96,55,4,Matches
2884,Szymon Żurkowski,pl POL,MF,Fiorentina,it Serie A,24,1997,0.4,0,0,0,0,0,0,0,,0,0,0,0,0,0,0,0,Matches
2885,Szymon Żurkowski,pl POL,MF,Spezia,it Serie A,24,1997,4.7,9,3,4,4,1,2,15,13.3,13,9,2,7,4,13,6,0,Matches
2886,Martin Ødegaard,no NOR,MF,Arsenal,eng Premier League,23,1998,34.7,36,23,12,14,10,14,47,29.8,33,20,5,15,6,42,12,1,Matches
2887,Milan Đurić,ba BIH,FW,Hellas Verona,it Serie A,32,1990,15.2,2,1,1,0,1,1,3,33.3,2,7,4,3,1,3,24,0,Matches
2888,Filip Đuričić,rs SRB,"MF,FW",Sampdoria,it Serie A,30,1992,24.1,43,22,18,20,5,14,32,43.8,18,19,6,13,7,50,8,0,Matches
