,Player,Nation,Pos,Squad,Comp,Age,Born,90s,Tackles,Tackles_Won,Tackles_Def_3rd,Tackles_Mid_3rd,Tackles_Att_3rd,Dribblers_Tackled,Dribblers_Challenged,Dribblers_Tackle_W%,Dribblers_Tackle_Lost,Blocks,Shots_Blocked,Passes_Blocked,Interceptions,Tackles+Interceptions,Clearances,Errors_Shots,Matches
0,Max Aarons,eng ENG,DF,Bournemouth,eng Premier League,24-065,2000,12.1,28,18,20,6,2,19,30,63.3,11,9,5,4,6,34,23,0,Matches
1,Brenden Aaronson,us USA,"MF,FW",Union Berlin,de Bundesliga,23-139,2000,6.9,14,9,5,7,2,7,16,43.8,9,16,0,16,1,15,3,0,Matches
2,Paxten Aaronson,us USA,MF,Eint Frankfurt,de Bundesliga,20-196,2003,1.1,2,2,1,1,0,1,1,100.0,0,2,0,2,0,2,0,0,Matches
3,Yunis Abdelhamid,ma MAR,DF,Reims,fr Ligue 1,36-163,1987,20.9,41,25,19,19,3,17,32,53.1,15,34,22,12,25,66,62,1,Matches
4,Salis Abdul Samed,gh GHA,MF,Lens,fr Ligue 1,23-349,2000,15.4,18,12,7,8,3,6,13,46.2,7,10,1,9,10,28,14,0,Matches
5,Laurent Abergel,fr FRA,MF,Lorient,fr Ligue 1,31-037,1993,23.8,64,36,33,26,5,27,72,37.5,45,22,5,17,46,110,45,1,Matches
6,Matthis Abline,fr FRA,FW,Nantes,fr Ligue 1,20-347,2003,5.2,1,1,0,1,0,1,3,33.3,2,1,0,1,0,1,3,0,Matches
7,Abner,br BRA,DF,Betis,es La Liga,23-287,2000,12.9,20,17,12,7,1,14,28,50.0,14,21,4,17,11,31,51,0,Matches
8,Zakaria Aboukhlal,ma MAR,"MF,FW",Toulouse,fr Ligue 1,24-020,2000,4.2,1,1,0,0,1,1,3,33.3,2,3,0,3,1,2,1,0,Matches
9,Abdel Abqar,ma MAR,DF,Alavés,es La Liga,24-365,1999,17.2,20,9,15,3,2,11,21,52.4,10,17,13,4,15,35,80,0,Matches
10,Francesco Acerbi,it ITA,DF,Inter,it Serie A,36-028,1988,18.5,18,11,14,4,0,9,12,75.0,3,12,8,4,24,42,54,0,Matches
11,Marcos Acuña,ar ARG,DF,Sevilla,es La Liga,32-133,1991,7.8,17,12,12,5,0,5,6,83.3,1,6,1,5,4,21,12,0,Matches
12,Bénie Adama Traore,ci CIV,"FW,MF",Sheffield Utd,eng Premier League,21-100,2002,4.3,4,2,1,2,1,0,4,0.0,4,4,1,3,1,5,1,0,Matches
13,Bénie Adama Traore,ci CIV,"FW,MF",Nantes,fr Ligue 1,21-100,2002,2.4,4,1,0,3,1,2,4,50.0,2,1,0,1,1,5,0,0,Matches
14,Akor Adams,ng NGA,FW,Montpellier,fr Ligue 1,24-040,2000,19.4,10,4,3,3,4,3,7,42.9,4,4,1,3,4,14,8,0,Matches
15,Junior Adamu,at AUT,"FW,MF",Freiburg,de Bundesliga,22-277,2001,1.1,5,1,1,2,2,1,2,50.0,1,1,0,1,0,5,1,0,Matches
16,Sargis Adamyan,am ARM,"FW,MF",Köln,de Bundesliga,30-291,1993,2.9,3,2,0,2,1,1,3,33.3,2,4,0,4,2,5,3,0,Matches
17,Tosin Adarabioyo,eng ENG,DF,Fulham,eng Premier League,26-167,1997,11.0,14,8,10,4,0,10,14,71.4,4,11,8,3,17,31,58,0,Matches
18,Elijah Adebayo,eng ENG,FW,Luton Town,eng Premier League,26-062,1998,12.9,1,0,1,0,0,0,9,0.0,9,8,1,7,5,6,23,0,Matches
19,Karim Adeyemi,de GER,"FW,MF",Dortmund,de Bundesliga,22-051,2002,5.1,8,7,3,3,2,3,10,30.0,7,7,0,7,2,10,2,0,Matches
20,Simon Adingra,ci CIV,FW,Brighton,eng Premier League,22-068,2002,15.2,22,12,12,5,5,11,28,39.3,17,16,1,15,12,34,10,0,Matches
21,Nathaniel Adjei,gh GHA,DF,Lorient,fr Ligue 1,21-201,2002,5.1,8,6,6,0,2,4,4,100.0,0,6,4,2,6,14,28,1,Matches
22,Amine Adli,ma MAR,"FW,MF",Leverkusen,de Bundesliga,23-304,2000,6.0,8,3,1,4,3,5,11,45.5,6,9,2,7,6,14,2,0,Matches
23,Yacine Adli,fr FRA,MF,Milan,it Serie A,23-224,2000,11.8,27,14,13,11,3,10,29,34.5,19,15,6,9,18,45,14,1,Matches
24,Adryelson,br BRA,"DF,FW",Lyon,fr Ligue 1,25-352,1998,0.1,0,0,0,0,0,0,0,,0,0,0,0,1,1,3,0,Matches
25,Adson,br BRA,"MF,FW",Nantes,fr Ligue 1,23-155,2000,2.6,7,6,1,6,0,2,2,100.0,0,5,0,5,2,9,2,0,Matches
26,Michel Aebischer,ch SUI,MF,Bologna,it Serie A,27-063,1997,16.2,22,16,4,16,2,9,22,40.9,13,20,3,17,10,32,13,0,Matches
27,Emmanuel Agbadou,ci CIV,DF,Reims,fr Ligue 1,26-266,1997,18.8,41,26,20,17,4,28,41,68.3,13,23,8,15,34,75,69,1,Matches
28,Lucien Agoume,fr FRA,MF,Inter,it Serie A,22-029,2002,0.1,0,0,0,0,0,0,0,,0,0,0,0,0,0,0,0,Matches
29,Lucien Agoume,fr FRA,MF,Sevilla,es La Liga,22-029,2002,1.7,4,3,2,2,0,2,2,100.0,0,2,0,2,2,6,0,0,Matches
30,Felix Agu,de GER,"DF,MF",Werder Bremen,de Bundesliga,24-164,1999,9.4,17,12,11,4,2,11,15,73.3,4,7,0,7,7,24,19,0,Matches
31,Nayef Aguerd,ma MAR,DF,West Ham,eng Premier League,27-345,1996,18.7,22,11,16,6,0,13,17,76.5,4,28,21,7,16,38,81,2,Matches
32,Ruben Aguilar,fr FRA,DF,Lens,fr Ligue 1,30-318,1993,16.5,41,24,21,18,2,20,34,58.8,14,23,2,21,21,62,32,0,Matches
33,Brandon Aguilera,cr CRC,FW,Nott'ham Forest,eng Premier League,20-255,2003,0.1,0,0,0,0,0,0,0,,0,0,0,0,0,0,0,0,Matches
34,Naouirou Ahamada,fr FRA,"MF,FW",Crystal Palace,eng Premier League,21-346,2002,2.4,4,3,3,1,0,3,9,33.3,6,2,0,2,1,5,3,0,Matches
35,Anel Ahmedhodžić,ba BIH,DF,Sheffield Utd,eng Premier League,24-349,1999,20.2,47,29,35,10,2,22,36,61.1,14,31,18,13,22,69,93,1,Matches
36,Joseph Aidoo,gh GHA,DF,Celta Vigo,es La Liga,28-162,1995,4.5,8,3,6,2,0,4,8,50.0,4,3,1,2,4,12,28,0,Matches
37,Ola Aina,ng NGA,DF,Nott'ham Forest,eng Premier League,27-153,1996,11.0,26,15,21,4,1,17,23,73.9,6,10,3,7,8,34,38,1,Matches
38,Rayan Aït Nouri,dz ALG,"DF,MF",Wolves,eng Premier League,22-277,2001,17.9,48,28,27,16,5,18,29,62.1,11,23,6,17,12,60,30,0,Matches
39,Tosin Aiyegun,bj BEN,"MF,FW",Lorient,fr Ligue 1,25-257,1998,8.1,6,4,2,3,1,3,7,42.9,4,2,1,1,1,7,7,0,Matches
40,Kristoffer Ajer,no NOR,DF,Brentford,eng Premier League,25-327,1998,12.4,23,12,15,7,1,16,25,64.0,9,14,6,8,15,38,49,1,Matches
41,Ludovic Ajorque,fr FRA,FW,Mainz 05,de Bundesliga,30-013,1994,12.3,2,2,1,1,0,1,9,11.1,8,6,2,4,1,3,7,0,Matches
42,Manuel Akanji,ch SUI,"DF,MF",Manchester City,eng Premier League,28-234,1995,17.6,24,15,9,10,5,14,26,53.8,12,21,10,11,17,41,51,1,Matches
43,Marley Aké,fr FRA,FW,Udinese,it Serie A,23-064,2001,0.1,0,0,0,0,0,0,0,,0,0,0,0,0,0,0,0,Matches
44,Nathan Aké,nl NED,DF,Manchester City,eng Premier League,29-020,1995,18.2,20,10,13,5,2,11,16,68.8,5,12,1,11,9,29,39,0,Matches
45,Ilias Akhomach,es ESP,"MF,FW",Villarreal,es La Liga,19-328,2004,12.5,29,19,10,14,5,9,14,64.3,5,9,2,7,9,38,9,0,Matches
46,Sergio Akieme,es ESP,DF,Almería,es La Liga,26-084,1997,18.6,27,15,18,7,2,13,16,81.3,3,14,4,10,10,37,34,0,Matches
47,Sergio Akieme,es ESP,DF,Reims,fr Ligue 1,26-084,1997,2.6,4,1,1,3,0,3,4,75.0,1,2,0,2,2,6,2,0,Matches
48,Ebenezer Akinsanmiro,ng NGA,MF,Inter,it Serie A,19-105,2004,0.2,0,0,0,0,0,0,1,0.0,1,0,0,0,0,0,0,0,Matches
49,Maghnes Akliouche,fr FRA,"MF,FW",Monaco,fr Ligue 1,22-013,2002,10.0,21,15,9,9,3,7,24,29.2,17,12,0,12,7,28,0,0,Matches
50,Paul Akouokou,ci CIV,MF,Betis,es La Liga,26-080,1997,0.3,5,3,0,2,3,3,3,100.0,0,3,1,2,1,6,1,0,Matches
51,Paul Akouokou,ci CIV,MF,Lyon,fr Ligue 1,26-080,1997,3.4,14,9,2,10,2,6,7,85.7,1,5,1,4,6,20,11,0,Matches
52,Jean-Daniel Akpa-Akpro,ci CIV,MF,Monza,it Serie A,31-150,1992,3.5,9,3,6,2,1,1,4,25.0,3,4,2,2,6,15,5,0,Matches
53,Kevin Akpoguma,ng NGA,DF,Hoffenheim,de Bundesliga,28-325,1995,7.7,24,12,16,7,1,18,22,81.8,4,15,6,9,10,34,19,0,Matches
54,David Alaba,at AUT,DF,Real Madrid,es La Liga,31-259,1992,12.8,13,9,7,5,1,4,8,50.0,4,10,7,3,15,28,34,0,Matches
55,Luis Alberto,es ESP,MF,Lazio,it Serie A,31-163,1992,19.9,27,15,12,9,6,11,38,28.9,27,29,4,25,5,32,11,0,Matches
56,Raúl Albiol,es ESP,DF,Villarreal,es La Liga,38-187,1985,18.2,16,9,7,8,1,12,21,57.1,9,26,20,6,13,29,91,0,Matches
57,Thiago Alcántara,es ESP,MF,Liverpool,eng Premier League,32-333,1991,0.1,0,0,0,0,0,0,0,,0,0,0,0,0,0,0,0,Matches
58,Carlos Alcaraz,ar ARG,MF,Juventus,it Serie A,21-100,2002,2.0,2,2,0,2,0,1,4,25.0,3,1,0,1,2,4,0,0,Matches
59,Rubén Alcaraz,es ESP,MF,Cádiz,es La Liga,32-313,1991,23.8,61,37,25,32,4,29,78,37.2,49,46,11,35,25,86,42,0,Matches
60,Omar Alderete,py PAR,DF,Getafe,es La Liga,27-074,1996,14.1,17,13,12,5,0,12,20,60.0,8,20,13,7,7,24,74,0,Matches
61,Iván Alejo,es ESP,MF,Cádiz,es La Liga,29-028,1995,17.3,34,17,21,8,5,16,53,30.2,37,18,0,18,4,38,17,0,Matches
62,Carles Aleñá,es ESP,"MF,FW",Getafe,es La Liga,26-064,1998,8.8,15,6,5,8,2,5,15,33.3,10,12,3,9,3,18,10,0,Matches
63,Trent Alexander-Arnold,eng ENG,DF,Liverpool,eng Premier League,25-154,1998,18.0,28,19,19,8,1,20,67,29.9,47,13,1,12,23,51,39,4,Matches
64,Mohamed Ali Cho,fr FRA,"FW,MF",Real Sociedad,es La Liga,20-050,2004,2.8,4,3,3,1,0,2,7,28.6,5,6,0,6,1,5,1,0,Matches
65,Mohamed Ali Cho,fr FRA,"FW,MF",Nice,fr Ligue 1,20-050,2004,3.5,6,5,1,4,1,1,2,50.0,1,4,0,4,3,9,3,0,Matches
66,Yanis Ali Issoufou,fr FRA,FW,Montpellier,fr Ligue 1,17-133,2006,0.1,,0,,,,,,,,,,,0,,,,Matches
67,Faride Alidou,de GER,"FW,MF",Köln,de Bundesliga,22-235,2001,7.1,8,2,3,4,1,3,12,25.0,9,12,2,10,5,13,10,1,Matches
68,Nabil Alioui,fr FRA,"MF,FW",Le Havre,fr Ligue 1,25-020,1999,11.2,3,2,2,1,0,2,4,50.0,2,6,1,5,3,6,4,0,Matches
69,Alisson,br BRA,GK,Liverpool,eng Premier League,31-159,1992,21.0,0,0,0,0,0,0,1,0.0,1,0,0,0,0,0,10,3,Matches
70,Tadeo Allende,ar ARG,"MF,FW",Celta Vigo,es La Liga,25-018,1999,2.4,5,1,3,1,1,3,4,75.0,1,3,0,3,2,7,2,0,Matches
71,Jim Allevinah,ga GAB,"DF,MF",Clermont Foot,fr Ligue 1,29-011,1995,16.8,24,13,9,10,5,12,30,40.0,18,20,3,17,11,35,21,0,Matches
72,Domingos André Ribeiro Almeida,pt POR,"FW,MF",Valencia,es La Liga,23-284,2000,5.3,11,6,3,6,2,5,10,50.0,5,4,0,4,2,13,2,0,Matches
73,Miguel Almirón,py PAR,FW,Newcastle Utd,eng Premier League,30-028,1994,19.7,33,22,11,15,7,11,27,40.7,16,27,2,25,8,41,11,0,Matches
74,Pontus Almqvist,se SWE,FW,Lecce,it Serie A,24-243,1999,18.0,33,21,11,15,7,15,38,39.5,23,18,1,17,10,43,8,0,Matches
75,Marcos Alonso,es ESP,DF,Barcelona,es La Liga,33-072,1990,1.8,5,3,2,3,0,3,4,75.0,1,2,0,2,4,9,3,0,Matches
76,Adrià Altimira,es ESP,"DF,MF",Villarreal,es La Liga,22-347,2001,8.6,16,7,9,6,1,9,24,37.5,15,18,5,13,5,21,18,0,Matches
77,Sergi Altimira,es ESP,MF,Betis,es La Liga,22-197,2001,5.6,15,8,8,6,1,11,22,50.0,11,12,1,11,8,23,10,0,Matches
78,Edson Álvarez,mx MEX,MF,West Ham,eng Premier League,26-137,1997,20.4,61,30,37,20,4,22,44,50.0,22,40,16,24,30,91,69,0,Matches
79,Gastón Álvarez,uy URU,DF,Getafe,es La Liga,23-351,2000,20.7,46,24,33,11,2,23,35,65.7,12,31,9,22,30,76,63,0,Matches
80,Hugo Álvarez,es ESP,MF,Celta Vigo,es La Liga,20-251,2003,0.4,1,1,0,0,1,1,2,50.0,1,1,0,1,1,2,0,0,Matches
81,Julián Álvarez,ar ARG,"MF,FW",Manchester City,eng Premier League,24-038,2000,23.7,18,9,3,7,8,6,24,25.0,18,23,0,23,2,20,13,0,Matches
82,Yeray Álvarez,es ESP,DF,Athletic Club,es La Liga,29-045,1995,7.0,9,7,7,2,0,5,7,71.4,2,6,4,2,9,18,20,0,Matches
83,Skelly Alvero,fr FRA,MF,Lyon,fr Ligue 1,21-310,2002,4.7,8,7,5,2,1,2,9,22.2,7,5,1,4,2,10,5,0,Matches
84,Skelly Alvero,fr FRA,MF,Werder Bremen,de Bundesliga,21-310,2002,0.3,3,2,0,3,0,2,2,100.0,0,0,0,0,1,4,0,0,Matches
85,Papa Amadou Diallo,sn SEN,"FW,MF",Metz,fr Ligue 1,19-258,2004,3.0,4,2,1,2,1,2,5,40.0,3,3,0,3,4,8,2,0,Matches
86,Selim Amallah,ma MAR,"FW,MF",Valencia,es La Liga,27-115,1996,6.4,17,12,7,7,3,3,9,33.3,6,13,0,13,10,27,4,0,Matches
87,Amath,sn SEN,"FW,MF",Mallorca,es La Liga,27-237,1996,4.4,9,6,7,2,0,2,10,20.0,8,2,0,2,3,12,6,0,Matches
88,Lorenzo Amatucci,it ITA,MF,Fiorentina,it Serie A,20-033,2004,0.2,0,0,0,0,0,0,0,,0,0,0,0,0,0,0,0,Matches
89,Zeki Amdouni,ch SUI,FW,Burnley,eng Premier League,23-096,2000,19.5,25,16,1,13,11,7,23,30.4,16,20,9,11,7,32,10,0,Matches
90,Kelvin Amian,fr FRA,DF,Nantes,fr Ligue 1,26-030,1998,1.1,2,2,1,1,0,1,3,33.3,2,0,0,0,0,2,1,0,Matches
91,Bruno Amione,ar ARG,DF,Hellas Verona,it Serie A,22-066,2002,6.4,11,3,9,2,0,4,5,80.0,1,4,2,2,9,20,19,2,Matches
92,Michael Amir Murillo,pa PAN,DF,Marseille,fr Ligue 1,28-027,1996,7.1,14,6,7,4,3,8,11,72.7,3,5,1,4,5,19,13,0,Matches
93,Nadiem Amiri,de GER,MF,Mainz 05,de Bundesliga,27-134,1996,5.7,11,8,3,5,3,6,8,75.0,2,6,0,6,8,19,4,0,Matches
94,Nadiem Amiri,de GER,MF,Leverkusen,de Bundesliga,27-134,1996,1.0,4,2,0,3,1,0,3,0.0,3,0,0,0,0,4,1,0,Matches
95,Kofi Amoako,de GER,MF,Wolfsburg,de Bundesliga,18-308,2005,0.0,0,0,0,0,0,0,0,,0,0,0,0,0,0,0,0,Matches
96,Sofyan Amrabat,ma MAR,"MF,DF",Manchester Utd,eng Premier League,27-201,1996,7.0,22,14,13,7,2,15,24,62.5,9,12,3,9,5,27,12,2,Matches
97,Joachim Andersen,dk DEN,DF,Crystal Palace,eng Premier League,27-283,1996,27.0,34,21,25,8,1,19,28,67.9,9,27,17,10,30,64,133,1,Matches
98,Elliot Anderson,sct SCO,"MF,FW",Newcastle Utd,eng Premier League,21-124,2002,4.6,8,6,3,4,1,3,9,33.3,6,6,3,3,2,10,6,0,Matches
99,Felipe Anderson,br BRA,FW,Lazio,it Serie A,30-329,1993,22.4,58,33,22,24,12,28,74,37.8,46,36,3,33,22,80,20,0,Matches
100,Benjamin André,fr FRA,MF,Lille,fr Ligue 1,33-219,1990,21.0,75,41,33,37,5,34,67,50.7,33,27,4,23,24,99,47,0,Matches
101,Komnen Andrić,rs SRB,FW,Clermont Foot,fr Ligue 1,28-252,1995,1.8,2,1,0,1,1,0,3,0.0,3,2,0,2,0,2,1,0,Matches
102,Robert Andrich,de GER,"MF,DF",Leverkusen,de Bundesliga,29-169,1994,10.8,15,9,3,8,4,5,11,45.5,6,10,3,7,11,26,14,0,Matches
103,Miguel Ángel Rubio,es ESP,DF,Granada,es La Liga,25-364,1998,8.3,10,5,6,4,0,7,10,70.0,3,18,11,7,14,24,29,1,Matches
104,Angeliño,es ESP,DF,Roma,it Serie A,27-065,1997,3.5,1,1,1,0,0,0,0,,0,2,0,2,2,3,12,0,Matches
105,Fabrizio Angileri,ar ARG,"DF,MF",Getafe,es La Liga,29-360,1994,1.1,0,0,0,0,0,0,2,0.0,2,0,0,0,2,2,5,0,Matches
106,Jaidon Anthony,eng ENG,FW,Bournemouth,eng Premier League,24-099,1999,1.7,3,1,1,0,2,1,7,14.3,6,3,0,3,1,4,3,0,Matches
107,Waldemar Anton,de GER,DF,Stuttgart,de Bundesliga,27-233,1996,24.1,27,18,13,13,1,15,29,51.7,14,21,13,8,28,55,117,1,Matches
108,Michail Antonio,jm JAM,FW,West Ham,eng Premier League,33-347,1990,10.2,8,4,3,3,2,3,5,60.0,2,10,3,7,1,9,1,0,Matches
109,Antony,br BRA,FW,Manchester Utd,eng Premier League,24-014,2000,10.5,28,14,10,12,6,16,30,53.3,14,20,1,19,8,36,5,0,Matches
110,Christopher Antwi-Adjei,gh GHA,"FW,MF",Bochum,de Bundesliga,30-031,1994,11.6,18,11,9,5,4,10,20,50.0,10,11,2,9,2,20,10,1,Matches
111,Houssem Aouar,dz ALG,MF,Roma,it Serie A,25-253,1998,5.0,12,9,3,8,1,2,8,25.0,6,4,0,4,4,16,1,0,Matches
112,Stredair Appuah,fr FRA,"FW,MF",Nantes,fr Ligue 1,19-256,2004,0.7,0,0,0,0,0,0,2,0.0,2,0,0,0,1,1,1,0,Matches
113,Mauro Arambarri,uy URU,MF,Getafe,es La Liga,28-161,1995,3.8,6,2,3,2,1,1,6,16.7,5,1,0,1,2,8,7,0,Matches
114,Jon Aramburu,ve VEN,DF,Real Sociedad,es La Liga,21-230,2002,4.8,14,9,8,4,2,10,14,71.4,4,6,3,3,5,19,15,0,Matches
115,Julian Araujo,mx MEX,DF,Las Palmas,es La Liga,22-209,2001,12.6,30,16,20,5,5,18,27,66.7,9,18,12,6,10,40,42,1,Matches
116,Ronald Araújo,uy URU,DF,Barcelona,es La Liga,25-002,1999,17.9,23,18,10,12,1,8,12,66.7,4,18,9,9,9,32,53,2,Matches
117,Oliver Arblaster,eng ENG,MF,Sheffield Utd,eng Premier League,19-309,2004,0.3,0,0,0,0,0,0,0,,0,0,0,0,1,1,0,0,Matches
118,Cameron Archer,eng ENG,"FW,MF",Sheffield Utd,eng Premier League,22-232,2001,16.1,14,9,6,5,3,6,15,40.0,9,17,3,14,1,15,10,0,Matches
119,Cameron Archer,eng ENG,MF,Aston Villa,eng Premier League,22-232,2001,0.1,0,0,0,0,0,0,0,,0,0,0,0,0,0,0,0,Matches
120,Alphonse Areola,fr FRA,GK,West Ham,eng Premier League,31-011,1993,23.5,1,1,1,0,0,1,3,33.3,2,0,0,0,1,2,9,0,Matches
121,Adu Ares,es ESP,"FW,MF",Athletic Club,es La Liga,22-149,2001,1.7,7,4,3,2,2,2,3,66.7,1,1,0,1,1,8,0,0,Matches
122,Jesús Areso,es ESP,DF,Osasuna,es La Liga,24-251,1999,19.7,29,14,15,10,4,18,23,78.3,5,25,9,16,11,40,43,0,Matches
123,Matias Arezo,uy URU,FW,Granada,es La Liga,21-109,2002,2.2,3,1,0,3,0,1,4,25.0,3,3,1,2,0,3,3,0,Matches
124,Iñigo Arguibide,es ESP,DF,Osasuna,es La Liga,18-325,2005,0.2,1,0,0,1,0,0,0,,0,0,0,0,0,1,1,0,Matches
125,Yoël Armougom,fr FRA,DF,Clermont Foot,fr Ligue 1,25-278,1998,1.6,2,2,2,0,0,1,1,100.0,0,0,0,0,1,3,3,0,Matches
126,José Arnaiz,es ESP,"FW,MF",Osasuna,es La Liga,28-329,1995,6.4,9,5,3,3,3,2,14,14.3,12,7,0,7,3,12,1,0,Matches
127,Hákon Arnar Haraldsson,is ISL,"FW,MF",Lille,fr Ligue 1,20-334,2003,6.5,5,4,2,2,1,1,11,9.1,10,1,0,1,1,6,3,0,Matches
128,Marko Arnautović,at AUT,FW,Inter,it Serie A,34-325,1989,6.5,8,4,3,3,2,4,5,80.0,1,6,1,5,4,12,3,0,Matches
129,Maximilian Arnold,de GER,MF,Wolfsburg,de Bundesliga,29-287,1994,17.9,32,24,9,17,6,18,37,48.6,19,11,1,10,23,55,38,0,Matches
130,Mohamed El Arouch,fr FRA,FW,Lyon,fr Ligue 1,19-338,2004,0.0,0,0,0,0,0,0,0,,0,0,0,0,0,0,0,0,Matches
131,Sergio Arribas,es ESP,"MF,FW",Almería,es La Liga,22-161,2001,19.4,31,15,16,14,1,12,27,44.4,15,17,1,16,13,44,8,1,Matches
132,Kepa Arrizabalaga,es ESP,GK,Real Madrid,es La Liga,29-158,1994,12.0,0,0,0,0,0,0,1,0.0,1,0,0,0,0,0,4,0,Matches
133,Arthur,br BRA,DF,Leverkusen,de Bundesliga,20-358,2003,0.4,2,2,1,0,1,2,2,100.0,0,0,0,0,0,2,1,0,Matches
134,Takuma Asano,jp JPN,"FW,MF",Bochum,de Bundesliga,29-120,1994,16.8,11,2,2,5,4,4,15,26.7,11,12,2,10,3,14,10,0,Matches
135,Marco Asensio,es ESP,"FW,MF",Paris S-G,fr Ligue 1,28-048,1996,7.5,6,4,2,4,0,1,5,20.0,4,5,0,5,1,7,2,0,Matches
136,Kristjan Asllani,al ALB,MF,Inter,it Serie A,22-000,2002,5.7,5,1,3,2,0,0,6,0.0,6,5,1,4,9,14,7,0,Matches
137,Joel Asoro,se SWE,"FW,MF",Metz,fr Ligue 1,24-317,1999,9.2,13,9,7,6,0,3,10,30.0,7,7,1,6,5,18,9,0,Matches
138,Iago Aspas,es ESP,FW,Celta Vigo,es La Liga,36-221,1987,19.9,5,3,1,4,0,0,8,0.0,8,13,2,11,8,13,6,0,Matches
139,Lorenz Assignon,tg TOG,DF,Burnley,eng Premier League,23-261,2000,4.9,17,8,9,6,2,9,12,75.0,3,7,2,5,5,22,13,0,Matches
140,Lorenz Assignon,tg TOG,DF,Rennes,fr Ligue 1,23-261,2000,11.2,24,12,12,8,4,9,24,37.5,15,9,4,5,9,33,27,1,Matches
141,Youcef Atal,dz ALG,DF,Nice,fr Ligue 1,27-297,1996,4.0,9,3,6,2,1,6,8,75.0,2,7,1,6,4,13,1,0,Matches
142,Valentin Atangana Edoa,fr FRA,"MF,DF",Reims,fr Ligue 1,18-197,2005,2.7,10,8,2,5,3,3,5,60.0,2,3,0,3,4,14,3,0,Matches
143,Arthur Atta,fr FRA,MF,Metz,fr Ligue 1,21-055,2003,3.0,9,8,2,5,2,6,11,54.5,5,3,0,3,8,17,11,0,Matches
144,Noah Atubolu,de GER,GK,Freiburg,de Bundesliga,21-289,2002,24.0,0,0,0,0,0,0,1,0.0,1,0,0,0,0,0,5,0,Matches
145,Pierre-Emerick Aubameyang,ga GAB,FW,Marseille,fr Ligue 1,34-265,1989,19.6,13,9,2,9,2,4,15,26.7,11,20,5,15,8,21,19,0,Matches
146,Emil Audero,it ITA,GK,Inter,it Serie A,27-051,1997,1.0,0,0,0,0,0,0,0,,0,0,0,0,0,0,1,0,Matches
147,Tommaso Augello,it ITA,DF,Cagliari,it Serie A,29-192,1994,17.6,21,15,15,4,2,13,19,68.4,6,14,7,7,7,28,59,0,Matches
148,Yann Aurel Bisseck,de GER,DF,Inter,it Serie A,23-101,2000,5.5,7,3,4,2,1,4,6,66.7,2,3,2,1,0,7,11,0,Matches
149,Serge Aurier,ci CIV,"DF,MF",Nott'ham Forest,eng Premier League,31-076,1992,9.3,20,14,9,11,0,5,11,45.5,6,10,3,7,9,29,36,1,Matches
150,Ezequiel Ávila,ar ARG,"FW,MF",Osasuna,es La Liga,30-032,1994,9.6,3,2,1,1,1,3,11,27.3,8,14,0,14,4,7,8,0,Matches
151,Ezequiel Ávila,ar ARG,FW,Betis,es La Liga,30-032,1994,2.3,2,1,0,2,0,1,2,50.0,1,2,0,2,1,3,2,0,Matches
152,Taiwo Awoniyi,ng NGA,FW,Nott'ham Forest,eng Premier League,26-210,1997,11.2,9,7,1,4,4,1,2,50.0,1,6,1,5,1,10,9,0,Matches
153,André Ayew,gh GHA,"FW,MF",Le Havre,fr Ligue 1,34-083,1989,3.8,3,2,1,2,0,3,4,75.0,1,4,1,3,1,4,5,0,Matches
154,Jordan Ayew,gh GHA,"FW,MF",Crystal Palace,eng Premier League,32-180,1991,22.9,52,27,21,19,12,14,32,43.8,18,37,2,35,13,65,12,0,Matches
155,Neil El Aynaoui,fr FRA,MF,Lens,fr Ligue 1,22-251,2001,11.6,20,8,8,10,2,9,26,34.6,17,16,4,12,18,38,16,1,Matches
156,Sardar Azmoun,ir IRN,"FW,MF",Roma,it Serie A,29-068,1995,4.5,6,4,2,3,1,3,7,42.9,4,0,0,0,2,8,3,1,Matches
157,César Azpilicueta,es ESP,DF,Atlético Madrid,es La Liga,34-194,1989,10.6,20,12,11,8,1,10,16,62.5,6,19,4,15,12,32,32,0,Matches
158,Paulo Azzi,br BRA,"DF,MF",Cagliari,it Serie A,29-238,1994,9.4,19,11,10,6,3,9,18,50.0,9,10,1,9,15,34,22,0,Matches
159,Oussama El Azzouzi,ma MAR,MF,Bologna,it Serie A,22-285,2001,3.4,7,5,3,3,1,5,9,55.6,4,4,2,2,5,12,8,0,Matches
160,Abdellah Baallal,ma MAR,MF,Clermont Foot,fr Ligue 1,19-123,2004,0.0,0,0,0,0,0,0,0,,0,1,0,1,0,0,0,0,Matches
161,Iddrisu Baba,gh GHA,MF,Almería,es La Liga,28-047,1996,15.3,45,25,27,17,1,16,37,43.2,21,20,6,14,11,56,26,2,Matches
162,Srđan Babić,rs SRB,DF,Almería,es La Liga,27-322,1996,1.0,2,2,0,2,0,1,1,100.0,0,1,1,0,0,2,2,0,Matches
163,Shavy Babicka,ga GAB,FW,Toulouse,fr Ligue 1,23-282,2000,3.0,6,5,2,4,0,1,4,25.0,3,3,0,3,0,6,2,0,Matches
164,Aliou Badara Baldé,sn SEN,FW,Nice,fr Ligue 1,21-088,2002,0.6,3,1,0,3,0,1,1,100.0,0,2,1,1,1,4,0,0,Matches
165,Loïc Bade,fr FRA,DF,Sevilla,es La Liga,23-333,2000,17.0,43,28,36,7,0,22,34,64.7,12,19,12,7,23,66,87,0,Matches
166,Milan Badelj,hr CRO,MF,Genoa,it Serie A,35-013,1989,20.2,40,22,18,20,2,21,45,46.7,24,32,7,25,38,78,36,1,Matches
167,Matthias Bader,de GER,"DF,MF",Darmstadt 98,de Bundesliga,26-266,1997,16.2,41,20,25,9,7,27,51,52.9,24,19,4,15,21,62,18,0,Matches
168,Benoît Badiashile,fr FRA,DF,Chelsea,eng Premier League,22-349,2001,6.2,13,10,8,5,0,6,10,60.0,4,9,4,5,5,18,31,1,Matches
169,Alex Baena,es ESP,"MF,FW",Villarreal,es La Liga,22-233,2001,20.0,21,13,6,8,7,11,31,35.5,20,14,2,12,9,30,9,1,Matches
170,Jaime Báez,uy URU,"FW,MF",Frosinone,it Serie A,28-319,1995,5.5,4,1,0,2,2,0,7,0.0,7,5,0,5,4,8,1,0,Matches
171,Leon Bailey,jm JAM,"MF,FW",Aston Villa,eng Premier League,26-213,1997,14.8,6,3,3,1,2,2,10,20.0,8,11,1,10,7,13,5,0,Matches
172,Eric Bailly,ci CIV,DF,Villarreal,es La Liga,29-332,1994,5.3,3,2,2,1,0,1,1,100.0,0,3,3,0,8,11,23,2,Matches
173,Nedim Bajrami,al ALB,"MF,FW",Sassuolo,it Serie A,25-010,1999,11.2,10,4,4,3,3,2,10,20.0,8,4,1,3,4,14,7,0,Matches
174,Cédric Bakambu,cd COD,FW,Betis,es La Liga,32-333,1991,0.3,0,0,0,0,0,0,0,,0,1,0,1,0,0,0,0,Matches
175,Tiemoué Bakayoko,fr FRA,MF,Lorient,fr Ligue 1,29-205,1994,7.9,17,11,8,7,2,3,10,30.0,7,6,4,2,15,32,11,0,Matches
176,Mitchel Bakker,nl NED,DF,Atalanta,it Serie A,23-263,2000,3.1,5,2,5,0,0,1,9,11.1,8,5,0,5,1,6,5,0,Matches
177,Ridle Baku,de GER,"DF,MF",Wolfsburg,de Bundesliga,25-336,1998,14.1,23,13,15,4,4,14,30,46.7,16,16,0,16,13,36,37,1,Matches
178,Dilane Bakwa,fr FRA,"FW,MF",Strasbourg,fr Ligue 1,21-196,2002,15.8,24,18,9,11,4,8,33,24.2,25,14,0,14,17,41,8,0,Matches
179,Tommaso Baldanzi,it ITA,"MF,FW",Empoli,it Serie A,20-352,2003,8.3,4,2,1,1,2,3,10,30.0,7,7,0,7,2,6,0,0,Matches
180,Tommaso Baldanzi,it ITA,"FW,MF",Roma,it Serie A,20-352,2003,1.4,1,1,1,0,0,0,0,,0,0,0,0,0,1,2,0,Matches
181,Alejandro Balde,es ESP,DF,Barcelona,es La Liga,20-143,2003,15.3,20,11,11,6,3,7,11,63.6,4,14,1,13,5,25,21,1,Matches
182,George Baldock,gr GRE,DF,Sheffield Utd,eng Premier League,31-000,1993,9.8,17,9,9,7,1,6,14,42.9,8,12,8,4,9,26,28,0,Matches
183,Carlos Baleba,cm CMR,MF,Brighton,eng Premier League,20-066,2004,7.5,27,14,12,12,3,15,27,55.6,12,14,4,10,12,39,18,2,Matches
184,Carlos Baleba,cm CMR,MF,Lille,fr Ligue 1,20-066,2004,0.7,6,2,1,4,1,3,4,75.0,1,0,0,0,2,8,0,0,Matches
185,Leonardo Balerdi,ar ARG,DF,Marseille,fr Ligue 1,25-043,1999,17.4,52,31,37,14,1,36,49,73.5,13,24,10,14,33,85,72,0,Matches
186,Iván Balliu,al ALB,DF,Rayo Vallecano,es La Liga,32-068,1992,23.0,31,21,13,18,0,16,30,53.3,14,21,8,13,24,55,53,1,Matches
187,Fodé Ballo-Touré,sn SEN,"DF,MF",Fulham,eng Premier League,27-066,1997,0.6,3,2,1,2,0,1,1,100.0,0,1,0,1,3,6,2,0,Matches
188,Folarin Balogun,us USA,FW,Monaco,fr Ligue 1,22-250,2001,13.4,9,3,2,6,1,5,13,38.5,8,7,0,7,2,11,3,0,Matches
189,Jonathan Bamba,ci CIV,"MF,FW",Celta Vigo,es La Liga,27-349,1996,16.6,11,7,4,5,2,1,12,8.3,11,15,0,15,11,22,9,0,Matches
190,Muhamad Bamba,ci CIV,MF,Lorient,fr Ligue 1,22-090,2001,4.6,,2,,,,,,,,,,,0,,,,Matches
191,Samuel Bamba,de GER,FW,Dortmund,de Bundesliga,20-025,2004,0.5,1,1,1,0,0,1,2,50.0,1,0,0,0,0,1,1,0,Matches
192,Lameck Banda,zm ZAM,FW,Lecce,it Serie A,23-040,2001,13.4,26,22,11,12,3,7,21,33.3,14,18,0,18,3,29,6,0,Matches
193,Daniel Bandeira,pt POR,"MF,FW",Hellas Verona,it Serie A,23-333,2000,1.5,2,2,0,1,1,1,1,100.0,0,1,0,1,0,2,2,0,Matches
194,Mamady Bangré,bf BFA,"FW,MF",Toulouse,fr Ligue 1,22-268,2001,1.1,4,2,2,2,0,3,4,75.0,1,0,0,0,4,8,3,0,Matches
195,Mattia Bani,it ITA,DF,Genoa,it Serie A,30-090,1993,20.7,21,9,15,5,1,10,20,50.0,10,43,27,16,17,38,98,1,Matches
196,Léo Baptistão,br BRA,FW,Almería,es La Liga,31-196,1992,13.4,15,8,6,4,5,6,18,33.3,12,7,1,6,6,21,16,0,Matches
197,Shandon Baptiste,gd GRN,MF,Brentford,eng Premier League,25-336,1998,2.4,4,4,2,2,0,1,5,20.0,4,5,1,4,3,7,6,0,Matches
198,Antonín Barák,cz CZE,MF,Fiorentina,it Serie A,29-097,1994,3.3,3,1,1,1,1,2,5,40.0,3,4,0,4,0,3,2,0,Matches
199,Francisco Barbosa,es ESP,GK,Betis,es La Liga,24-307,1999,2.5,0,0,0,0,0,0,0,,0,0,0,0,0,0,2,0,Matches
200,Bradley Barcola,fr FRA,FW,Lyon,fr Ligue 1,21-189,2002,3.0,5,2,0,2,3,1,7,14.3,6,4,0,4,2,7,0,0,Matches
201,Bradley Barcola,fr FRA,"FW,MF",Paris S-G,fr Ligue 1,21-189,2002,10.9,25,12,11,9,5,5,17,29.4,12,20,2,18,8,33,9,1,Matches
202,Melvin Bard,fr FRA,DF,Nice,fr Ligue 1,23-124,2000,23.3,52,28,17,27,8,24,46,52.2,22,39,11,28,34,86,36,0,Matches
203,Nicolò Barella,it ITA,MF,Inter,it Serie A,27-031,1997,22.5,32,19,13,13,6,13,48,27.1,35,17,0,17,6,38,7,0,Matches
204,Kike Barja,es ESP,"FW,MF",Osasuna,es La Liga,26-343,1997,3.4,6,2,2,2,2,3,8,37.5,5,2,1,1,2,8,2,0,Matches
205,Ross Barkley,eng ENG,MF,Luton Town,eng Premier League,30-095,1993,18.8,37,15,13,17,7,7,32,21.9,25,17,6,11,18,55,40,2,Matches
206,Aymen Barkok,ma MAR,"MF,FW",Mainz 05,de Bundesliga,25-293,1998,3.6,9,5,2,6,1,3,6,50.0,3,7,0,7,2,11,1,0,Matches
207,Harvey Barnes,eng ENG,FW,Newcastle Utd,eng Premier League,26-091,1997,4.0,3,1,1,2,0,0,1,0.0,1,0,0,0,2,5,1,0,Matches
208,Leandro Barreiro Martins,lu LUX,MF,Mainz 05,de Bundesliga,24-066,2000,20.5,41,24,11,24,6,15,31,48.4,16,33,12,21,29,70,34,0,Matches
209,Enzo Barrenechea,ar ARG,MF,Frosinone,it Serie A,22-292,2001,21.3,51,33,23,21,7,23,54,42.6,31,31,6,25,24,75,44,2,Matches
210,Ander Barrenetxea,es ESP,"FW,MF",Real Sociedad,es La Liga,22-073,2001,11.0,22,12,3,13,6,7,21,33.3,14,9,1,8,5,27,3,0,Matches
211,Pablo Barrios,es ESP,MF,Atlético Madrid,es La Liga,20-268,2003,12.6,34,18,12,21,1,15,32,46.9,17,18,1,17,22,56,18,2,Matches
212,Davide Bartesaghi,it ITA,"DF,MF",Milan,it Serie A,18-071,2005,0.8,1,0,0,1,0,1,3,33.3,2,1,1,0,0,1,4,0,Matches
213,Marc Bartra,es ESP,DF,Betis,es La Liga,33-054,1991,2.5,4,3,3,1,0,4,5,80.0,1,3,1,2,3,7,10,0,Matches
214,Federico Baschirotto,it ITA,DF,Lecce,it Serie A,27-171,1996,25.6,15,8,11,4,0,4,9,44.4,5,34,22,12,20,35,106,1,Matches
215,Steven Baseya,fr FRA,DF,Strasbourg,fr Ligue 1,19-055,2005,0.1,2,1,1,1,0,1,1,100.0,0,0,0,0,0,2,1,0,Matches
216,Chris Basham,eng ENG,"DF,MF",Sheffield Utd,eng Premier League,35-233,1988,3.6,7,2,4,3,0,2,9,22.2,7,9,4,5,5,12,17,0,Matches
217,Toma Bašić,hr CRO,MF,Salernitana,it Serie A,27-105,1996,6.2,9,6,4,4,1,5,9,55.6,4,13,5,8,8,17,13,0,Matches
218,Calvin Bassey,ng NGA,DF,Fulham,eng Premier League,24-069,1999,14.6,25,15,15,9,1,8,12,66.7,4,19,8,11,21,46,43,3,Matches
219,Alessandro Bastoni,it ITA,DF,Inter,it Serie A,24-331,1999,18.2,32,25,22,7,3,17,30,56.7,13,16,8,8,19,51,35,0,Matches
220,Simone Bastoni,it ITA,"DF,MF",Empoli,it Serie A,27-125,1996,4.1,15,9,9,5,1,9,14,64.3,5,6,0,6,8,23,16,0,Matches
221,Augusto Batalla,ar ARG,GK,Granada,es La Liga,27-314,1996,8.0,0,0,0,0,0,0,1,0.0,1,0,0,0,0,0,0,1,Matches
222,Daniel Batz,de GER,GK,Mainz 05,de Bundesliga,33-057,1991,4.0,0,0,0,0,0,0,0,,0,0,0,0,0,0,3,0,Matches
223,Maximilian Bauer,de GER,DF,Augsburg,de Bundesliga,24-029,2000,6.7,10,6,6,4,0,4,11,36.4,7,9,8,1,9,19,26,1,Matches
224,Elias Baum,de GER,"DF,MF",Eint Frankfurt,de Bundesliga,18-135,2005,0.3,1,0,0,0,1,0,0,,0,3,2,1,0,1,1,0,Matches
225,Oliver Baumann,de GER,GK,Hoffenheim,de Bundesliga,33-281,1990,24.0,1,1,1,0,0,1,1,100.0,0,0,0,0,0,1,11,1,Matches
226,Christoph Baumgartner,at AUT,"MF,FW",RB Leipzig,de Bundesliga,24-221,1999,9.5,23,12,8,11,4,12,28,42.9,16,15,1,14,4,27,10,0,Matches
227,Bebé,cv CPV,"MF,FW",Rayo Vallecano,es La Liga,33-241,1990,1.6,2,2,1,1,0,1,4,25.0,3,1,0,1,0,2,0,0,Matches
228,Ihlas Bebou,tg TOG,"FW,DF",Hoffenheim,de Bundesliga,29-321,1994,12.6,16,8,8,6,2,7,15,46.7,8,8,1,7,8,24,11,0,Matches
229,Mohamed Bechikh,fr FRA,"FW,MF",Strasbourg,fr Ligue 1,18-240,2005,0.2,0,0,0,0,0,0,0,,0,0,0,0,0,0,0,0,Matches
230,Adrian Beck,de GER,"MF,FW",Heidenheim,de Bundesliga,26-274,1997,10.3,20,11,6,12,2,8,22,36.4,14,16,0,16,4,24,14,0,Matches
231,Owen Beck,wls WAL,DF,Liverpool,eng Premier League,21-213,2002,0.1,2,1,1,1,0,0,0,,0,0,0,0,0,2,1,0,Matches
232,Sheraldo Becker,sr SUR,"MF,FW",Real Sociedad,es La Liga,29-029,1995,1.3,0,0,0,0,0,0,0,,0,1,0,1,0,0,0,0,Matches
233,Sheraldo Becker,sr SUR,"FW,MF",Union Berlin,de Bundesliga,29-029,1995,7.2,3,3,0,2,1,0,2,0.0,2,2,0,2,0,3,2,0,Matches
234,Chris Bedia,ci CIV,"FW,MF",Union Berlin,de Bundesliga,28-004,1996,0.5,0,0,0,0,0,0,1,0.0,1,2,0,2,0,0,0,0,Matches
235,Donny van de Beek,nl NED,DF,Manchester Utd,eng Premier League,26-326,1997,0.0,0,0,0,0,0,0,0,,0,1,0,1,0,0,0,0,Matches
236,Donny van de Beek,nl NED,"MF,FW",Eint Frankfurt,de Bundesliga,26-326,1997,3.3,7,3,2,3,2,2,5,40.0,3,5,1,4,2,9,1,0,Matches
237,Yanis Begraoui,ma MAR,"FW,MF",Toulouse,fr Ligue 1,22-249,2001,3.3,5,3,1,3,1,3,9,33.3,6,4,0,4,5,10,5,0,Matches
238,Kevin Behrens,de GER,FW,Wolfsburg,de Bundesliga,33-035,1991,4.3,0,0,0,0,0,0,0,,0,8,0,8,3,3,4,0,Matches
239,Kevin Behrens,de GER,FW,Union Berlin,de Bundesliga,33-035,1991,14.0,13,10,3,7,3,1,4,25.0,3,7,2,5,6,19,19,0,Matches
240,Maximilian Beier,de GER,FW,Hoffenheim,de Bundesliga,21-144,2002,17.9,11,6,4,5,2,3,13,23.1,10,13,0,13,3,14,11,0,Matches
241,Jérémie Bela,ao ANG,"MF,FW",Clermont Foot,fr Ligue 1,30-336,1993,0.6,0,0,0,0,0,0,0,,0,0,0,0,0,0,0,0,Matches
242,Reda Belahyane,fr FRA,MF,Hellas Verona,it Serie A,19-282,2004,0.2,1,1,0,1,0,1,1,100.0,0,0,0,0,0,1,0,0,Matches
243,Reda Belahyane,fr FRA,MF,Nice,fr Ligue 1,19-282,2004,0.3,1,0,0,1,0,1,1,100.0,0,0,0,0,0,1,0,0,Matches
244,Amari'i Bell,jm JAM,DF,Luton Town,eng Premier League,29-309,1994,19.1,50,33,30,19,1,22,35,62.9,13,33,15,18,25,75,60,1,Matches
245,Stefan Bell,de GER,DF,Mainz 05,de Bundesliga,32-198,1991,7.4,8,8,7,1,0,4,8,50.0,4,7,5,2,6,14,30,0,Matches
246,Alaa Bellaarouch,ma MAR,GK,Strasbourg,fr Ligue 1,22-068,2002,5.0,0,0,0,0,0,0,0,,0,0,0,0,1,1,4,2,Matches
247,Raoul Bellanova,it ITA,"DF,MF",Torino,it Serie A,23-297,2000,24.7,25,17,11,12,2,12,19,63.2,7,16,2,14,13,38,26,1,Matches
248,Jean-Ricner Bellegarde,fr FRA,"MF,FW",Wolves,eng Premier League,25-256,1998,8.8,15,9,7,6,2,6,13,46.2,7,17,2,15,7,22,13,0,Matches
249,Jean-Ricner Bellegarde,fr FRA,"MF,FW",Strasbourg,fr Ligue 1,25-256,1998,3.0,5,3,3,2,0,3,6,50.0,3,4,0,4,4,9,0,0,Matches
250,Héctor Bellerín,es ESP,DF,Betis,es La Liga,28-356,1995,16.4,28,19,11,13,4,16,43,37.2,27,11,5,6,19,47,35,1,Matches
251,Jude Bellingham,eng ENG,"MF,FW",Real Madrid,es La Liga,20-254,2003,20.7,31,26,10,15,6,10,25,40.0,15,41,5,36,19,50,12,0,Matches
252,Jeanuël Belocian,fr FRA,DF,Rennes,fr Ligue 1,19-021,2005,12.7,26,16,19,7,0,18,22,81.8,4,13,9,4,12,38,38,0,Matches
253,Andrea Belotti,it ITA,FW,Fiorentina,it Serie A,30-080,1993,5.1,4,1,0,3,1,2,4,50.0,2,4,1,3,0,4,2,0,Matches
254,Andrea Belotti,it ITA,FW,Roma,it Serie A,30-080,1993,7.5,8,4,2,3,3,3,6,50.0,3,7,0,7,2,10,3,0,Matches
255,Fran Beltrán,es ESP,MF,Celta Vigo,es La Liga,25-035,1999,17.1,35,19,13,16,6,17,43,39.5,26,18,0,18,15,50,18,0,Matches
256,Lucas Beltrán,ar ARG,"FW,MF",Fiorentina,it Serie A,22-346,2001,14.7,23,14,3,16,4,10,17,58.8,7,24,3,21,1,24,10,0,Matches
257,Eliesse Ben Seghir,fr FRA,"FW,MF",Monaco,fr Ligue 1,19-022,2005,1.7,3,2,0,2,1,2,5,40.0,3,3,0,3,0,3,0,0,Matches
258,Anis Ben Slimane,tn TUN,MF,Sheffield Utd,eng Premier League,22-359,2001,4.1,8,5,3,1,4,3,8,37.5,5,5,1,4,4,12,6,0,Matches
259,Wissam Ben Yedder,fr FRA,"FW,MF",Monaco,fr Ligue 1,33-210,1990,17.1,3,3,0,2,1,0,8,0.0,8,11,0,11,6,9,1,0,Matches
260,Carlos Benavídez,uy URU,MF,Alavés,es La Liga,25-345,1998,7.3,32,19,11,15,6,11,19,57.9,8,7,4,3,14,46,19,0,Matches
261,Ismaël Bennacer,dz ALG,MF,Milan,it Serie A,26-099,1997,5.4,12,7,4,8,0,7,13,53.8,6,5,0,5,4,16,4,1,Matches
262,Saïd Benrahma,dz ALG,"FW,MF",West Ham,eng Premier League,28-212,1995,6.9,8,4,5,3,0,4,15,26.7,11,8,0,8,5,13,7,0,Matches
263,Saïd Benrahma,dz ALG,"FW,MF",Lyon,fr Ligue 1,28-212,1995,2.8,7,6,1,5,1,3,4,75.0,1,3,0,3,0,7,0,0,Matches
264,Ramy Bensebaini,dz ALG,DF,Dortmund,de Bundesliga,28-328,1995,11.3,33,20,20,11,2,23,33,69.7,10,22,7,15,16,49,37,0,Matches
265,Nabil Bentaleb,dz ALG,MF,Lille,fr Ligue 1,29-106,1994,13.2,33,24,17,14,2,14,27,51.9,13,28,9,19,24,57,19,0,Matches
266,Rodrigo Bentancur,uy URU,MF,Tottenham,eng Premier League,26-258,1997,5.4,11,6,7,2,2,5,12,41.7,7,7,2,5,5,16,11,0,Matches
267,Daniel Bentley,eng ENG,GK,Wolves,eng Premier League,30-240,1993,3.3,0,0,0,0,0,0,0,,0,0,0,0,0,0,1,0,Matches
268,Lucas Beraldo,br BRA,DF,Paris S-G,fr Ligue 1,20-106,2003,5.2,15,8,10,5,0,6,18,33.3,12,11,4,7,7,22,9,0,Matches
269,Domenico Berardi,it ITA,FW,Sassuolo,it Serie A,29-221,1994,15.9,17,8,7,9,1,2,21,9.5,19,17,0,17,13,30,9,0,Matches
270,Yuri Berchiche,es ESP,DF,Athletic Club,es La Liga,34-028,1990,15.8,23,18,10,10,3,14,24,58.3,10,18,5,13,16,39,45,0,Matches
271,Álex Berenguer,es ESP,FW,Athletic Club,es La Liga,28-249,1995,12.1,14,9,5,6,3,3,16,18.8,13,20,0,20,4,18,10,0,Matches
272,Bartosz Bereszyński,pl POL,DF,Empoli,it Serie A,31-241,1992,9.7,21,11,12,7,2,11,18,61.1,7,7,3,4,9,30,24,0,Matches
273,Jóhann Berg Guðmundsson,is ISL,MF,Burnley,eng Premier League,33-134,1990,11.7,13,4,6,5,2,7,15,46.7,8,13,0,13,14,27,14,0,Matches
274,Sander Berge,no NOR,MF,Burnley,eng Premier League,26-024,1998,22.4,53,30,25,25,3,25,44,56.8,19,35,15,20,18,71,46,1,Matches
275,Etrit Berisha,al ALB,GK,Empoli,it Serie A,34-365,1989,14.0,0,0,0,0,0,0,1,0.0,1,0,0,0,0,0,7,1,Matches
276,Medon Berisha,al ALB,MF,Lecce,it Serie A,20-140,2003,0.1,1,0,1,0,0,0,0,,0,0,0,0,0,1,0,0,Matches
277,Mergim Berisha,de GER,FW,Hoffenheim,de Bundesliga,25-303,1998,1.6,0,0,0,0,0,0,0,,0,2,1,1,0,0,0,0,Matches
278,Mergim Berisha,de GER,FW,Augsburg,de Bundesliga,25-303,1998,1.4,0,0,0,0,0,0,0,,0,1,0,1,0,0,3,0,Matches
279,Isaac Bernal,es ESP,FW,Sevilla,es La Liga,23-296,2000,6.7,,0,,,,,,,,,,,0,,,,Matches
280,Bernardo,br BRA,DF,Bochum,de Bundesliga,28-300,1995,23.0,71,45,44,23,4,29,48,60.4,19,49,19,30,39,110,91,1,Matches
281,Victor Bernth Kristiansen,dk DEN,DF,Bologna,it Serie A,21-084,2002,17.7,31,20,14,14,3,10,22,45.5,12,29,6,23,9,40,34,0,Matches
282,Matúš Bero,sk SVK,"MF,FW",Bochum,de Bundesliga,28-185,1995,13.2,22,14,11,6,5,9,23,39.1,14,19,1,18,7,29,12,0,Matches
283,Luke Berry,eng ENG,"MF,DF",Luton Town,eng Premier League,31-241,1992,0.6,0,0,0,0,0,0,0,,0,1,0,1,0,0,0,0,Matches
284,Jan-Niklas Beste,de GER,"FW,MF",Heidenheim,de Bundesliga,25-065,1999,19.3,45,24,16,17,12,15,34,44.1,19,33,1,32,14,59,20,0,Matches
285,Beto,gw GNB,FW,Everton,eng Premier League,26-038,1998,7.6,11,5,1,6,4,3,10,30.0,7,9,0,9,0,11,10,0,Matches
286,Beto,gw GNB,FW,Udinese,it Serie A,26-038,1998,0.8,1,0,0,0,1,0,0,,0,0,0,0,0,1,0,0,Matches
287,Davide Bettella,it ITA,MF,Monza,it Serie A,23-337,2000,0.0,0,0,0,0,0,0,0,,0,0,0,0,0,0,0,0,Matches
288,Sam Beukema,nl NED,DF,Bologna,it Serie A,25-113,1998,22.6,25,10,13,11,1,16,23,69.6,7,27,16,11,14,39,77,0,Matches
289,Jordan Beyer,de GER,DF,Burnley,eng Premier League,23-295,2000,13.7,35,20,22,12,1,14,24,58.3,10,22,15,7,16,51,68,1,Matches
290,Pep Biel,es ESP,MF,Augsburg,de Bundesliga,27-186,1996,1.4,2,2,0,0,2,0,1,0.0,1,1,0,1,0,2,1,0,Matches
291,Jaka Bijol,si SVN,DF,Udinese,it Serie A,25-033,1999,13.0,26,16,22,4,0,13,23,56.5,10,17,11,6,14,40,68,1,Matches
292,El Bilal Touré,ml MLI,FW,Atalanta,it Serie A,22-158,2001,0.6,0,0,0,0,0,0,0,,0,0,0,0,0,0,1,0,Matches
293,Philip Billing,dk DEN,MF,Bournemouth,eng Premier League,27-272,1996,13.6,27,13,4,19,4,8,23,34.8,15,27,5,22,16,43,26,1,Matches
294,Cristiano Biraghi,it ITA,DF,Fiorentina,it Serie A,31-190,1992,20.2,38,24,14,21,3,25,46,54.3,21,24,4,20,12,50,32,0,Matches
295,Davide Biraschi,it ITA,DF,Genoa,it Serie A,29-251,1994,1.0,3,3,1,2,0,1,3,33.3,2,0,0,0,2,5,5,0,Matches
296,Samuele Birindelli,it ITA,DF,Monza,it Serie A,24-234,1999,12.9,18,12,10,5,3,9,15,60.0,6,22,7,15,13,31,25,0,Matches
297,Tom Bischof,de GER,"MF,FW",Hoffenheim,de Bundesliga,18-255,2005,1.7,7,4,5,1,1,1,8,12.5,7,1,0,1,1,8,2,0,Matches
298,Yves Bissouma,ml MLI,MF,Tottenham,eng Premier League,27-192,1996,15.5,57,36,23,26,8,31,44,70.5,13,22,4,18,27,84,31,2,Matches
299,Leonardo Bittencourt,de GER,MF,Werder Bremen,de Bundesliga,30-081,1993,10.0,25,13,14,9,2,8,24,33.3,16,14,1,13,8,33,4,0,Matches
300,Marco Bizot,nl NED,GK,Brest,fr Ligue 1,32-365,1991,22.0,0,0,0,0,0,0,0,,0,0,0,0,0,0,13,1,Matches
301,Antonio Blanco,es ESP,MF,Alavés,es La Liga,23-230,2000,18.5,45,27,23,19,3,23,60,38.3,37,17,1,16,23,68,21,0,Matches
302,Rubén Blanco,es ESP,GK,Marseille,fr Ligue 1,28-228,1995,1.3,0,0,0,0,0,0,0,,0,0,0,0,0,0,0,0,Matches
303,Hendry Blank,de GER,DF,Dortmund,de Bundesliga,19-201,2004,0.5,1,0,1,0,0,1,1,100.0,0,1,0,1,0,1,4,0,Matches
304,Ludovic Blas,fr FRA,"FW,MF",Rennes,fr Ligue 1,26-069,1997,13.9,21,9,10,10,1,10,25,40.0,15,13,1,12,5,26,6,0,Matches
305,Janis Blaswich,de GER,GK,RB Leipzig,de Bundesliga,32-312,1991,20.0,1,1,1,0,0,0,0,,0,0,0,0,0,1,6,3,Matches
306,Alexis Blin,fr FRA,"MF,DF",Lecce,it Serie A,27-175,1996,9.4,18,10,7,11,0,10,24,41.7,14,9,1,8,17,35,21,0,Matches
307,Daley Blind,nl NED,DF,Girona,es La Liga,34-000,1990,22.0,32,13,20,11,1,19,31,61.3,12,30,13,17,15,47,84,0,Matches
308,Myron Boadu,nl NED,FW,Monaco,fr Ligue 1,23-055,2001,0.9,2,2,0,1,1,1,2,50.0,1,2,0,2,0,2,0,0,Matches
309,Benicio Boaitey,eng ENG,"DF,FW",Brighton,eng Premier League,20-060,2004,0.2,0,0,0,0,0,0,0,,0,0,0,0,0,0,2,0,Matches
310,Jérôme Boateng,de GER,DF,Salernitana,it Serie A,35-188,1988,1.9,0,0,0,0,0,0,0,,0,4,3,1,2,2,17,0,Matches
311,Oscar Bobb,no NOR,"FW,MF",Manchester City,eng Premier League,20-241,2003,2.0,3,0,1,0,2,1,2,50.0,1,3,0,3,1,4,1,0,Matches
312,Sacha Boey,fr FRA,DF,Bayern Munich,de Bundesliga,23-178,2000,1.2,2,0,2,0,0,1,2,50.0,1,1,0,1,1,3,2,0,Matches
313,Jeremie Boga,ci CIV,"FW,MF",Nice,fr Ligue 1,27-066,1997,14.1,8,4,1,7,0,5,12,41.7,7,21,1,20,3,11,2,0,Matches
314,Jayden Bogle,eng ENG,DF,Sheffield Utd,eng Premier League,23-226,2000,20.5,47,27,33,12,2,24,52,46.2,28,32,10,22,27,74,73,0,Matches
315,Emil Bohinen,no NOR,FW,Genoa,it Serie A,24-363,1999,0.0,0,0,0,0,0,0,0,,0,0,0,0,0,0,1,0,Matches
316,Emil Bohinen,no NOR,MF,Salernitana,it Serie A,24-363,1999,5.9,8,6,5,3,0,2,10,20.0,8,8,2,6,14,22,6,1,Matches
317,Adama Bojang,gm GAM,FW,Reims,fr Ligue 1,19-286,2004,0.4,1,0,0,0,1,0,0,,0,1,0,1,1,2,0,0,Matches
318,Daniel Boloca,ro ROU,MF,Sassuolo,it Serie A,25-078,1998,18.5,40,28,13,23,4,22,35,62.9,13,19,10,9,13,53,24,2,Matches
319,Willy Boly,ci CIV,DF,Nott'ham Forest,eng Premier League,33-035,1991,11.1,30,18,26,4,0,13,23,56.5,10,19,14,5,20,50,68,0,Matches
320,Giacomo Bonaventura,it ITA,MF,Fiorentina,it Serie A,34-200,1989,20.2,23,12,5,8,10,7,15,46.7,8,15,0,15,8,31,5,0,Matches
321,Federico Bonazzoli,it ITA,"FW,MF",Hellas Verona,it Serie A,26-293,1997,7.5,1,0,0,1,0,0,6,0.0,6,6,1,5,2,3,1,0,Matches
322,Warren Bondo,fr FRA,MF,Monza,it Serie A,20-176,2003,8.1,13,9,6,6,1,6,7,85.7,1,6,1,5,6,19,6,0,Matches
323,Giovanni Bonfanti,it ITA,DF,Atalanta,it Serie A,21-052,2003,0.2,0,0,0,0,0,0,0,,0,0,0,0,0,0,1,0,Matches
324,Victor Boniface,ng NGA,FW,Leverkusen,de Bundesliga,23-077,2000,14.2,6,4,0,1,5,1,4,25.0,3,5,0,5,0,6,10,0,Matches
325,Kevin Bonifazi,it ITA,DF,Bologna,it Serie A,27-295,1996,1.0,4,0,0,4,0,1,2,50.0,1,0,0,0,0,4,7,1,Matches
326,Kevin Bonifazi,it ITA,DF,Frosinone,it Serie A,27-295,1996,1.0,3,2,0,3,0,0,1,0.0,1,1,0,1,1,4,6,0,Matches
327,Leonardo Bonucci,it ITA,DF,Union Berlin,de Bundesliga,36-313,1987,5.1,6,5,2,4,0,4,4,100.0,0,5,3,2,7,13,16,0,Matches
328,Ângelo Borges,br BRA,"FW,MF",Strasbourg,fr Ligue 1,19-079,2004,12.2,24,11,9,7,8,11,31,35.5,20,18,0,18,9,33,2,0,Matches
329,Neto Borges,br BRA,DF,Clermont Foot,fr Ligue 1,27-178,1996,19.0,32,17,15,13,4,18,44,40.9,26,17,3,14,41,73,54,0,Matches
330,Yvandro Borges Sanches,lu LUX,"MF,FW",M'Gladbach,de Bundesliga,19-290,2004,0.2,0,0,0,0,0,0,0,,0,0,0,0,0,0,0,0,Matches
331,Sebastiaan Bornauw,be BEL,DF,Wolfsburg,de Bundesliga,24-353,1999,8.2,14,4,11,3,0,9,13,69.2,4,14,8,6,12,26,41,0,Matches
332,Rafael Borré,co COL,FW,Werder Bremen,de Bundesliga,28-176,1995,11.0,10,7,2,4,4,5,16,31.3,11,8,2,6,2,12,10,0,Matches
333,Gennaro Borrelli,it ITA,FW,Frosinone,it Serie A,23-365,2000,0.3,0,0,0,0,0,0,0,,0,0,0,0,0,0,0,0,Matches
334,Adri Bosch,es ESP,DF,Granada,es La Liga,22-274,2001,0.3,1,1,1,0,0,0,0,,0,0,0,0,0,1,1,0,Matches
335,Erik Botheim,no NOR,"FW,MF",Salernitana,it Serie A,24-059,2000,3.5,2,0,2,0,0,0,1,0.0,1,3,0,3,0,2,2,0,Matches
336,Sven Botman,nl NED,DF,Newcastle Utd,eng Premier League,24-057,2000,14.3,19,13,13,6,0,8,12,66.7,4,18,16,2,7,26,55,3,Matches
337,Ayyoub Bouaddi,fr FRA,MF,Lille,fr Ligue 1,16-159,2007,1.0,6,2,6,0,0,2,5,40.0,3,2,0,2,1,7,2,0,Matches
338,Badredine Bouanani,dz ALG,FW,Nice,fr Ligue 1,19-092,2004,1.8,3,2,1,1,1,3,4,75.0,1,5,0,5,3,6,0,0,Matches
339,Badredine Bouanani,dz ALG,MF,Lorient,fr Ligue 1,19-092,2004,0.4,0,0,0,0,0,0,0,,0,0,0,0,1,1,1,0,Matches
340,Hicham Boudaoui,dz ALG,MF,Nice,fr Ligue 1,24-168,1999,13.3,31,15,11,17,3,15,21,71.4,6,11,0,11,8,39,12,0,Matches
341,Yassine Bounou,ma MAR,GK,Sevilla,es La Liga,32-339,1991,1.0,0,0,0,0,0,0,0,,0,0,0,0,0,0,0,0,Matches
342,Mehdi Bourabia,ma MAR,MF,Frosinone,it Serie A,32-215,1991,2.2,5,4,1,4,0,2,4,50.0,2,3,0,3,0,5,4,0,Matches
343,Benjamin Bourigeaud,fr FRA,"MF,DF",Rennes,fr Ligue 1,30-055,1994,18.8,24,14,12,6,6,10,31,32.3,21,24,2,22,17,41,25,1,Matches
344,Bilal Boutobba,fr FRA,"FW,MF",Clermont Foot,fr Ligue 1,25-193,1998,9.0,18,11,6,7,5,8,21,38.1,13,9,0,9,7,25,2,0,Matches
345,Hugo Boutsingkham,fr FRA,"MF,FW",Nantes,fr Ligue 1,21-049,2003,0.1,0,0,0,0,0,0,0,,0,0,0,0,0,0,1,0,Matches
346,Edoardo Bove,it ITA,MF,Roma,it Serie A,21-298,2002,15.6,48,26,11,27,10,24,39,61.5,15,21,1,20,6,54,10,1,Matches
347,Jarrod Bowen,eng ENG,FW,West Ham,eng Premier League,27-080,1996,26.0,30,18,12,8,10,10,26,38.5,16,29,5,24,16,46,12,0,Matches
348,Lucas Boyé,ar ARG,FW,Granada,es La Liga,28-010,1996,16.9,36,19,9,19,8,10,22,45.5,12,23,3,20,5,41,30,0,Matches
349,Domagoj Bradarić,hr CRO,DF,Salernitana,it Serie A,24-090,1999,22.7,28,19,12,10,6,14,21,66.7,7,17,4,13,25,53,48,1,Matches
350,Conor Bradley,nir NIR,DF,Liverpool,eng Premier League,20-244,2003,4.2,15,12,8,5,2,10,17,58.8,7,8,0,8,3,18,7,0,Matches
351,Bilal Brahimi,dz ALG,FW,Nice,fr Ligue 1,23-361,2000,0.1,0,0,0,0,0,0,1,0.0,1,0,0,0,0,0,0,0,Matches
352,Bilal Brahimi,dz ALG,"FW,MF",Brest,fr Ligue 1,23-361,2000,2.2,0,0,0,0,0,0,3,0.0,3,2,0,2,0,0,0,0,Matches
353,Juan Brandáriz,es ESP,DF,Almería,es La Liga,25-007,1999,18.5,27,17,18,9,0,14,19,73.7,5,27,18,9,11,38,69,0,Matches
354,Julian Brandt,de GER,"MF,FW",Dortmund,de Bundesliga,27-312,1996,17.8,13,11,7,6,0,7,21,33.3,14,13,2,11,8,21,14,0,Matches
355,Jarrad Branthwaite,eng ENG,DF,Everton,eng Premier League,21-256,2002,24.0,48,25,31,16,1,33,40,82.5,7,31,22,9,41,89,107,1,Matches
356,Darko Brašanac,rs SRB,MF,Osasuna,es La Liga,32-026,1992,0.5,1,0,1,0,0,1,1,100.0,0,1,0,1,0,1,0,0,Matches
357,Lilian Brassier,fr FRA,DF,Brest,fr Ligue 1,24-128,1999,20.7,24,14,14,10,0,11,17,64.7,6,18,14,4,33,57,62,0,Matches
358,Claudio Bravo,cl CHI,GK,Betis,es La Liga,40-331,1983,7.0,0,0,0,0,0,0,1,0.0,1,0,0,0,0,0,2,0,Matches
359,Fabian Bredlow,de GER,GK,Stuttgart,de Bundesliga,29-007,1995,3.0,0,0,0,0,0,0,1,0.0,1,0,0,0,0,0,2,0,Matches
360,Tim Breithaupt,de GER,MF,Augsburg,de Bundesliga,22-031,2002,2.9,5,3,4,1,0,4,6,66.7,2,4,2,2,1,6,5,0,Matches
361,Josip Brekalo,hr CRO,FW,Fiorentina,it Serie A,25-260,1998,7.2,8,6,6,2,0,2,11,18.2,9,7,0,7,1,9,0,0,Matches
362,Gleison Bremer,br BRA,DF,Juventus,it Serie A,26-357,1997,25.9,42,29,24,15,3,17,24,70.8,7,29,18,11,30,72,106,0,Matches
363,Brenner,br BRA,FW,Udinese,it Serie A,24-053,2000,0.4,3,3,0,2,1,1,1,100.0,0,2,0,2,0,3,1,0,Matches
364,Ben Brereton,cl CHI,MF,Sheffield Utd,eng Premier League,24-326,1999,1.9,1,1,0,1,0,0,1,0.0,1,0,0,0,0,1,2,0,Matches
365,Ben Brereton,cl CHI,"FW,MF",Villarreal,es La Liga,24-326,1999,3.0,2,2,1,0,1,0,2,0.0,2,0,0,0,0,2,0,0,Matches
366,Marco Brescianini,it ITA,"MF,DF",Frosinone,it Serie A,24-049,2000,16.2,21,10,9,10,2,6,20,30.0,14,17,4,13,7,28,29,0,Matches
367,Maximilian Breunig,de GER,FW,Freiburg,de Bundesliga,23-208,2000,0.1,0,0,0,0,0,0,0,,0,1,0,1,0,0,0,0,Matches
368,Rhian Brewster,eng ENG,"FW,MF",Sheffield Utd,eng Premier League,23-343,2000,3.4,5,1,1,2,2,0,2,0.0,2,2,0,2,0,5,2,0,Matches
369,Armando Broja,al ALB,FW,Chelsea,eng Premier League,22-181,2001,5.0,3,0,0,1,2,1,2,50.0,1,5,1,4,0,3,3,0,Matches
370,Armando Broja,al ALB,FW,Fulham,eng Premier League,22-181,2001,0.4,0,0,0,0,0,0,0,,0,1,0,1,0,0,0,0,Matches
371,Dylan Bronn,tn TUN,"DF,MF",Salernitana,it Serie A,28-264,1995,0.6,0,0,0,0,0,0,1,0.0,1,2,0,2,0,0,4,0,Matches
372,Andre Brooks,eng ENG,"MF,DF",Sheffield Utd,eng Premier League,20-202,2003,7.2,10,7,2,7,1,5,14,35.7,9,11,1,10,9,19,14,0,Matches
373,David Brooks,wls WAL,"FW,MF",Bournemouth,eng Premier League,26-245,1997,3.1,5,4,2,1,2,2,4,50.0,2,3,0,3,2,7,2,0,Matches
374,John Brooks,us USA,DF,Hoffenheim,de Bundesliga,31-041,1993,16.0,26,13,17,8,1,13,28,46.4,15,28,17,11,26,52,102,1,Matches
375,Moritz Broschinski,de GER,"FW,MF",Bochum,de Bundesliga,23-168,2000,9.0,9,5,1,4,4,1,4,25.0,3,8,2,6,0,9,6,0,Matches
376,Jacob Brown,sct SCO,"MF,FW",Luton Town,eng Premier League,25-334,1998,11.3,19,12,7,7,5,7,18,38.9,11,20,1,19,8,27,22,0,Matches
377,Josh Brownhill,eng ENG,MF,Burnley,eng Premier League,28-081,1995,22.0,47,31,17,21,9,20,28,71.4,8,28,7,21,29,76,32,1,Matches
378,Alexander Brunst,de GER,GK,Darmstadt 98,de Bundesliga,28-246,1995,1.0,0,0,0,0,0,0,0,,0,0,0,0,0,0,0,0,Matches
379,Jacob Bruun Larsen,dk DEN,"MF,FW",Burnley,eng Premier League,25-172,1998,6.1,4,2,2,0,2,3,7,42.9,4,5,0,5,3,7,6,0,Matches
380,Tajon Buchanan,ca CAN,DF,Inter,it Serie A,25-030,1999,0.3,0,0,0,0,0,0,0,,0,0,0,0,0,0,0,0,Matches
381,Ante Budimir,hr CRO,FW,Osasuna,es La Liga,32-231,1991,22.8,18,13,2,11,5,3,11,27.3,8,13,5,8,4,22,15,0,Matches
382,Hugo Bueno,es ESP,"DF,MF",Wolves,eng Premier League,21-173,2002,4.8,17,11,9,6,2,8,13,61.5,5,9,1,8,4,21,15,0,Matches
383,Santiago Bueno,uy URU,DF,Wolves,eng Premier League,25-121,1998,2.2,4,2,1,3,0,2,3,66.7,1,6,2,4,2,6,16,0,Matches
384,Marius Bülter,de GER,"FW,DF",Hoffenheim,de Bundesliga,30-346,1993,11.2,13,7,7,5,1,8,18,44.4,10,13,0,13,9,22,19,0,Matches
385,Facundo Buonanotte,ar ARG,"MF,FW",Brighton,eng Premier League,19-077,2004,10.5,31,16,8,18,5,10,28,35.7,18,18,3,15,5,36,4,0,Matches
386,Alessandro Buongiorno,it ITA,DF,Torino,it Serie A,24-277,1999,19.3,50,30,31,16,3,16,26,61.5,10,16,11,5,46,96,97,0,Matches
387,Jonathan Burkardt,de GER,"FW,MF",Mainz 05,de Bundesliga,23-242,2000,7.6,5,3,1,4,0,1,5,20.0,4,8,2,6,3,8,1,0,Matches
388,Oliver Burke,sct SCO,FW,Werder Bremen,de Bundesliga,26-337,1997,0.4,0,0,0,0,0,0,2,0.0,2,0,0,0,0,0,0,0,Matches
389,Reece Burke,eng ENG,DF,Luton Town,eng Premier League,27-189,1996,9.5,16,10,8,5,3,5,13,38.5,8,10,6,4,10,26,43,0,Matches
390,Dan Burn,eng ENG,DF,Newcastle Utd,eng Premier League,31-305,1992,19.5,44,22,26,17,1,18,47,38.3,29,32,11,21,26,70,80,1,Matches
391,Rareș-Cătălin Burnete,ro ROU,FW,Lecce,it Serie A,20-038,2004,0.1,0,0,0,0,0,0,0,,0,0,0,0,0,0,0,0,Matches
392,Mason Burstow,eng ENG,FW,Chelsea,eng Premier League,20-218,2003,0.1,0,0,0,0,0,0,0,,0,0,0,0,0,0,0,0,Matches
393,Marnon Busch,de GER,DF,Heidenheim,de Bundesliga,29-092,1994,5.3,10,8,5,3,2,6,11,54.5,5,8,1,7,8,18,9,0,Matches
394,Maxime Busi,be BEL,"FW,DF",Reims,fr Ligue 1,24-147,1999,1.3,1,0,0,1,0,0,2,0.0,2,4,0,4,2,3,1,0,Matches
395,Pablo Busto,es ESP,DF,Betis,es La Liga,18-176,2005,0.5,1,1,0,0,1,1,1,100.0,0,0,0,0,1,2,3,0,Matches
396,Aurélio Buta,pt POR,"DF,MF",Eint Frankfurt,de Bundesliga,27-028,1997,15.1,33,21,15,14,4,17,29,58.6,12,22,5,17,12,45,31,0,Matches
397,Marcin Bułka,pl POL,GK,Nice,fr Ligue 1,24-157,1999,25.0,0,0,0,0,0,0,0,,0,0,0,0,0,0,7,3,Matches
398,Jamie Bynoe-Gittens,eng ENG,"FW,MF",Dortmund,de Bundesliga,19-214,2004,7.3,9,5,4,4,1,2,12,16.7,10,7,2,5,4,13,7,0,Matches
399,Juan Cabal,co COL,DF,Hellas Verona,it Serie A,23-061,2001,7.5,16,10,10,5,1,9,12,75.0,3,13,3,10,5,21,23,1,Matches
400,Rémy Cabella,fr FRA,"FW,MF",Lille,fr Ligue 1,34-001,1990,12.3,41,27,14,15,12,15,37,40.5,22,21,0,21,4,45,3,0,Matches
401,Jovane Cabral,cv CPV,"MF,FW",Salernitana,it Serie A,25-269,1998,7.5,13,9,4,7,2,3,9,33.3,6,3,0,3,1,14,4,0,Matches
402,Liberato Cacace,nz NZL,DF,Empoli,it Serie A,23-164,2000,17.6,33,19,21,9,3,21,32,65.6,11,14,3,11,14,47,45,0,Matches
403,Anthony Caci,fr FRA,DF,Mainz 05,de Bundesliga,26-252,1997,19.7,41,16,22,19,0,20,32,62.5,12,26,5,21,23,64,36,0,Matches
404,Moisés Caicedo,ec ECU,MF,Chelsea,eng Premier League,22-128,2001,20.6,55,30,25,23,7,20,37,54.1,17,32,15,17,17,72,29,2,Matches
405,Tom Cairney,sct SCO,MF,Fulham,eng Premier League,33-049,1991,13.5,21,13,10,9,2,11,23,47.8,12,14,3,11,13,34,5,0,Matches
406,Jens Cajuste,se SWE,MF,Napoli,it Serie A,24-212,1999,6.6,24,16,10,12,2,15,23,65.2,8,10,2,8,2,26,10,0,Matches
407,Davide Calabria,it ITA,DF,Milan,it Serie A,27-094,1996,18.3,47,23,27,16,4,31,53,58.5,22,20,4,16,21,68,40,0,Matches
408,Riccardo Calafiori,it ITA,DF,Bologna,it Serie A,21-295,2002,19.4,29,22,19,7,3,11,19,57.9,8,30,11,19,39,68,52,2,Matches
409,Luca Caldirola,it ITA,DF,Monza,it Serie A,33-037,1991,21.6,23,13,18,3,2,12,21,57.1,9,26,17,9,27,50,47,0,Matches
410,Duje Ćaleta-Car,hr CRO,DF,Lyon,fr Ligue 1,27-174,1996,13.1,14,5,12,2,0,9,10,90.0,1,15,8,7,8,22,51,1,Matches
411,Hakan Çalhanoğlu,tr TUR,MF,Inter,it Serie A,30-030,1994,20.7,44,23,19,19,6,22,37,59.5,15,19,8,11,12,56,16,0,Matches
412,José Callejón,es ESP,"MF,FW",Granada,es La Liga,37-027,1987,7.1,9,4,6,3,0,6,16,37.5,10,4,1,3,1,10,10,0,Matches
413,Dominic Calvert-Lewin,eng ENG,FW,Everton,eng Premier League,26-359,1997,17.3,9,3,1,5,3,2,11,18.2,9,11,3,8,3,12,25,0,Matches
414,Lamine Camara,sn SEN,MF,Metz,fr Ligue 1,20-068,2004,17.9,48,33,20,23,5,19,39,48.7,20,29,1,28,22,70,25,0,Matches
415,Mahdi Camara,fr FRA,MF,Brest,fr Ligue 1,25-253,1998,15.7,39,27,6,28,5,17,37,45.9,20,19,0,19,19,58,12,0,Matches
416,Mohamed Camara,ml MLI,MF,Monaco,fr Ligue 1,24-063,2000,9.3,27,14,8,15,4,11,22,50.0,11,7,2,5,10,37,5,0,Matches
417,Francesco Camarda,it ITA,FW,Milan,it Serie A,15-365,2008,0.2,0,0,0,0,0,0,2,0.0,2,0,0,0,0,0,0,0,Matches
418,Eduardo Camavinga,fr FRA,"MF,DF",Real Madrid,es La Liga,21-120,2002,13.4,50,30,22,23,5,16,25,64.0,9,24,4,20,19,69,16,1,Matches
419,Nicolò Cambiaghi,it ITA,"FW,MF",Empoli,it Serie A,23-072,2000,21.2,37,27,14,12,11,13,29,44.8,16,22,1,21,11,48,5,0,Matches
420,Andrea Cambiaso,it ITA,"DF,FW",Juventus,it Serie A,24-018,2000,17.7,28,20,16,8,4,17,31,54.8,14,20,1,19,9,37,19,0,Matches
421,Axel Camblan,fr FRA,FW,Brest,fr Ligue 1,20-192,2003,1.0,3,1,0,2,1,2,4,50.0,2,2,0,2,0,3,0,0,Matches
422,Sergio Camello,es ESP,FW,Rayo Vallecano,es La Liga,23-028,2001,12.2,11,4,2,7,2,3,6,50.0,3,6,1,5,1,12,10,0,Matches
423,José Campaña,es ESP,MF,Las Palmas,es La Liga,30-283,1993,0.5,0,0,0,0,0,0,0,,0,2,1,1,0,0,0,0,Matches
424,Emre Can,de GER,"MF,DF",Dortmund,de Bundesliga,30-057,1994,15.9,48,34,30,15,3,22,33,66.7,11,23,6,17,18,66,33,2,Matches
425,Matteo Cancellieri,it ITA,"FW,MF",Empoli,it Serie A,22-026,2002,15.2,30,19,10,15,5,12,27,44.4,15,16,0,16,6,36,18,0,Matches
426,João Cancelo,pt POR,DF,Barcelona,es La Liga,29-287,1994,20.8,50,34,23,19,8,33,48,68.8,15,26,6,20,20,70,48,1,Matches
427,Fali Candé,gw GNB,DF,Metz,fr Ligue 1,26-045,1998,14.5,27,17,22,5,0,12,22,54.5,10,26,19,7,15,42,78,0,Matches
428,Antonio Candreva,it ITA,"MF,FW",Salernitana,it Serie A,37-010,1987,23.7,15,12,7,6,2,9,22,40.9,13,6,0,6,5,20,21,0,Matches
429,Thomas Cannon,ie IRL,FW,Everton,eng Premier League,21-072,2002,0.0,0,0,0,0,0,0,0,,0,0,0,0,0,0,0,0,Matches
430,Sergi Canós,es ESP,"MF,FW",Valencia,es La Liga,27-036,1997,7.9,15,8,5,6,4,3,11,27.3,8,9,1,8,7,22,4,0,Matches
431,Luigi Canotto,it ITA,FW,Frosinone,it Serie A,29-295,1994,0.2,0,0,0,0,0,0,0,,0,0,0,0,0,0,0,0,Matches
432,Gino Caoki,fr FRA,MF,Lorient,fr Ligue 1,19-236,2004,0.1,0,0,0,0,0,0,1,0.0,1,0,0,0,0,0,0,0,Matches
433,Étienne Capoue,fr FRA,MF,Villarreal,es La Liga,35-242,1988,14.6,27,16,14,10,3,14,21,66.7,7,19,4,15,21,48,24,1,Matches
434,Gianluca Caprari,it ITA,"MF,FW",Monza,it Serie A,30-223,1993,2.8,2,1,1,1,0,0,1,0.0,1,0,0,0,2,4,0,0,Matches
435,Elia Caprile,it ITA,GK,Empoli,it Serie A,22-197,2001,12.0,1,0,1,0,0,1,1,100.0,0,0,0,0,0,1,8,2,Matches
436,Francesco Caputo,it ITA,FW,Empoli,it Serie A,36-216,1987,12.2,2,0,0,0,2,0,1,0.0,1,4,0,4,1,3,2,0,Matches
437,Maxence Caqueret,fr FRA,MF,Lyon,fr Ligue 1,24-023,2000,23.6,62,44,24,27,11,24,68,35.3,44,28,6,22,36,98,18,1,Matches
438,Andrea Carboni,it ITA,DF,Monza,it Serie A,23-034,2001,13.2,31,17,20,10,1,15,23,65.2,8,18,12,6,11,42,42,1,Matches
439,Valentin Carboni,ar ARG,MF,Monza,it Serie A,19-004,2005,8.8,12,6,6,5,1,7,17,41.2,10,9,1,8,5,17,3,0,Matches
440,Isaac Carcelen,es ESP,DF,Cádiz,es La Liga,30-321,1993,22.3,39,24,26,12,1,18,33,54.5,15,20,6,14,22,61,75,2,Matches
441,Irvin Cardona,fr FRA,"MF,DF",Augsburg,de Bundesliga,26-214,1997,0.6,1,1,0,0,1,1,3,33.3,2,1,0,1,0,1,1,0,Matches
442,Marc Cardona,es ESP,FW,Las Palmas,es La Liga,28-245,1995,5.9,6,5,3,1,2,1,8,12.5,7,5,0,5,1,7,7,0,Matches
443,Sergi Cardona,es ESP,DF,Las Palmas,es La Liga,24-245,1999,24.1,72,44,41,24,7,46,79,58.2,33,34,7,27,38,110,82,0,Matches
444,Johnny Cardoso,us USA,MF,Betis,es La Liga,22-171,2001,6.8,21,14,10,8,3,9,14,64.3,5,10,4,6,18,39,18,0,Matches
445,Igor Carioca,br BRA,"DF,MF",Lorient,fr Ligue 1,27-201,1996,2.9,8,6,6,1,1,4,6,66.7,2,0,0,0,3,11,6,0,Matches
446,Carlos,br BRA,DF,Inter,it Serie A,25-062,1999,12.8,17,13,11,6,0,6,11,54.5,5,14,5,9,10,27,35,0,Matches
447,Diego Carlos,br BRA,DF,Aston Villa,eng Premier League,30-360,1993,12.9,16,11,12,3,1,7,13,53.8,6,12,9,3,10,26,48,1,Matches
448,Carmona,es ESP,"MF,DF",Getafe,es La Liga,22-040,2002,8.0,12,8,4,8,0,2,14,14.3,12,10,1,9,10,22,8,0,Matches
449,Marco Carnesecchi,it ITA,GK,Atalanta,it Serie A,23-252,2000,17.0,0,0,0,0,0,0,0,,0,0,0,0,0,0,15,2,Matches
450,Yannick Carrasco,be BEL,DF,Atlético Madrid,es La Liga,30-187,1993,2.5,4,4,3,1,0,2,7,28.6,5,2,0,2,1,5,6,0,Matches
451,Álvaro Carreras,es ESP,"MF,FW",Granada,es La Liga,20-352,2003,5.3,13,8,8,4,1,5,11,45.5,6,5,1,4,7,20,9,1,Matches
452,Rasmus Carstensen,dk DEN,"DF,FW",Köln,de Bundesliga,23-150,2000,16.0,39,18,19,17,3,26,47,55.3,21,36,8,28,19,58,42,2,Matches
453,Antonin Cartillier,fr FRA,DF,Monaco,fr Ligue 1,19-260,2004,0.1,0,0,0,0,0,0,0,,0,1,0,1,0,0,0,0,Matches
454,Dani Carvajal,es ESP,DF,Real Madrid,es La Liga,32-058,1992,18.3,40,25,23,13,4,19,36,52.8,17,22,8,14,20,60,35,3,Matches
455,Fabio Carvalho,pt POR,MF,RB Leipzig,de Bundesliga,21-192,2002,1.8,3,1,0,2,1,1,3,33.3,2,8,0,8,0,3,1,0,Matches
456,William Carvalho,pt POR,MF,Betis,es La Liga,31-337,1992,4.9,15,9,6,7,2,7,9,77.8,2,4,1,3,3,18,4,0,Matches
457,Cesare Casadei,it ITA,MF,Chelsea,eng Premier League,21-059,2003,0.2,1,0,1,0,0,0,0,,0,0,0,0,0,1,2,0,Matches
458,Nicolò Casale,it ITA,DF,Lazio,it Serie A,26-024,1998,10.5,8,3,8,0,0,6,13,46.2,7,12,10,2,5,13,41,0,Matches
459,Casemiro,br BRA,MF,Manchester Utd,eng Premier League,32-015,1992,12.1,47,28,21,20,6,28,60,46.7,32,40,13,27,10,57,36,0,Matches
460,Matty Cash,pl POL,DF,Aston Villa,eng Premier League,26-215,1997,19.6,44,24,20,20,4,21,42,50.0,21,28,10,18,17,61,50,0,Matches
461,Josué Casimir,fr FRA,"DF,FW",Le Havre,fr Ligue 1,22-167,2001,16.5,26,13,11,12,3,6,14,42.9,8,18,2,16,9,35,21,0,Matches
462,Giuseppe Caso,it ITA,"FW,MF",Frosinone,it Serie A,25-091,1998,4.6,4,3,2,0,2,2,3,66.7,1,0,0,0,0,4,0,0,Matches
463,Cristian Cásseres Jr.,ve VEN,MF,Toulouse,fr Ligue 1,24-049,2000,15.3,53,27,23,25,5,23,44,52.3,21,25,3,22,21,74,26,1,Matches
464,Timothy Castagne,be BEL,DF,Fulham,eng Premier League,28-095,1995,20.5,36,17,15,12,9,20,31,64.5,11,27,7,20,32,68,53,1,Matches
465,Koen Casteels,be BEL,GK,Wolfsburg,de Bundesliga,31-258,1992,20.0,2,1,2,0,0,2,3,66.7,1,0,0,0,0,2,15,4,Matches
466,Valentín Castellanos,ar ARG,FW,Lazio,it Serie A,25-158,1998,11.9,16,9,0,8,8,2,10,20.0,8,15,2,13,1,17,10,0,Matches
467,Jean-Charles Castelletto,cm CMR,DF,Nantes,fr Ligue 1,29-043,1995,19.4,23,18,12,9,2,14,20,70.0,6,14,8,6,26,49,60,0,Matches
468,Samu Castillejo,es ESP,"FW,MF",Sassuolo,it Serie A,29-051,1995,5.8,12,10,5,5,2,7,19,36.8,12,16,1,15,1,13,3,0,Matches
469,Jonny Castro,es ESP,MF,Wolves,eng Premier League,30-006,1994,0.1,0,0,0,0,0,0,1,0.0,1,1,1,0,0,0,0,0,Matches
470,Danilo Cataldi,it ITA,MF,Lazio,it Serie A,29-216,1994,12.1,20,9,5,14,1,6,12,50.0,6,13,6,7,14,34,16,1,Matches
471,Catena,es ESP,DF,Osasuna,es La Liga,29-133,1994,18.7,18,9,14,3,1,8,21,38.1,13,17,11,6,11,29,87,2,Matches
472,Maximiliano Caufriez,be BEL,DF,Clermont Foot,fr Ligue 1,27-022,1997,13.7,28,20,22,4,2,17,27,63.0,10,10,4,6,15,43,56,2,Matches
473,Ivan Cavaleiro,pt POR,FW,Lille,fr Ligue 1,30-143,1993,8.1,9,5,2,4,3,6,18,33.3,12,8,2,6,5,14,5,0,Matches
474,Dani Ceballos,es ESP,"MF,FW",Real Madrid,es La Liga,27-215,1996,2.6,4,3,1,3,0,1,4,25.0,3,5,1,4,0,4,2,0,Matches
475,Emil Ceide,no NOR,"FW,MF",Sassuolo,it Serie A,22-188,2001,1.5,0,0,0,0,0,0,0,,0,5,1,4,0,0,0,0,Matches
476,Zeki Çelik,tr TUR,DF,Roma,it Serie A,27-021,1997,3.6,14,10,5,7,2,8,13,61.5,5,5,2,3,3,17,12,0,Matches
477,Álex Centelles,es ESP,DF,Almería,es La Liga,26-122,1997,4.9,8,4,7,1,0,5,12,41.7,7,4,2,2,8,16,14,0,Matches
478,Fabien Centonze,fr FRA,DF,Hellas Verona,it Serie A,28-053,1996,1.0,2,1,1,1,0,2,3,66.7,1,1,0,1,4,6,5,0,Matches
479,Fabien Centonze,fr FRA,DF,Nantes,fr Ligue 1,28-053,1996,1.0,2,1,2,0,0,2,3,66.7,1,2,1,1,0,2,1,0,Matches
480,Václav Černý,cz CZE,"FW,MF",Wolfsburg,de Bundesliga,26-144,1997,9.6,6,3,2,4,0,1,13,7.7,12,12,0,12,7,13,6,0,Matches
481,Michele Cerofolini,it ITA,GK,Frosinone,it Serie A,25-065,1999,3.0,0,0,0,0,0,0,0,,0,0,0,0,0,0,0,0,Matches
482,Alberto Cerri,it ITA,FW,Empoli,it Serie A,27-328,1996,3.9,3,3,1,1,1,2,4,50.0,2,3,1,2,3,6,5,0,Matches
483,Leonardo Cerri,it ITA,DF,Juventus,it Serie A,21-005,2003,0.1,0,0,0,0,0,0,0,,0,0,0,0,0,0,0,0,Matches
484,Franco Cervi,ar ARG,"MF,DF",Celta Vigo,es La Liga,29-288,1994,5.0,18,13,10,7,1,10,20,50.0,10,14,0,14,7,25,4,0,Matches
485,Julian Chabot,de GER,DF,Köln,de Bundesliga,26-026,1998,20.4,43,31,30,13,0,23,35,65.7,12,48,29,19,36,79,91,0,Matches
486,El Chadaille Bitshiabu,fr FRA,"DF,MF",RB Leipzig,de Bundesliga,18-298,2005,0.1,0,0,0,0,0,0,0,,0,0,0,0,0,0,0,0,Matches
487,Fares Chaïbi,dz ALG,"FW,MF",Toulouse,fr Ligue 1,21-102,2002,0.6,0,0,0,0,0,0,0,,0,0,0,0,0,0,2,0,Matches
488,Fares Chaïbi,dz ALG,"MF,FW",Eint Frankfurt,de Bundesliga,21-102,2002,14.7,19,11,5,8,6,4,8,50.0,4,32,1,31,2,21,12,0,Matches
489,Trevoh Chalobah,eng ENG,DF,Chelsea,eng Premier League,24-248,1999,1.2,1,1,0,0,1,1,1,100.0,0,1,1,0,2,3,3,0,Matches
490,Muhammed Cham,at AUT,"MF,FW",Clermont Foot,fr Ligue 1,23-165,2000,19.9,18,11,7,9,2,8,21,38.1,13,15,2,13,6,24,4,1,Matches
491,Calum Chambers,eng ENG,DF,Aston Villa,eng Premier League,29-049,1995,0.5,0,0,0,0,0,0,0,,0,0,0,0,0,0,4,0,Matches
492,Timothy Chandler,us USA,MF,Eint Frankfurt,de Bundesliga,33-346,1990,0.0,0,0,0,0,0,0,0,,0,0,0,0,0,0,0,0,Matches
493,Brendan Chardonnet,fr FRA,DF,Brest,fr Ligue 1,29-078,1994,23.0,36,21,22,12,2,23,41,56.1,18,40,25,15,35,71,97,2,Matches
494,Charlys,br BRA,MF,Hellas Verona,it Serie A,20-019,2004,0.0,0,0,0,0,0,0,0,,0,0,0,0,0,0,0,0,Matches
495,Pep Chavarría,es ESP,"DF,MF",Rayo Vallecano,es La Liga,25-334,1998,5.9,7,5,4,3,0,4,4,100.0,0,6,0,6,3,10,13,0,Matches
496,Jhoanner Chávez,ec ECU,DF,Lens,fr Ligue 1,21-319,2002,4.3,4,3,1,2,1,2,7,28.6,5,2,0,2,3,7,9,0,Matches
497,Walid Cheddira,ma MAR,FW,Frosinone,it Serie A,26-047,1998,13.4,8,4,1,4,3,2,3,66.7,1,3,1,2,2,10,7,0,Matches
498,Rayan Cherki,fr FRA,"FW,MF",Lyon,fr Ligue 1,20-205,2003,14.5,19,8,2,13,4,11,31,35.5,20,13,3,10,5,24,0,0,Matches
499,Youssef Chermiti,pt POR,FW,Everton,eng Premier League,19-290,2004,0.7,0,0,0,0,0,0,2,0.0,2,1,0,1,0,0,0,0,Matches
500,Lucas Chevalier,fr FRA,GK,Lille,fr Ligue 1,22-124,2001,24.0,1,0,1,0,0,1,2,50.0,1,1,0,1,0,1,8,2,Matches
501,Fabio Chiarodia,it ITA,"DF,MF",M'Gladbach,de Bundesliga,18-278,2005,0.7,4,2,4,0,0,2,2,100.0,0,1,1,0,1,5,6,0,Matches
502,Federico Chiesa,it ITA,FW,Juventus,it Serie A,26-136,1997,16.0,12,5,3,4,5,3,9,33.3,6,11,1,10,5,17,4,0,Matches
503,Ben Chilwell,eng ENG,DF,Chelsea,eng Premier League,27-079,1996,8.3,15,10,5,9,1,5,8,62.5,3,11,3,8,4,19,19,1,Matches
504,Tawanda Chirewa,eng ENG,"MF,FW",Wolves,eng Premier League,20-150,2003,0.1,2,0,2,0,0,1,1,100.0,0,0,0,0,1,3,0,0,Matches
505,Pedro Chirivella,es ESP,MF,Nantes,fr Ligue 1,26-291,1997,21.8,36,20,15,20,1,22,54,40.7,32,19,4,15,22,58,21,0,Matches
506,Tahith Chong,nl NED,MF,Luton Town,eng Premier League,24-096,1999,11.4,21,9,14,5,2,8,17,47.1,9,15,3,12,4,25,2,0,Matches
507,Joris Chotard,fr FRA,MF,Montpellier,fr Ligue 1,22-167,2001,22.4,69,46,40,20,9,39,79,49.4,40,40,18,22,32,101,46,0,Matches
508,Andreas Christensen,dk DEN,"DF,MF",Barcelona,es La Liga,27-334,1996,17.5,15,9,7,8,0,10,18,55.6,8,16,5,11,18,33,36,0,Matches
509,Jacob Christensen,dk DEN,"MF,FW",Köln,de Bundesliga,22-258,2001,0.4,1,0,1,0,0,0,0,,0,2,1,1,0,1,0,0,Matches
510,Oliver Christensen,dk DEN,GK,Fiorentina,it Serie A,24-353,1999,2.0,0,0,0,0,0,0,0,,0,0,0,0,0,0,0,0,Matches
511,Ryan Christie,sct SCO,MF,Bournemouth,eng Premier League,29-016,1995,22.5,58,29,24,21,13,28,66,42.4,38,29,5,24,34,92,29,0,Matches
512,Carney Chukwuemeka,eng ENG,MF,Chelsea,eng Premier League,20-141,2003,1.9,2,2,1,1,0,1,2,50.0,1,1,1,0,0,2,0,0,Matches
513,Samuel Chukwueze,ng NGA,FW,Milan,it Serie A,24-292,1999,6.6,15,5,8,5,2,7,14,50.0,7,2,1,1,4,19,1,0,Matches
514,Víctor Chust,es ESP,DF,Cádiz,es La Liga,24-004,2000,11.0,15,9,11,4,0,8,13,61.5,5,14,9,5,6,21,39,0,Matches
515,Pathé Ciss,sn SEN,MF,Rayo Vallecano,es La Liga,29-359,1994,12.5,27,12,10,17,0,12,20,60.0,8,17,7,10,23,50,36,0,Matches
516,Djaoui Cissé,fr FRA,MF,Rennes,fr Ligue 1,20-038,2004,0.0,0,0,0,0,0,0,0,,0,0,0,0,0,0,0,0,Matches
517,Ibrahim Cissoko,nl NED,"FW,MF",Toulouse,fr Ligue 1,20-349,2003,2.4,3,2,2,1,0,1,3,33.3,2,3,0,3,1,4,0,0,Matches
518,Giorgio Cittadini,it ITA,DF,Monza,it Serie A,21-326,2002,0.2,1,1,1,0,0,1,1,100.0,0,1,1,0,0,1,0,0,Matches
519,Giorgio Cittadini,it ITA,DF,Genoa,it Serie A,21-326,2002,0.0,0,0,0,0,0,0,0,,0,0,0,0,0,0,2,0,Matches
520,Patrick Ciurria,it ITA,"DF,MF",Monza,it Serie A,29-029,1995,17.3,30,18,13,13,4,13,20,65.0,7,18,5,13,9,39,28,0,Matches
521,Bobby Clark,eng ENG,MF,Liverpool,eng Premier League,19-031,2005,1.0,2,1,1,1,0,1,5,20.0,4,6,2,4,1,3,1,0,Matches
522,Jordan Clark,eng ENG,MF,Luton Town,eng Premier League,30-169,1993,5.4,14,5,7,5,2,3,14,21.4,11,10,1,9,4,18,4,0,Matches
523,Alexis Claude-Maurice,fr FRA,MF,Nice,fr Ligue 1,25-277,1998,3.5,11,5,3,5,3,1,3,33.3,2,3,0,3,4,15,5,0,Matches
524,Jonathan Clauss,fr FRA,DF,Marseille,fr Ligue 1,31-166,1992,18.7,36,16,16,16,4,21,41,51.2,20,15,2,13,26,62,40,0,Matches
525,Silvi Clúa,es ESP,MF,Girona,es La Liga,19-040,2005,0.0,2,0,2,0,0,2,2,100.0,0,1,0,1,0,2,0,0,Matches
526,Nathaniel Clyne,eng ENG,DF,Crystal Palace,eng Premier League,32-339,1991,8.0,15,9,7,6,2,9,12,75.0,3,9,2,7,4,19,21,0,Matches
527,Marcus Coco,fr FRA,DF,Nantes,fr Ligue 1,27-259,1996,12.6,34,20,23,7,4,23,50,46.0,27,15,1,14,17,51,32,0,Matches
528,Saúl Coco,gq EQG,DF,Las Palmas,es La Liga,25-029,1999,17.4,21,13,16,5,0,7,12,58.3,5,18,12,6,15,36,87,3,Matches
529,Séamus Coleman,ie IRL,DF,Everton,eng Premier League,35-150,1988,2.6,8,7,5,1,2,5,8,62.5,3,3,2,1,3,11,11,0,Matches
530,Maxime Colin,fr FRA,DF,Metz,fr Ligue 1,32-115,1991,13.0,29,16,17,6,6,12,22,54.5,10,15,4,11,12,41,50,0,Matches
531,Nathan Collins,ie IRL,DF,Brentford,eng Premier League,22-314,2001,19.5,22,11,14,7,1,12,21,57.1,9,26,15,11,32,54,102,4,Matches
532,Lorenzo Colombo,it ITA,FW,Monza,it Serie A,22-001,2002,14.1,17,12,3,9,5,8,14,57.1,6,17,5,12,0,17,13,0,Matches
533,Andrea Colpani,it ITA,"MF,FW",Monza,it Serie A,24-303,1999,21.0,17,12,3,9,5,5,9,55.6,4,7,3,4,10,27,10,0,Matches
534,Levi Colwill,eng ENG,DF,Chelsea,eng Premier League,21-012,2003,20.0,48,30,26,17,5,26,34,76.5,8,28,10,18,26,74,66,0,Matches
535,Kingsley Coman,fr FRA,FW,Bayern Munich,de Bundesliga,27-270,1996,11.5,11,6,5,3,3,8,16,50.0,8,14,1,13,2,13,5,0,Matches
536,Eray Cömert,ch SUI,DF,Nantes,fr Ligue 1,26-034,1998,15.7,28,18,19,9,0,18,25,72.0,7,23,10,13,24,52,58,0,Matches
537,Santi Comesaña,es ESP,MF,Villarreal,es La Liga,27-156,1996,11.6,28,16,9,14,5,13,28,46.4,15,28,7,21,17,45,15,1,Matches
538,Pietro Comuzzo,it ITA,"DF,FW",Fiorentina,it Serie A,19-018,2005,0.3,1,1,1,0,0,1,1,100.0,0,0,0,0,1,2,2,0,Matches
539,Andrea Consigli,it ITA,GK,Sassuolo,it Serie A,37-042,1987,25.0,0,0,0,0,0,0,0,,0,1,0,1,0,0,14,0,Matches
540,Bambasé Conté,de GER,"MF,FW",Hoffenheim,de Bundesliga,20-246,2003,0.3,3,3,2,0,1,1,1,100.0,0,0,0,0,0,3,0,0,Matches
541,Nikita Contini Baranovsky,it ITA,GK,Napoli,it Serie A,27-293,1996,0.2,0,0,0,0,0,0,0,,0,0,0,0,0,0,1,0,Matches
542,Lewis Cook,eng ENG,MF,Bournemouth,eng Premier League,27-035,1997,19.0,40,27,18,20,2,23,41,56.1,18,20,7,13,43,83,26,1,Matches
543,Copete,es ESP,DF,Mallorca,es La Liga,24-151,1999,10.4,31,16,20,11,0,21,28,75.0,7,10,5,5,22,53,32,1,Matches
544,Diego Coppola,it ITA,DF,Hellas Verona,it Serie A,20-072,2003,9.1,26,16,18,7,1,12,18,66.7,6,12,4,8,13,39,54,1,Matches
545,Francis Coquelin,fr FRA,MF,Villarreal,es La Liga,32-301,1991,6.1,10,5,2,7,1,3,7,42.9,4,10,3,7,13,23,14,0,Matches
546,Tommaso Corazza,it ITA,DF,Bologna,it Serie A,19-254,2004,1.6,8,3,7,1,0,3,7,42.9,4,2,0,2,4,12,2,0,Matches
547,Theo Corbeanu,ca CAN,MF,Granada,es La Liga,21-297,2002,0.4,1,0,1,0,0,0,0,,0,1,0,1,1,2,0,0,Matches
548,Jeppe Corfitzen,dk DEN,FW,Lecce,it Serie A,19-071,2004,0.1,1,0,0,1,0,1,1,100.0,0,0,0,0,0,1,0,0,Matches
549,Jack Cork,eng ENG,MF,Burnley,eng Premier League,34-258,1989,0.2,2,0,0,2,0,1,3,33.3,2,0,0,0,0,2,1,0,Matches
550,Maxwel Cornet,ci CIV,"MF,FW",West Ham,eng Premier League,27-164,1996,1.2,3,2,3,0,0,1,5,20.0,4,0,0,0,1,4,1,0,Matches
551,Giacomo Corona,it ITA,FW,Empoli,it Serie A,20-014,2004,0.1,0,0,0,0,0,0,0,,0,0,0,0,0,0,0,0,Matches
552,Jesús Corona,mx MEX,"MF,DF",Sevilla,es La Liga,31-063,1993,0.2,0,0,0,0,0,0,0,,0,0,0,0,1,1,0,0,Matches
553,Ángel Correa,ar ARG,"FW,MF",Atlético Madrid,es La Liga,29-000,1995,9.3,12,9,3,3,6,2,11,18.2,9,7,0,7,1,13,0,0,Matches
554,Joaquín Correa,ar ARG,"FW,MF",Marseille,fr Ligue 1,29-209,1994,4.0,4,3,2,1,1,0,8,0.0,8,2,0,2,1,5,1,0,Matches
555,Thierry Correia,pt POR,DF,Valencia,es La Liga,25-000,1999,15.8,44,28,27,14,3,23,40,57.5,17,20,7,13,28,72,44,0,Matches
556,Oscar Cortés,co COL,"FW,MF",Lens,fr Ligue 1,20-097,2003,0.5,0,0,0,0,0,0,0,,0,1,0,1,0,0,0,0,Matches
557,Danny da Costa,de GER,DF,Mainz 05,de Bundesliga,30-240,1993,8.7,15,7,7,6,2,6,16,37.5,10,15,3,12,16,31,22,0,Matches
558,David Pereira da Costa,pt POR,MF,Lens,fr Ligue 1,23-064,2001,8.6,11,8,4,7,0,6,12,50.0,6,11,3,8,9,20,8,0,Matches
559,Jaume Costa,es ESP,DF,Mallorca,es La Liga,35-357,1988,13.9,33,19,20,9,4,17,27,63.0,10,13,4,9,13,46,23,0,Matches
560,Logan Costa,cv CPV,DF,Toulouse,fr Ligue 1,22-343,2001,19.4,30,20,21,9,0,10,19,52.6,9,32,20,12,15,45,91,0,Matches
561,Samu Costa,pt POR,MF,Mallorca,es La Liga,23-103,2000,20.9,75,41,31,42,2,38,79,48.1,41,27,13,14,30,105,51,3,Matches
562,Benoît Costil,fr FRA,GK,Salernitana,it Serie A,36-250,1987,8.0,1,1,1,0,0,1,2,50.0,1,0,0,0,0,1,4,1,Matches
563,Grégoire Coudert,fr FRA,GK,Brest,fr Ligue 1,24-341,1999,2.0,0,0,0,0,0,0,0,,0,0,0,0,0,0,0,0,Matches
564,Vladimír Coufal,cz CZE,DF,West Ham,eng Premier League,31-200,1992,24.6,49,33,39,8,2,29,53,54.7,24,29,9,20,34,83,77,0,Matches
565,Lassana Coulibaly,ml MLI,MF,Salernitana,it Serie A,27-334,1996,14.9,33,25,15,12,6,17,34,50.0,17,17,3,14,12,45,21,0,Matches
566,Mamadou Coulibaly,sn SEN,DF,Salernitana,it Serie A,25-035,1999,0.0,0,0,0,0,0,0,0,,0,0,0,0,0,0,0,0,Matches
567,Mamadou Coulibaly,fr FRA,MF,Monaco,fr Ligue 1,19-323,2004,0.7,5,2,2,2,1,2,6,33.3,4,2,0,2,0,5,0,0,Matches
568,Tanguy Coulibaly,fr FRA,"FW,MF",Montpellier,fr Ligue 1,23-020,2001,2.4,2,2,1,1,0,0,2,0.0,2,5,0,5,1,3,1,0,Matches
569,Philippe Coutinho,br BRA,"MF,FW",Aston Villa,eng Premier League,31-271,1992,0.3,0,0,0,0,0,0,1,0.0,1,0,0,0,0,0,0,0,Matches
570,Yan Couto,br BRA,"DF,MF",Girona,es La Liga,21-280,2002,18.8,35,24,19,11,5,16,33,48.5,17,12,2,10,6,41,27,1,Matches
571,Nicolas Cozza,fr FRA,DF,Nantes,fr Ligue 1,25-061,1999,3.1,15,13,10,5,0,9,11,81.8,2,3,0,3,4,19,11,0,Matches
572,Nicolas Cozza,fr FRA,DF,Wolfsburg,de Bundesliga,25-061,1999,3.1,8,6,4,4,0,2,7,28.6,5,3,0,3,4,12,6,0,Matches
573,Alessio Cragno,it ITA,GK,Sassuolo,it Serie A,29-255,1994,2.0,0,0,0,0,0,0,0,,0,0,0,0,0,0,3,0,Matches
574,Crespo,pt POR,MF,Rayo Vallecano,es La Liga,27-180,1996,2.3,6,5,3,2,1,4,5,80.0,1,4,1,3,5,11,2,0,Matches
575,Aaron Cresswell,eng ENG,DF,West Ham,eng Premier League,34-085,1989,1.6,1,0,1,0,0,1,1,100.0,0,2,1,1,0,1,3,0,Matches
576,Bryan Cristante,it ITA,"MF,DF",Roma,it Serie A,29-006,1995,25.7,45,27,22,17,6,17,35,48.6,18,22,4,18,19,64,44,1,Matches
577,Juan Cruz Armada,es ESP,DF,Osasuna,es La Liga,31-225,1992,14.6,21,11,13,7,1,13,19,68.4,6,13,7,6,7,28,33,1,Matches
578,Juan Cruz,ar ARG,"FW,MF",Hellas Verona,it Serie A,24-234,1999,1.2,2,2,0,0,2,0,0,,0,1,0,1,1,3,0,0,Matches
579,Juan Cruz,es ESP,FW,Betis,es La Liga,23-319,2000,0.8,0,0,0,0,0,0,1,0.0,1,0,0,0,0,0,0,0,Matches
580,Juan Cuadrado,co COL,DF,Inter,it Serie A,35-288,1988,1.7,3,3,1,2,0,2,3,66.7,1,5,1,4,0,3,1,0,Matches
581,Pau Cubarsí,es ESP,DF,Barcelona,es La Liga,17-047,2007,8.1,17,10,15,2,0,9,10,90.0,1,9,7,2,6,23,30,1,Matches
582,Marc Cucurella,es ESP,DF,Chelsea,eng Premier League,25-231,1998,7.8,27,17,15,10,2,16,27,59.3,11,17,5,12,12,39,22,0,Matches
583,Jorge Cuenca,es ESP,DF,Villarreal,es La Liga,24-113,1999,16.4,30,23,20,8,2,15,22,68.2,7,23,13,10,17,47,102,0,Matches
584,Josh Cullen,ie IRL,MF,Burnley,eng Premier League,27-337,1996,12.0,20,13,9,9,2,12,21,57.1,9,20,11,9,7,27,16,0,Matches
585,Matheus Cunha,br BRA,"FW,MF",Wolves,eng Premier League,24-287,1999,21.8,24,11,6,15,3,10,30,33.3,20,23,7,16,13,37,16,1,Matches
586,Marvin Cuni,al ALB,FW,Frosinone,it Serie A,22-243,2001,5.2,5,3,1,2,2,3,4,75.0,1,9,1,8,1,6,0,0,Matches
587,Eric Curbelo,es ESP,DF,Las Palmas,es La Liga,30-055,1994,1.0,2,1,1,1,0,1,2,50.0,1,3,1,2,2,4,5,1,Matches
588,Tomáš Čvančara,cz CZE,FW,M'Gladbach,de Bundesliga,23-209,2000,7.1,2,2,0,2,0,0,1,0.0,1,3,1,2,0,2,8,0,Matches
589,Danilo D'Ambrosio,it ITA,DF,Monza,it Serie A,35-182,1988,15.1,51,31,31,17,3,26,38,68.4,12,19,12,7,11,62,30,0,Matches
590,Alberto Dadie,es ESP,MF,Real Sociedad,es La Liga,21-233,2002,0.3,2,1,2,0,0,0,0,,0,1,0,1,0,2,0,0,Matches
591,Trévis Dago,ci CIV,"MF,FW",Lille,fr Ligue 1,19-048,2005,0.1,0,0,0,0,0,0,0,,0,0,0,0,0,0,0,0,Matches
592,Finn Dahmen,de GER,GK,Augsburg,de Bundesliga,25-348,1998,24.0,1,0,1,0,0,1,2,50.0,1,0,0,0,0,1,15,5,Matches
593,Mahmoud Dahoud,de GER,MF,Brighton,eng Premier League,28-068,1996,5.0,9,4,2,4,3,3,9,33.3,6,4,1,3,1,10,5,0,Matches
594,Mahmoud Dahoud,de GER,MF,Stuttgart,de Bundesliga,28-068,1996,0.8,2,0,0,2,0,1,2,50.0,1,2,0,2,0,2,1,0,Matches
595,Ameen Al-Dakhil,be BEL,DF,Burnley,eng Premier League,22-003,2002,11.7,12,5,4,7,1,1,10,10.0,9,13,6,7,12,24,38,2,Matches
596,Thijs Dallinga,nl NED,FW,Toulouse,fr Ligue 1,23-219,2000,18.3,23,13,6,7,10,6,11,54.5,5,9,4,5,2,25,25,0,Matches
597,Diogo Dalot,pt POR,DF,Manchester Utd,eng Premier League,24-357,1999,24.3,54,34,40,8,6,35,47,74.5,12,34,12,22,27,81,79,0,Matches
598,Mikkel Damsgaard,dk DEN,MF,Brentford,eng Premier League,23-250,2000,4.0,14,7,7,5,2,8,22,36.4,14,8,1,7,7,21,3,1,Matches
599,Flavius Daniliuc,at AUT,DF,Salernitana,it Serie A,22-317,2001,8.3,19,11,12,5,2,9,19,47.4,10,13,4,9,8,27,15,0,Matches
600,Danilo,br BRA,"MF,FW",Nott'ham Forest,eng Premier League,22-315,2001,11.8,20,9,11,8,1,13,30,43.3,17,19,5,14,17,37,25,0,Matches
601,Danilo,br BRA,DF,Juventus,it Serie A,32-238,1991,17.2,37,23,24,11,2,18,27,66.7,9,21,8,13,27,64,65,0,Matches
602,Arnaut Danjuma,nl NED,"MF,FW",Everton,eng Premier League,27-038,1997,6.6,6,4,2,3,1,1,4,25.0,3,4,0,4,3,9,0,0,Matches
603,Jayden Danns,eng ENG,FW,Liverpool,eng Premier League,18-053,2006,0.1,0,0,0,0,0,0,0,,0,0,0,0,0,0,0,0,Matches
604,Kevin Danso,at AUT,DF,Lens,fr Ligue 1,25-172,1998,22.0,18,10,10,8,0,12,23,52.2,11,35,23,12,17,35,84,1,Matches
605,Dante,br BRA,DF,Nice,fr Ligue 1,40-143,1983,23.6,45,22,30,13,2,29,39,74.4,10,28,14,14,25,70,61,2,Matches
606,Mohammed Daramy,dk DEN,FW,Reims,fr Ligue 1,22-062,2002,16.5,10,9,4,4,2,6,16,37.5,10,4,1,3,4,14,4,0,Matches
607,Sergi Darder,es ESP,MF,Mallorca,es La Liga,30-078,1993,18.1,31,21,11,16,4,8,21,38.1,13,18,4,14,15,46,10,0,Matches
608,Achraf Dari,ma MAR,"DF,FW",Brest,fr Ligue 1,24-308,1999,1.3,1,1,1,0,0,0,2,0.0,2,2,0,2,5,6,9,1,Matches
609,Matteo Darmian,it ITA,DF,Inter,it Serie A,34-098,1989,19.6,36,16,17,14,5,14,38,36.8,24,23,9,14,10,46,42,0,Matches
610,Lukas Daschner,de GER,"MF,FW",Bochum,de Bundesliga,25-160,1998,3.8,5,3,2,2,1,3,7,42.9,4,6,0,6,2,7,1,0,Matches
611,Josh Dasilva,eng ENG,"DF,FW",Brentford,eng Premier League,25-138,1998,0.3,2,1,0,1,1,0,0,,0,0,0,0,0,2,0,0,Matches
612,David Datro Fofana,ci CIV,FW,Burnley,eng Premier League,21-078,2002,4.7,4,1,0,2,2,0,2,0.0,2,3,1,2,0,4,0,0,Matches
613,David Datro Fofana,ci CIV,"FW,MF",Union Berlin,de Bundesliga,21-078,2002,7.6,10,7,3,5,2,4,9,44.4,5,4,0,4,0,10,5,0,Matches
614,Jonathan David,ca CAN,FW,Lille,fr Ligue 1,24-055,2000,19.6,17,12,3,9,5,7,21,33.3,14,9,0,9,6,23,1,0,Matches
615,Alphonso Davies,ca CAN,DF,Bayern Munich,de Bundesliga,23-128,2000,16.0,35,17,21,12,2,20,39,51.3,19,20,1,19,21,56,33,1,Matches
616,Ben Davies,wls WAL,DF,Tottenham,eng Premier League,30-320,1993,11.1,21,17,13,6,2,15,18,83.3,3,16,14,2,10,31,33,0,Matches
617,Tom Davies,eng ENG,"MF,FW",Sheffield Utd,eng Premier League,25-253,1998,2.0,8,4,3,2,3,2,8,25.0,6,2,1,1,3,11,5,1,Matches
618,Keinan Davis,eng ENG,FW,Udinese,it Serie A,26-025,1998,0.2,0,0,0,0,0,0,0,,0,0,0,0,0,0,0,0,Matches
619,Paweł Dawidowicz,pl POL,DF,Hellas Verona,it Serie A,28-294,1995,18.1,39,24,24,14,1,13,23,56.5,10,13,8,5,16,55,89,0,Matches
620,Craig Dawson,eng ENG,DF,Wolves,eng Premier League,33-308,1990,24.5,30,20,23,6,1,22,34,64.7,12,51,39,12,16,46,120,1,Matches
621,Kevin De Bruyne,be BEL,MF,Manchester City,eng Premier League,32-255,1991,4.7,4,3,1,1,2,4,7,57.1,3,1,0,1,1,5,1,0,Matches
622,Charles De Ketelaere,be BEL,"FW,MF",Atalanta,it Serie A,22-365,2001,16.4,24,16,3,7,14,6,14,42.9,8,21,1,20,5,29,5,0,Matches
623,Rodrigo De Paul,ar ARG,MF,Atlético Madrid,es La Liga,29-290,1994,16.3,26,18,8,12,6,12,30,40.0,18,20,1,19,8,34,14,1,Matches
624,Lorenzo De Silvestri,it ITA,DF,Bologna,it Serie A,35-291,1988,6.3,6,4,3,2,1,3,5,60.0,2,7,3,4,5,11,19,0,Matches
625,Thibault De Smet,be BEL,"DF,FW",Reims,fr Ligue 1,25-278,1998,16.8,50,30,32,14,4,30,50,60.0,20,18,2,16,18,68,42,0,Matches
626,Koni De Winter,be BEL,DF,Genoa,it Serie A,21-271,2002,17.4,29,19,17,11,1,14,22,63.6,8,19,4,15,17,46,55,0,Matches
627,Grégoire Defrel,mq MTQ,"FW,MF",Sassuolo,it Serie A,32-266,1991,3.5,9,4,4,4,1,2,3,66.7,1,2,0,2,1,10,4,0,Matches
628,Alessandro Deiola,it ITA,MF,Cagliari,it Serie A,28-221,1995,9.5,15,10,7,6,2,10,27,37.0,17,11,3,8,5,20,15,0,Matches
629,Romain Del Castillo,fr FRA,FW,Brest,fr Ligue 1,27-346,1996,21.2,29,21,7,11,11,11,49,22.4,38,23,1,22,9,38,6,0,Matches
630,Thomas Delaine,fr FRA,"DF,MF",Strasbourg,fr Ligue 1,31-351,1992,14.4,22,10,15,6,1,15,27,55.6,12,10,2,8,15,37,38,0,Matches
631,Sacha Delaye,fr FRA,"FW,MF",Montpellier,fr Ligue 1,21-321,2002,1.1,5,2,1,1,3,1,5,20.0,4,1,0,1,0,5,0,0,Matches
632,Hannes Delcroix,be BEL,DF,Burnley,eng Premier League,25-010,1999,6.3,10,6,6,4,0,3,4,75.0,1,8,2,6,8,18,22,0,Matches
633,Olivier Deman,be BEL,DF,Werder Bremen,de Bundesliga,23-338,2000,12.8,25,13,19,4,2,16,32,50.0,16,22,8,14,9,34,31,0,Matches
634,Karamoko Dembele,sct SCO,"MF,FW",Brest,fr Ligue 1,21-016,2003,0.2,0,0,0,0,0,0,0,,0,0,0,0,0,0,0,0,Matches
635,Ousmane Dembélé,fr FRA,"MF,FW",Paris S-G,fr Ligue 1,26-299,1997,14.0,15,12,2,5,8,3,9,33.3,6,10,0,10,4,19,3,1,Matches
636,Jessy Deminguet,fr FRA,"MF,FW",Strasbourg,fr Ligue 1,26-062,1998,7.6,14,9,6,8,0,6,18,33.3,12,8,0,8,8,22,5,1,Matches
637,Ermedin Demirović,ba BIH,"FW,MF",Augsburg,de Bundesliga,25-350,1998,23.0,20,12,5,13,2,11,30,36.7,19,20,1,19,7,27,20,0,Matches
638,Diego Demme,de GER,MF,Napoli,it Serie A,32-109,1991,0.8,1,1,0,1,0,0,1,0.0,1,0,0,0,0,1,0,0,Matches
639,Sepp van den Berg,nl NED,DF,Mainz 05,de Bundesliga,22-080,2001,21.5,34,21,18,14,2,13,21,61.9,8,42,16,26,30,64,105,2,Matches
640,Leander Dendoncker,be BEL,MF,Aston Villa,eng Premier League,28-329,1995,1.3,6,4,3,2,1,4,5,80.0,1,5,2,3,2,8,3,1,Matches
641,Leander Dendoncker,be BEL,MF,Napoli,it Serie A,28-329,1995,0.3,0,0,0,0,0,0,0,,0,1,1,0,0,0,0,0,Matches
642,Rémy Descamps,fr FRA,GK,Nantes,fr Ligue 1,27-258,1996,6.0,0,0,0,0,0,0,0,,0,0,0,0,0,0,7,0,Matches
643,Mikkel Desler,dk DEN,DF,Toulouse,fr Ligue 1,29-019,1995,14.1,13,8,6,6,1,6,12,50.0,6,25,9,16,14,27,31,0,Matches
644,Arthur Desmas,fr FRA,GK,Le Havre,fr Ligue 1,29-337,1994,23.0,0,0,0,0,0,0,1,0.0,1,0,0,0,0,0,10,0,Matches
645,Mattia Destro,it ITA,"FW,MF",Empoli,it Serie A,32-355,1991,3.0,1,0,0,1,0,1,1,100.0,0,1,0,1,2,3,3,0,Matches
646,Samuele Di Benedetto,de GER,MF,Stuttgart,de Bundesliga,18-237,2005,0.1,0,0,0,0,0,0,0,,0,0,0,0,1,1,0,0,Matches
647,Federico Di Francesco,it ITA,"FW,MF",Lecce,it Serie A,29-269,1994,0.2,1,0,0,1,0,0,0,,0,0,0,0,0,1,0,0,Matches
648,Michele Di Gregorio,it ITA,GK,Monza,it Serie A,26-226,1997,22.9,1,0,1,0,0,1,2,50.0,1,0,0,0,1,2,9,1,Matches
649,Giovanni Di Lorenzo,it ITA,DF,Napoli,it Serie A,30-218,1993,27.0,41,26,22,15,4,24,53,45.3,29,30,10,20,17,58,34,0,Matches
650,Alessandro Di Pardo,it ITA,"DF,MF",Cagliari,it Serie A,24-235,1999,2.6,3,1,2,0,1,0,2,0.0,2,6,2,4,4,7,3,0,Matches
651,Boulaye Dia,sn SEN,"FW,MF",Salernitana,it Serie A,27-114,1996,12.7,4,2,2,2,0,1,3,33.3,2,5,0,5,3,7,7,0,Matches
652,Moussa Diaby,fr FRA,"FW,MF",Aston Villa,eng Premier League,24-246,1999,16.6,7,2,2,4,1,3,10,30.0,7,5,0,5,5,12,4,0,Matches
653,Lamine Diack,sn SEN,MF,Nantes,fr Ligue 1,23-115,2000,0.0,0,0,0,0,0,0,0,,0,0,0,0,0,0,0,0,Matches
654,Mouctar Diakhaby,gn GUI,"DF,MF",Valencia,es La Liga,27-081,1996,11.9,18,11,9,9,0,11,13,84.6,2,17,7,10,11,29,62,0,Matches
655,Mamadou Diakhon,fr FRA,"FW,MF",Reims,fr Ligue 1,18-169,2005,1.6,3,1,1,1,1,3,7,42.9,4,0,0,0,1,4,1,0,Matches
656,Bafodé Diakité,fr FRA,DF,Lille,fr Ligue 1,23-063,2001,9.8,22,16,7,13,2,17,22,77.3,5,11,6,5,13,35,23,0,Matches
657,Ibrahim Diakité,gn GUI,DF,Reims,fr Ligue 1,20-130,2003,1.2,1,0,0,1,0,0,1,0.0,1,3,0,3,2,3,5,0,Matches
658,Moussa Diakité,ml MLI,MF,Cádiz,es La Liga,20-126,2003,0.0,0,0,0,0,0,0,0,,0,0,0,0,0,0,0,0,Matches
659,Oumar Diakité,ci CIV,FW,Reims,fr Ligue 1,20-080,2003,8.6,11,6,6,3,2,4,12,33.3,8,6,0,6,3,14,4,0,Matches
660,Amad Diallo,ci CIV,FW,Manchester Utd,eng Premier League,21-242,2002,0.5,3,1,0,2,1,1,1,100.0,0,0,0,0,0,3,0,0,Matches
661,Amadou Diallo,eng ENG,MF,Newcastle Utd,eng Premier League,21-023,2003,0.0,0,0,0,0,0,0,0,,0,0,0,0,0,0,0,0,Matches
662,Assane Diao,es ESP,FW,Betis,es La Liga,18-184,2005,11.4,19,11,5,8,6,5,16,31.3,11,22,4,18,7,26,7,0,Matches
663,Mouhamadou Diarra,fr FRA,"MF,FW",Strasbourg,fr Ligue 1,20-066,2004,17.4,16,12,3,13,0,5,26,19.2,21,18,4,14,15,31,9,0,Matches
664,Moussa Diarra,ml MLI,DF,Toulouse,fr Ligue 1,23-120,2000,9.4,21,8,10,10,1,8,19,42.1,11,21,12,9,14,35,32,0,Matches
665,Rúben Dias,pt POR,DF,Manchester City,eng Premier League,26-300,1997,21.4,27,12,11,15,1,14,20,70.0,6,25,13,12,22,49,69,0,Matches
666,Krépin Diatta,sn SEN,DF,Monaco,fr Ligue 1,25-013,1999,7.3,17,11,7,8,2,14,27,51.9,13,11,1,10,8,25,9,0,Matches
667,Mory Diaw,sn SEN,GK,Clermont Foot,fr Ligue 1,30-261,1993,22.0,0,0,0,0,0,0,1,0.0,1,0,0,0,1,1,8,3,Matches
668,Mahamadou Diawara,fr FRA,MF,Lyon,fr Ligue 1,19-021,2005,3.8,8,5,4,4,0,3,10,30.0,7,4,1,3,3,11,4,0,Matches
669,Brahim Díaz,es ESP,"FW,MF",Real Madrid,es La Liga,24-219,1999,10.4,20,14,1,12,7,5,11,45.5,6,10,0,10,3,23,1,0,Matches
670,Luis Díaz,co COL,FW,Liverpool,eng Premier League,27-056,1997,19.4,20,16,3,9,8,6,26,23.1,20,13,0,13,2,22,7,0,Matches
671,Víctor Díaz,es ESP,"DF,MF",Granada,es La Liga,35-271,1988,1.8,5,3,2,3,0,1,3,33.3,2,1,0,1,1,6,8,0,Matches
672,Famara Diedhiou,sn SEN,"FW,MF",Granada,es La Liga,31-085,1992,1.0,1,1,0,1,0,0,1,0.0,1,0,0,0,0,1,2,0,Matches
673,Justin Diehl,de GER,"FW,MF",Köln,de Bundesliga,19-103,2004,1.8,0,0,0,0,0,0,0,,0,1,1,0,0,0,0,1,Matches
674,Bamba Dieng,sn SEN,FW,Lorient,fr Ligue 1,23-352,2000,5.0,2,2,0,2,0,1,2,50.0,1,2,0,2,0,2,6,0,Matches
675,Eric Dier,eng ENG,DF,Tottenham,eng Premier League,30-054,1994,2.2,2,1,2,0,0,2,2,100.0,0,3,3,0,2,4,12,0,Matches
676,Eric Dier,eng ENG,DF,Bayern Munich,de Bundesliga,30-054,1994,5.6,1,0,0,1,0,0,0,,0,7,6,1,6,7,23,0,Matches
677,Guillaume Dietsch,fr FRA,GK,Metz,fr Ligue 1,22-327,2001,0.8,0,0,0,0,0,0,0,,0,0,0,0,0,0,0,0,Matches
678,Florian Dietz,de GER,"FW,DF",Köln,de Bundesliga,25-219,1998,0.6,0,0,0,0,0,0,0,,0,1,0,1,0,0,0,0,Matches
679,Lucas Digne,fr FRA,DF,Aston Villa,eng Premier League,30-233,1993,17.5,31,13,24,6,1,17,29,58.6,12,11,0,11,19,50,39,0,Matches
680,Federico Dimarco,it ITA,DF,Inter,it Serie A,26-120,1997,16.6,30,21,11,11,8,13,26,50.0,13,13,2,11,8,38,28,1,Matches
681,Stole Dimitrievski,mk MKD,GK,Rayo Vallecano,es La Liga,30-075,1993,27.0,1,1,1,0,0,1,1,100.0,0,0,0,0,0,1,12,3,Matches
682,Junior Dina Ebimbe,fr FRA,"MF,DF",Eint Frankfurt,de Bundesliga,23-109,2000,15.3,30,18,8,13,9,13,31,41.9,18,21,6,15,5,35,28,0,Matches
683,Eren Dinkçi,de GER,"FW,MF",Heidenheim,de Bundesliga,22-087,2001,20.3,20,11,11,8,1,11,29,37.9,18,25,2,23,7,27,17,0,Matches
684,Sinaly Diomande,ci CIV,DF,Lyon,fr Ligue 1,22-335,2001,9.9,10,4,5,3,2,9,16,56.3,7,12,9,3,15,25,26,1,Matches
685,Edan Diop,fr FRA,"DF,MF",Monaco,fr Ligue 1,19-194,2004,1.6,9,7,6,2,1,6,7,85.7,1,3,0,3,1,10,5,0,Matches
686,Issa Diop,fr FRA,DF,Fulham,eng Premier League,27-060,1997,12.8,23,12,17,5,1,11,16,68.8,5,20,14,6,12,35,63,1,Matches
687,Sofiane Diop,fr FRA,FW,Nice,fr Ligue 1,23-274,2000,5.5,8,6,3,4,1,4,10,40.0,6,4,0,4,3,11,3,0,Matches
688,Andy Diouf,fr FRA,MF,Lens,fr Ligue 1,20-297,2003,12.4,25,17,10,11,4,12,19,63.2,7,11,2,9,3,28,3,0,Matches
689,Yehvann Diouf,fr FRA,GK,Reims,fr Ligue 1,24-114,1999,24.0,0,0,0,0,0,0,0,,0,0,0,0,0,0,14,2,Matches
690,Axel Disasi,fr FRA,DF,Chelsea,eng Premier League,25-364,1998,23.7,25,12,13,9,3,15,21,71.4,6,20,15,5,15,40,88,1,Matches
691,Chaim El Djebali,tn TUN,MF,Lyon,fr Ligue 1,20-031,2004,0.1,0,0,0,0,0,0,0,,0,0,0,0,0,0,0,0,Matches
692,Djené,tg TOG,"DF,MF",Getafe,es La Liga,32-069,1991,18.8,21,12,9,11,1,9,17,52.9,8,19,8,11,16,37,46,0,Matches
693,Koffi Djidji,ci CIV,DF,Torino,it Serie A,31-100,1992,8.4,14,9,9,5,0,3,4,75.0,1,10,5,5,10,24,20,0,Matches
694,Berat Djimsiti,al ALB,DF,Atalanta,it Serie A,31-019,1993,25.0,29,16,19,10,0,9,17,52.9,8,45,26,19,45,74,75,0,Matches
695,Marko Dmitrović,rs SRB,GK,Sevilla,es La Liga,32-045,1992,13.0,1,1,1,0,0,1,2,50.0,1,0,0,0,1,2,5,0,Matches
696,Ben Doak,sct SCO,FW,Liverpool,eng Premier League,18-119,2005,0.2,0,0,0,0,0,0,0,,0,0,0,0,0,0,0,0,Matches
697,Ritsu Doan,jp JPN,"MF,DF",Freiburg,de Bundesliga,25-267,1998,15.0,32,16,13,11,8,13,25,52.0,12,17,2,15,4,36,18,0,Matches
698,Lewis Dobbin,eng ENG,MF,Everton,eng Premier League,21-066,2003,2.0,6,5,3,2,1,4,8,50.0,4,4,1,3,1,7,0,0,Matches
699,Dodô,br BRA,DF,Fiorentina,it Serie A,25-113,1998,3.0,3,2,1,2,0,1,4,25.0,3,2,0,2,3,6,6,0,Matches
700,Danilho Doekhi,nl NED,DF,Union Berlin,de Bundesliga,25-253,1998,15.0,20,14,12,8,0,8,12,66.7,4,24,10,14,25,45,76,1,Matches
701,Matt Doherty,ie IRL,"DF,MF",Wolves,eng Premier League,32-053,1992,6.4,13,7,6,5,2,5,11,45.5,6,7,2,5,4,17,23,0,Matches
702,Josh Doig,sct SCO,DF,Hellas Verona,it Serie A,21-296,2002,9.2,16,9,9,7,0,13,17,76.5,4,12,3,9,4,20,17,1,Matches
703,Josh Doig,sct SCO,DF,Sassuolo,it Serie A,21-296,2002,6.6,12,9,8,4,0,7,15,46.7,8,20,8,12,4,16,11,0,Matches
704,Jeremy Doku,be BEL,"FW,MF",Manchester City,eng Premier League,21-287,2002,13.1,28,19,10,11,7,9,17,52.9,8,9,0,9,8,36,3,0,Matches
705,Jeremy Doku,be BEL,FW,Rennes,fr Ligue 1,21-287,2002,1.2,2,2,1,0,1,1,1,100.0,0,0,0,0,0,2,0,0,Matches
706,Carlos Dominguez,es ESP,DF,Celta Vigo,es La Liga,23-027,2001,11.0,22,12,9,9,4,15,22,68.2,7,15,6,9,20,42,52,0,Matches
707,Mario Dominguez,es ESP,FW,Valencia,es La Liga,20-028,2004,0.3,0,0,0,0,0,0,0,,0,0,0,0,0,0,0,0,Matches
708,Nicolás Domínguez,ar ARG,"MF,FW",Nott'ham Forest,eng Premier League,25-255,1998,14.2,59,31,33,25,1,22,42,52.4,20,24,4,20,13,72,22,0,Matches
709,Nicolás Domínguez,ar ARG,MF,Bologna,it Serie A,25-255,1998,1.1,1,0,1,0,0,0,2,0.0,2,3,0,3,0,1,2,0,Matches
710,Giulio Donati,it ITA,DF,Monza,it Serie A,34-033,1990,0.2,0,0,0,0,0,0,0,,0,0,0,0,0,0,0,0,Matches
711,Jamie Donley,eng ENG,FW,Tottenham,eng Premier League,19-066,2005,0.0,0,0,0,0,0,0,0,,0,0,0,0,0,0,3,0,Matches
712,Gianluigi Donnarumma,it ITA,GK,Paris S-G,fr Ligue 1,25-013,1999,20.1,0,0,0,0,0,0,0,,0,0,0,0,1,1,6,4,Matches
713,Patrick Dorgu,dk DEN,DF,Lecce,it Serie A,19-135,2004,9.5,26,14,18,6,2,14,20,70.0,6,10,3,7,9,35,26,2,Matches
714,Niklas Dorsch,de GER,MF,Augsburg,de Bundesliga,26-054,1998,13.1,29,21,11,18,0,11,28,39.3,17,14,9,5,15,44,23,0,Matches
715,Gabriel Dos Santos,br BRA,DF,Arsenal,eng Premier League,26-081,1997,23.2,32,16,18,13,1,13,16,81.3,3,34,25,9,22,54,60,0,Matches
716,Alberto Dossena,it ITA,DF,Cagliari,it Serie A,25-148,1998,25.2,48,31,37,11,0,29,45,64.4,16,43,25,18,36,84,134,2,Matches
717,Carlos Dotor,es ESP,MF,Celta Vigo,es La Liga,22-360,2001,7.7,14,7,3,8,3,4,13,30.8,9,12,2,10,4,18,3,0,Matches
718,Abdoulaye Doucouré,ml MLI,"FW,MF",Everton,eng Premier League,31-068,1993,19.8,29,18,13,11,5,13,30,43.3,17,19,2,17,13,42,11,0,Matches
719,Cheick Doucouré,ml MLI,MF,Crystal Palace,eng Premier League,24-061,2000,10.2,34,17,15,13,6,18,30,60.0,12,13,2,11,20,54,12,0,Matches
720,Siriné Doucouré,ml MLI,FW,Lorient,fr Ligue 1,21-336,2002,4.7,8,6,0,4,4,3,3,100.0,0,4,0,4,1,9,6,0,Matches
721,Désiré Doué,fr FRA,"MF,FW",Rennes,fr Ligue 1,18-280,2005,10.3,26,15,8,12,6,7,22,31.8,15,18,0,18,10,36,6,0,Matches
722,Guela Doué,fr FRA,DF,Rennes,fr Ligue 1,21-144,2002,7.2,18,14,8,8,2,13,22,59.1,9,9,1,8,10,28,34,0,Matches
723,Alfie Doughty,eng ENG,DF,Luton Town,eng Premier League,24-079,1999,21.2,40,24,19,12,9,22,52,42.3,30,25,1,24,19,59,29,1,Matches
724,Douglas,br BRA,MF,Nantes,fr Ligue 1,27-056,1997,16.3,64,39,32,26,6,26,50,52.0,24,21,7,14,24,88,21,0,Matches
725,Ismaël Doukouré,fr FRA,"MF,DF",Strasbourg,fr Ligue 1,20-229,2003,15.4,19,13,4,13,2,12,19,63.2,7,13,5,8,18,37,21,2,Matches
726,Kamory Doumbia,ml MLI,MF,Brest,fr Ligue 1,21-020,2003,5.4,14,9,3,4,7,5,18,27.8,13,11,0,11,4,18,3,0,Matches
727,Anastasios Douvikas,gr GRE,FW,Celta Vigo,es La Liga,24-220,1999,7.4,10,5,2,3,5,1,6,16.7,5,3,2,1,1,11,8,0,Matches
728,Artem Dovbyk,ua UKR,FW,Girona,es La Liga,26-262,1997,18.4,3,2,2,0,1,0,1,0.0,1,7,1,6,0,3,15,0,Matches
729,Nikola Dovedan,at AUT,MF,Heidenheim,de Bundesliga,29-247,1994,4.8,12,8,1,9,2,5,17,29.4,12,6,0,6,1,13,3,0,Matches
730,Damion Downs,de GER,"FW,MF",Köln,de Bundesliga,19-247,2004,0.3,0,0,0,0,0,0,0,,0,0,0,0,0,0,0,0,Matches
731,Tommy Doyle,eng ENG,MF,Wolves,eng Premier League,22-144,2001,8.1,17,8,9,5,3,10,13,76.9,3,14,6,8,8,25,12,0,Matches
732,Radu Drăgușin,ro ROU,"DF,MF",Tottenham,eng Premier League,22-035,2002,0.1,0,0,0,0,0,0,0,,0,0,0,0,2,2,2,0,Matches
733,Radu Drăgușin,ro ROU,DF,Genoa,it Serie A,22-035,2002,19.0,16,11,9,6,1,8,9,88.9,1,18,12,6,21,37,87,3,Matches
734,Dion Drena Beljo,hr CRO,"FW,MF",Augsburg,de Bundesliga,22-008,2002,5.2,0,0,0,0,0,0,1,0.0,1,8,1,7,1,1,3,0,Matches
735,Domingos Duarte,pt POR,DF,Getafe,es La Liga,28-365,1995,10.1,7,4,6,0,1,5,7,71.4,2,7,5,2,8,15,27,0,Matches
736,Rubén Duarte,es ESP,DF,Alavés,es La Liga,28-143,1995,16.0,32,19,16,14,2,15,22,68.2,7,17,5,12,20,52,52,0,Matches
737,Martin Dúbravka,sk SVK,GK,Newcastle Utd,eng Premier League,35-054,1989,12.1,0,0,0,0,0,0,2,0.0,2,0,0,0,0,0,4,1,Matches
738,Marvin Ducksch,de GER,FW,Werder Bremen,de Bundesliga,30-002,1994,20.2,8,3,4,3,1,6,12,50.0,6,0,0,0,2,10,19,0,Matches
739,Ondrej Duda,sk SVK,MF,Hellas Verona,it Serie A,29-095,1994,20.4,44,28,14,27,3,23,42,54.8,19,21,8,13,17,61,13,0,Matches
740,Denzel Dumfries,nl NED,DF,Inter,it Serie A,27-326,1996,14.9,19,12,7,10,2,7,18,38.9,11,15,6,9,9,28,27,0,Matches
741,Paul Dummett,wls WAL,DF,Newcastle Utd,eng Premier League,32-165,1991,0.1,1,0,1,0,0,1,1,100.0,0,0,0,0,0,1,0,0,Matches
742,Alfred Duncan,gh GHA,MF,Fiorentina,it Serie A,30-365,1993,15.8,27,17,8,13,6,13,28,46.4,15,21,4,17,10,37,11,0,Matches
743,Lewis Dunk,eng ENG,DF,Brighton,eng Premier League,32-109,1991,22.4,19,10,12,6,1,7,27,25.9,20,35,27,8,19,38,48,1,Matches
744,Jhon Durán,co COL,"FW,MF",Aston Villa,eng Premier League,20-087,2003,2.1,3,3,1,1,1,0,3,0.0,3,3,0,3,0,3,7,0,Matches
745,Julien Duranville,be BEL,MF,Dortmund,de Bundesliga,17-309,2006,0.0,1,0,0,1,0,1,1,100.0,0,0,0,0,0,1,0,0,Matches
746,Hugo Duro,es ESP,FW,Valencia,es La Liga,24-120,1999,24.0,11,6,3,5,3,6,22,27.3,16,17,3,14,4,15,18,0,Matches
747,Jean-Kevin Duverne,ht HAI,DF,Nantes,fr Ligue 1,26-241,1997,12.9,31,17,14,14,3,15,39,38.5,24,14,5,9,17,48,27,0,Matches
748,Paulo Dybala,ar ARG,"FW,MF",Roma,it Serie A,30-115,1993,15.8,17,11,3,5,9,1,9,11.1,8,8,0,8,3,20,3,0,Matches
749,Aron Dønnum,no NOR,"FW,MF",Toulouse,fr Ligue 1,25-324,1998,14.0,13,8,2,7,4,5,19,26.3,14,11,0,11,8,21,15,1,Matches
750,Simon Ebonog,cm CMR,MF,Le Havre,fr Ligue 1,19-206,2004,0.2,1,1,0,1,0,1,1,100.0,0,1,1,0,0,1,1,0,Matches
751,Festy Ebosele,ie IRL,DF,Udinese,it Serie A,21-220,2002,17.6,32,20,22,9,1,20,34,58.8,14,29,1,28,7,39,27,0,Matches
752,Enzo Ebosse,cm CMR,DF,Udinese,it Serie A,24-364,1999,0.1,1,1,1,0,0,0,1,0.0,1,0,0,0,1,2,0,0,Matches
753,Tyronne Ebuehi,ng NGA,DF,Empoli,it Serie A,28-084,1995,11.9,14,9,9,5,0,7,11,63.6,4,9,4,5,6,20,27,0,Matches
754,Ederson,br BRA,GK,Manchester City,eng Premier League,30-205,1993,25.1,0,0,0,0,0,0,1,0.0,1,0,0,0,0,0,6,1,Matches
755,Éderson,br BRA,MF,Atalanta,it Serie A,24-246,1999,23.8,66,41,28,31,7,36,50,72.0,14,38,5,33,32,98,23,1,Matches
756,Odsonne Édouard,fr FRA,"FW,MF",Crystal Palace,eng Premier League,26-053,1998,15.7,19,10,7,5,7,3,17,17.6,14,14,1,13,5,24,19,0,Matches
757,John Egan,ie IRL,DF,Sheffield Utd,eng Premier League,31-141,1992,5.4,6,4,4,2,0,4,11,36.4,7,10,4,6,13,19,39,1,Matches
758,Maximilian Eggestein,de GER,MF,Freiburg,de Bundesliga,27-092,1996,23.4,30,13,16,11,3,5,23,21.7,18,38,15,23,22,52,30,0,Matches
759,Lilian Egloff,de GER,"MF,DF",Stuttgart,de Bundesliga,21-202,2002,1.2,4,1,3,1,0,2,4,50.0,2,3,1,2,1,5,0,0,Matches
760,Kingsley Ehizibue,nl NED,DF,Udinese,it Serie A,28-289,1995,4.5,7,6,6,1,0,4,5,80.0,1,6,3,3,5,12,14,0,Matches
761,Hjalmar Ekdal,se SWE,DF,Burnley,eng Premier League,25-140,1998,3.6,2,1,1,1,0,0,1,0.0,1,4,2,2,4,6,17,0,Matches
762,Hugo Ekitike,fr FRA,FW,Paris S-G,fr Ligue 1,21-263,2002,0.1,0,0,0,0,0,0,0,,0,0,0,0,0,0,0,0,Matches
763,Hugo Ekitike,fr FRA,FW,Eint Frankfurt,de Bundesliga,21-263,2002,1.8,4,4,1,3,0,1,1,100.0,0,4,0,4,0,4,2,0,Matches
764,Emmanuel Ekong,se SWE,FW,Empoli,it Serie A,21-258,2002,0.1,0,0,0,0,0,0,0,,0,0,0,0,0,0,0,0,Matches
765,Caleb Ekuban,gh GHA,"FW,MF",Genoa,it Serie A,29-352,1994,8.0,6,3,1,3,2,3,5,60.0,2,10,3,7,0,6,6,0,Matches
766,Anthony Elanga,se SWE,FW,Nott'ham Forest,eng Premier League,21-317,2002,20.1,28,17,16,6,6,14,28,50.0,14,20,2,18,7,35,15,1,Matches
767,Simon Elisor,fr FRA,FW,Metz,fr Ligue 1,24-231,1999,8.5,9,2,3,2,4,2,6,33.3,4,6,1,5,0,9,9,0,Matches
768,Harvey Elliott,eng ENG,"MF,FW",Liverpool,eng Premier League,20-340,2003,8.3,15,11,3,9,3,6,18,33.3,12,13,0,13,4,19,6,0,Matches
769,Elif Elmas,mk MKD,"FW,MF",Napoli,it Serie A,24-167,1999,3.8,4,3,1,3,0,2,2,100.0,0,2,0,2,2,6,8,0,Matches
770,Elif Elmas,mk MKD,MF,RB Leipzig,de Bundesliga,24-167,1999,1.0,3,1,1,1,1,3,5,60.0,2,2,0,2,1,4,1,0,Matches
771,Mohamed Elneny,eg EGY,MF,Arsenal,eng Premier League,31-242,1992,0.3,0,0,0,0,0,0,1,0.0,1,0,0,0,1,1,0,0,Matches
772,Aritz Elustondo,es ESP,DF,Real Sociedad,es La Liga,29-347,1994,5.5,6,4,1,4,1,5,8,62.5,3,6,5,1,5,11,15,0,Matches
773,Nico Elvedi,ch SUI,DF,M'Gladbach,de Bundesliga,27-161,1996,18.9,23,11,16,6,1,14,17,82.4,3,23,15,8,29,52,95,1,Matches
774,Adri Embarba,es ESP,"FW,MF",Almería,es La Liga,31-307,1992,18.1,38,24,22,7,9,16,33,48.5,17,20,0,20,9,47,8,0,Matches
775,Emanuel Emegha,nl NED,FW,Strasbourg,fr Ligue 1,21-035,2003,16.2,7,4,2,3,2,4,8,50.0,4,8,2,6,2,9,19,0,Matches
776,Emerson,br BRA,DF,Tottenham,eng Premier League,25-055,1999,10.7,31,21,19,9,3,19,35,54.3,16,17,8,9,18,49,45,1,Matches
777,Youssef En-Nesyri,ma MAR,FW,Sevilla,es La Liga,26-282,1997,18.2,7,5,2,3,2,0,5,0.0,5,6,0,6,4,11,15,1,Matches
778,Julio Enciso,py PAR,"MF,FW",Brighton,eng Premier League,20-046,2004,1.5,0,0,0,0,0,0,2,0.0,2,2,0,2,0,0,0,0,Matches
779,Wataru Endo,jp JPN,MF,Liverpool,eng Premier League,31-029,1993,11.2,26,16,7,15,4,11,35,31.4,24,15,2,13,10,36,19,1,Matches
780,Arne Engels,be BEL,"MF,DF",Augsburg,de Bundesliga,20-183,2003,11.2,18,11,5,10,3,7,21,33.3,14,18,1,17,7,25,13,0,Matches
781,Christian Eriksen,dk DEN,MF,Manchester Utd,eng Premier League,32-024,1992,9.9,14,12,4,7,3,8,27,29.6,19,14,5,9,3,17,10,0,Matches
782,Martin Erlic,hr CRO,DF,Sassuolo,it Serie A,26-045,1998,21.2,30,16,23,5,2,18,25,72.0,7,20,11,9,21,51,94,1,Matches
783,Gonzalo Escalante,ar ARG,MF,Cádiz,es La Liga,30-348,1993,13.7,29,18,13,10,6,16,39,41.0,23,16,4,12,19,48,28,1,Matches
784,Alfonso Espino,uy URU,DF,Rayo Vallecano,es La Liga,32-064,1992,23.6,56,37,33,21,2,25,67,37.3,42,19,1,18,35,91,52,0,Matches
785,Bernardo Espinosa,co COL,DF,Girona,es La Liga,34-242,1989,0.0,1,1,1,0,0,1,1,100.0,0,0,0,0,0,1,2,0,Matches
786,Maxime Estève,fr FRA,DF,Burnley,eng Premier League,21-288,2002,4.1,6,4,3,3,0,4,7,57.1,3,5,3,2,3,9,21,0,Matches
787,Maxime Estève,fr FRA,DF,Montpellier,fr Ligue 1,21-288,2002,11.1,16,12,11,5,0,10,15,66.7,5,13,9,4,18,34,50,0,Matches
788,Oscar Estupiñan,co COL,FW,Metz,fr Ligue 1,27-071,1996,2.9,5,4,0,3,2,1,2,50.0,1,2,0,2,0,5,0,0,Matches
789,Pervis Estupiñán,ec ECU,DF,Brighton,eng Premier League,26-048,1998,10.9,18,8,7,9,2,9,21,42.9,12,11,2,9,17,35,14,0,Matches
790,Karl Etta,cm CMR,FW,Cádiz,es La Liga,20-068,2004,0.2,1,1,0,1,0,0,0,,0,0,0,0,0,1,0,0,Matches
791,Jonny Evans,nir NIR,DF,Manchester Utd,eng Premier League,36-066,1988,11.1,12,7,10,2,0,9,16,56.3,7,15,10,5,15,27,61,0,Matches
792,Eberechi Eze,eng ENG,"MF,FW",Crystal Palace,eng Premier League,25-254,1998,13.6,23,9,1,11,11,10,21,47.6,11,11,1,10,6,29,4,0,Matches
793,Abdessamad Ezzalzouli,ma MAR,"FW,MF",Barcelona,es La Liga,22-083,2001,0.8,1,1,0,0,1,0,1,0.0,1,1,0,1,0,1,0,0,Matches
794,Abdessamad Ezzalzouli,ma MAR,FW,Betis,es La Liga,22-083,2001,7.5,11,10,3,5,3,4,11,36.4,7,8,0,8,4,15,3,0,Matches
795,Giovanni Fabbian,it ITA,"MF,FW",Bologna,it Serie A,21-055,2003,9.3,13,6,6,7,0,6,10,60.0,4,4,2,2,7,20,9,0,Matches
796,Łukasz Fabiański,pl POL,GK,West Ham,eng Premier League,38-326,1985,3.5,1,0,1,0,0,1,1,100.0,0,0,0,0,1,2,0,0,Matches
797,Nicolò Fagioli,it ITA,MF,Juventus,it Serie A,23-026,2001,3.8,4,2,1,2,1,2,5,40.0,3,3,0,3,3,7,0,0,Matches
798,Romain Faivre,fr FRA,"MF,DF",Bournemouth,eng Premier League,25-239,1998,0.2,1,1,0,1,0,0,3,0.0,3,0,0,0,0,1,0,0,Matches
799,Romain Faivre,fr FRA,"MF,FW",Lorient,fr Ligue 1,25-239,1998,16.1,13,6,5,4,4,6,15,40.0,9,6,1,5,7,20,3,1,Matches
800,Radamel Falcao,co COL,"FW,DF",Rayo Vallecano,es La Liga,38-028,1986,2.5,5,4,0,5,0,0,1,0.0,1,1,0,1,1,6,3,0,Matches
801,Wladimiro Falcone,it ITA,GK,Lecce,it Serie A,28-332,1995,27.0,0,0,0,0,0,0,0,,0,1,0,1,1,1,12,2,Matches
802,Fali,es ESP,DF,Cádiz,es La Liga,30-210,1993,21.6,29,17,20,8,1,14,26,53.8,12,30,20,10,20,49,87,0,Matches
803,Davide Faraoni,it ITA,DF,Hellas Verona,it Serie A,32-136,1991,6.7,13,10,5,6,2,7,10,70.0,3,9,5,4,6,19,21,0,Matches
804,Davide Faraoni,it ITA,DF,Fiorentina,it Serie A,32-136,1991,3.2,9,4,5,2,2,5,10,50.0,5,2,1,1,5,14,10,0,Matches
805,Ansu Fati,es ESP,"MF,FW",Brighton,eng Premier League,21-130,2002,4.6,3,1,1,1,1,0,7,0.0,7,6,0,6,2,5,2,0,Matches
806,Ansu Fati,es ESP,"MF,FW",Barcelona,es La Liga,21-130,2002,0.6,0,0,0,0,0,0,1,0.0,1,0,0,0,0,0,0,0,Matches
807,Khalil Fayad,fr FRA,"FW,MF",Montpellier,fr Ligue 1,19-274,2004,9.3,22,13,15,4,3,8,21,38.1,13,11,0,11,11,33,3,0,Matches
808,Federico Fazio,ar ARG,DF,Salernitana,it Serie A,36-358,1987,9.3,11,8,9,2,0,4,9,44.4,5,16,13,3,8,19,63,0,Matches
809,Jacopo Fazzini,it ITA,MF,Empoli,it Serie A,20-359,2003,9.7,37,19,21,10,6,23,43,53.5,20,17,1,16,8,45,13,0,Matches
810,Nabil Fekir,fr FRA,"MF,FW",Betis,es La Liga,30-235,1993,5.5,8,5,3,3,2,4,6,66.7,2,5,0,5,4,12,0,0,Matches
811,Felipe,br BRA,DF,Nott'ham Forest,eng Premier League,34-298,1989,3.0,9,6,6,3,0,7,9,77.8,2,2,1,1,1,10,6,0,Matches
812,Luiz Felipe,it ITA,DF,Betis,es La Liga,26-353,1997,4.0,7,3,5,2,0,4,5,80.0,1,10,4,6,4,11,16,0,Matches
813,João Félix,pt POR,FW,Barcelona,es La Liga,24-120,1999,13.4,18,13,9,4,5,6,16,37.5,10,13,1,12,8,26,6,0,Matches
814,Ohis Felix Uduokhai,de GER,DF,Augsburg,de Bundesliga,26-182,1997,22.5,24,12,12,9,3,9,17,52.9,8,19,13,6,36,60,128,1,Matches
815,Kiko Femenía,es ESP,DF,Villarreal,es La Liga,33-036,1991,8.6,18,13,10,7,1,12,21,57.1,9,10,4,6,15,33,19,0,Matches
816,Evan Ferguson,ie IRL,FW,Brighton,eng Premier League,19-142,2004,14.4,13,6,3,7,3,5,14,35.7,9,10,3,7,2,15,6,0,Matches
817,Lewis Ferguson,sct SCO,MF,Bologna,it Serie A,24-198,1999,25.8,36,20,15,17,4,15,32,46.9,17,15,6,9,14,50,24,1,Matches
818,Bruno Fernandes,pt POR,"MF,FW",Manchester Utd,eng Premier League,29-183,1994,26.0,56,33,22,20,14,26,76,34.2,50,34,4,30,20,76,35,1,Matches
819,Edimilson Fernandes,ch SUI,DF,Mainz 05,de Bundesliga,27-329,1996,11.8,19,12,12,6,1,13,20,65.0,7,10,4,6,21,40,44,0,Matches
820,Aitor Fernández,es ESP,GK,Osasuna,es La Liga,32-311,1991,4.1,0,0,0,0,0,0,1,0.0,1,0,0,0,0,0,2,1,Matches
821,Álex Fernández,es ESP,"MF,FW",Cádiz,es La Liga,31-146,1992,9.8,10,3,7,3,0,7,13,53.8,6,11,4,7,11,21,23,0,Matches
822,Carlos Fernández,es ESP,FW,Real Sociedad,es La Liga,27-292,1996,4.5,11,7,3,6,2,0,2,0.0,2,4,0,4,0,11,5,0,Matches
823,Enzo Fernández,ar ARG,MF,Chelsea,eng Premier League,23-052,2001,19.8,44,21,19,15,10,23,52,44.2,29,33,12,21,15,59,23,0,Matches
824,Raúl Fernández,es ESP,GK,Granada,es La Liga,35-362,1988,3.1,0,0,0,0,0,0,1,0.0,1,0,0,0,0,0,1,2,Matches
825,Valery Fernández,es ESP,"MF,DF",Girona,es La Liga,24-107,1999,5.0,9,7,4,5,0,4,6,66.7,2,6,1,5,1,10,3,0,Matches
826,Fernando,es ESP,GK,Almería,es La Liga,33-273,1990,2.0,0,0,0,0,0,0,0,,0,1,0,1,0,0,1,0,Matches
827,Fernando,br BRA,MF,Sevilla,es La Liga,36-228,1987,5.1,9,8,2,4,3,5,9,55.6,4,2,0,2,7,16,9,0,Matches
828,Ichem Ferrah,fr FRA,FW,Lille,fr Ligue 1,18-168,2005,0.0,0,0,0,0,0,0,0,,0,0,0,0,0,0,0,0,Matches
829,André Ferreira,pt POR,GK,Granada,es La Liga,27-285,1996,14.9,0,0,0,0,0,0,1,0.0,1,0,0,0,0,0,9,2,Matches
830,João Ferreira,pt POR,DF,Udinese,it Serie A,22-353,2001,15.5,42,31,29,11,2,24,39,61.5,15,20,5,15,23,65,61,0,Matches
831,Jordan Ferri,fr FRA,MF,Montpellier,fr Ligue 1,31-363,1992,17.9,27,14,12,14,1,16,51,31.4,35,16,1,15,13,40,21,0,Matches
832,Nacho Ferri,es ESP,"FW,MF",Eint Frankfurt,de Bundesliga,19-156,2004,0.6,3,3,1,2,0,2,2,100.0,0,0,0,0,0,3,2,0,Matches
833,Rachad Fettal,ma MAR,FW,Almería,es La Liga,19-053,2005,0.2,,0,,,,,,,,,,,0,,,,Matches
834,Seydou Fini,it ITA,"DF,FW",Genoa,it Serie A,17-281,2006,0.4,0,0,0,0,0,0,0,,0,0,0,0,0,0,0,0,Matches
835,Max Finkgräfe,de GER,DF,Köln,de Bundesliga,19-348,2004,11.0,39,22,24,15,0,23,46,50.0,23,24,4,20,14,53,26,0,Matches
836,Kilian Fischer,de GER,DF,Wolfsburg,de Bundesliga,23-149,2000,0.1,0,0,0,0,0,0,0,,0,0,0,0,0,0,0,0,Matches
837,John Fleck,sct SCO,"MF,DF",Sheffield Utd,eng Premier League,32-198,1991,1.0,1,0,0,1,0,0,1,0.0,1,0,0,0,0,1,1,0,Matches
838,Mark Flekken,nl NED,GK,Brentford,eng Premier League,30-270,1993,25.5,0,0,0,0,0,0,3,0.0,3,1,0,1,0,0,8,0,Matches
839,Alessandro Florenzi,it ITA,DF,Milan,it Serie A,32-364,1991,13.3,35,17,21,10,4,20,41,48.8,21,13,7,6,15,50,18,1,Matches
840,Phil Foden,eng ENG,"FW,MF",Manchester City,eng Premier League,23-286,2000,24.7,23,13,10,7,6,12,24,50.0,12,21,0,21,13,36,14,1,Matches
841,Wes Foderingham,eng ENG,GK,Sheffield Utd,eng Premier League,33-055,1991,24.4,3,1,3,0,0,3,4,75.0,1,0,0,0,0,3,12,6,Matches
842,Malick Fofana,be BEL,"FW,DF",Lyon,fr Ligue 1,18-344,2005,2.1,2,2,1,0,1,2,2,100.0,0,2,0,2,3,5,2,0,Matches
843,Youssouf Fofana,fr FRA,MF,Monaco,fr Ligue 1,25-059,1999,21.5,40,25,10,24,6,22,47,46.8,25,25,6,19,24,64,20,1,Matches
844,Jonas Föhrenbach,de GER,DF,Heidenheim,de Bundesliga,28-043,1996,21.9,30,19,18,8,4,14,29,48.3,15,26,16,10,20,50,46,0,Matches
845,Thomas Foket,be BEL,DF,Reims,fr Ligue 1,29-166,1994,17.0,27,13,18,6,3,17,37,45.9,20,30,9,21,20,47,27,0,Matches
846,Michael Folorunsho,ng NGA,"MF,FW",Hellas Verona,it Serie A,26-031,1998,23.4,40,24,17,16,7,17,50,34.0,33,38,10,28,17,57,33,2,Matches
847,Tiago Fonseca Morais,pt POR,FW,Lille,fr Ligue 1,20-188,2003,0.5,1,1,0,1,0,0,0,,0,0,0,0,0,1,0,0,Matches
848,Pablo Fornals,es ESP,"MF,FW",West Ham,eng Premier League,28-016,1996,4.7,10,6,4,3,3,5,16,31.3,11,8,1,7,6,16,7,0,Matches
849,Pablo Fornals,es ESP,"FW,MF",Betis,es La Liga,28-016,1996,4.3,3,3,0,2,1,2,4,50.0,2,6,0,6,7,10,2,1,Matches
850,Emil Forsberg,se SWE,"MF,FW",RB Leipzig,de Bundesliga,32-138,1991,5.2,7,3,2,5,0,5,12,41.7,7,7,0,7,0,7,5,0,Matches
851,Omari Forson,eng ENG,FW,Manchester Utd,eng Premier League,19-233,2004,0.7,2,0,0,2,0,1,1,100.0,0,0,0,0,0,2,0,0,Matches
852,Philipp Förster,de GER,"MF,FW",Bochum,de Bundesliga,29-034,1995,3.6,8,5,3,3,2,2,4,50.0,2,3,0,3,6,14,2,0,Matches
853,Héctor Fort,es ESP,DF,Barcelona,es La Liga,17-220,2006,1.1,2,1,2,0,0,2,5,40.0,3,0,0,0,2,4,1,0,Matches
854,Lyle Foster,za RSA,FW,Burnley,eng Premier League,23-188,2000,12.5,15,7,3,5,7,4,12,33.3,8,11,3,8,2,17,19,0,Matches
855,Dimitri Foulquier,fr FRA,"DF,MF",Valencia,es La Liga,30-352,1993,13.3,28,16,16,9,3,15,20,75.0,5,7,0,7,10,38,31,1,Matches
856,Juan Foyth,ar ARG,DF,Villarreal,es La Liga,26-057,1998,11.8,26,15,18,8,0,12,27,44.4,15,17,4,13,12,38,44,0,Matches
857,Matheus França,br BRA,"MF,FW",Crystal Palace,eng Premier League,19-343,2004,2.6,3,3,2,1,0,1,7,14.3,6,4,0,4,1,4,1,0,Matches
858,Bartol Franjić,hr CRO,MF,Darmstadt 98,de Bundesliga,24-055,2000,10.9,11,9,2,8,1,5,18,27.8,13,9,2,7,26,37,22,1,Matches
859,Przemysław Frankowski,pl POL,DF,Lens,fr Ligue 1,28-332,1995,15.7,33,21,12,15,6,15,44,34.1,29,20,5,15,12,45,22,0,Matches
860,Nathan Fraser,ie IRL,FW,Wolves,eng Premier League,19-016,2005,1.1,1,0,0,1,0,0,2,0.0,2,2,1,1,0,1,1,0,Matches
861,Davide Frattesi,it ITA,MF,Inter,it Serie A,24-139,1999,6.2,4,1,2,2,0,1,3,33.3,2,3,0,3,2,6,11,0,Matches
862,Jean Frederic N'Guessan,ci CIV,"MF,FW",Metz,fr Ligue 1,20-327,2003,1.2,3,1,0,3,0,0,3,0.0,3,3,0,3,1,4,0,0,Matches
863,Morten Frendrup,dk DEN,MF,Genoa,it Serie A,22-337,2001,24.7,98,51,32,53,13,44,67,65.7,23,39,8,31,32,130,28,1,Matches
864,Remo Freuler,ch SUI,MF,Bologna,it Serie A,31-329,1992,19.6,54,32,28,21,5,25,46,54.3,21,24,6,18,23,77,34,2,Matches
865,Marco Friedl,at AUT,DF,Werder Bremen,de Bundesliga,25-359,1998,17.4,36,23,24,12,0,28,38,73.7,10,38,24,14,24,60,95,0,Matches
866,Marvin Friedrich,de GER,DF,M'Gladbach,de Bundesliga,28-087,1995,10.7,16,10,13,2,1,8,11,72.7,3,22,16,6,8,24,59,0,Matches
867,Jeremie Frimpong,nl NED,DF,Leverkusen,de Bundesliga,23-090,2000,19.6,20,12,9,6,5,6,17,35.3,11,23,0,23,6,26,12,0,Matches
868,Jorge de Frutos,es ESP,"MF,FW",Rayo Vallecano,es La Liga,27-018,1997,8.8,5,1,1,3,1,1,9,11.1,8,7,0,7,4,9,8,0,Matches
869,Chris Führich,de GER,"FW,MF",Stuttgart,de Bundesliga,26-060,1998,21.9,21,15,4,10,7,13,33,39.4,20,22,0,22,6,27,4,0,Matches
870,Shiō Fukuda,jp JPN,"MF,FW",M'Gladbach,de Bundesliga,19-336,2004,0.3,1,0,1,0,0,0,0,,0,0,0,0,0,1,0,0,Matches
871,Angelo Fulgini,fr FRA,MF,Lens,fr Ligue 1,27-202,1996,10.4,14,7,3,8,3,6,12,50.0,6,15,0,15,3,17,8,0,Matches
872,Niclas Füllkrug,de GER,FW,Werder Bremen,de Bundesliga,31-029,1993,2.0,1,1,0,1,0,1,1,100.0,0,2,1,1,0,1,1,0,Matches
873,Niclas Füllkrug,de GER,FW,Dortmund,de Bundesliga,31-029,1993,18.7,7,2,1,6,0,2,5,40.0,3,12,3,9,1,8,20,0,Matches
874,Matteo Gabbia,it ITA,DF,Milan,it Serie A,24-140,1999,8.0,17,15,10,6,1,11,14,78.6,3,7,3,4,6,23,28,0,Matches
875,Matteo Gabbia,it ITA,DF,Villarreal,es La Liga,24-140,1999,5.3,10,6,4,6,0,5,8,62.5,3,5,2,3,8,18,36,1,Matches
876,Gianluca Gaetano,it ITA,"FW,MF",Cagliari,it Serie A,23-309,2000,3.9,3,1,0,2,1,0,3,0.0,3,1,0,1,2,5,2,0,Matches
877,Gianluca Gaetano,it ITA,MF,Napoli,it Serie A,23-309,2000,1.8,4,1,0,4,0,2,4,50.0,2,5,2,3,1,5,4,0,Matches
878,Roberto Gagliardini,it ITA,"MF,DF",Monza,it Serie A,29-337,1994,21.3,50,26,22,21,7,25,39,64.1,14,25,7,18,28,78,32,0,Matches
879,Cody Gakpo,nl NED,"FW,MF",Liverpool,eng Premier League,24-307,1999,12.8,18,11,5,9,4,4,14,28.6,10,18,4,14,8,26,7,0,Matches
880,Javi Galán,es ESP,DF,Atlético Madrid,es La Liga,29-111,1994,1.0,5,4,2,2,1,4,5,80.0,1,1,0,1,1,6,3,0,Matches
881,Javi Galán,es ESP,DF,Real Sociedad,es La Liga,29-111,1994,5.1,18,11,7,8,3,6,12,50.0,6,12,1,11,7,25,5,0,Matches
882,Iñigo Ruiz de Galarreta,es ESP,MF,Athletic Club,es La Liga,30-216,1993,17.2,38,23,9,22,7,18,37,48.6,19,11,2,9,10,48,14,0,Matches
883,Pablo Galdames Millán,cl CHI,"MF,DF",Genoa,it Serie A,27-070,1996,0.1,0,0,0,0,0,0,0,,0,1,0,1,0,0,0,0,Matches
884,Conor Gallagher,eng ENG,MF,Chelsea,eng Premier League,24-032,2000,23.2,65,38,25,27,13,25,52,48.1,27,38,8,30,32,97,13,0,Matches
885,Antonino Gallo,it ITA,DF,Lecce,it Serie A,24-064,2000,17.5,27,19,19,7,1,22,33,66.7,11,23,6,17,14,41,47,0,Matches
886,Cristian Gamboa,cr CRC,DF,Bochum,de Bundesliga,34-137,1989,12.7,22,16,10,11,1,12,31,38.7,19,18,6,12,14,36,33,1,Matches
887,Kévin Gameiro,fr FRA,"FW,MF",Strasbourg,fr Ligue 1,36-305,1987,10.3,10,10,5,3,2,2,14,14.3,12,7,0,7,2,12,4,0,Matches
888,Idrissa Gana Gueye,sn SEN,MF,Everton,eng Premier League,34-165,1989,14.5,53,36,22,19,12,20,36,55.6,16,16,3,13,19,72,10,0,Matches
889,Ignatius Ganago,cm CMR,"FW,MF",Nantes,fr Ligue 1,25-022,1999,2.0,0,0,0,0,0,0,1,0.0,1,1,0,1,1,1,1,0,Matches
890,Aleix García,es ESP,MF,Girona,es La Liga,26-255,1997,25.8,36,21,11,20,5,19,37,51.4,18,34,13,21,30,66,38,3,Matches
891,Álvaro García,es ESP,"FW,MF",Rayo Vallecano,es La Liga,31-134,1992,21.9,26,19,12,8,6,6,29,20.7,23,24,0,24,28,54,30,0,Matches
892,Dani García,es ESP,MF,Athletic Club,es La Liga,33-290,1990,5.8,10,5,1,5,4,8,18,44.4,10,7,1,6,6,16,6,0,Matches
893,David García,es ESP,DF,Osasuna,es La Liga,30-024,1994,24.7,27,18,19,7,1,15,25,60.0,10,40,19,21,16,43,113,2,Matches
894,Eric García,es ESP,DF,Barcelona,es La Liga,23-060,2001,0.6,0,0,0,0,0,0,0,,0,1,1,0,0,0,0,0,Matches
895,Eric García,es ESP,DF,Girona,es La Liga,23-060,2001,18.6,29,20,16,10,3,17,25,68.0,8,20,12,8,20,49,50,2,Matches
896,Fran Garcia,es ESP,DF,Real Madrid,es La Liga,24-208,1999,11.4,15,10,5,8,2,7,19,36.8,12,11,2,9,15,30,16,1,Matches
897,Francisco Jesús Crespo García,es ESP,FW,Las Palmas,es La Liga,27-224,1996,5.3,12,8,3,6,3,6,18,33.3,12,4,0,4,2,14,5,0,Matches
898,Gonzalo García,es ESP,"FW,MF",Real Madrid,es La Liga,19-351,2004,0.2,0,0,0,0,0,0,1,0.0,1,1,1,0,0,0,1,0,Matches
899,Raúl García,es ESP,"FW,MF",Athletic Club,es La Liga,37-242,1986,2.0,2,2,1,1,0,2,5,40.0,3,3,0,3,2,4,4,0,Matches
900,Rubén García,es ESP,FW,Osasuna,es La Liga,30-239,1993,9.9,13,10,2,9,2,5,17,29.4,12,17,3,14,8,21,10,0,Matches
901,Santiago García,,FW,Getafe,es La Liga,22-193,2001,0.3,1,0,0,0,1,1,1,100.0,0,0,0,0,0,1,0,0,Matches
902,Ulisses Garcia,ch SUI,DF,Marseille,fr Ligue 1,28-058,1996,2.7,9,8,3,6,0,5,6,83.3,1,2,0,2,2,11,5,1,Matches
903,Unai García,es ESP,DF,Osasuna,es La Liga,32-035,1992,3.9,10,7,7,2,1,4,4,100.0,0,4,1,3,5,15,12,0,Matches
904,Alejandro Garnacho,ar ARG,FW,Manchester Utd,eng Premier League,19-252,2004,18.7,16,11,5,4,7,8,35,22.9,27,19,1,18,13,29,18,0,Matches
905,James Garner,eng ENG,MF,Everton,eng Premier League,22-362,2001,24.9,66,34,27,29,10,28,69,40.6,41,36,10,26,37,103,38,1,Matches
906,Luca Garritano,it ITA,"MF,DF",Frosinone,it Serie A,30-027,1994,5.3,9,4,7,2,0,5,15,33.3,10,13,0,13,4,13,8,1,Matches
907,Johan Gastien,fr FRA,MF,Clermont Foot,fr Ligue 1,36-044,1988,16.8,28,14,13,13,2,19,58,32.8,39,20,6,14,21,49,18,2,Matches
908,Federico Gatti,it ITA,DF,Juventus,it Serie A,25-259,1998,20.8,22,13,11,10,1,14,19,73.7,5,16,10,6,13,35,68,1,Matches
909,Federico Gattoni,ar ARG,"DF,FW",Sevilla,es La Liga,25-022,1999,0.1,1,0,1,0,0,1,1,100.0,0,0,0,0,0,1,1,0,Matches
910,Gavi,es ESP,"MF,FW",Barcelona,es La Liga,19-217,2004,10.5,39,21,20,14,5,18,36,50.0,18,19,3,16,8,47,16,1,Matches
911,Paulo Gazzaniga,ar ARG,GK,Girona,es La Liga,32-067,1992,27.0,2,2,2,0,0,2,3,66.7,1,0,0,0,0,2,9,1,Matches
912,Yann Gboho,fr FRA,"MF,FW",Toulouse,fr Ligue 1,23-055,2001,4.7,6,2,3,3,0,5,8,62.5,3,8,0,8,2,8,0,0,Matches
913,Dennis Geiger,de GER,MF,Hoffenheim,de Bundesliga,25-273,1998,0.5,1,0,1,0,0,0,0,,0,1,1,0,0,1,0,0,Matches
914,Gelabert,es ESP,"MF,FW",Toulouse,fr Ligue 1,23-130,2000,8.4,14,8,5,6,3,7,20,35.0,13,8,2,6,5,19,8,0,Matches
915,Francesco Gelli,it ITA,"MF,DF",Frosinone,it Serie A,27-146,1996,15.4,17,11,8,2,7,9,18,50.0,9,14,2,12,11,28,25,1,Matches
916,Luca Gemello,it ITA,GK,Torino,it Serie A,23-250,2000,1.0,0,0,0,0,0,0,1,0.0,1,0,0,0,0,0,1,0,Matches
917,Valentin Gendrey,fr FRA,DF,Lecce,it Serie A,23-262,2000,24.5,41,23,27,11,3,23,33,69.7,10,24,5,19,30,71,72,0,Matches
918,Denis Genreau,au AUS,"FW,MF",Toulouse,fr Ligue 1,24-293,1999,4.8,11,8,5,6,0,8,13,61.5,5,8,1,7,4,15,8,0,Matches
919,Yannick Gerhardt,de GER,MF,Wolfsburg,de Bundesliga,29-362,1994,11.2,18,12,9,7,2,6,22,27.3,16,11,2,9,6,24,17,0,Matches
920,Anwar El Ghazi,nl NED,"MF,DF",Mainz 05,de Bundesliga,28-311,1995,0.6,0,0,0,0,0,0,1,0.0,1,0,0,0,0,0,0,0,Matches
921,Farés Ghedjemis,fr FRA,"MF,FW",Frosinone,it Serie A,21-185,2002,1.3,1,0,0,0,1,0,1,0.0,1,1,0,1,0,1,2,0,Matches
922,Saman Ghoddos,ir IRN,DF,Brentford,eng Premier League,30-185,1993,7.8,25,17,19,4,2,16,27,59.3,11,8,2,6,5,30,11,0,Matches
923,Lautaro Gianetti,ar ARG,DF,Udinese,it Serie A,30-117,1993,5.0,7,3,6,1,0,3,3,100.0,0,6,3,3,15,22,28,0,Matches
924,Morgan Gibbs-White,eng ENG,"MF,FW",Nott'ham Forest,eng Premier League,24-042,2000,24.6,28,19,5,14,9,12,25,48.0,13,19,4,15,11,39,17,0,Matches
925,Samuel Gigot,fr FRA,DF,Marseille,fr Ligue 1,30-149,1993,15.0,28,21,12,13,3,12,18,66.7,6,24,14,10,20,48,81,1,Matches
926,Bryan Gil,es ESP,"FW,MF",Tottenham,eng Premier League,23-027,2001,2.2,1,0,0,0,1,1,3,33.3,2,3,0,3,3,4,4,0,Matches
927,David Gil,es ESP,GK,Cádiz,es La Liga,30-058,1994,3.1,0,0,0,0,0,0,0,,0,0,0,0,0,0,3,0,Matches
928,Mario Gila,es ESP,DF,Lazio,it Serie A,23-193,2000,13.3,19,8,15,3,1,13,23,56.5,10,13,9,4,12,31,51,0,Matches
929,Alfie Gilchrist,eng ENG,"DF,FW",Chelsea,eng Premier League,20-102,2003,0.2,1,0,1,0,0,0,1,0.0,1,1,1,0,1,2,2,0,Matches
930,Billy Gilmour,sct SCO,MF,Brighton,eng Premier League,22-272,2001,19.8,21,14,13,6,2,9,30,30.0,21,21,8,13,8,29,14,1,Matches
931,Benedikt Gimber,de GER,DF,Heidenheim,de Bundesliga,27-019,1997,13.7,30,20,17,12,1,15,23,65.2,8,17,12,5,11,41,65,0,Matches
932,Gvidas Gineitis,lt LTU,MF,Torino,it Serie A,19-329,2004,5.0,9,6,2,7,0,4,7,57.1,3,8,4,4,3,12,9,1,Matches
933,Matthias Ginter,de GER,DF,Freiburg,de Bundesliga,30-050,1994,19.8,27,13,18,9,0,14,25,56.0,11,34,22,12,16,43,84,0,Matches
934,Olivier Giroud,fr FRA,FW,Milan,it Serie A,37-161,1986,20.0,13,8,5,5,3,1,8,12.5,7,14,3,11,4,17,19,0,Matches
935,Klaus Gjasula,al ALB,"DF,MF",Darmstadt 98,de Bundesliga,34-086,1989,11.0,34,18,17,17,0,12,20,60.0,8,18,11,7,13,47,37,2,Matches
936,Serge Gnabry,de GER,"FW,MF",Bayern Munich,de Bundesliga,28-239,1995,2.5,3,2,0,3,0,2,9,22.2,7,3,0,3,0,3,2,0,Matches
937,Ben Godfrey,eng ENG,DF,Everton,eng Premier League,26-054,1998,6.4,20,14,11,5,4,10,20,50.0,10,9,4,5,6,26,27,0,Matches
938,Edoardo Goldaniga,it ITA,DF,Cagliari,it Serie A,30-128,1993,11.2,12,7,9,3,0,4,10,40.0,6,11,7,4,15,27,37,1,Matches
939,Pierluigi Gollini,it ITA,GK,Napoli,it Serie A,28-357,1995,7.0,1,1,1,0,0,1,1,100.0,0,0,0,0,1,2,2,0,Matches
940,Aleksandr Golovin,ru RUS,"MF,FW",Monaco,fr Ligue 1,27-284,1996,20.0,34,23,10,19,5,12,35,34.3,23,30,2,28,19,53,9,0,Matches
941,André Gomes,pt POR,MF,Everton,eng Premier League,30-223,1993,1.9,1,1,1,0,0,0,1,0.0,1,6,0,6,1,2,0,0,Matches
942,Angel Gomes,eng ENG,MF,Lille,fr Ligue 1,23-191,2000,20.8,20,10,3,12,5,11,24,45.8,13,17,4,13,14,34,20,1,Matches
943,João Gomes,br BRA,MF,Wolves,eng Premier League,23-026,2001,19.2,80,46,45,28,7,29,64,45.3,35,40,3,37,15,95,16,2,Matches
944,Toti Gomes,pt POR,DF,Wolves,eng Premier League,25-053,1999,20.3,34,22,24,7,3,18,24,75.0,6,24,13,11,18,52,53,1,Matches
945,Joe Gomez,eng ENG,DF,Liverpool,eng Premier League,26-291,1997,15.1,35,21,18,12,5,24,49,49.0,25,18,3,15,13,48,40,2,Matches
946,Maxi Gómez,uy URU,FW,Cádiz,es La Liga,27-208,1996,9.8,3,2,1,1,1,2,2,100.0,0,4,3,1,2,5,3,0,Matches
947,Moi Gómez,es ESP,"MF,FW",Osasuna,es La Liga,29-260,1994,16.8,28,17,7,17,4,9,23,39.1,14,10,1,9,9,37,16,0,Matches
948,Papu Gómez,ar ARG,"MF,FW",Monza,it Serie A,36-023,1988,0.5,0,0,0,0,0,0,2,0.0,2,0,0,0,1,1,0,0,Matches
949,Sergio Gómez,es ESP,FW,Manchester City,eng Premier League,23-187,2000,0.2,0,0,0,0,0,0,0,,0,0,0,0,1,1,0,0,Matches
950,Unai Gómez,es ESP,MF,Athletic Club,es La Liga,20-289,2003,5.3,8,7,0,4,4,4,7,57.1,3,7,0,7,1,9,6,0,Matches
951,Iron Gomis,fr FRA,MF,Salernitana,it Serie A,24-122,1999,0.2,0,0,0,0,0,0,0,,0,0,0,0,0,0,1,0,Matches
952,Maxime Gonalons,fr FRA,MF,Clermont Foot,fr Ligue 1,34-365,1989,14.2,46,32,14,27,5,25,57,43.9,32,17,3,14,20,66,9,0,Matches
953,Édgar González,es ESP,DF,Almería,es La Liga,26-343,1997,21.1,35,17,16,16,3,18,32,56.3,14,37,20,17,27,62,100,1,Matches
954,Fabio González,es ESP,MF,Las Palmas,es La Liga,27-026,1997,0.0,0,0,0,0,0,0,0,,0,0,0,0,0,0,0,0,Matches
955,Giovanni González,uy URU,DF,Mallorca,es La Liga,29-171,1994,20.3,54,37,30,22,2,28,61,45.9,33,19,3,16,21,75,43,2,Matches
956,Hugo González,es ESP,"MF,FW",Valencia,es La Liga,21-031,2003,0.6,2,1,0,2,0,0,0,,0,0,0,0,0,2,0,0,Matches
957,Iñaki González,es ESP,MF,Las Palmas,es La Liga,19-226,2004,0.1,1,0,1,0,0,0,0,,0,0,0,0,0,1,1,0,Matches
958,Joan Gonzàlez,es ESP,MF,Lecce,it Serie A,22-037,2002,10.6,18,9,8,7,3,9,16,56.3,7,13,1,12,3,21,6,0,Matches
959,Nicolás González,ar ARG,FW,Fiorentina,it Serie A,25-338,1998,15.3,19,12,8,7,4,7,22,31.8,15,20,1,19,7,26,7,0,Matches
960,Peter González,do DOM,"FW,MF",Valencia,es La Liga,21-228,2002,0.8,1,1,0,0,1,0,3,0.0,3,2,0,2,0,1,0,0,Matches
961,Urko González,es ESP,MF,Real Sociedad,es La Liga,22-355,2001,1.7,4,1,0,3,1,2,2,100.0,0,1,0,1,0,4,6,0,Matches
962,Anthony Gordon,eng ENG,FW,Newcastle Utd,eng Premier League,23-014,2001,23.9,41,24,12,21,8,17,52,32.7,35,24,0,24,5,46,4,0,Matches
963,Kaide Gordon,eng ENG,FW,Liverpool,eng Premier League,19-156,2004,0.0,0,0,0,0,0,0,0,,0,0,0,0,0,0,0,0,Matches
964,Daniel Gore,eng ENG,MF,Manchester Utd,eng Premier League,19-165,2004,0.0,1,1,0,1,0,1,1,100.0,0,0,0,0,1,2,0,0,Matches
965,Leon Goretzka,de GER,MF,Bayern Munich,de Bundesliga,29-032,1995,16.4,20,11,10,6,4,9,25,36.0,16,25,3,22,20,40,32,1,Matches
966,Mathieu Gorgelin,fr FRA,GK,Le Havre,fr Ligue 1,33-217,1990,1.0,0,0,0,0,0,0,0,,0,0,0,0,0,0,0,0,Matches
967,Andoni Gorosabel,es ESP,DF,Alavés,es La Liga,27-218,1996,24.7,41,28,24,15,2,25,55,45.5,30,19,5,14,19,60,61,0,Matches
968,Robin Gosens,de GER,DF,Union Berlin,de Bundesliga,29-248,1994,18.0,45,30,18,24,3,23,35,65.7,12,38,7,31,28,73,53,0,Matches
969,Mario Götze,de GER,MF,Eint Frankfurt,de Bundesliga,31-280,1992,14.4,28,19,11,12,5,15,33,45.5,18,14,1,13,6,34,8,0,Matches
970,Amine Gouiri,dz ALG,"FW,MF",Rennes,fr Ligue 1,24-022,2000,16.0,16,9,4,8,4,7,14,50.0,7,14,0,14,9,25,7,0,Matches
971,Jeffrey Gouweleeuw,nl NED,DF,Augsburg,de Bundesliga,32-243,1991,18.8,25,17,9,14,2,12,16,75.0,4,31,16,15,24,49,75,0,Matches
972,Pablo Gozalbez,es ESP,"MF,FW",Valencia,es La Liga,22-314,2001,1.1,1,0,0,0,1,1,6,16.7,5,0,0,0,1,2,2,0,Matches
973,Jonathan Gradit,fr FRA,DF,Lens,fr Ligue 1,31-106,1992,16.4,25,13,12,11,2,13,26,50.0,13,19,9,10,32,57,36,0,Matches
974,Jens Grahl,de GER,GK,Eint Frankfurt,de Bundesliga,35-169,1988,2.0,0,0,0,0,0,0,0,,0,0,0,0,0,0,3,0,Matches
975,Samuel Grandsir,fr FRA,"MF,FW",Le Havre,fr Ligue 1,27-208,1996,5.7,13,9,3,8,2,5,15,33.3,10,4,0,4,3,16,3,1,Matches
976,Alberto Grassi,it ITA,MF,Empoli,it Serie A,29-002,1995,17.0,19,12,8,10,1,6,19,31.6,13,23,10,13,38,57,29,0,Matches
977,Ryan Gravenberch,nl NED,MF,Liverpool,eng Premier League,21-298,2002,9.4,20,9,5,9,6,7,21,33.3,14,14,1,13,11,31,11,0,Matches
978,Ryan Gravenberch,nl NED,FW,Bayern Munich,de Bundesliga,21-298,2002,0.1,0,0,0,0,0,0,0,,0,0,0,0,0,0,0,0,Matches
979,Adrian Grbić,at AUT,FW,Lorient,fr Ligue 1,27-218,1996,0.3,0,0,0,0,0,0,0,,0,0,0,0,0,0,0,0,Matches
980,Ivo Grbić,hr CRO,GK,Sheffield Utd,eng Premier League,28-051,1996,2.6,0,0,0,0,0,0,0,,0,0,0,0,0,0,0,0,Matches
981,Jack Grealish,eng ENG,FW,Manchester City,eng Premier League,28-181,1995,7.9,12,8,6,6,0,6,11,54.5,5,12,2,10,4,16,4,0,Matches
982,Mason Greenwood,eng ENG,"MF,FW",Getafe,es La Liga,22-160,2001,19.6,6,2,1,3,2,2,10,20.0,8,5,0,5,3,9,2,0,Matches
983,Michael Gregoritsch,at AUT,FW,Freiburg,de Bundesliga,29-326,1994,11.3,6,5,3,1,2,1,8,12.5,7,11,1,10,9,15,12,0,Matches
984,Antoine Griezmann,fr FRA,"FW,MF",Atlético Madrid,es La Liga,32-354,1991,21.6,24,13,7,12,5,10,31,32.3,21,24,2,22,9,33,16,0,Matches
985,Vincenzo Grifo,it ITA,"MF,FW",Freiburg,de Bundesliga,30-337,1993,18.8,21,15,8,9,4,11,24,45.8,13,16,0,16,9,30,12,0,Matches
986,Florian Grillitsch,at AUT,"MF,DF",Hoffenheim,de Bundesliga,28-215,1995,15.6,27,17,16,9,2,9,28,32.1,19,16,5,11,30,57,42,2,Matches
987,Álex Grimaldo,es ESP,DF,Leverkusen,de Bundesliga,28-171,1995,23.9,36,20,21,6,9,26,45,57.8,19,25,5,20,18,54,28,0,Matches
988,Christian Groß,de GER,"DF,MF",Werder Bremen,de Bundesliga,35-030,1989,7.1,13,9,7,6,0,6,17,35.3,11,11,3,8,12,25,14,1,Matches
989,Pascal Groß,de GER,"MF,DF",Brighton,eng Premier League,32-268,1991,23.6,48,30,20,16,12,20,47,42.6,27,32,6,26,16,64,22,3,Matches
990,Brajan Gruda,de GER,"MF,FW",Mainz 05,de Bundesliga,19-283,2004,11.7,14,10,2,7,5,10,18,55.6,8,14,0,14,4,18,4,0,Matches
991,Ilia Gruev,bg BUL,MF,Werder Bremen,de Bundesliga,23-308,2000,0.0,0,0,0,0,0,0,0,,0,0,0,0,0,0,0,0,Matches
992,Vicente Guaita,es ESP,GK,Celta Vigo,es La Liga,37-059,1987,17.7,1,1,1,0,0,1,1,100.0,0,0,0,0,0,1,6,0,Matches
993,Andrés Guardado,mx MEX,MF,Betis,es La Liga,37-163,1986,5.0,17,12,5,9,3,7,14,50.0,7,4,2,2,6,23,5,0,Matches
994,Sergi Guardiola,es ESP,"FW,MF",Cádiz,es La Liga,32-285,1991,4.1,6,4,1,3,2,3,5,60.0,2,7,0,7,0,6,4,0,Matches
995,Nemanja Gudelj,rs SRB,DF,Sevilla,es La Liga,32-114,1991,15.3,18,13,11,5,2,10,22,45.5,12,13,7,6,19,37,47,0,Matches
996,Gabriel Gudmundsson,se SWE,"DF,FW",Lille,fr Ligue 1,24-315,1999,10.6,17,13,6,10,1,11,16,68.8,5,10,3,7,13,30,20,0,Matches
997,Gonçalo Guedes,pt POR,"FW,MF",Villarreal,es La Liga,27-101,1996,3.8,2,2,0,2,0,1,2,50.0,1,3,0,3,0,2,1,0,Matches
998,Axel Gueguin,fr FRA,"DF,FW",Montpellier,fr Ligue 1,18-351,2005,1.5,9,5,6,2,1,2,6,33.3,4,2,0,2,2,11,6,0,Matches
999,Marc Guéhi,eng ENG,DF,Crystal Palace,eng Premier League,23-240,2000,21.2,26,17,21,5,0,13,23,56.5,10,22,17,5,18,44,86,1,Matches
1000,Mattéo Guendouzi,fr FRA,MF,Lazio,it Serie A,24-330,1999,20.8,28,13,8,16,4,17,41,41.5,24,16,4,12,16,44,19,1,Matches
1001,Mattéo Guendouzi,fr FRA,MF,Marseille,fr Ligue 1,24-330,1999,0.2,0,0,0,0,0,0,0,,0,1,1,0,0,0,0,0,Matches
1002,Javier Guerra,es ESP,"MF,FW",Valencia,es La Liga,21-068,2003,18.5,32,15,16,11,5,11,35,31.4,24,19,3,16,10,42,25,0,Matches
1003,Raphaël Guerreiro,pt POR,"DF,MF",Bayern Munich,de Bundesliga,30-078,1993,9.6,16,13,6,6,4,7,13,53.8,6,5,0,5,14,30,5,1,Matches
1004,Axel Guessand,fr FRA,DF,Udinese,it Serie A,19-124,2004,0.5,1,1,0,1,0,1,1,100.0,0,1,0,1,0,1,0,0,Matches
1005,Evann Guessand,fr FRA,FW,Nice,fr Ligue 1,22-252,2001,13.4,12,4,1,5,6,3,4,75.0,1,8,1,7,8,20,5,0,Matches
1006,Ander Guevara,es ESP,MF,Alavés,es La Liga,26-246,1997,25.4,44,25,21,18,5,25,48,52.1,23,23,8,15,12,56,36,1,Matches
1007,Pape Gueye,sn SEN,MF,Marseille,fr Ligue 1,25-045,1999,1.3,6,4,0,6,0,2,4,50.0,2,4,0,4,4,10,1,0,Matches
1008,Josuha Guilavogui,fr FRA,DF,Mainz 05,de Bundesliga,33-172,1990,2.8,9,6,6,3,0,4,5,80.0,1,9,6,3,8,17,13,0,Matches
1009,Morgan Guilavogui,gn GUI,"FW,MF",Lens,fr Ligue 1,25-365,1998,5.7,18,9,3,11,4,5,11,45.5,6,8,1,7,4,22,3,0,Matches
1010,Frederic Guilbert,fr FRA,"DF,MF",Strasbourg,fr Ligue 1,29-076,1994,17.9,61,36,34,22,5,31,51,60.8,20,27,5,22,51,112,54,1,Matches
1011,Hugo Guillamón,es ESP,MF,Valencia,es La Liga,24-038,2000,11.1,20,12,5,12,3,10,15,66.7,5,5,3,2,9,29,24,1,Matches
1012,Bruno Guimarães,br BRA,MF,Newcastle Utd,eng Premier League,26-114,1997,25.4,54,31,30,17,7,20,46,43.5,26,37,9,28,24,78,16,0,Matches
1013,Serhou Guirassy,gn GUI,FW,Stuttgart,de Bundesliga,27-363,1996,15.7,4,2,0,4,0,1,3,33.3,2,5,1,4,4,8,20,0,Matches
1014,Marc Guiu,es ESP,"FW,MF",Barcelona,es La Liga,18-065,2006,0.8,1,0,0,1,0,0,0,,0,0,0,0,0,1,0,0,Matches
1015,Péter Gulácsi,hu HUN,GK,RB Leipzig,de Bundesliga,33-308,1990,4.0,0,0,0,0,0,0,0,,0,0,0,0,0,0,6,1,Matches
1016,Manuel Gulde,de GER,DF,Freiburg,de Bundesliga,33-026,1991,14.1,23,16,16,6,1,8,10,80.0,2,14,8,6,16,39,42,0,Matches
1017,Arda Güler,tr TUR,"FW,MF",Real Madrid,es La Liga,19-013,2005,0.3,2,2,1,1,0,2,2,100.0,0,0,0,0,0,2,0,0,Matches
1018,Gerard Gumbau,es ESP,MF,Granada,es La Liga,29-082,1994,18.9,31,17,10,19,2,8,30,26.7,22,17,3,14,13,44,20,1,Matches
1019,Robert Gumny,pl POL,DF,Augsburg,de Bundesliga,25-279,1998,5.3,6,5,1,3,2,1,5,20.0,4,13,5,8,7,13,15,0,Matches
1020,İlkay Gündoğan,de GER,MF,Barcelona,es La Liga,33-137,1990,25.3,20,13,9,10,1,7,24,29.2,17,16,2,14,18,38,13,0,Matches
1021,Christian Günter,de GER,DF,Freiburg,de Bundesliga,31-010,1993,3.0,8,3,2,6,0,2,4,50.0,2,5,1,4,0,8,5,0,Matches
1022,Jon Guridi,es ESP,MF,Alavés,es La Liga,29-010,1995,21.5,30,18,7,19,4,8,35,22.9,27,21,3,18,13,43,14,0,Matches
1023,Gorka Guruzeta,es ESP,FW,Athletic Club,es La Liga,27-179,1996,19.9,26,17,4,20,2,6,21,28.6,15,22,1,21,15,41,19,0,Matches
1024,Malo Gusto,fr FRA,DF,Chelsea,eng Premier League,20-295,2003,14.2,41,21,28,11,2,25,39,64.1,14,21,3,18,10,51,32,1,Matches
1025,Miguel Gutiérrez,es ESP,"DF,MF",Girona,es La Liga,22-226,2001,25.7,23,14,9,10,4,11,28,39.3,17,21,10,11,17,40,53,1,Matches
1026,Albert Guðmundsson,is ISL,"FW,MF",Genoa,it Serie A,26-268,1997,24.8,17,8,6,7,4,9,27,33.3,18,13,2,11,10,27,7,0,Matches
1027,Joško Gvardiol,hr CRO,DF,Manchester City,eng Premier League,22-046,2002,16.4,30,21,11,15,4,14,23,60.9,9,20,9,11,20,50,24,2,Matches
1028,Emmanuel Gyasi,gh GHA,"DF,FW",Empoli,it Serie A,30-058,1994,10.8,19,10,8,9,2,8,14,57.1,6,13,6,7,2,21,15,1,Matches
1029,Norbert Gyömbér,sk SVK,DF,Salernitana,it Serie A,31-250,1992,17.0,35,17,29,6,0,19,24,79.2,5,32,22,10,22,57,69,2,Matches
1030,Erling Haaland,no NOR,FW,Manchester City,eng Premier League,23-232,2000,20.4,4,1,0,3,1,2,2,100.0,0,9,1,8,1,5,12,0,Matches
1031,Nicolas Haas,ch SUI,MF,Empoli,it Serie A,28-046,1996,1.0,5,3,1,2,2,3,3,100.0,0,1,0,1,1,6,1,0,Matches
1032,Janik Haberer,de GER,MF,Union Berlin,de Bundesliga,29-342,1994,12.5,35,23,16,13,6,21,43,48.8,22,20,3,17,11,46,16,0,Matches
1033,Robin Hack,de GER,"FW,MF",M'Gladbach,de Bundesliga,25-195,1998,8.7,9,5,5,4,0,1,8,12.5,7,10,0,10,11,20,13,0,Matches
1034,Antwoine Hackford,eng ENG,FW,Sheffield Utd,eng Premier League,19-355,2004,0.1,0,0,0,0,0,0,0,,0,0,0,0,0,0,0,0,Matches
1035,Munir El Haddadi,ma MAR,FW,Las Palmas,es La Liga,28-190,1995,22.0,32,20,14,14,4,15,35,42.9,20,19,1,18,9,41,11,0,Matches
1036,Jaouen Hadjam,dz ALG,DF,Nantes,fr Ligue 1,20-349,2003,1.2,6,4,5,1,0,1,2,50.0,1,0,0,0,3,9,2,0,Matches
1037,Ianis Hagi,ro ROU,"MF,FW",Alavés,es La Liga,25-139,1998,6.4,10,8,2,7,1,3,10,30.0,7,6,0,6,2,12,4,0,Matches
1038,Amadou Haidara,ml MLI,MF,RB Leipzig,de Bundesliga,26-038,1998,9.6,28,17,16,10,2,14,25,56.0,11,14,1,13,13,41,16,0,Matches
1039,Massadio Haïdara,ml MLI,DF,Lens,fr Ligue 1,31-098,1992,6.3,7,6,3,3,1,2,4,50.0,2,6,1,5,10,17,18,1,Matches
1040,Oualid El Hajjam,ma MAR,"DF,MF",Le Havre,fr Ligue 1,33-019,1991,2.2,3,3,2,1,0,0,2,0.0,2,4,1,3,3,6,5,0,Matches
1041,Achraf Hakimi,ma MAR,DF,Paris S-G,fr Ligue 1,25-126,1998,15.6,25,15,12,7,6,15,28,53.6,13,23,3,20,11,36,18,1,Matches
1042,Lewis Hall,eng ENG,DF,Newcastle Utd,eng Premier League,19-183,2004,1.2,10,7,7,3,0,4,7,57.1,3,2,0,2,2,12,0,0,Matches
1043,Sébastien Haller,ci CIV,FW,Dortmund,de Bundesliga,29-261,1994,4.0,1,0,0,1,0,1,1,100.0,0,4,1,3,0,1,7,0,Matches
1044,Gustavo Hamer,nl NED,MF,Sheffield Utd,eng Premier League,26-259,1997,21.9,33,19,17,11,5,11,46,23.9,35,22,3,19,18,51,29,0,Matches
1045,Andreas Hanche-Olsen,no NOR,DF,Mainz 05,de Bundesliga,27-052,1997,2.4,4,1,3,1,0,2,2,100.0,0,1,0,1,3,7,10,0,Matches
1046,Ridgeciano Haps,sr SUR,"DF,FW",Genoa,it Serie A,30-271,1993,6.4,4,4,2,0,2,3,4,75.0,1,3,0,3,5,9,5,1,Matches
1047,Genki Haraguchi,jp JPN,MF,Stuttgart,de Bundesliga,32-305,1991,0.2,1,1,1,0,0,0,0,,0,0,0,0,0,1,1,0,Matches
1048,Amine Harit,ma MAR,"MF,FW",Marseille,fr Ligue 1,26-265,1997,14.7,23,13,4,16,3,10,25,40.0,15,22,3,19,7,30,2,0,Matches
1049,Luke Harris,wls WAL,MF,Fulham,eng Premier League,18-341,2005,0.8,1,1,1,0,0,0,1,0.0,1,0,0,0,0,1,0,0,Matches
1050,Jack Harrison,eng ENG,"MF,FW",Everton,eng Premier League,27-110,1996,18.6,21,10,4,9,8,10,34,29.4,24,15,0,15,9,30,18,0,Matches
1051,Abdou Harroui,nl NED,"MF,FW",Frosinone,it Serie A,26-056,1998,9.4,17,8,7,10,0,7,15,46.7,8,16,3,13,3,20,6,0,Matches
1052,Makoto Hasebe,jp JPN,"DF,MF",Eint Frankfurt,de Bundesliga,40-051,1984,1.4,2,2,2,0,0,2,4,50.0,2,1,1,0,2,4,3,0,Matches
1053,Daiki Hashioka,jp JPN,DF,Luton Town,eng Premier League,24-297,1999,0.4,1,1,1,0,0,0,0,,0,0,0,0,0,1,1,0,Matches
1054,Hans Hateboer,nl NED,DF,Atalanta,it Serie A,30-060,1994,6.3,6,3,4,1,1,2,5,40.0,3,11,2,9,2,8,11,0,Matches
1055,Pantelis Hatzidiakos,gr GRE,DF,Cagliari,it Serie A,27-051,1997,7.1,18,7,10,8,0,9,15,60.0,6,11,4,7,6,24,19,1,Matches
1056,Kai Havertz,de GER,"MF,FW",Arsenal,eng Premier League,24-272,1999,18.8,25,11,3,16,6,11,29,37.9,18,20,1,19,14,39,13,0,Matches
1057,Thorgan Hazard,be BEL,DF,Dortmund,de Bundesliga,30-346,1993,0.1,0,0,0,0,0,0,0,,0,0,0,0,0,0,0,0,Matches
1058,Jan Paul van Hecke,nl NED,DF,Brighton,eng Premier League,23-275,2000,20.3,37,22,19,15,3,22,37,59.5,15,39,20,19,26,63,64,4,Matches
1059,Hwang Hee-chan,kr KOR,"FW,MF",Wolves,eng Premier League,28-043,1996,18.0,16,8,9,6,1,8,21,38.1,13,18,1,17,8,24,9,0,Matches
1060,Silvan Hefti,ch SUI,"MF,DF",Genoa,it Serie A,26-136,1997,1.3,6,1,2,3,1,4,7,57.1,3,2,0,2,0,6,1,0,Matches
1061,Silvan Hefti,ch SUI,"FW,DF",Montpellier,fr Ligue 1,26-136,1997,4.9,15,10,7,5,3,11,21,52.4,10,5,1,4,5,20,5,0,Matches
1062,Dominique Heintz,de GER,DF,Köln,de Bundesliga,30-207,1993,4.6,11,5,6,5,0,7,10,70.0,3,6,1,5,3,14,22,0,Matches
1063,Dean Henderson,eng ENG,GK,Crystal Palace,eng Premier League,26-363,1997,8.0,0,0,0,0,0,0,0,,0,0,0,0,0,0,6,1,Matches
1064,Liam Henderson,sct SCO,MF,Empoli,it Serie A,27-319,1996,0.1,0,0,0,0,0,0,0,,0,0,0,0,0,0,0,0,Matches
1065,Benjamin Henrichs,de GER,DF,RB Leipzig,de Bundesliga,27-015,1997,20.2,48,27,23,18,7,20,40,50.0,20,31,2,29,28,76,24,0,Matches
1066,Henrique,br BRA,DF,Lyon,fr Ligue 1,29-319,1994,3.7,5,3,2,3,0,2,4,50.0,2,3,1,2,8,13,1,0,Matches
1067,Luis Henrique,br BRA,FW,Marseille,fr Ligue 1,22-086,2001,2.4,3,3,2,1,0,2,2,100.0,0,3,0,3,1,4,0,0,Matches
1068,Luiz Henrique,br BRA,FW,Betis,es La Liga,23-067,2001,6.8,15,11,4,10,1,9,14,64.3,5,11,0,11,5,20,8,0,Matches
1069,Matheus Henrique,br BRA,MF,Sassuolo,it Serie A,26-081,1997,20.9,28,19,13,14,1,12,33,36.4,21,12,7,5,17,45,21,5,Matches
1070,Rico Henry,eng ENG,DF,Brentford,eng Premier League,26-245,1997,4.5,7,5,3,3,1,6,7,85.7,1,8,3,5,5,12,5,1,Matches
1071,Thomas Henry,fr FRA,"FW,MF",Hellas Verona,it Serie A,29-171,1994,3.4,0,0,0,0,0,0,0,,0,0,0,0,0,0,5,0,Matches
1072,Christophe Hérelle,mq MTQ,DF,Metz,fr Ligue 1,31-200,1992,14.0,24,12,18,6,0,9,17,52.9,8,14,7,7,13,37,58,1,Matches
1073,Mario Hermoso,es ESP,DF,Atlético Madrid,es La Liga,28-265,1995,21.6,37,21,21,13,3,21,41,51.2,20,22,8,14,23,60,74,0,Matches
1074,Javi Hernández ,es ESP,DF,Cádiz,es La Liga,25-312,1998,18.5,20,13,12,5,3,10,22,45.5,12,21,7,14,10,30,47,0,Matches
1075,Aridane Hernández,es ESP,DF,Rayo Vallecano,es La Liga,34-352,1989,16.8,10,8,5,4,1,4,9,44.4,5,17,12,5,12,22,95,1,Matches
1076,Lucas Hernández,fr FRA,DF,Paris S-G,fr Ligue 1,28-024,1996,18.0,47,33,24,14,9,26,46,56.5,20,18,4,14,25,72,31,0,Matches
1077,Luis Hernández,es ESP,DF,Cádiz,es La Liga,34-330,1989,8.0,7,3,4,3,0,4,8,50.0,4,3,2,1,8,15,25,0,Matches
1078,Theo Hernández,fr FRA,DF,Milan,it Serie A,26-155,1997,23.9,25,12,17,8,0,9,19,47.4,10,28,13,15,15,40,36,1,Matches
1079,Yarek Hernandis,es ESP,DF,Valencia,es La Liga,19-057,2005,3.2,,7,,,,,,,,,,,7,,,,Matches
1080,Jorge Herrando,es ESP,DF,Osasuna,es La Liga,23-010,2001,7.4,11,7,9,2,0,3,6,50.0,3,10,5,5,9,20,37,0,Matches
1081,Ander Herrera,es ESP,MF,Athletic Club,es La Liga,34-208,1989,8.8,38,27,9,24,5,17,30,56.7,13,9,1,8,14,52,12,0,Matches
1082,Cristian Herrera,es ESP,"FW,MF",Las Palmas,es La Liga,32-362,1991,1.7,1,1,0,1,0,1,2,50.0,1,1,0,1,0,1,2,0,Matches
1083,Sergio Herrera,es ESP,GK,Osasuna,es La Liga,30-278,1993,22.9,1,1,1,0,0,1,2,50.0,1,0,0,0,0,1,16,2,Matches
1084,Yangel Herrera,ve VEN,MF,Girona,es La Liga,26-055,1998,16.8,45,24,17,23,5,20,42,47.6,22,21,6,15,16,61,34,0,Matches
1085,Patrick Herrmann,de GER,"DF,FW",M'Gladbach,de Bundesliga,33-026,1991,0.7,2,2,1,0,1,1,1,100.0,0,1,0,1,1,3,1,0,Matches
1086,Juan Herzog,es ESP,DF,Las Palmas,es La Liga,20-301,2003,2.2,5,4,4,1,0,3,5,60.0,2,3,0,3,2,7,13,0,Matches
1087,Son Heung-min,kr KOR,FW,Tottenham,eng Premier League,31-245,1992,21.1,14,8,5,4,5,6,15,40.0,9,3,1,2,7,21,4,0,Matches
1088,Aaron Hickey,sct SCO,DF,Brentford,eng Premier League,21-273,2002,7.9,16,9,9,3,4,7,7,100.0,0,7,3,4,3,19,10,0,Matches
1089,Isak Hien,se SWE,DF,Hellas Verona,it Serie A,25-056,1999,9.6,17,10,10,7,0,10,19,52.6,9,12,5,7,7,24,33,1,Matches
1090,Isak Hien,se SWE,DF,Atalanta,it Serie A,25-056,1999,1.1,5,5,2,3,0,1,1,100.0,0,1,0,1,2,7,2,0,Matches
1091,James Hill,eng ENG,DF,Bournemouth,eng Premier League,22-059,2002,0.8,3,2,1,2,0,1,1,100.0,0,1,1,0,2,5,6,0,Matches
1092,Piero Hincapié,ec ECU,DF,Leverkusen,de Bundesliga,22-060,2002,10.2,18,10,6,10,2,7,9,77.8,2,10,3,7,12,30,28,0,Matches
1093,Jack Hinshelwood,eng ENG,DF,Brighton,eng Premier League,18-333,2005,9.7,14,5,7,4,3,5,13,38.5,8,6,2,4,14,28,18,0,Matches
1094,Adam Hložek,cz CZE,"MF,FW",Leverkusen,de Bundesliga,21-228,2002,2.8,7,3,1,3,3,3,6,50.0,3,1,0,1,2,9,0,0,Matches
1095,Nicolas Höfler,de GER,MF,Freiburg,de Bundesliga,34-000,1990,17.0,38,23,23,10,5,14,28,50.0,14,19,9,10,23,61,28,0,Matches
1096,Jonas Hofmann,de GER,MF,Leverkusen,de Bundesliga,31-239,1992,18.7,19,13,6,8,5,9,21,42.9,12,14,0,14,6,25,5,0,Matches
1097,Philipp Hofmann,de GER,FW,Bochum,de Bundesliga,30-345,1993,9.5,8,3,2,5,1,4,6,66.7,2,5,0,5,2,10,12,0,Matches
1098,Lucas Höler,de GER,"FW,MF",Freiburg,de Bundesliga,29-243,1994,19.8,25,18,13,6,6,4,17,23.5,13,17,3,14,12,37,24,0,Matches
1099,Mason Holgate,eng ENG,DF,Sheffield Utd,eng Premier League,27-139,1996,2.1,3,0,1,1,1,0,2,0.0,2,5,2,3,5,8,8,0,Matches
1100,Fabian Holland,de GER,"MF,DF",Darmstadt 98,de Bundesliga,33-242,1990,17.9,39,22,16,18,5,18,33,54.5,15,19,10,9,19,58,27,0,Matches
1101,Benedict Hollerbach,de GER,"FW,MF",Union Berlin,de Bundesliga,22-297,2001,10.2,14,9,4,6,4,6,15,40.0,9,21,0,21,1,15,3,0,Matches
1102,Emil Holm,se SWE,DF,Atalanta,it Serie A,23-301,2000,7.7,18,13,12,4,2,9,28,32.1,19,17,3,14,7,25,17,0,Matches
1103,Gerrit Holtmann,ph PHI,"MF,FW",Darmstadt 98,de Bundesliga,28-350,1995,1.6,5,2,1,3,1,4,5,80.0,1,1,0,1,1,6,0,0,Matches
1104,Martin Hongla,cm CMR,MF,Hellas Verona,it Serie A,25-359,1998,12.0,24,13,9,13,2,8,11,72.7,3,8,3,5,7,31,24,0,Matches
1105,Martin Hongla,cm CMR,"MF,DF",Granada,es La Liga,25-359,1998,3.4,2,1,1,1,0,0,1,0.0,1,4,2,2,5,7,8,1,Matches
1106,Franck Honorat,fr FRA,"DF,FW",M'Gladbach,de Bundesliga,27-211,1996,19.7,22,12,11,9,2,11,17,64.7,6,17,2,15,7,29,24,1,Matches
1107,Mathias Honsak,at AUT,"MF,FW",Darmstadt 98,de Bundesliga,27-080,1996,6.6,6,4,3,2,1,4,10,40.0,6,7,1,6,3,9,12,0,Matches
1108,Sydney van Hooijdonk,nl NED,FW,Bologna,it Serie A,24-032,2000,2.4,3,0,0,2,1,1,2,50.0,1,1,1,0,1,4,4,0,Matches
1109,Fraser Hornby,sct SCO,"FW,MF",Darmstadt 98,de Bundesliga,24-178,1999,2.4,0,0,0,0,0,0,1,0.0,1,2,1,1,0,0,4,0,Matches
1110,Lukáš Hrádecký,fi FIN,GK,Leverkusen,de Bundesliga,34-106,1989,23.0,0,0,0,0,0,0,1,0.0,1,1,0,1,0,0,6,2,Matches
1111,Timo Hübers,de GER,DF,Köln,de Bundesliga,27-233,1996,21.9,52,36,37,12,3,36,58,62.1,22,38,21,17,46,98,112,0,Matches
1112,Callum Hudson-Odoi,eng ENG,FW,Nott'ham Forest,eng Premier League,23-123,2000,11.7,10,4,2,3,5,4,16,25.0,12,9,1,8,4,14,9,0,Matches
1113,Will Hughes,eng ENG,MF,Crystal Palace,eng Premier League,28-327,1995,14.5,40,22,18,14,8,13,28,46.4,15,24,9,15,12,52,20,0,Matches
1114,Dean Huijsen,nl NED,DF,Roma,it Serie A,18-330,2005,3.9,4,1,3,1,0,1,3,33.3,2,5,2,3,3,7,20,1,Matches
1115,Dean Huijsen,nl NED,DF,Juventus,it Serie A,18-330,2005,0.1,0,0,0,0,0,0,0,,0,0,0,0,0,0,1,0,Matches
1116,Mats Hummels,de GER,DF,Dortmund,de Bundesliga,35-084,1988,11.3,34,24,18,10,6,20,36,55.6,16,22,5,17,25,59,54,0,Matches
1117,Denis Huseinbasic,de GER,MF,Köln,de Bundesliga,22-250,2001,11.8,19,9,7,6,6,10,19,52.6,9,22,1,21,10,29,6,0,Matches
1118,Elseid Hysaj,al ALB,DF,Lazio,it Serie A,30-018,1994,7.9,17,9,6,10,1,10,17,58.8,7,12,5,7,9,26,26,0,Matches
1119,Pierre Højbjerg,dk DEN,MF,Tottenham,eng Premier League,28-217,1995,11.0,23,13,8,13,2,10,27,37.0,17,18,7,11,13,36,26,1,Matches
1120,Rasmus Højlund,dk DEN,FW,Manchester Utd,eng Premier League,21-034,2003,16.3,9,5,2,2,5,4,11,36.4,7,3,0,3,1,10,11,0,Matches
1121,Iago,br BRA,"DF,FW",Augsburg,de Bundesliga,26-352,1997,13.5,22,12,15,5,2,12,27,44.4,15,31,6,25,11,33,34,0,Matches
1122,Pablo Ibáñez,es ESP,MF,Osasuna,es La Liga,25-171,1998,7.8,16,8,4,7,5,5,13,38.5,8,14,1,13,5,21,7,0,Matches
1123,Arijon Ibrahimović,de GER,"FW,DF",Frosinone,it Serie A,18-089,2005,4.8,7,6,4,2,1,1,8,12.5,7,4,0,4,0,7,3,0,Matches
1124,Iglesias,es ESP,"DF,FW",Getafe,es La Liga,25-250,1998,12.5,30,18,17,8,5,13,20,65.0,7,16,7,9,13,43,39,0,Matches
1125,Borja Iglesias,es ESP,FW,Betis,es La Liga,31-052,1993,4.5,0,0,0,0,0,0,3,0.0,3,0,0,0,2,2,2,0,Matches
1126,Borja Iglesias,es ESP,FW,Leverkusen,de Bundesliga,31-052,1993,1.5,1,0,0,1,0,0,1,0.0,1,1,0,1,1,2,1,0,Matches
1127,Igor,br BRA,DF,Brighton,eng Premier League,26-031,1998,11.0,17,11,4,11,2,10,17,58.8,7,13,6,7,9,26,30,0,Matches
1128,Jonathan Ikone,fr FRA,FW,Fiorentina,it Serie A,25-312,1998,12.9,19,9,6,8,5,7,13,53.8,6,9,0,9,2,21,6,0,Matches
1129,Chukwubuikem Ikwuemesi,ng NGA,"FW,DF",Salernitana,it Serie A,22-217,2001,7.1,2,0,0,1,1,1,3,33.3,2,1,1,0,1,3,5,0,Matches
1130,Andrej Ilic,rs SRB,FW,Lille,fr Ligue 1,23-341,2000,0.1,0,0,0,0,0,0,0,,0,0,0,0,0,0,0,0,Matches
1131,Ivan Ilić,rs SRB,MF,Torino,it Serie A,22-358,2001,17.4,14,6,3,8,3,8,18,44.4,10,16,6,10,15,29,24,0,Matches
1132,Samuel Iling-Junior,eng ENG,"DF,FW",Juventus,it Serie A,20-157,2003,4.0,14,9,8,5,1,8,11,72.7,3,7,1,6,3,17,8,0,Matches
1133,Imanol,es ESP,DF,Athletic Club,es La Liga,23-275,2000,4.4,5,4,0,4,1,3,12,25.0,9,6,0,6,6,11,8,0,Matches
1134,Ciro Immobile,it ITA,FW,Lazio,it Serie A,34-018,1990,14.5,7,5,1,4,2,2,10,20.0,8,5,3,2,4,11,7,0,Matches
1135,Gino Infantino,ar ARG,MF,Fiorentina,it Serie A,20-295,2003,0.9,1,1,0,1,0,0,1,0.0,1,3,0,3,1,2,1,0,Matches
1136,Danny Ings,eng ENG,FW,West Ham,eng Premier League,31-230,1992,2.8,5,2,0,5,0,3,9,33.3,6,4,1,3,1,6,5,0,Matches
1137,Bonke Innocent,ng NGA,MF,Lorient,fr Ligue 1,28-049,1996,2.3,6,4,2,2,2,2,9,22.2,7,2,1,1,4,10,2,0,Matches
1138,Tim Iroegbunam,eng ENG,MF,Aston Villa,eng Premier League,20-253,2003,0.4,2,2,1,1,0,0,2,0.0,2,2,0,2,1,3,1,0,Matches
1139,Alexander Isak,se SWE,FW,Newcastle Utd,eng Premier League,24-170,1999,14.6,3,0,2,1,0,1,5,20.0,4,7,0,7,3,6,6,0,Matches
1140,Gustav Isaksen,dk DEN,FW,Lazio,it Serie A,22-325,2001,9.7,4,3,2,1,1,1,9,11.1,8,10,1,9,2,6,2,0,Matches
1141,Isco,es ESP,MF,Betis,es La Liga,31-323,1992,20.5,29,19,9,17,3,10,28,35.7,18,16,1,15,8,37,7,0,Matches
1142,Thomas Isherwood,se SWE,DF,Darmstadt 98,de Bundesliga,26-041,1998,3.6,7,3,3,3,1,4,5,80.0,1,3,2,1,5,12,16,0,Matches
1143,Ismaily,br BRA,DF,Lille,fr Ligue 1,34-058,1990,18.1,50,32,22,19,9,23,42,54.8,19,23,3,20,21,71,48,0,Matches
1144,Ardian Ismajli,al ALB,DF,Empoli,it Serie A,27-161,1996,18.3,20,11,13,5,2,14,17,82.4,3,24,15,9,18,38,102,1,Matches
1145,Ko Itakura,jp JPN,DF,M'Gladbach,de Bundesliga,27-042,1997,9.5,20,14,12,8,0,11,17,64.7,6,20,12,8,13,33,38,0,Matches
1146,Hiroki Ito,jp JPN,DF,Stuttgart,de Bundesliga,24-302,1999,15.9,8,7,6,2,0,5,14,35.7,9,18,11,7,19,27,50,1,Matches
1147,Junya Ito,jp JPN,"FW,MF",Reims,fr Ligue 1,31-000,1993,20.8,21,11,7,10,4,6,26,23.1,20,15,1,14,8,29,6,0,Matches
1148,Diego Iturralde,es ESP,DF,Sevilla,es La Liga,20-328,2003,0.4,0,0,0,0,0,0,0,,0,1,1,0,0,0,2,0,Matches
1149,Alex Iwobi,ng NGA,MF,Everton,eng Premier League,27-311,1996,1.6,2,0,1,0,1,2,3,66.7,1,2,0,2,1,3,0,0,Matches
1150,Alex Iwobi,ng NGA,"FW,MF",Fulham,eng Premier League,27-311,1996,14.6,16,11,7,8,1,7,18,38.9,11,9,0,9,13,29,5,0,Matches
1151,Armando Izzo,it ITA,DF,Monza,it Serie A,32-007,1992,8.1,14,10,8,6,0,4,10,40.0,6,7,4,3,12,26,22,1,Matches
1152,Nicolas Jackson,sn SEN,FW,Chelsea,eng Premier League,22-263,2001,19.2,10,7,1,4,5,1,14,7.1,13,15,5,10,3,13,14,0,Matches
1153,Jérémy Jacquet,fr FRA,MF,Rennes,fr Ligue 1,18-240,2005,0.1,1,1,1,0,0,0,1,0.0,1,0,0,0,1,2,0,0,Matches
1154,Lee Jae-sung,kr KOR,"MF,FW",Mainz 05,de Bundesliga,31-212,1992,15.7,20,12,6,10,4,9,27,33.3,18,19,1,18,19,39,14,0,Matches
1155,Paul Jaeckel,de GER,DF,Union Berlin,de Bundesliga,25-231,1998,2.5,7,2,4,3,0,5,8,62.5,3,3,2,1,4,11,7,0,Matches
1156,Filip Jagiełło,pl POL,MF,Genoa,it Serie A,26-214,1997,0.4,0,0,0,0,0,0,1,0.0,1,1,1,0,1,1,0,0,Matches
1157,Kristijan Jakić,hr CRO,MF,Augsburg,de Bundesliga,26-300,1997,5.9,19,8,10,6,3,10,18,55.6,8,7,1,6,8,27,10,0,Matches
1158,Kristijan Jakić,hr CRO,"MF,FW",Eint Frankfurt,de Bundesliga,26-300,1997,2.2,3,3,1,2,0,1,3,33.3,2,1,0,1,2,5,2,0,Matches
1159,Ismail Jakobs,sn SEN,DF,Monaco,fr Ligue 1,24-205,1999,13.7,45,30,23,15,7,25,39,64.1,14,16,1,15,10,55,33,0,Matches
1160,Ablie Jallow,gm GAM,"MF,FW",Metz,fr Ligue 1,25-116,1998,7.8,5,3,0,3,2,1,3,33.3,2,3,0,3,5,10,2,0,Matches
1161,Reece James,eng ENG,DF,Chelsea,eng Premier League,24-092,1999,4.3,13,8,10,2,1,8,10,80.0,2,4,4,0,3,16,7,1,Matches
1162,Vitaly Janelt,de GER,"MF,DF",Brentford,eng Premier League,25-304,1998,23.9,42,24,18,17,7,24,49,49.0,25,21,6,15,20,62,43,1,Matches
1163,Jakub Jankto,cz CZE,"MF,FW",Cagliari,it Serie A,28-050,1996,8.2,9,6,7,1,1,7,17,41.2,10,5,1,4,4,13,20,0,Matches
1164,Tony Jantschke,de GER,"DF,MF",M'Gladbach,de Bundesliga,33-337,1990,0.2,1,1,1,0,0,1,1,100.0,0,2,2,0,1,2,3,0,Matches
1165,Adnan Januzaj,be BEL,"FW,MF",Sevilla,es La Liga,29-033,1995,2.1,3,3,2,0,1,0,1,0.0,1,2,0,2,1,4,0,0,Matches
1166,Mikel Jauregizar,es ESP,MF,Athletic Club,es La Liga,20-118,2003,0.7,,0,,,,,,,,,,,0,,,,Matches
1167,Luis Javier Suárez,co COL,"FW,MF",Almería,es La Liga,26-098,1997,8.0,5,4,2,3,0,1,4,25.0,3,9,0,9,0,5,9,0,Matches
1168,Danley Jean-Jacques,ht HAI,MF,Metz,fr Ligue 1,23-294,2000,22.2,43,23,19,19,5,18,50,36.0,32,36,5,31,36,79,28,0,Matches
1169,Jeffinho,br BRA,"FW,MF",Lyon,fr Ligue 1,24-070,1999,3.4,11,4,3,5,3,4,11,36.4,7,1,0,1,0,11,0,0,Matches
1170,Fredrik Jensen,fi FIN,"MF,FW",Augsburg,de Bundesliga,26-182,1997,12.3,23,11,9,8,6,14,24,58.3,10,22,1,21,10,33,17,0,Matches
1171,Mathias Jensen,dk DEN,MF,Brentford,eng Premier League,28-068,1996,16.2,35,20,18,13,4,16,62,25.8,46,29,4,25,11,46,17,1,Matches
1172,Moritz Jenz,de GER,DF,Wolfsburg,de Bundesliga,24-314,1999,16.0,25,19,15,9,1,8,14,57.1,6,24,15,9,23,48,86,0,Matches
1173,Gabriel Jesus,br BRA,FW,Arsenal,eng Premier League,26-341,1997,12.4,19,13,10,4,5,3,13,23.1,10,16,1,15,7,26,7,0,Matches
1174,Juan Jesus,br BRA,DF,Napoli,it Serie A,32-273,1991,16.5,29,13,23,5,1,16,24,66.7,8,16,7,9,12,41,54,0,Matches
1175,Alejandro Jiménez,es ESP,DF,Milan,it Serie A,18-306,2005,0.8,2,1,2,0,0,2,5,40.0,3,0,0,0,0,2,4,0,Matches
1176,Raúl Jiménez,mx MEX,FW,Fulham,eng Premier League,32-309,1991,13.8,13,10,3,7,3,6,17,35.3,11,9,2,7,3,16,12,0,Matches
1177,João Pedro,br BRA,"FW,MF",Brighton,eng Premier League,22-165,2001,15.5,23,13,7,11,5,9,17,52.9,8,10,1,9,9,32,23,0,Matches
1178,Joelinton,br BRA,"MF,FW",Newcastle Utd,eng Premier League,27-208,1996,12.6,30,22,16,12,2,10,30,33.3,20,19,5,14,17,47,11,1,Matches
1179,Ryan John Giles,eng ENG,"DF,MF",Luton Town,eng Premier League,24-043,2000,5.6,8,6,4,3,1,2,7,28.6,5,2,0,2,4,12,22,0,Matches
1180,Ben Johnson,eng ENG,"DF,FW",West Ham,eng Premier League,24-045,2000,4.4,7,6,5,1,1,6,7,85.7,1,1,1,0,5,12,8,0,Matches
1181,Brennan Johnson,wls WAL,FW,Tottenham,eng Premier League,22-291,2001,12.3,16,9,10,3,3,8,20,40.0,12,17,0,17,6,22,11,1,Matches
1182,Brennan Johnson,wls WAL,"FW,MF",Nott'ham Forest,eng Premier League,22-291,2001,2.6,4,1,1,1,2,2,4,50.0,2,4,1,3,0,4,0,0,Matches
1183,Sam Johnstone,eng ENG,GK,Crystal Palace,eng Premier League,30-350,1993,19.0,1,0,1,0,0,1,1,100.0,0,0,0,0,1,2,5,0,Matches
1184,Curtis Jones,eng ENG,MF,Liverpool,eng Premier League,23-039,2001,10.6,21,13,12,7,2,8,20,40.0,12,17,0,17,6,27,8,0,Matches
1185,Frenkie de Jong,nl NED,MF,Barcelona,es La Liga,26-302,1997,17.7,42,26,14,23,5,8,19,42.1,11,18,8,10,13,55,28,1,Matches
1186,Joan Jordán,es ESP,MF,Sevilla,es La Liga,29-247,1994,3.9,7,6,2,3,2,6,14,42.9,8,4,2,2,4,11,2,0,Matches
1187,Jordi,es ESP,MF,Getafe,es La Liga,23-064,2001,4.9,14,10,2,11,1,7,13,53.8,6,3,1,2,6,20,6,0,Matches
1188,Kaio Jorge,br BRA,FW,Frosinone,it Serie A,22-045,2002,8.6,6,4,0,1,5,3,4,75.0,1,6,0,6,1,7,0,0,Matches
1189,Jorginho,it ITA,MF,Arsenal,eng Premier League,32-080,1991,7.3,18,7,6,5,7,9,19,47.4,10,14,1,13,8,26,4,1,Matches
1190,Willian José,br BRA,FW,Betis,es La Liga,32-107,1991,14.8,6,2,1,2,3,1,3,33.3,2,8,2,6,1,7,14,0,Matches
1191,Joselu,es ESP,FW,Real Madrid,es La Liga,33-348,1990,13.2,5,3,1,3,1,0,4,0.0,4,7,0,7,5,10,9,0,Matches
1192,Diogo Jota,pt POR,FW,Liverpool,eng Premier League,27-096,1996,11.6,23,13,6,13,4,10,22,45.5,12,8,1,7,6,29,4,0,Matches
1193,Antoine Joujou,fr FRA,"MF,FW",Le Havre,fr Ligue 1,20-363,2003,6.9,16,10,5,7,4,9,19,47.4,10,8,2,6,5,21,5,0,Matches
1194,Luka Jović,rs SRB,FW,Milan,it Serie A,26-077,1997,6.5,5,3,0,3,2,3,5,60.0,2,3,0,3,0,5,8,0,Matches
1195,Kamil Jóźwiak,pl POL,"MF,FW",Granada,es La Liga,25-322,1998,0.2,1,0,1,0,0,1,1,100.0,0,0,0,0,0,1,0,0,Matches
1196,Juanmi,es ESP,FW,Cádiz,es La Liga,30-294,1993,3.5,1,1,0,1,0,0,0,,0,4,0,4,3,4,1,0,Matches
1197,Juanpe,es ESP,DF,Girona,es La Liga,32-314,1991,6.7,6,4,5,1,0,5,6,83.3,1,15,11,4,6,12,40,1,Matches
1198,Mads Juel Andersen,dk DEN,DF,Luton Town,eng Premier League,26-073,1997,4.4,6,5,4,2,0,4,4,100.0,0,9,6,3,8,14,29,0,Matches
1199,Christopher Jullien,fr FRA,DF,Montpellier,fr Ligue 1,30-353,1993,9.2,6,4,5,1,0,4,11,36.4,7,18,15,3,7,13,72,1,Matches
1200,Anthony Jung,de GER,"DF,FW",Werder Bremen,de Bundesliga,32-127,1991,21.4,30,18,18,10,2,14,24,58.3,10,29,12,17,19,49,73,0,Matches
1201,Eli Junior Kroupi,fr FRA,FW,Lorient,fr Ligue 1,17-260,2006,9.9,7,4,2,2,3,1,8,12.5,7,3,0,3,9,16,5,0,Matches
1202,Hamed Junior Traorè,ci CIV,MF,Bournemouth,eng Premier League,24-022,2000,0.5,1,0,1,0,0,1,3,33.3,2,3,0,3,0,1,0,0,Matches
1203,Hamed Junior Traorè,ci CIV,MF,Napoli,it Serie A,24-022,2000,2.5,1,0,0,0,1,0,3,0.0,3,3,0,3,1,2,1,1,Matches
1204,Vinicius Júnior,br BRA,FW,Real Madrid,es La Liga,23-241,2000,15.1,15,10,5,4,6,2,10,20.0,8,8,0,8,1,16,3,2,Matches
1205,Josip Juranović,hr CRO,DF,Union Berlin,de Bundesliga,28-206,1995,10.5,16,10,8,7,1,7,15,46.7,8,10,3,7,9,25,21,1,Matches
1206,David Jurásek,cz CZE,"DF,MF",Hoffenheim,de Bundesliga,23-215,2000,0.6,4,3,4,0,0,3,8,37.5,5,1,0,1,0,4,2,0,Matches
1207,Julian Justvan,de GER,"FW,MF",Hoffenheim,de Bundesliga,25-342,1998,0.5,1,0,1,0,0,1,2,50.0,1,1,0,1,0,1,0,0,Matches
1208,Julian Justvan,de GER,"MF,FW",Darmstadt 98,de Bundesliga,25-342,1998,5.0,3,2,0,2,1,1,6,16.7,5,5,0,5,2,5,0,0,Matches
1209,Filip Jørgensen,dk DEN,GK,Villarreal,es La Liga,21-328,2002,26.0,3,1,3,0,0,3,4,75.0,1,0,0,0,2,5,9,3,Matches
1210,Mathias Jørgensen,dk DEN,DF,Brentford,eng Premier League,33-321,1990,5.1,8,4,6,1,1,4,9,44.4,5,4,2,2,7,15,15,0,Matches
1211,Mohamed Kaba,fr FRA,MF,Lecce,it Serie A,22-134,2001,15.3,39,23,15,16,8,17,34,50.0,17,22,4,18,12,51,13,0,Matches
1212,Sory Kaba,gn GUI,FW,Las Palmas,es La Liga,28-225,1995,6.6,1,0,0,1,0,0,5,0.0,5,4,0,4,0,1,8,0,Matches
1213,Ozan Kabak,tr TUR,DF,Hoffenheim,de Bundesliga,23-350,2000,17.7,36,27,24,10,2,15,23,65.2,8,29,11,18,31,67,75,1,Matches
1214,Christian Kabasele,be BEL,DF,Udinese,it Serie A,33-014,1991,9.5,10,7,4,5,1,2,11,18.2,9,14,8,6,12,22,56,0,Matches
1215,Issa Kaboré,bf BFA,DF,Luton Town,eng Premier League,22-302,2001,12.8,35,20,19,11,5,15,28,53.6,13,13,5,8,12,47,31,2,Matches
1216,Abdoul Kader Bamba,fr FRA,"MF,FW",Nantes,fr Ligue 1,29-289,1994,4.8,9,6,2,4,3,4,7,57.1,3,4,0,4,3,12,4,1,Matches
1217,Yaya Kader Fofana,ml MLI,"MF,DF",Reims,fr Ligue 1,19-271,2004,0.2,2,2,0,1,1,0,0,,0,0,0,0,1,3,0,0,Matches
1218,Pavel Kadeřábek,cz CZE,"DF,FW",Hoffenheim,de Bundesliga,31-319,1992,18.0,22,13,8,12,2,13,27,48.1,14,14,5,9,13,35,48,0,Matches
1219,Tino Kadewere,zw ZIM,"FW,MF",Lyon,fr Ligue 1,28-064,1996,3.3,1,1,0,1,0,1,5,20.0,4,3,1,2,5,6,7,0,Matches
1220,Tino Kadewere,zw ZIM,"FW,MF",Nantes,fr Ligue 1,28-064,1996,5.2,4,1,2,2,0,3,5,60.0,2,6,0,6,7,11,3,0,Matches
1221,Kaiky,br BRA,DF,Almería,es La Liga,20-057,2004,5.8,7,4,6,0,1,3,6,50.0,3,9,7,2,3,10,29,1,Matches
1222,Florian Kainz,at AUT,"MF,FW",Köln,de Bundesliga,31-137,1992,17.8,21,15,6,9,6,13,26,50.0,13,15,6,9,10,31,18,0,Matches
1223,Sasa Kalajdzic,at AUT,FW,Wolves,eng Premier League,26-246,1997,1.8,6,2,3,2,1,1,2,50.0,1,3,0,3,1,7,6,0,Matches
1224,Sasa Kalajdzic,at AUT,FW,Eint Frankfurt,de Bundesliga,26-246,1997,3.6,2,2,0,2,0,0,0,,0,2,2,0,2,4,6,0,Matches
1225,Arnaud Kalimuendo,fr FRA,FW,Rennes,fr Ligue 1,22-049,2002,15.7,4,3,1,2,1,2,4,50.0,2,9,2,7,4,8,3,0,Matches
1226,Yayah Kallon,sl SLE,FW,Hellas Verona,it Serie A,22-253,2001,0.0,0,0,0,0,0,0,0,,0,0,0,0,0,0,0,0,Matches
1227,Gedeon Kalulu,cd COD,DF,Lorient,fr Ligue 1,26-193,1997,9.1,21,15,13,7,1,10,19,52.6,9,16,2,14,4,25,30,0,Matches
1228,Pierre Kalulu,fr FRA,DF,Milan,it Serie A,23-278,2000,1.2,4,0,2,2,0,0,1,0.0,1,3,2,1,1,5,6,1,Matches
1229,Daichi Kamada,jp JPN,MF,Lazio,it Serie A,27-217,1996,8.4,29,19,12,12,5,14,26,53.8,12,9,3,6,5,34,5,0,Matches
1230,Waren Kamanzi,no NOR,"DF,FW",Toulouse,fr Ligue 1,23-119,2000,8.2,24,16,11,10,3,10,17,58.8,7,6,2,4,5,29,25,0,Matches
1231,Boubacar Kamara,fr FRA,MF,Aston Villa,eng Premier League,24-107,1999,18.4,43,29,16,21,6,24,47,51.1,23,21,7,14,21,64,16,0,Matches
1232,Hassane Kamara,ci CIV,DF,Udinese,it Serie A,30-004,1994,14.9,27,19,18,5,4,15,23,65.2,8,20,2,18,17,44,35,0,Matches
1233,Willy Kambwala,fr FRA,DF,Manchester Utd,eng Premier League,19-197,2004,1.2,1,0,0,1,0,1,2,50.0,1,1,1,0,0,1,4,0,Matches
1234,Jakub Kamiński,pl POL,"FW,MF",Wolfsburg,de Bundesliga,21-278,2002,3.3,11,4,11,0,0,2,5,40.0,3,3,0,3,2,13,3,0,Matches
1235,Thomas Kaminski,be BEL,GK,Luton Town,eng Premier League,31-138,1992,26.0,2,1,2,0,0,2,4,50.0,2,1,0,1,0,2,9,2,Matches
1236,Kevin Kampl,si SVN,MF,RB Leipzig,de Bundesliga,33-152,1990,12.8,18,8,8,8,2,9,17,52.9,8,17,6,11,9,27,13,1,Matches
1237,Harry Kane,eng ENG,FW,Bayern Munich,de Bundesliga,30-225,1993,23.6,9,5,3,3,3,4,14,28.6,10,7,2,5,4,13,13,0,Matches
1238,Lee Kang-in,kr KOR,"MF,FW",Paris S-G,fr Ligue 1,23-019,2001,10.0,19,10,4,6,9,11,25,44.0,14,6,0,6,4,23,1,0,Matches
1239,Yann Karamoh,fr FRA,"MF,FW",Torino,it Serie A,25-245,1998,1.8,1,0,0,0,1,0,0,,0,0,0,0,0,1,1,0,Matches
1240,Yann Karamoh,fr FRA,"FW,MF",Montpellier,fr Ligue 1,25-245,1998,0.8,0,0,0,0,0,0,1,0.0,1,2,0,2,0,0,0,0,Matches
1241,Atakan Karazor,de GER,MF,Stuttgart,de Bundesliga,27-148,1996,22.6,65,41,21,35,9,27,48,56.3,21,25,5,20,23,88,36,0,Matches
1242,Ayman Kari,fr FRA,"MF,FW",Lorient,fr Ligue 1,19-111,2004,5.8,13,9,6,7,0,10,16,62.5,6,13,2,11,5,18,4,1,Matches
1243,Emir Karic,at AUT,DF,Darmstadt 98,de Bundesliga,26-274,1997,13.2,35,21,19,10,6,16,22,72.7,6,25,5,20,10,45,26,0,Matches
1244,Loris Karius,de GER,GK,Newcastle Utd,eng Premier League,30-261,1993,1.0,0,0,0,0,0,0,0,,0,0,0,0,0,0,1,0,Matches
1245,Jesper Karlsson,se SWE,FW,Bologna,it Serie A,25-228,1998,3.6,3,3,2,1,0,2,8,25.0,6,4,0,4,3,6,1,0,Matches
1246,Jon Karrikaburu,es ESP,"MF,FW",Alavés,es La Liga,21-172,2002,0.2,0,0,0,0,0,0,0,,0,0,0,0,0,0,0,0,Matches
1247,Rick Karsdorp,nl NED,DF,Roma,it Serie A,29-027,1995,10.9,21,15,10,5,6,13,19,68.4,6,8,2,6,8,29,13,0,Matches
1248,Grigoris Kastanos,cy CYP,"MF,DF",Salernitana,it Serie A,26-039,1998,13.7,19,12,7,6,6,7,15,46.7,8,11,3,8,8,27,5,0,Matches
1249,Silas Katompa,cd COD,"FW,MF",Stuttgart,de Bundesliga,25-155,1998,8.4,3,2,2,1,0,2,7,28.6,5,8,0,8,0,3,3,0,Matches
1250,Panos Katseris,gr GRE,DF,Lorient,fr Ligue 1,22-248,2001,4.5,16,12,9,6,1,11,16,68.8,5,7,2,5,4,20,9,0,Matches
1251,Mikkel Kaufmann,dk DEN,FW,Union Berlin,de Bundesliga,23-066,2001,2.3,1,0,0,1,0,1,4,25.0,3,5,0,5,1,2,2,0,Matches
1252,Michael Kayode,it ITA,DF,Fiorentina,it Serie A,19-243,2004,16.0,39,23,18,12,9,24,34,70.6,10,21,11,10,14,53,33,2,Matches
1253,Moise Kean,it ITA,FW,Juventus,it Serie A,24-010,2000,5.2,7,4,3,2,2,1,2,50.0,1,2,1,1,1,8,4,0,Matches
1254,Michael Keane,eng ENG,DF,Everton,eng Premier League,31-058,1993,4.5,7,3,3,3,1,1,6,16.7,5,4,4,0,5,12,18,1,Matches
1255,Ibrahima Kebe,ml MLI,MF,Girona,es La Liga,23-220,2000,0.1,1,1,0,1,0,0,0,,0,1,0,1,1,2,0,0,Matches
1256,Kévin Keben Biakolo,cm CMR,DF,Toulouse,fr Ligue 1,20-043,2004,3.1,3,2,3,0,0,2,3,66.7,1,5,0,5,3,6,10,0,Matches
1257,Yassine Kechta,ma MAR,MF,Le Havre,fr Ligue 1,22-013,2002,14.8,37,17,19,16,2,23,55,41.8,32,13,3,10,20,57,12,1,Matches
1258,Thilo Kehrer,de GER,"DF,MF",West Ham,eng Premier League,27-170,1996,0.2,1,1,0,1,0,0,0,,0,2,2,0,0,1,0,0,Matches
1259,Thilo Kehrer,de GER,DF,Monaco,fr Ligue 1,27-170,1996,6.0,12,8,9,1,2,8,16,50.0,8,9,0,9,11,23,16,0,Matches
1260,Habib Keita,ml MLI,MF,Clermont Foot,fr Ligue 1,22-033,2002,8.7,26,15,9,14,3,13,18,72.2,5,23,9,14,21,47,18,0,Matches
1261,Naby Keïta,gn GUI,MF,Werder Bremen,de Bundesliga,29-028,1995,0.9,0,0,0,0,0,0,1,0.0,1,1,0,1,1,1,0,0,Matches
1262,Yannik Keitel,de GER,"MF,DF",Freiburg,de Bundesliga,24-023,2000,2.3,9,7,5,3,1,4,6,66.7,2,4,0,4,4,13,4,1,Matches
1263,Caoimhín Kelleher,ie IRL,GK,Liverpool,eng Premier League,25-107,1998,6.0,0,0,0,0,0,0,0,,0,0,0,0,0,0,2,1,Matches
1264,Thomas Keller,de GER,"MF,FW",Heidenheim,de Bundesliga,24-217,1999,0.0,0,0,0,0,0,0,0,,0,0,0,0,0,0,0,0,Matches
1265,Lloyd Kelly,eng ENG,DF,Bournemouth,eng Premier League,25-155,1998,11.2,19,15,7,9,3,12,21,57.1,9,14,7,7,7,26,40,0,Matches
1266,Aljoscha Kemlein,de GER,MF,Union Berlin,de Bundesliga,19-220,2004,0.3,0,0,0,0,0,0,3,0.0,3,1,0,1,0,0,0,0,Matches
1267,Tobias Kempe,de GER,MF,Darmstadt 98,de Bundesliga,34-256,1989,9.6,9,8,5,3,1,5,12,41.7,7,8,2,6,6,15,6,0,Matches
1268,Milos Kerkez,hu HUN,DF,Bournemouth,eng Premier League,20-123,2003,15.6,36,20,23,11,2,22,32,68.8,10,25,9,16,15,51,51,1,Matches
1269,Reda Khadra,de GER,"FW,MF",Reims,fr Ligue 1,22-249,2001,9.0,7,4,1,3,3,3,10,30.0,7,4,0,4,2,9,5,0,Matches
1270,Wahbi Khazri,tn TUN,"FW,MF",Montpellier,fr Ligue 1,33-030,1991,10.3,19,12,6,11,2,12,26,46.2,14,8,0,8,3,22,6,0,Matches
1271,Rani Khedira,de GER,MF,Union Berlin,de Bundesliga,30-042,1994,8.9,22,12,10,12,0,12,16,75.0,4,8,2,6,14,36,26,0,Matches
1272,Kiké,es ESP,"FW,MF",Alavés,es La Liga,34-105,1989,10.9,4,2,1,2,1,4,9,44.4,5,11,4,7,0,4,10,0,Matches
1273,Luca Kilian,de GER,DF,Köln,de Bundesliga,24-190,1999,6.1,16,9,15,1,0,9,12,75.0,3,10,4,6,4,20,25,0,Matches
1274,Max Kilman,eng ENG,DF,Wolves,eng Premier League,26-291,1997,27.0,32,17,28,3,1,18,24,75.0,6,42,19,23,29,61,129,2,Matches
1275,Joshua Kimmich,de GER,"MF,DF",Bayern Munich,de Bundesliga,29-030,1995,14.9,26,19,9,12,5,14,22,63.6,8,20,3,17,12,38,12,1,Matches
1276,Jakub Kiwior,pl POL,DF,Arsenal,eng Premier League,24-023,2000,7.9,17,12,8,8,1,13,16,81.3,3,7,2,5,6,23,25,0,Matches
1277,Simon Kjær,dk DEN,DF,Milan,it Serie A,34-349,1989,12.0,21,13,9,10,2,14,21,66.7,7,22,16,6,14,35,46,0,Matches
1278,Davy Klaassen,nl NED,"MF,FW",Inter,it Serie A,31-017,1993,1.7,4,2,0,4,0,1,1,100.0,0,3,0,3,2,6,2,0,Matches
1279,Christoph Klarer,at AUT,DF,Darmstadt 98,de Bundesliga,23-269,2000,16.6,23,14,18,2,3,13,23,56.5,10,19,9,10,10,33,50,1,Matches
1280,Tim Kleindienst,de GER,FW,Heidenheim,de Bundesliga,28-191,1995,23.0,14,9,4,8,2,5,19,26.3,14,20,6,14,9,23,39,0,Matches
1281,Lukas Klostermann,de GER,DF,RB Leipzig,de Bundesliga,27-280,1996,13.9,14,9,7,6,1,4,13,30.8,9,21,10,11,11,25,58,1,Matches
1282,Justin Kluivert,nl NED,"MF,FW",Bournemouth,eng Premier League,24-309,1999,12.9,21,11,3,9,9,5,20,25.0,15,9,0,9,5,26,7,0,Matches
1283,Ansgar Knauff,de GER,"MF,FW",Eint Frankfurt,de Bundesliga,22-059,2002,16.4,31,18,15,11,5,12,25,48.0,13,30,3,27,9,40,10,0,Matches
1284,Robin Knoche,de GER,DF,Union Berlin,de Bundesliga,31-292,1992,18.6,32,21,25,7,0,18,29,62.1,11,23,16,7,11,43,59,0,Matches
1285,Gregor Kobel,ch SUI,GK,Dortmund,de Bundesliga,26-094,1997,19.3,0,0,0,0,0,0,1,0.0,1,0,0,0,0,0,9,0,Matches
1286,Robin Koch,de GER,DF,Eint Frankfurt,de Bundesliga,27-236,1996,20.4,27,17,18,9,0,11,16,68.8,5,22,16,6,24,51,100,0,Matches
1287,Philipp Köhn,ch SUI,GK,Monaco,fr Ligue 1,25-342,1998,22.0,1,1,1,0,0,1,1,100.0,0,0,0,0,1,2,5,3,Matches
1288,Dominik Kohr,de GER,"DF,MF",Mainz 05,de Bundesliga,30-038,1994,17.0,39,24,22,14,3,19,34,55.9,15,21,5,16,34,73,38,0,Matches
1289,Koke,es ESP,MF,Atlético Madrid,es La Liga,32-061,1992,17.7,47,34,19,23,5,27,54,50.0,27,24,9,15,13,60,18,1,Matches
1290,Sead Kolašinac,ba BIH,DF,Atalanta,it Serie A,30-263,1993,20.8,35,25,20,13,2,23,39,59.0,16,18,8,10,18,53,37,0,Matches
1291,Luca Koleosho,it ITA,"MF,FW",Burnley,eng Premier League,19-176,2004,10.8,7,4,2,5,0,2,10,20.0,8,13,0,13,2,9,0,0,Matches
1292,Randal Kolo Muani,fr FRA,"FW,MF",Paris S-G,fr Ligue 1,25-095,1998,9.6,7,6,4,2,1,3,10,30.0,7,5,0,5,4,11,7,0,Matches
1293,Randal Kolo Muani,fr FRA,FW,Eint Frankfurt,de Bundesliga,25-095,1998,1.7,0,0,0,0,0,0,0,,0,0,0,0,0,0,1,0,Matches
1294,Cheick Konaté,ci CIV,DF,Clermont Foot,fr Ligue 1,20-006,2004,10.9,24,14,17,7,0,19,34,55.9,15,16,2,14,12,36,19,0,Matches
1295,Ibrahima Konaté,fr FRA,DF,Liverpool,eng Premier League,24-289,1999,14.8,30,19,18,11,1,15,21,71.4,6,17,11,6,18,48,45,0,Matches
1296,Geoffrey Kondogbia,cf CTA,MF,Marseille,fr Ligue 1,31-023,1993,11.2,33,21,14,16,3,9,22,40.9,13,15,2,13,25,58,19,0,Matches
1297,Amadou Koné,ml MLI,MF,Reims,fr Ligue 1,18-300,2005,1.9,4,3,4,0,0,1,3,33.3,2,1,0,1,2,6,6,0,Matches
1298,Ibrahima Koné,ml MLI,FW,Almería,es La Liga,24-267,1999,2.9,1,0,1,0,0,1,1,100.0,0,1,0,1,0,1,4,0,Matches
1299,Ibrahima Koné,ml MLI,FW,Lorient,fr Ligue 1,24-267,1999,0.4,0,0,0,0,0,0,1,0.0,1,0,0,0,0,0,0,0,Matches
1300,Kouadio Koné,fr FRA,MF,M'Gladbach,de Bundesliga,22-297,2001,13.7,29,17,12,12,5,11,17,64.7,6,18,1,17,11,40,14,1,Matches
1301,Ezri Konsa,eng ENG,DF,Aston Villa,eng Premier League,26-138,1997,23.2,36,21,19,14,3,17,19,89.5,2,25,14,11,22,58,54,2,Matches
1302,Teun Koopmeiners,nl NED,MF,Atalanta,it Serie A,26-010,1998,22.3,31,19,11,16,4,16,46,34.8,30,23,2,21,9,40,30,0,Matches
1303,Odilon Kossonou,ci CIV,DF,Leverkusen,de Bundesliga,23-065,2001,14.4,23,17,9,10,4,9,15,60.0,6,21,2,19,24,47,29,0,Matches
1304,Filip Kostić,rs SRB,"DF,FW",Juventus,it Serie A,31-129,1992,16.7,31,20,17,11,3,15,28,53.6,13,25,8,17,8,39,33,0,Matches
1305,Christian Kouamé,ci CIV,FW,Fiorentina,it Serie A,26-094,1997,7.6,8,2,4,4,0,3,5,60.0,2,12,0,12,0,8,7,0,Matches
1306,Rominigue Kouamé,ml MLI,MF,Cádiz,es La Liga,27-083,1996,6.9,10,7,5,4,1,5,10,50.0,5,5,2,3,12,22,6,1,Matches
1307,Koffi Kouao,ci CIV,DF,Metz,fr Ligue 1,25-294,1998,7.5,15,10,8,6,1,8,14,57.1,6,6,3,3,13,28,25,1,Matches
1308,Therence Koudou,fr FRA,"DF,MF",Reims,fr Ligue 1,19-087,2004,1.7,0,0,0,0,0,0,0,,0,2,2,0,2,2,5,0,Matches
1309,Jules Koundé,fr FRA,DF,Barcelona,es La Liga,25-118,1998,22.9,26,17,16,7,3,19,34,55.9,15,22,9,13,20,46,72,4,Matches
1310,Boubakar Kouyaté,ml MLI,DF,Montpellier,fr Ligue 1,26-329,1997,17.8,39,26,30,7,2,22,44,50.0,22,26,15,11,22,61,101,1,Matches
1311,Cheikhou Kouyaté,sn SEN,MF,Nott'ham Forest,eng Premier League,34-079,1989,2.3,8,5,3,3,2,1,4,25.0,3,4,1,3,2,10,10,0,Matches
1312,Mateo Kovačić,hr CRO,MF,Manchester City,eng Premier League,29-308,1994,10.5,21,16,11,8,2,11,17,64.7,6,12,0,12,2,23,8,0,Matches
1313,Viktor Kovalenko,ua UKR,MF,Empoli,it Serie A,28-024,1996,5.6,5,2,2,2,1,2,8,25.0,6,9,2,7,1,6,7,0,Matches
1314,Matej Kovar,cz CZE,GK,Leverkusen,de Bundesliga,23-297,2000,1.0,0,0,0,0,0,0,0,,0,0,0,0,0,0,0,0,Matches
1315,Dawid Kownacki,pl POL,"FW,MF",Werder Bremen,de Bundesliga,26-361,1997,3.1,1,1,1,0,0,1,4,25.0,3,2,1,1,0,1,1,0,Matches
1316,Emil Krafth,se SWE,DF,Newcastle Utd,eng Premier League,29-220,1994,1.0,3,2,1,1,1,3,3,100.0,0,0,0,0,0,3,1,0,Matches
1317,Alex Král,cz CZE,MF,Union Berlin,de Bundesliga,25-295,1998,13.6,17,12,5,10,2,6,15,40.0,9,14,3,11,9,26,26,0,Matches
1318,Andrej Kramarić,hr CRO,"MF,FW",Hoffenheim,de Bundesliga,32-264,1991,16.0,5,1,2,2,1,2,8,25.0,6,9,2,7,8,13,8,0,Matches
1319,Christoph Kramer,de GER,MF,M'Gladbach,de Bundesliga,33-019,1991,2.8,10,5,5,5,0,2,14,14.3,12,7,1,6,4,14,6,0,Matches
1320,Frans Krätzig,de GER,DF,Bayern Munich,de Bundesliga,21-055,2003,0.6,2,0,2,0,0,1,2,50.0,1,0,0,0,0,2,0,0,Matches
1321,Tom Krauß,de GER,MF,Mainz 05,de Bundesliga,22-261,2001,13.1,47,26,17,26,4,16,48,33.3,32,24,4,20,16,63,24,0,Matches
1322,Thomas Kristensen,dk DEN,DF,Udinese,it Serie A,22-052,2002,14.8,22,18,16,6,0,12,18,66.7,6,12,8,4,21,43,75,0,Matches
1323,Toni Kroos,de GER,MF,Real Madrid,es La Liga,34-065,1990,19.0,45,27,16,22,7,21,48,43.8,27,20,4,16,12,57,8,1,Matches
1324,Nikola Krstović,me MNE,FW,Lecce,it Serie A,23-339,2000,17.5,12,4,3,6,3,3,7,42.9,4,9,3,6,3,15,17,0,Matches
1325,Rade Krunić,ba BIH,MF,Milan,it Serie A,30-154,1993,7.6,10,8,3,6,1,4,9,44.4,5,7,3,4,11,21,14,0,Matches
1326,Lukas Kübler,de GER,DF,Freiburg,de Bundesliga,31-192,1992,13.8,36,16,27,8,1,22,32,68.8,10,23,9,14,23,59,34,1,Matches
1327,Takefusa Kubo,jp JPN,"FW,MF",Real Sociedad,es La Liga,22-279,2001,18.7,18,14,10,5,3,6,16,37.5,10,19,2,17,9,27,6,1,Matches
1328,Dejan Kulusevski,se SWE,"FW,MF",Tottenham,eng Premier League,23-319,2000,22.5,43,23,15,13,15,15,44,34.1,29,15,1,14,9,52,2,1,Matches
1329,Sael Kumbedi,fr FRA,DF,Lyon,fr Ligue 1,18-349,2005,10.2,30,20,14,12,4,9,22,40.9,13,12,3,9,14,44,18,2,Matches
1330,Marash Kumbulla,al ALB,DF,Sassuolo,it Serie A,24-030,2000,0.2,0,0,0,0,0,0,0,,0,3,3,0,0,0,0,0,Matches
1331,Justin Kumi,it ITA,FW,Sassuolo,it Serie A,19-237,2004,0.0,0,0,0,0,0,0,0,,0,0,0,0,0,0,0,0,Matches
1332,Layvin Kurzawa,fr FRA,DF,Paris S-G,fr Ligue 1,31-187,1992,0.1,0,0,0,0,0,0,0,,0,0,0,0,0,0,0,0,Matches
1333,Berkan Kutlu,tr TUR,MF,Genoa,it Serie A,26-044,1998,2.2,6,4,5,1,0,3,6,50.0,3,3,0,3,4,10,5,0,Matches
1334,Daler Kuzyaev,ru RUS,MF,Le Havre,fr Ligue 1,31-054,1993,16.4,29,15,9,13,7,12,32,37.5,20,11,3,8,14,43,14,1,Matches
1335,Khvicha Kvaratskhelia,ge GEO,FW,Napoli,it Serie A,23-026,2001,23.1,27,15,6,14,7,10,34,29.4,24,12,1,11,12,39,8,0,Matches
1336,Giorgi Kvernadze,ge GEO,"FW,DF",Frosinone,it Serie A,21-031,2003,0.7,3,0,2,0,1,2,2,100.0,0,1,0,1,1,4,0,0,Matches
1337,Moritz-Broni Kwarteng,gh GHA,"FW,MF",Bochum,de Bundesliga,25-316,1998,3.1,3,0,0,3,0,1,7,14.3,6,4,0,4,2,5,0,0,Matches
1338,Grejohn Kyei,fr FRA,FW,Clermont Foot,fr Ligue 1,28-210,1995,7.5,5,3,1,2,2,2,3,66.7,1,2,0,2,1,6,4,0,Matches
1339,Giorgos Kyriakopoulos,gr GRE,DF,Monza,it Serie A,28-033,1996,14.9,15,9,12,3,0,7,17,41.2,10,10,0,10,11,26,19,0,Matches
1340,Luca de la Torre,us USA,"MF,FW",Celta Vigo,es La Liga,25-291,1998,19.1,34,18,12,19,3,18,37,48.6,19,18,3,15,10,44,15,0,Matches
1341,Gaëtan Laborde,fr FRA,FW,Nice,fr Ligue 1,29-311,1994,18.4,15,11,8,3,4,10,25,40.0,15,19,2,17,6,21,7,1,Matches
1342,Alexandre Lacazette,fr FRA,FW,Lyon,fr Ligue 1,32-286,1991,18.5,16,9,7,7,2,4,14,28.6,10,20,3,17,5,21,6,0,Matches
1343,Maxence Lacroix,fr FRA,DF,Wolfsburg,de Bundesliga,23-338,2000,18.4,34,20,20,13,1,20,28,71.4,8,26,11,15,22,56,88,0,Matches
1344,Alban Lafont,fr FRA,GK,Nantes,fr Ligue 1,25-046,1999,17.7,0,0,0,0,0,0,1,0.0,1,0,0,0,0,0,5,0,Matches
1345,Aïssa Laïdouni,tn TUN,MF,Union Berlin,de Bundesliga,27-087,1996,10.5,17,10,4,10,3,3,8,37.5,5,20,2,18,10,27,10,1,Matches
1346,Konrad Laimer,at AUT,"DF,MF",Bayern Munich,de Bundesliga,26-287,1997,14.7,42,24,18,15,9,19,34,55.9,15,32,4,28,15,57,12,1,Matches
1347,Stefan Lainer,at AUT,DF,M'Gladbach,de Bundesliga,31-195,1992,2.6,7,6,3,4,0,4,8,50.0,4,3,1,2,4,11,14,0,Matches
1348,Kenny Lala,mg MAD,DF,Brest,fr Ligue 1,32-158,1991,24.0,62,38,27,26,9,23,43,53.5,20,17,4,13,20,82,57,1,Matches
1349,Adam Lallana,eng ENG,MF,Brighton,eng Premier League,35-304,1988,7.3,7,2,3,4,0,0,3,0.0,3,2,1,1,2,9,1,0,Matches
1350,Mathis Lambourde,fr FRA,FW,Rennes,fr Ligue 1,18-060,2006,0.1,0,0,0,0,0,0,1,0.0,1,1,0,1,0,0,1,0,Matches
1351,Érik Lamela,ar ARG,"FW,MF",Sevilla,es La Liga,32-005,1992,4.2,17,11,3,9,5,8,13,61.5,5,10,0,10,1,18,5,0,Matches
1352,Mohamed Lamine Bayo,gn GUI,FW,Le Havre,fr Ligue 1,25-279,1998,12.7,8,3,1,3,4,1,9,11.1,8,8,1,7,1,9,10,0,Matches
1353,Didier Lamkel Zé,cm CMR,"FW,MF",Metz,fr Ligue 1,27-174,1996,4.5,5,1,0,4,1,2,3,66.7,1,4,0,4,0,5,6,0,Matches
1354,Tariq Lamptey,gh GHA,"DF,FW",Brighton,eng Premier League,23-161,2000,6.2,10,8,6,3,1,4,12,33.3,8,4,2,2,5,15,1,0,Matches
1355,Bruno Langa,mz MOZ,DF,Almería,es La Liga,26-130,1997,3.0,5,3,4,1,0,2,5,40.0,3,8,3,5,2,7,16,1,Matches
1356,Gianluca Lapadula,pe PER,FW,Cagliari,it Serie A,34-031,1990,7.4,1,1,0,0,1,1,4,25.0,3,2,1,1,2,3,4,0,Matches
1357,Aymeric Laporte,es ESP,DF,Manchester City,eng Premier League,29-287,1994,0.1,0,0,0,0,0,0,0,,0,1,1,0,0,0,1,0,Matches
1358,Julien Laporte,fr FRA,DF,Lorient,fr Ligue 1,30-126,1993,14.1,14,9,10,4,0,10,23,43.5,13,21,17,4,8,22,76,1,Matches
1359,Cyle Larin,ca CAN,FW,Mallorca,es La Liga,28-327,1995,15.5,15,7,5,3,7,2,5,40.0,3,13,4,9,2,17,13,0,Matches
1360,Yasser Larouci,dz ALG,DF,Sheffield Utd,eng Premier League,23-068,2001,4.7,15,7,8,5,2,8,11,72.7,3,5,1,4,7,22,18,1,Matches
1361,Hugo Larsson,se SWE,MF,Eint Frankfurt,de Bundesliga,19-256,2004,17.3,28,14,15,9,4,14,26,53.8,12,27,6,21,25,53,21,1,Matches
1362,Jamaal Lascelles,eng ENG,DF,Newcastle Utd,eng Premier League,30-119,1993,11.8,14,9,7,7,0,6,10,60.0,4,17,12,5,4,18,42,0,Matches
1363,Juanmi Latasa,es ESP,FW,Getafe,es La Liga,22-352,2001,12.6,5,4,0,4,1,0,8,0.0,8,5,0,5,3,8,16,0,Matches
1364,Toni Lato,es ESP,DF,Mallorca,es La Liga,26-109,1997,12.9,29,19,15,11,3,12,22,54.5,10,12,2,10,12,41,20,0,Matches
1365,Armand Lauriente,fr FRA,FW,Sassuolo,it Serie A,25-096,1998,23.5,18,11,3,11,4,10,34,29.4,24,22,3,19,9,27,6,0,Matches
1366,Roméo Lavia,be BEL,MF,Chelsea,eng Premier League,20-063,2004,0.4,1,0,0,1,0,0,0,,0,0,0,0,0,1,1,0,Matches
1367,Lázaro,br BRA,"FW,MF",Almería,es La Liga,21-363,2002,3.2,4,1,2,0,2,2,8,25.0,6,4,0,4,1,5,1,0,Matches
1368,Valentino Lazaro,at AUT,"DF,MF",Torino,it Serie A,27-351,1996,19.0,11,8,2,8,1,7,12,58.3,5,11,1,10,8,19,25,0,Matches
1369,Darko Lazović,rs SRB,"FW,DF",Hellas Verona,it Serie A,33-176,1990,13.0,14,8,7,1,6,7,15,46.7,8,6,1,5,2,16,10,0,Matches
1370,Manuel Lazzari,it ITA,DF,Lazio,it Serie A,30-101,1993,14.5,20,14,10,7,3,15,23,65.2,8,15,4,11,11,31,29,1,Matches
1371,Théo Le Bris,fr FRA,"DF,MF",Lorient,fr Ligue 1,21-160,2002,14.0,30,19,21,6,3,15,33,45.5,18,22,3,19,6,36,34,0,Matches
1372,Julien Le Cardinal,fr FRA,DF,Brest,fr Ligue 1,26-219,1997,3.3,9,4,4,4,1,4,6,66.7,2,3,2,1,8,17,14,0,Matches
1373,Julien Le Cardinal,fr FRA,DF,Lens,fr Ligue 1,26-219,1997,0.6,6,2,4,2,0,4,9,44.4,5,2,1,1,0,6,0,0,Matches
1374,Jérémy Le Douaron,fr FRA,FW,Brest,fr Ligue 1,25-323,1998,14.8,20,10,6,9,5,11,24,45.8,13,8,1,7,2,22,7,0,Matches
1375,Enzo Le Fée,fr FRA,MF,Rennes,fr Ligue 1,24-035,2000,13.9,37,26,16,15,6,19,37,51.4,18,16,3,13,14,51,17,0,Matches
1376,Vincent Le Goff,fr FRA,"DF,MF",Lorient,fr Ligue 1,34-146,1989,6.0,5,0,4,0,1,4,8,50.0,4,11,3,8,3,8,10,0,Matches
1377,Robin Le Normand,es ESP,DF,Real Sociedad,es La Liga,27-119,1996,19.5,22,17,13,9,0,12,22,54.5,10,22,13,9,23,45,64,1,Matches
1378,Nicola Leali,it ITA,GK,Genoa,it Serie A,31-021,1993,1.0,0,0,0,0,0,0,0,,0,0,0,0,0,0,0,0,Matches
1379,Rafael Leão,pt POR,FW,Milan,it Serie A,24-273,1999,20.0,11,9,2,6,3,4,7,57.1,3,12,1,11,6,17,11,0,Matches
1380,Adrien Lebeau,fr FRA,"MF,FW",Brest,fr Ligue 1,24-245,1999,0.5,0,0,0,0,0,0,3,0.0,3,1,1,0,0,0,1,0,Matches
1381,Benjamin Lecomte,fr FRA,GK,Montpellier,fr Ligue 1,32-318,1991,25.0,0,0,0,0,0,0,1,0.0,1,0,0,0,0,0,12,1,Matches
1382,Jeremías Ledesma,ar ARG,GK,Cádiz,es La Liga,31-025,1993,23.9,0,0,0,0,0,0,2,0.0,2,0,0,0,0,0,12,3,Matches
1383,Pierre Lees-Melou,fr FRA,MF,Brest,fr Ligue 1,30-289,1993,22.7,76,50,42,32,2,36,98,36.7,62,50,9,41,39,115,57,3,Matches
1384,Diogo Leite,pt POR,DF,Union Berlin,de Bundesliga,25-046,1999,21.7,36,25,23,8,5,20,38,52.6,18,31,16,15,33,69,105,0,Matches
1385,Maxim Leitsch,de GER,DF,Mainz 05,de Bundesliga,25-296,1998,4.2,6,3,5,1,0,3,6,50.0,3,2,0,2,4,10,13,0,Matches
1386,Florian Lejeune,fr FRA,DF,Rayo Vallecano,es La Liga,32-294,1991,27.0,21,12,13,7,1,10,19,52.6,9,25,11,14,15,36,124,1,Matches
1387,Stefan Lekovic,rs SRB,DF,Villarreal,es La Liga,20-060,2004,0.3,0,0,0,0,0,0,0,,0,1,1,0,0,0,1,0,Matches
1388,Iñigo Lekue,es ESP,DF,Athletic Club,es La Liga,30-310,1993,14.8,29,13,18,8,3,19,40,47.5,21,17,2,15,8,37,35,0,Matches
1389,Thomas Lemar,fr FRA,MF,Atlético Madrid,es La Liga,28-118,1995,1.8,3,1,2,1,0,1,2,50.0,1,0,0,0,0,3,0,0,Matches
1390,Mario Lemina,ga GAB,MF,Wolves,eng Premier League,30-190,1993,23.2,68,47,36,23,9,15,31,48.4,16,19,5,14,35,103,53,0,Matches
1391,Álvaro Lemos,es ESP,DF,Las Palmas,es La Liga,30-345,1993,2.2,4,1,1,3,0,0,1,0.0,1,3,1,2,2,6,4,0,Matches
1392,Clément Lenglet,fr FRA,DF,Aston Villa,eng Premier League,28-266,1995,9.7,8,7,5,3,0,5,8,62.5,3,14,7,7,5,13,36,0,Matches
1393,Bernd Leno,de GER,GK,Fulham,eng Premier League,32-005,1992,27.0,0,0,0,0,0,0,0,,0,0,0,0,0,0,12,1,Matches
1394,Christopher Lenz,de GER,"DF,MF",RB Leipzig,de Bundesliga,29-169,1994,0.4,1,1,1,0,0,1,1,100.0,0,0,0,0,1,2,2,0,Matches
1395,Christopher Lenz,de GER,DF,Eint Frankfurt,de Bundesliga,29-169,1994,0.1,1,1,0,1,0,1,1,100.0,0,0,0,0,0,1,1,0,Matches
1396,Johann Lepenant,fr FRA,MF,Lyon,fr Ligue 1,21-139,2002,2.8,4,3,2,2,0,1,8,12.5,7,5,0,5,4,8,0,0,Matches
1397,Jefferson Lerma,co COL,MF,Crystal Palace,eng Premier League,29-136,1994,21.5,30,17,8,19,3,11,28,39.3,17,24,8,16,25,55,46,0,Matches
1398,Léo Leroy,fr FRA,MF,Montpellier,fr Ligue 1,24-024,2000,2.9,13,5,5,5,3,3,10,30.0,7,7,1,6,3,16,7,0,Matches
1399,Robert Lewandowski,pl POL,FW,Barcelona,es La Liga,35-201,1988,23.0,6,4,0,5,1,3,8,37.5,5,10,4,6,5,11,15,0,Matches
1400,Jamie Leweling,de GER,"FW,MF",Stuttgart,de Bundesliga,23-012,2001,10.5,10,5,3,3,4,2,8,25.0,6,17,1,16,1,11,10,0,Matches
1401,Rico Lewis,eng ENG,"MF,DF",Manchester City,eng Premier League,19-109,2004,5.0,5,3,3,1,1,1,3,33.3,2,4,1,3,4,9,3,0,Matches
1402,Keane Lewis-Potter,eng ENG,"FW,DF",Brentford,eng Premier League,23-016,2001,10.2,16,6,5,10,1,6,10,60.0,4,7,1,6,5,21,9,0,Matches
1403,Philipp Lienhart,at AUT,DF,Freiburg,de Bundesliga,27-242,1996,13.7,18,12,12,5,1,11,20,55.0,9,17,10,7,13,31,50,0,Matches
1404,Matthijs de Ligt,nl NED,DF,Bayern Munich,de Bundesliga,24-210,1999,10.1,10,8,2,5,3,3,4,75.0,1,9,5,4,13,23,37,0,Matches
1405,Victor Lindelöf,se SWE,DF,Manchester Utd,eng Premier League,29-236,1994,13.0,12,7,5,7,0,4,11,36.4,7,14,8,6,11,23,32,1,Matches
1406,Jesper Lindstrøm,dk DEN,"FW,MF",Napoli,it Serie A,24-009,2000,3.6,6,2,2,1,3,4,8,50.0,4,3,0,3,2,8,4,0,Matches
1407,Jesper Lindstrøm,dk DEN,FW,Eint Frankfurt,de Bundesliga,24-009,2000,0.9,1,1,1,0,0,0,0,,0,0,0,0,0,1,0,0,Matches
1408,Karol Linetty,pl POL,MF,Torino,it Serie A,29-036,1995,13.7,21,17,6,15,0,7,21,33.3,14,20,8,12,16,37,22,1,Matches
1409,Samuel Lino,br BRA,DF,Atlético Madrid,es La Liga,24-077,1999,14.9,43,25,26,9,8,29,46,63.0,17,24,0,24,10,53,20,0,Matches
1410,Luca Lipani,it ITA,MF,Sassuolo,it Serie A,18-296,2005,2.2,4,3,1,2,1,1,5,20.0,4,6,2,4,4,8,5,0,Matches
1411,Pol Lirola,es ESP,"DF,MF",Frosinone,it Serie A,26-209,1997,7.5,11,5,4,6,1,5,15,33.3,10,8,0,8,10,21,18,0,Matches
1412,Marcin Listkowski,pl POL,FW,Lecce,it Serie A,26-028,1998,0.1,0,0,0,0,0,0,0,,0,0,0,0,0,0,0,0,Matches
1413,Valentino Livramento,eng ENG,DF,Newcastle Utd,eng Premier League,21-118,2002,9.8,16,8,11,4,1,7,16,43.8,9,10,5,5,16,32,30,0,Matches
1414,Dejan Ljubicic,at AUT,"MF,FW",Köln,de Bundesliga,26-153,1997,18.8,35,24,19,12,4,17,36,47.2,19,19,2,17,17,52,7,0,Matches
1415,Javier Llabrés,es ESP,"MF,FW",Mallorca,es La Liga,21-180,2002,1.9,2,0,1,1,0,1,1,100.0,0,1,0,1,1,3,3,0,Matches
1416,Diego Llorente,es ESP,DF,Roma,it Serie A,30-206,1993,18.1,27,17,19,8,0,10,20,50.0,10,30,20,10,16,43,54,0,Matches
1417,Marcos Llorente,es ESP,"MF,DF",Atlético Madrid,es La Liga,29-039,1995,19.8,23,13,11,9,3,9,30,30.0,21,26,8,18,10,33,26,0,Matches
1418,Gautier Lloris,fr FRA,DF,Le Havre,fr Ligue 1,28-235,1995,22.9,39,21,32,7,0,22,34,64.7,12,43,25,18,23,62,105,1,Matches
1419,Abou Lô,sn SEN,DF,Metz,fr Ligue 1,24-067,2000,0.8,1,0,1,0,0,1,2,50.0,1,1,1,0,0,1,2,0,Matches
1420,Giovani Lo Celso,ar ARG,MF,Tottenham,eng Premier League,27-335,1996,4.7,16,8,6,7,3,7,10,70.0,3,3,1,2,4,20,2,0,Matches
1421,Stanislav Lobotka,sk SVK,MF,Napoli,it Serie A,29-105,1994,26.5,47,30,13,25,9,19,49,38.8,30,23,5,18,15,62,21,0,Matches
1422,Manuel Locatelli,it ITA,MF,Juventus,it Serie A,26-061,1998,23.6,46,28,16,23,7,20,41,48.8,21,29,12,17,18,64,51,0,Matches
1423,Bradley Locko,fr FRA,DF,Brest,fr Ligue 1,21-308,2002,23.9,74,41,42,28,4,37,61,60.7,24,20,0,20,28,102,50,0,Matches
1424,Tom Lockyer,wls WAL,DF,Luton Town,eng Premier League,29-097,1994,13.0,25,16,17,6,2,15,22,68.2,7,23,13,10,23,48,68,0,Matches
1425,Renan Lodi,br BRA,DF,Marseille,fr Ligue 1,25-336,1998,13.7,24,16,8,13,3,13,21,61.9,8,7,2,5,16,40,35,0,Matches
1426,Ruben Loftus-Cheek,eng ENG,MF,Milan,it Serie A,28-046,1996,18.0,20,14,6,8,6,11,21,52.4,10,20,11,9,5,25,8,1,Matches
1427,Andy Logbo,fr FRA,FW,Le Havre,fr Ligue 1,19-308,2004,2.8,0,0,0,0,0,0,3,0.0,3,7,3,4,0,0,2,0,Matches
1428,Enzo Loiodice,fr FRA,MF,Las Palmas,es La Liga,23-103,2000,14.9,42,24,11,22,9,12,32,37.5,20,16,2,14,11,53,13,1,Matches
1429,Sean Longstaff,eng ENG,MF,Newcastle Utd,eng Premier League,26-131,1997,20.1,35,19,11,19,5,17,46,37.0,29,26,5,21,10,45,16,0,Matches
1430,Ademola Lookman,ng NGA,"FW,MF",Atalanta,it Serie A,26-141,1997,14.2,8,5,1,4,3,6,14,42.9,8,10,0,10,7,15,0,1,Matches
1431,Noah Loosli,ch SUI,DF,Bochum,de Bundesliga,27-046,1997,3.8,10,7,6,4,0,7,14,50.0,7,7,1,6,7,17,18,0,Matches
1432,Anthony Lopes,pt POR,GK,Lyon,fr Ligue 1,33-160,1990,21.0,0,0,0,0,0,0,0,,0,0,0,0,0,0,12,0,Matches
1433,David López,es ESP,"DF,MF",Girona,es La Liga,34-152,1989,14.0,24,17,14,10,0,10,13,76.9,3,17,13,4,15,39,41,1,Matches
1434,Diego López,es ESP,"FW,MF",Valencia,es La Liga,21-301,2002,18.9,25,15,6,12,7,8,35,22.9,27,14,0,14,11,36,7,0,Matches
1435,Fermin López,es ESP,"MF,FW",Barcelona,es La Liga,20-303,2003,8.9,24,13,9,11,4,8,25,32.0,17,8,0,8,3,27,5,0,Matches
1436,Javi López,es ESP,"DF,MF",Alavés,es La Liga,22-068,2002,17.8,15,8,7,6,2,10,19,52.6,9,14,4,10,4,19,58,1,Matches
1437,Maxime Lopez,fr FRA,MF,Fiorentina,it Serie A,26-096,1997,4.7,10,4,4,4,2,3,7,42.9,4,2,0,2,2,12,6,0,Matches
1438,Maxime Lopez,fr FRA,MF,Sassuolo,it Serie A,26-096,1997,1.6,2,1,1,1,0,1,2,50.0,1,1,1,0,2,4,0,0,Matches
1439,Pau López,es ESP,GK,Marseille,fr Ligue 1,29-087,1994,22.7,0,0,0,0,0,0,1,0.0,1,0,0,0,0,0,7,1,Matches
1440,Unai López,es ESP,MF,Rayo Vallecano,es La Liga,28-131,1995,15.9,29,15,12,13,4,12,35,34.3,23,18,2,16,7,36,11,1,Matches
1441,Dion Lopy,sn SEN,MF,Almería,es La Liga,22-036,2002,18.1,53,32,32,17,4,14,38,36.8,24,19,5,14,13,66,20,1,Matches
1442,Anthony Losilla,fr FRA,MF,Bochum,de Bundesliga,37-365,1986,20.4,47,25,11,30,6,19,39,48.7,20,25,6,19,19,66,38,0,Matches
1443,Jordan Lotomba,ch SUI,DF,Nice,fr Ligue 1,25-162,1998,15.0,29,22,15,8,6,21,29,72.4,8,23,7,16,11,40,19,0,Matches
1444,Tom Louchet,fr FRA,"FW,DF",Nice,fr Ligue 1,20-310,2003,2.2,9,2,2,5,2,4,8,50.0,4,3,0,3,0,9,4,0,Matches
1445,Imran Louza,ma MAR,MF,Lorient,fr Ligue 1,24-313,1999,3.6,2,1,1,1,0,1,4,25.0,3,5,1,4,2,4,2,0,Matches
1446,Matteo Lovato,it ITA,DF,Torino,it Serie A,24-024,2000,3.2,10,7,5,5,0,4,4,100.0,0,5,2,3,11,21,4,0,Matches
1447,Matteo Lovato,it ITA,DF,Salernitana,it Serie A,24-024,2000,10.5,27,14,17,8,2,16,24,66.7,8,14,7,7,18,45,41,1,Matches
1448,Dejan Lovren,hr CRO,DF,Lyon,fr Ligue 1,34-248,1989,8.0,9,7,6,3,0,3,7,42.9,4,6,5,1,12,21,37,0,Matches
1449,Sandi Lovrić,si SVN,MF,Udinese,it Serie A,25-347,1998,19.0,23,11,8,10,5,9,19,47.4,10,18,2,16,18,41,18,0,Matches
1450,Max Lowe,eng ENG,"DF,MF",Sheffield Utd,eng Premier League,26-303,1997,4.4,20,10,12,5,3,8,15,53.3,7,7,3,4,5,25,13,0,Matches
1451,Anthony Lozano,hn HON,"MF,FW",Getafe,es La Liga,30-319,1993,1.0,0,0,0,0,0,0,1,0.0,1,0,0,0,0,0,1,0,Matches
1452,Anthony Lozano,hn HON,FW,Almería,es La Liga,30-319,1993,3.4,1,1,0,1,0,1,2,50.0,1,1,0,1,1,2,7,0,Matches
1453,Lucas,br BRA,DF,Cádiz,es La Liga,22-351,2001,13.7,38,21,25,9,4,24,41,58.5,17,22,3,19,12,50,41,0,Matches
1454,Lorenzo Lucca,it ITA,FW,Udinese,it Serie A,23-181,2000,19.8,10,6,3,5,2,3,14,21.4,11,13,2,11,3,13,24,1,Matches
1455,Jhon Lucumí,co COL,DF,Bologna,it Serie A,25-257,1998,13.6,35,22,23,12,0,23,28,82.1,5,16,8,8,5,40,43,0,Matches
1456,José Luis Gayà,es ESP,DF,Valencia,es La Liga,28-289,1995,18.0,65,33,41,20,4,40,62,64.5,22,15,2,13,9,74,38,0,Matches
1457,José Luis Morales,es ESP,"FW,MF",Villarreal,es La Liga,36-230,1987,9.9,5,3,1,4,0,3,12,25.0,9,8,0,8,6,11,4,0,Matches
1458,José Luis Palomino,ar ARG,DF,Atalanta,it Serie A,34-064,1990,0.3,2,1,1,1,0,1,1,100.0,0,2,1,1,1,3,6,0,Matches
1459,Douglas Luiz,br BRA,MF,Aston Villa,eng Premier League,25-305,1998,24.9,47,30,16,23,8,20,42,47.6,22,28,6,22,17,64,17,1,Matches
1460,Romelu Lukaku,be BEL,FW,Roma,it Serie A,30-301,1993,21.9,3,2,1,1,1,1,3,33.3,2,7,1,6,0,3,13,1,Matches
1461,Castello Lukeba,fr FRA,DF,RB Leipzig,de Bundesliga,21-083,2002,14.4,10,6,5,5,0,6,8,75.0,2,29,10,19,7,17,56,1,Matches
1462,Dodi Lukebakio,be BEL,FW,Sevilla,es La Liga,26-167,1997,8.2,4,2,2,1,1,1,5,20.0,4,7,2,5,2,6,1,0,Matches
1463,Saša Lukić,rs SRB,MF,Fulham,eng Premier League,27-209,1996,6.4,18,9,4,9,5,8,18,44.4,10,7,3,4,8,26,9,1,Matches
1464,Karlo Lulić,hr CRO,MF,Frosinone,it Serie A,27-304,1996,0.2,0,0,0,0,0,0,0,,0,1,0,1,1,1,0,0,Matches
1465,Andriy Lunin,ua UKR,GK,Real Madrid,es La Liga,25-027,1999,15.0,0,0,0,0,0,0,1,0.0,1,0,0,0,0,0,9,0,Matches
1466,Sebastiano Luperto,it ITA,DF,Empoli,it Serie A,27-185,1996,27.0,28,18,20,6,2,13,20,65.0,7,33,28,5,18,46,107,1,Matches
1467,Mateus Lusuardi,br BRA,DF,Frosinone,it Serie A,20-061,2004,2.4,2,1,1,1,0,1,3,33.3,2,4,2,2,4,6,7,0,Matches
1468,Andreas Luthe,de GER,GK,Bochum,de Bundesliga,36-365,1987,1.0,0,0,0,0,0,0,0,,0,0,0,0,0,0,1,1,Matches
1469,Zito Luvumbo,ao ANG,"FW,MF",Cagliari,it Serie A,22-000,2002,15.4,6,4,4,0,2,3,8,37.5,5,11,0,11,1,7,2,0,Matches
1470,Charalambos Lykogiannis,gr GRE,DF,Bologna,it Serie A,30-139,1993,7.9,9,5,4,4,1,5,9,55.6,4,14,5,9,5,14,26,0,Matches
1471,Senne Lynen,be BEL,MF,Werder Bremen,de Bundesliga,25-019,1999,11.8,34,22,18,13,3,12,36,33.3,24,24,3,21,27,61,32,0,Matches
1472,Ian Maatsen,nl NED,"FW,MF",Chelsea,eng Premier League,21-365,2002,2.3,3,2,1,1,1,0,4,0.0,4,4,0,4,3,6,10,0,Matches
1473,Ian Maatsen,nl NED,DF,Dortmund,de Bundesliga,21-365,2002,7.8,18,14,9,6,3,9,12,75.0,3,11,2,9,8,26,16,0,Matches
1474,Alexis Mac Allister,ar ARG,MF,Liverpool,eng Premier League,25-076,1998,19.1,60,35,21,32,7,40,85,47.1,45,48,5,43,26,86,14,0,Matches
1475,Deiver Machado,co COL,DF,Lens,fr Ligue 1,30-189,1993,7.0,8,5,2,5,1,6,10,60.0,4,9,1,8,4,12,5,0,Matches
1476,Darwin Machís,ve VEN,MF,Cádiz,es La Liga,31-031,1993,8.3,22,13,6,9,7,12,23,52.2,11,6,1,5,3,25,2,0,Matches
1477,James Maddison,eng ENG,MF,Tottenham,eng Premier League,27-107,1996,14.5,24,12,3,12,9,12,20,60.0,8,10,1,9,8,32,4,1,Matches
1478,Noni Madueke,eng ENG,FW,Chelsea,eng Premier League,21-365,2002,3.9,7,5,4,2,1,5,13,38.5,8,5,0,5,1,8,6,0,Matches
1479,Pablo Maffeo,es ESP,DF,Mallorca,es La Liga,26-241,1997,12.5,27,15,14,9,4,20,36,55.6,16,7,1,6,8,35,18,0,Matches
1480,Soungoutou Magassa,fr FRA,DF,Monaco,fr Ligue 1,20-153,2003,13.4,48,23,21,27,0,20,38,52.6,18,20,4,16,21,69,36,2,Matches
1481,Giulio Maggiore,it ITA,MF,Salernitana,it Serie A,25-363,1998,14.7,36,21,18,17,1,17,35,48.6,18,19,4,15,19,55,33,0,Matches
1482,Matej Maglica,hr CRO,DF,Darmstadt 98,de Bundesliga,25-166,1998,13.5,25,13,16,9,0,15,26,57.7,11,26,10,16,15,40,63,4,Matches
1483,Giangiacomo Magnani,it ITA,DF,Hellas Verona,it Serie A,28-157,1995,19.6,19,10,13,6,0,10,17,58.8,7,34,18,16,32,51,75,0,Matches
1484,Hugo Magnetti,fr FRA,MF,Brest,fr Ligue 1,25-284,1998,17.7,38,21,14,19,5,19,42,45.2,23,16,1,15,10,48,13,0,Matches
1485,Yohann Magnin,fr FRA,MF,Clermont Foot,fr Ligue 1,26-262,1997,11.1,24,14,6,16,2,7,19,36.8,12,26,7,19,11,35,13,0,Matches
1486,Frank Magri,cm CMR,"FW,MF",Toulouse,fr Ligue 1,24-187,1999,13.3,16,10,4,8,4,9,13,69.2,4,11,2,9,4,20,12,0,Matches
1487,Harry Maguire,eng ENG,DF,Manchester Utd,eng Premier League,31-004,1993,12.9,16,11,9,7,0,8,16,50.0,8,26,18,8,19,35,52,1,Matches
1488,Jon Magunacelaya,es ESP,"FW,MF",Real Sociedad,es La Liga,23-240,2000,1.3,5,3,2,3,0,4,7,57.1,3,2,0,2,0,5,2,0,Matches
1489,Adel Mahamoud,km COM,FW,Nantes,fr Ligue 1,21-034,2003,0.1,0,0,0,0,0,0,1,0.0,1,0,0,0,0,0,0,0,Matches
1490,Arne Maier,de GER,"MF,DF",Augsburg,de Bundesliga,25-061,1999,2.6,6,6,2,3,1,2,4,50.0,2,6,0,6,1,7,1,0,Matches
1491,Habib Maïga,ci CIV,"MF,FW",Metz,fr Ligue 1,28-068,1996,1.6,2,2,1,0,1,1,3,33.3,2,2,0,2,4,6,2,0,Matches
1492,Mike Maignan,fr FRA,GK,Milan,it Serie A,28-250,1995,24.0,1,0,1,0,0,1,1,100.0,0,1,0,1,0,1,4,3,Matches
1493,Linton Maina,de GER,"FW,MF",Köln,de Bundesliga,24-260,1999,15.3,13,12,8,3,2,7,21,33.3,14,9,1,8,6,19,5,0,Matches
1494,Patrick Mainka,de GER,DF,Heidenheim,de Bundesliga,29-124,1994,24.0,59,34,41,16,2,27,52,51.9,25,46,19,27,34,93,113,1,Matches
1495,Kobbie Mainoo,eng ENG,MF,Manchester Utd,eng Premier League,18-325,2005,11.4,23,14,8,11,4,8,20,40.0,12,13,8,5,12,35,24,1,Matches
1496,Ainsley Maitland-Niles,eng ENG,"DF,MF",Lyon,fr Ligue 1,26-193,1997,9.5,22,9,8,9,5,10,22,45.5,12,9,2,7,12,34,17,0,Matches
1497,Radosław Majecki,pl POL,GK,Monaco,fr Ligue 1,24-114,1999,2.0,0,0,0,0,0,0,0,,0,0,0,0,0,0,1,1,Matches
1498,Lovro Majer,hr CRO,MF,Rennes,fr Ligue 1,26-052,1998,0.2,0,0,0,0,0,0,0,,0,0,0,0,0,0,1,0,Matches
1499,Lovro Majer,hr CRO,"MF,FW",Wolfsburg,de Bundesliga,26-052,1998,18.5,27,14,10,17,0,9,24,37.5,15,17,1,16,7,34,11,0,Matches
1500,Jean-Victor Makengo,fr FRA,"MF,FW",Lorient,fr Ligue 1,25-271,1998,5.3,5,4,3,2,0,2,6,33.3,4,12,1,11,8,13,5,0,Matches
1501,Jordy Makengo,fr FRA,DF,Freiburg,de Bundesliga,22-219,2001,9.0,9,5,6,2,1,4,6,66.7,2,9,1,8,9,18,27,0,Matches
1502,Antoine Makoumbou,cg CGO,MF,Cagliari,it Serie A,25-235,1998,23.7,35,19,16,15,4,13,26,50.0,13,18,3,15,13,48,19,2,Matches
1503,Nemanja Maksimović,rs SRB,MF,Getafe,es La Liga,29-043,1995,25.5,45,33,16,23,6,16,27,59.3,11,42,20,22,38,83,49,0,Matches
1504,Julián Malatini,ar ARG,DF,Werder Bremen,de Bundesliga,22-283,2001,3.6,10,8,6,3,1,10,15,66.7,5,4,1,3,8,18,12,0,Matches
1505,Daniel Maldini,it ITA,"FW,MF",Monza,it Serie A,22-150,2001,0.8,1,1,0,1,0,1,2,50.0,1,0,0,0,0,1,0,0,Matches
1506,Daniel Maldini,it ITA,"FW,MF",Empoli,it Serie A,22-150,2001,2.9,4,2,0,2,2,2,2,100.0,0,5,0,5,2,6,2,0,Matches
1507,Youssef Maleh,ma MAR,MF,Empoli,it Serie A,25-200,1998,21.4,52,36,17,28,7,15,37,40.5,22,41,5,36,18,70,18,0,Matches
1508,Donyell Malen,nl NED,"FW,MF",Dortmund,de Bundesliga,25-060,1999,16.4,8,6,4,1,3,2,6,33.3,4,11,4,7,2,10,7,0,Matches
1509,Ruslan Malinovskyi,ua UKR,MF,Genoa,it Serie A,30-310,1993,15.4,29,16,17,7,5,16,39,41.0,23,19,6,13,3,32,13,0,Matches
1510,Lennard Maloney,us USA,MF,Heidenheim,de Bundesliga,24-153,1999,21.5,38,24,12,21,5,23,54,42.6,31,27,6,21,23,61,77,0,Matches
1511,Aaron Malouda,fr FRA,FW,Lille,fr Ligue 1,18-100,2005,0.0,0,0,0,0,0,0,0,,0,0,0,0,0,0,0,0,Matches
1512,Giorgi Mamardashvili,ge GEO,GK,Valencia,es La Liga,23-162,2000,26.0,2,2,2,0,0,2,2,100.0,0,0,0,0,0,2,13,2,Matches
1513,David Mamutovic,de GER,"FW,DF",Mainz 05,de Bundesliga,23-095,2000,0.1,1,1,0,1,0,1,1,100.0,0,0,0,0,0,1,0,0,Matches
1514,Wilson Manafá,pt POR,"DF,MF",Granada,es La Liga,29-230,1994,2.7,6,4,3,2,1,4,7,57.1,3,1,0,1,1,7,4,1,Matches
1515,Hianga Mananga Mbock,fr FRA,"MF,FW",Brest,fr Ligue 1,24-072,1999,0.1,1,0,0,0,1,1,2,50.0,1,0,0,0,1,2,0,0,Matches
1516,Gianluca Mancini,it ITA,DF,Roma,it Serie A,27-327,1996,24.2,26,14,17,7,2,8,21,38.1,13,24,17,7,28,54,56,0,Matches
1517,Marco Mancosu,it ITA,"MF,FW",Cagliari,it Serie A,35-200,1988,1.7,2,0,0,2,0,0,1,0.0,1,0,0,0,0,2,0,0,Matches
1518,Steve Mandanda,fr FRA,GK,Rennes,fr Ligue 1,38-347,1985,24.0,2,0,2,0,0,2,3,66.7,1,0,0,0,0,2,4,1,Matches
1519,Reinildo Mandava,mz MOZ,DF,Atlético Madrid,es La Liga,30-048,1994,4.6,15,13,8,7,0,10,10,100.0,0,8,2,6,9,24,15,0,Matches
1520,Aïssa Mandi,dz ALG,DF,Villarreal,es La Liga,32-139,1991,7.6,9,5,6,3,0,7,12,58.3,5,5,4,1,6,15,26,0,Matches
1521,Rolando Mandragora,it ITA,MF,Fiorentina,it Serie A,26-254,1997,12.7,21,10,7,9,5,7,16,43.8,9,10,2,8,6,27,14,1,Matches
1522,Orel Mangala,be BEL,MF,Nott'ham Forest,eng Premier League,25-357,1998,17.4,27,13,16,10,1,14,29,48.3,15,12,6,6,26,53,32,0,Matches
1523,Orel Mangala,be BEL,MF,Lyon,fr Ligue 1,25-357,1998,2.8,4,2,0,1,3,1,3,33.3,2,2,2,0,4,8,4,0,Matches
1524,Kostas Manolas,gr GRE,DF,Salernitana,it Serie A,32-269,1991,1.5,1,1,0,1,0,1,1,100.0,0,2,2,0,0,1,4,0,Matches
1525,Javier Manquillo,es ESP,"DF,MF",Celta Vigo,es La Liga,29-309,1994,3.6,10,6,3,4,3,7,10,70.0,3,9,1,8,1,11,6,0,Matches
1526,Braydon Manu,gh GHA,MF,Darmstadt 98,de Bundesliga,26-347,1997,0.9,1,0,0,1,0,0,0,,0,1,0,1,0,1,0,0,Matches
1527,Benson Manuel,be BEL,"MF,FW",Burnley,eng Premier League,26-347,1997,1.0,3,2,2,1,0,0,0,,0,1,0,1,0,3,0,0,Matches
1528,Faitout Maouassa,fr FRA,"DF,MF",Granada,es La Liga,25-247,1998,1.8,8,5,6,1,1,4,5,80.0,1,4,0,4,1,9,2,0,Matches
1529,Faitout Maouassa,fr FRA,"MF,DF",Lens,fr Ligue 1,25-247,1998,0.8,1,1,1,0,0,1,1,100.0,0,1,0,1,0,1,3,0,Matches
1530,Marcão,br BRA,DF,Sevilla,es La Liga,27-278,1996,3.4,8,5,4,4,0,5,9,55.6,4,8,6,2,3,11,7,1,Matches
1531,Solly March,eng ENG,"FW,DF",Brighton,eng Premier League,29-233,1994,6.2,19,14,9,7,3,8,14,57.1,6,5,0,5,11,30,8,0,Matches
1532,Riccardo Marchizza,it ITA,DF,Frosinone,it Serie A,25-349,1998,12.8,7,6,4,3,0,3,13,23.1,10,10,2,8,7,14,33,0,Matches
1533,Gian Marco Ferrari,it ITA,DF,Sassuolo,it Serie A,32-023,1992,14.2,12,6,8,4,0,7,10,70.0,3,17,10,7,14,26,37,0,Matches
1534,Óscar de Marcos,es ESP,DF,Athletic Club,es La Liga,34-330,1989,17.7,47,32,24,18,5,35,56,62.5,21,18,4,14,10,57,24,0,Matches
1535,Alberto Marí,es ESP,"FW,MF",Valencia,es La Liga,22-242,2001,0.6,2,1,0,1,1,1,1,100.0,0,0,0,0,0,2,1,0,Matches
1536,José Mari,es ESP,"MF,FW",Cádiz,es La Liga,36-094,1987,0.2,2,1,0,2,0,1,2,50.0,1,0,0,0,0,2,0,0,Matches
1537,Pablo Marí,es ESP,DF,Monza,it Serie A,30-191,1993,18.3,30,19,25,5,0,15,21,71.4,6,23,16,7,18,48,64,1,Matches
1538,José María Giménez,uy URU,DF,Atlético Madrid,es La Liga,29-049,1995,8.7,13,6,7,5,1,4,9,44.4,5,7,6,1,8,21,49,0,Matches
1539,Mariano,do DOM,FW,Sevilla,es La Liga,30-221,1993,2.4,1,1,0,1,0,0,0,,0,1,0,1,0,1,2,0,Matches
1540,Mirko Marić,hr CRO,FW,Monza,it Serie A,28-298,1995,3.2,4,0,2,1,1,0,2,0.0,2,4,0,4,2,6,3,0,Matches
1541,Rafa Marín ,es ESP,DF,Alavés,es La Liga,21-295,2002,19.2,17,13,12,5,0,6,15,40.0,9,25,16,9,18,35,94,1,Matches
1542,Răzvan Marin,ro ROU,MF,Empoli,it Serie A,27-291,1996,12.7,21,10,7,10,4,11,17,64.7,6,11,2,9,3,24,23,0,Matches
1543,Diego Mariño,es ESP,GK,Almería,es La Liga,33-305,1990,1.0,0,0,0,0,0,0,0,,0,0,0,0,0,0,1,0,Matches
1544,Guillermo Maripán,cl CHI,DF,Monaco,fr Ligue 1,29-308,1994,15.1,17,7,10,6,1,9,22,40.9,13,21,11,10,18,35,88,2,Matches
1545,Mika Màrmol,es ESP,DF,Las Palmas,es La Liga,21-251,2002,24.5,48,30,30,17,1,23,32,71.9,9,30,15,15,29,77,117,2,Matches
1546,Omar Marmoush,eg EGY,"FW,MF",Eint Frankfurt,de Bundesliga,25-031,1999,15.6,16,8,6,5,5,5,11,45.5,6,6,0,6,7,23,6,0,Matches
1547,Marquinhos,br BRA,"FW,MF",Nantes,fr Ligue 1,20-337,2003,1.7,3,2,2,0,1,1,4,25.0,3,7,2,5,6,9,1,0,Matches
1548,Marquinhos,br BRA,DF,Paris S-G,fr Ligue 1,29-300,1994,14.4,17,9,9,7,1,10,15,66.7,5,26,18,8,16,33,50,0,Matches
1549,Unai Marrero,es ESP,GK,Real Sociedad,es La Liga,22-152,2001,1.6,0,0,0,0,0,0,0,,0,0,0,0,0,0,0,0,Matches
1550,Agustín Martegani,ar ARG,MF,Salernitana,it Serie A,23-294,2000,7.6,12,7,6,3,3,6,16,37.5,10,3,1,2,4,16,7,1,Matches
1551,Eric Martel,de GER,MF,Köln,de Bundesliga,21-315,2002,20.1,56,34,26,26,4,32,56,57.1,24,45,14,31,25,81,61,0,Matches
1552,Roger Martí,es ESP,FW,Cádiz,es La Liga,33-066,1991,11.6,9,5,1,8,0,1,5,20.0,4,13,1,12,6,15,3,0,Matches
1553,Anthony Martial,fr FRA,FW,Manchester Utd,eng Premier League,28-095,1995,5.0,4,1,1,1,2,1,1,100.0,0,4,0,4,0,4,3,0,Matches
1554,Aarón Martín,es ESP,DF,Genoa,it Serie A,26-322,1997,9.1,13,6,5,6,2,7,16,43.8,9,7,1,6,6,19,8,0,Matches
1555,Iván Martín,es ESP,"MF,FW",Girona,es La Liga,25-024,1999,20.7,37,20,18,13,6,19,46,41.3,27,18,2,16,12,49,11,0,Matches
1556,Jonas Martin,fr FRA,MF,Brest,fr Ligue 1,33-335,1990,8.4,30,19,12,17,1,13,22,59.1,9,12,1,11,4,34,11,1,Matches
1557,Gabriel Martinelli,br BRA,FW,Arsenal,eng Premier League,22-265,2001,19.4,19,15,3,7,9,8,17,47.1,9,18,1,17,4,23,5,1,Matches
1558,Arnau Martinez,es ESP,DF,Girona,es La Liga,20-319,2003,11.0,21,14,14,6,1,12,26,46.2,14,11,4,7,10,31,34,2,Matches
1559,Emiliano Martínez,ar ARG,GK,Aston Villa,eng Premier League,31-189,1992,26.0,0,0,0,0,0,0,0,,0,0,0,0,0,0,10,1,Matches
1560,Iñigo Martínez,es ESP,DF,Barcelona,es La Liga,32-297,1991,8.8,7,5,6,1,0,3,4,75.0,1,10,9,1,8,15,40,0,Matches
1561,Josep Martinez,es ESP,GK,Genoa,it Serie A,25-287,1998,26.0,0,0,0,0,0,0,0,,0,0,0,0,1,1,17,3,Matches
1562,Lautaro Martínez,ar ARG,FW,Inter,it Serie A,26-200,1997,22.5,20,15,3,13,4,4,12,33.3,8,17,1,16,18,38,8,0,Matches
1563,Lisandro Martínez,ar ARG,DF,Manchester Utd,eng Premier League,26-051,1998,6.2,11,7,8,3,0,5,12,41.7,7,9,7,2,4,15,21,0,Matches
1564,Lucas Martínez Quarta,ar ARG,DF,Fiorentina,it Serie A,27-304,1996,18.4,58,36,35,20,3,28,41,68.3,13,32,12,20,24,82,42,3,Matches
1565,Adam Marušić,me MNE,DF,Lazio,it Serie A,31-144,1992,24.9,32,21,17,14,1,20,37,54.1,17,22,7,15,24,56,51,2,Matches
1566,Marvin,es ESP,"FW,DF",Las Palmas,es La Liga,23-250,2000,12.8,26,18,12,11,3,12,24,50.0,12,15,2,13,7,33,13,0,Matches
1567,Omar Mascarell,es ESP,MF,Mallorca,es La Liga,31-036,1993,11.7,24,13,10,14,0,13,26,50.0,13,12,3,9,23,47,24,1,Matches
1568,Adam Masina,ma MAR,DF,Udinese,it Serie A,30-067,1994,0.7,4,0,2,2,0,2,4,50.0,2,2,1,1,2,6,5,0,Matches
1569,Adam Masina,ma MAR,DF,Torino,it Serie A,30-067,1994,6.1,11,8,4,6,1,3,12,25.0,9,9,4,5,5,16,14,0,Matches
1570,Erhan Mašović,rs SRB,"DF,MF",Bochum,de Bundesliga,25-108,1998,18.2,53,33,31,17,5,31,57,54.4,26,27,10,17,18,71,54,1,Matches
1571,Han-Noah Massengo,fr FRA,"MF,DF",Burnley,eng Premier League,22-246,2001,0.2,1,1,1,0,0,0,0,,0,1,0,1,0,1,0,0,Matches
1572,Roberto Massimo,de GER,"FW,DF",Stuttgart,de Bundesliga,23-149,2000,0.9,1,0,1,0,0,1,2,50.0,1,0,0,0,0,1,1,0,Matches
1573,Clinton Mata,ao ANG,DF,Lyon,fr Ligue 1,31-123,1992,17.2,24,14,17,5,2,12,23,52.2,11,24,12,12,28,52,38,0,Matches
1574,Jaime Mata,es ESP,"FW,MF",Getafe,es La Liga,35-137,1988,13.1,20,13,10,7,3,10,22,45.5,12,13,1,12,12,32,19,0,Matches
1575,Pape Matar Sarr,sn SEN,MF,Tottenham,eng Premier League,21-177,2002,15.0,24,17,8,12,4,11,24,45.8,13,14,4,10,15,39,18,0,Matches
1576,Eliot Matazo,be BEL,MF,Monaco,fr Ligue 1,22-023,2002,1.1,3,1,0,3,0,2,4,50.0,2,1,1,0,3,6,0,0,Matches
1577,Jean-Philippe Mateta,fr FRA,FW,Crystal Palace,eng Premier League,26-255,1997,15.8,12,8,3,6,3,3,5,60.0,2,8,2,6,3,15,7,0,Matches
1578,Nemanja Matić,rs SRB,MF,Rennes,fr Ligue 1,35-221,1988,11.4,19,10,7,9,3,9,12,75.0,3,15,7,8,27,46,19,0,Matches
1579,Nemanja Matić,rs SRB,MF,Lyon,fr Ligue 1,35-221,1988,4.9,5,4,3,1,1,3,4,75.0,1,4,1,3,6,11,5,0,Matches
1580,Joël Matip,cm CMR,DF,Liverpool,eng Premier League,32-214,1991,8.7,12,6,7,4,1,8,12,66.7,4,16,12,4,9,21,43,0,Matches
1581,Alex Matos,eng ENG,MF,Chelsea,eng Premier League,19-158,2004,0.0,0,0,0,0,0,0,0,,0,0,0,0,0,0,0,0,Matches
1582,Chrislain Matsima,fr FRA,DF,Clermont Foot,fr Ligue 1,21-299,2002,5.0,6,3,2,4,0,3,6,50.0,3,4,3,1,6,12,26,1,Matches
1583,Chrislain Matsima,fr FRA,DF,Monaco,fr Ligue 1,21-299,2002,3.3,9,7,5,3,1,2,7,28.6,5,4,1,3,4,13,4,0,Matches
1584,Jean Mattéo Bahoya,fr FRA,"FW,DF",Eint Frankfurt,de Bundesliga,18-307,2005,0.4,0,0,0,0,0,0,1,0.0,1,0,0,0,1,1,0,0,Matches
1585,Remi Matthews,eng ENG,GK,Crystal Palace,eng Premier League,30-028,1994,0.0,0,0,0,0,0,0,0,,0,0,0,0,0,0,1,0,Matches
1586,Alan Matturro,uy URU,DF,Genoa,it Serie A,19-150,2004,1.0,1,1,1,0,0,1,1,100.0,0,4,1,3,2,3,3,0,Matches
1587,Azor Matusiwa,nl NED,MF,Reims,fr Ligue 1,25-316,1998,15.4,39,27,17,19,3,22,32,68.8,10,21,3,18,33,72,32,1,Matches
1588,Azor Matusiwa,nl NED,MF,Rennes,fr Ligue 1,25-316,1998,2.4,2,0,1,1,0,1,1,100.0,0,3,0,3,4,6,4,0,Matches
1589,Neal Maupay,fr FRA,FW,Brentford,eng Premier League,27-208,1996,13.2,10,7,4,5,1,3,13,23.1,10,8,0,8,2,12,3,0,Matches
1590,Neal Maupay,fr FRA,FW,Everton,eng Premier League,27-208,1996,1.2,0,0,0,0,0,0,1,0.0,1,2,0,2,0,0,1,0,Matches
1591,Aïman Maurer,ma MAR,"MF,FW",Clermont Foot,fr Ligue 1,19-166,2004,0.6,1,1,1,0,0,1,3,33.3,2,0,0,0,0,1,0,0,Matches
1592,Konstantinos Mavropanos,gr GRE,DF,West Ham,eng Premier League,26-089,1997,10.0,19,10,10,7,2,11,12,91.7,1,13,6,7,17,36,55,1,Matches
1593,Christian Mawissa,fr FRA,DF,Toulouse,fr Ligue 1,18-326,2005,8.0,16,11,10,3,3,7,14,50.0,7,13,6,7,13,29,28,1,Matches
1594,Philipp Max,de GER,"DF,MF",Eint Frankfurt,de Bundesliga,30-161,1993,12.7,23,14,6,15,2,17,23,73.9,6,15,1,14,7,30,16,1,Matches
1595,Eric Maxim Choupo-Moting,cm CMR,"MF,FW",Bayern Munich,de Bundesliga,34-352,1989,4.8,10,8,4,4,2,2,3,66.7,1,1,0,1,2,12,4,0,Matches
1596,Luís Maximiano,pt POR,GK,Almería,es La Liga,25-064,1999,24.0,0,0,0,0,0,0,1,0.0,1,0,0,0,0,0,11,1,Matches
1597,Noam Mayoka-Tika,be BEL,MF,Marseille,fr Ligue 1,20-128,2003,0.0,0,0,0,0,0,0,0,,0,0,0,0,0,0,0,0,Matches
1598,Borja Mayoral,es ESP,FW,Getafe,es La Liga,26-339,1997,23.9,9,5,2,2,5,5,22,22.7,17,7,0,7,4,13,16,0,Matches
1599,Youssef Maziz,fr FRA,"FW,MF",Metz,fr Ligue 1,25-259,1998,1.4,0,0,0,0,0,0,2,0.0,2,1,0,1,1,1,2,0,Matches
1600,Noussair Mazraoui,ma MAR,DF,Bayern Munich,de Bundesliga,26-116,1997,11.1,23,12,11,8,4,9,14,64.3,5,12,1,11,18,41,20,1,Matches
1601,Luca Mazzitelli,it ITA,MF,Frosinone,it Serie A,28-115,1995,17.5,33,21,11,16,6,19,40,47.5,21,17,3,14,11,44,44,0,Matches
1602,Pasquale Mazzocchi,it ITA,DF,Salernitana,it Serie A,28-226,1995,14.1,25,19,14,10,1,16,29,55.2,13,14,6,8,5,30,31,0,Matches
1603,Pasquale Mazzocchi,it ITA,DF,Napoli,it Serie A,28-226,1995,3.1,4,2,1,2,1,2,2,100.0,0,2,0,2,1,5,8,0,Matches
1604,Kevin Mbabu,ch SUI,DF,Augsburg,de Bundesliga,28-325,1995,15.7,37,27,18,13,6,15,25,60.0,10,22,8,14,17,54,36,0,Matches
1605,Noah Mbamba,be BEL,MF,Leverkusen,de Bundesliga,19-064,2005,0.2,0,0,0,0,0,0,0,,0,0,0,0,1,1,0,0,Matches
1606,Ethan Mbappé,fr FRA,MF,Paris S-G,fr Ligue 1,17-071,2006,0.0,0,0,0,0,0,0,0,,0,0,0,0,0,0,0,0,Matches
1607,Kylian Mbappé,fr FRA,FW,Paris S-G,fr Ligue 1,25-080,1998,19.3,3,1,1,1,1,3,7,42.9,4,3,0,3,2,5,1,0,Matches
1608,Malick Mbaye,sn SEN,"MF,FW",Metz,fr Ligue 1,19-338,2004,1.7,5,1,0,1,4,1,2,50.0,1,1,0,1,1,6,2,0,Matches
1609,Mamadou Mbaye,sn SEN,DF,Cádiz,es La Liga,25-255,1998,3.2,6,3,3,3,0,2,5,40.0,3,10,7,3,5,11,26,0,Matches
1610,Chancel Mbemba,cd COD,DF,Marseille,fr Ligue 1,29-214,1994,19.0,24,16,20,3,1,13,19,68.4,6,15,10,5,12,36,78,0,Matches
1611,Nolan Mbemba,cg CGO,MF,Le Havre,fr Ligue 1,29-019,1995,0.2,2,1,0,1,1,1,2,50.0,1,0,0,0,0,2,0,0,Matches
1612,Bryan Mbeumo,cm CMR,FW,Brentford,eng Premier League,24-215,1999,14.3,12,8,6,4,2,4,13,30.8,9,14,0,14,5,17,9,0,Matches
1613,Jordi Mboula,es ESP,"FW,MF",Hellas Verona,it Serie A,24-359,1999,3.4,4,4,1,2,1,4,7,57.1,3,4,1,3,1,5,0,0,Matches
1614,Nathanael Mbuku,fr FRA,FW,Augsburg,de Bundesliga,21-359,2002,0.1,0,0,0,0,0,0,0,,0,1,0,1,0,0,0,0,Matches
1615,James Mcatee,eng ENG,"MF,FW",Sheffield Utd,eng Premier League,21-143,2002,17.2,28,18,7,12,9,12,27,44.4,15,18,0,18,9,37,12,0,Matches
1616,James Mcatee,eng ENG,MF,Manchester City,eng Premier League,21-143,2002,0.0,0,0,0,0,0,0,0,,0,1,0,1,0,0,0,0,Matches
1617,Oliver McBurnie,sct SCO,FW,Sheffield Utd,eng Premier League,27-279,1996,9.3,10,2,1,4,5,1,5,20.0,4,14,2,12,3,13,17,0,Matches
1618,James McConnell,eng ENG,MF,Liverpool,eng Premier League,19-178,2004,0.0,0,0,0,0,0,0,0,,0,1,0,1,1,1,0,0,Matches
1619,John McGinn,sct SCO,"MF,FW",Aston Villa,eng Premier League,29-143,1994,25.7,45,28,12,27,6,23,56,41.1,33,20,2,18,15,60,17,0,Matches
1620,Scott McKenna,sct SCO,DF,Nott'ham Forest,eng Premier League,27-118,1996,4.6,4,0,3,1,0,2,3,66.7,1,6,4,2,5,9,27,0,Matches
1621,Weston McKennie,us USA,"MF,FW",Juventus,it Serie A,25-194,1998,22.7,41,25,27,10,4,15,23,65.2,8,22,6,16,17,58,58,0,Matches
1622,Dwight McNeil,eng ENG,"MF,FW",Everton,eng Premier League,24-108,1999,21.4,29,16,12,9,8,16,40,40.0,24,35,6,29,14,43,26,0,Matches
1623,Scott McTominay,sct SCO,MF,Manchester Utd,eng Premier League,27-092,1996,15.4,39,19,18,19,2,16,26,61.5,10,25,9,16,11,50,38,0,Matches
1624,Facundo Medina,ar ARG,DF,Lens,fr Ligue 1,24-286,1999,21.2,45,29,18,22,5,31,49,63.3,18,32,10,22,18,63,37,1,Matches
1625,Ben Mee,eng ENG,DF,Brentford,eng Premier League,34-170,1989,14.1,26,15,12,12,2,17,22,77.3,5,21,13,8,13,39,63,1,Matches
1626,Marvin Mehlem,de GER,MF,Darmstadt 98,de Bundesliga,26-180,1997,13.7,24,18,8,12,4,10,24,41.7,14,20,2,18,26,50,14,0,Matches
1627,Bamo Meïté,ci CIV,DF,Marseille,fr Ligue 1,22-097,2001,4.4,8,5,7,1,0,5,8,62.5,3,6,3,3,8,16,22,0,Matches
1628,Bamo Meïté,ci CIV,DF,Lorient,fr Ligue 1,22-097,2001,1.6,2,1,2,0,0,0,1,0.0,1,3,2,1,3,5,9,0,Matches
1629,Hannibal Mejbri,tn TUN,"MF,FW",Manchester Utd,eng Premier League,21-048,2003,1.5,3,3,1,2,0,1,3,33.3,2,1,1,0,0,3,0,0,Matches
1630,Hannibal Mejbri,tn TUN,MF,Sevilla,es La Liga,21-048,2003,1.0,2,2,1,1,0,0,1,0.0,1,0,0,0,0,2,0,0,Matches
1631,Óscar Melendo,es ESP,"MF,FW",Granada,es La Liga,26-199,1997,10.8,13,5,4,9,0,4,12,33.3,8,12,0,12,5,18,3,1,Matches
1632,Gonzalo Melero,es ESP,"MF,FW",Almería,es La Liga,30-067,1994,10.3,12,7,6,4,2,6,14,42.9,8,10,2,8,4,16,8,0,Matches
1633,Birger Meling,no NOR,DF,Rennes,fr Ligue 1,29-083,1994,0.2,1,1,1,0,0,1,1,100.0,0,1,0,1,0,1,0,0,Matches
1634,Arthur Melo,br BRA,MF,Fiorentina,it Serie A,27-210,1996,18.2,37,23,14,19,4,20,34,58.8,14,27,3,24,15,52,6,0,Matches
1635,Memphis,nl NED,FW,Atlético Madrid,es La Liga,30-025,1994,7.6,5,2,0,3,2,3,5,60.0,2,1,0,1,1,6,0,0,Matches
1636,Houboulang Mendes,gw GNB,DF,Almería,es La Liga,25-310,1998,4.4,16,13,11,5,0,8,16,50.0,8,4,2,2,1,17,17,1,Matches
1637,Nuno Mendes,pt POR,DF,Paris S-G,fr Ligue 1,21-264,2002,0.6,0,0,0,0,0,0,2,0.0,2,0,0,0,0,0,1,0,Matches
1638,Tomás Mendes,es ESP,MF,Alavés,es La Liga,19-109,2004,0.1,0,0,0,0,0,0,0,,0,0,0,0,0,0,0,0,Matches
1639,Brais Méndez,es ESP,"MF,FW",Real Sociedad,es La Liga,27-062,1997,21.0,34,22,11,15,8,12,38,31.6,26,18,3,15,8,42,14,0,Matches
1640,Bruno Méndez,uy URU,DF,Granada,es La Liga,24-181,1999,5.2,8,4,6,1,1,4,6,66.7,2,8,4,4,7,15,17,0,Matches
1641,Diego Méndez,es ESP,MF,Rayo Vallecano,es La Liga,20-193,2003,0.1,1,1,1,0,0,1,1,100.0,0,0,0,0,1,2,0,0,Matches
1642,Leonardo Mendicino,it ITA,MF,Atalanta,it Serie A,17-258,2006,0.0,0,0,0,0,0,0,0,,0,0,0,0,0,0,0,0,Matches
1643,Antoine Mendy,fr FRA,DF,Nice,fr Ligue 1,19-287,2004,1.0,3,1,1,2,0,2,3,66.7,1,1,0,1,2,5,2,0,Matches
1644,Benjamin Mendy,fr FRA,"DF,FW",Lorient,fr Ligue 1,29-236,1994,4.0,1,0,1,0,0,0,3,0.0,3,6,1,5,4,5,8,0,Matches
1645,Ferland Mendy,fr FRA,DF,Real Madrid,es La Liga,28-275,1995,13.2,10,5,7,2,1,6,9,66.7,3,7,2,5,12,22,20,1,Matches
1646,Formose Mendy,sn SEN,DF,Lorient,fr Ligue 1,23-067,2001,8.6,21,11,17,4,0,13,23,56.5,10,17,8,9,14,35,39,0,Matches
1647,Nampalys Mendy,sn SEN,MF,Lens,fr Ligue 1,31-260,1992,5.2,13,8,6,4,3,7,9,77.8,2,8,3,5,8,21,7,0,Matches
1648,Teden Mengi,eng ENG,DF,Luton Town,eng Premier League,21-314,2002,17.6,37,13,24,12,1,13,21,61.9,8,22,13,9,42,79,84,0,Matches
1649,Chris Mepham,wls WAL,DF,Bournemouth,eng Premier League,26-125,1997,3.9,5,5,4,1,0,3,7,42.9,4,8,4,4,6,11,16,1,Matches
1650,Jorge Meré,es ESP,DF,Cádiz,es La Liga,26-327,1997,7.5,8,7,6,2,0,4,7,57.1,3,5,3,2,8,16,33,0,Matches
1651,Alex Meret,it ITA,GK,Napoli,it Serie A,26-353,1997,20.8,0,0,0,0,0,0,0,,0,0,0,0,0,0,8,0,Matches
1652,Mikel Merino,es ESP,MF,Real Sociedad,es La Liga,27-261,1996,17.6,39,22,16,15,8,15,30,50.0,15,26,9,17,9,48,38,3,Matches
1653,Quentin Merlin,fr FRA,DF,Marseille,fr Ligue 1,21-298,2002,3.3,4,4,3,1,0,2,8,25.0,6,1,0,1,1,5,6,0,Matches
1654,Quentin Merlin,fr FRA,DF,Nantes,fr Ligue 1,21-298,2002,14.3,29,20,15,12,2,16,25,64.0,9,22,1,21,18,47,22,0,Matches
1655,Junior Messias,br BRA,"MF,DF",Genoa,it Serie A,32-301,1991,7.2,19,15,13,4,2,8,15,53.3,7,5,1,4,3,22,13,0,Matches
1656,Thomas Meunier,be BEL,DF,Dortmund,de Bundesliga,32-179,1991,6.5,5,1,3,2,0,3,13,23.1,10,8,2,6,4,9,22,0,Matches
1657,Bastien Meupiyou,fr FRA,DF,Nantes,fr Ligue 1,17-356,2006,0.1,0,0,0,0,0,0,0,,0,0,0,0,0,0,1,0,Matches
1658,Alexander Meyer,de GER,GK,Dortmund,de Bundesliga,32-331,1991,4.7,1,1,1,0,0,1,1,100.0,0,0,0,0,0,1,2,0,Matches
1659,Omenuke Mfulu,cd COD,"MF,FW",Las Palmas,es La Liga,29-355,1994,0.9,4,3,3,1,0,0,1,0.0,1,1,1,0,2,6,5,0,Matches
1660,Sven Michel,de GER,"FW,MF",Augsburg,de Bundesliga,33-238,1990,5.3,5,3,1,1,3,2,6,33.3,4,1,0,1,0,5,4,0,Matches
1661,Miguel,es ESP,"FW,MF",Alavés,es La Liga,24-188,1999,0.7,0,0,0,0,0,0,0,,0,2,0,2,0,0,0,0,Matches
1662,Georges Mikautadze,ge GEO,FW,Metz,fr Ligue 1,23-130,2000,9.5,2,2,0,2,0,0,5,0.0,5,5,0,5,7,9,1,0,Matches
1663,Nikola Milenković,rs SRB,DF,Fiorentina,it Serie A,26-149,1997,21.1,36,17,20,13,3,19,30,63.3,11,19,13,6,18,54,72,1,Matches
1664,Lewis Miley,eng ENG,MF,Newcastle Utd,eng Premier League,17-313,2006,13.2,33,21,6,20,7,15,32,46.9,17,20,3,17,8,41,18,2,Matches
1665,Arkadiusz Milik,pl POL,FW,Juventus,it Serie A,30-010,1994,7.4,7,3,1,4,2,2,3,66.7,1,7,1,6,3,10,2,0,Matches
1666,Vanja Milinković-Savić,rs SRB,GK,Torino,it Serie A,27-018,1997,27.0,1,0,1,0,0,1,1,100.0,0,0,0,0,1,2,7,4,Matches
1667,Éder Militão,br BRA,DF,Real Madrid,es La Liga,26-051,1998,0.5,0,0,0,0,0,0,0,,0,1,0,1,0,0,1,0,Matches
1668,Luis Milla,es ESP,MF,Getafe,es La Liga,29-154,1994,14.0,34,22,10,17,7,14,28,50.0,14,11,1,10,22,56,4,0,Matches
1669,Enzo Millot,fr FRA,MF,Stuttgart,de Bundesliga,21-236,2002,18.9,30,16,7,14,9,13,30,43.3,17,20,2,18,12,42,6,1,Matches
1670,James Milner,eng ENG,"DF,MF",Brighton,eng Premier League,38-065,1986,8.6,20,14,9,10,1,9,14,64.3,5,9,0,9,8,28,16,0,Matches
1671,Jovan Milošević,rs SRB,"FW,MF",Stuttgart,de Bundesliga,18-222,2005,0.3,0,0,0,0,0,0,0,,0,0,0,0,0,0,0,0,Matches
1672,Marko Milovanović,rs SRB,"FW,MF",Almería,es La Liga,20-218,2003,2.5,2,2,0,2,0,1,3,33.3,2,1,0,1,0,2,4,0,Matches
1673,Kim Min-jae,kr KOR,DF,Bayern Munich,de Bundesliga,27-115,1996,17.7,25,16,13,8,4,9,20,45.0,11,23,13,10,40,65,53,1,Matches
1674,Yerry Mina,co COL,"DF,MF",Fiorentina,it Serie A,29-168,1994,0.5,1,1,1,0,0,1,2,50.0,1,0,0,0,0,1,2,0,Matches
1675,Yerry Mina,co COL,DF,Cagliari,it Serie A,29-168,1994,4.5,7,4,7,0,0,4,7,57.1,3,14,9,5,2,9,26,0,Matches
1676,Takumi Minamino,jp JPN,"MF,FW",Monaco,fr Ligue 1,29-053,1995,16.3,22,13,4,10,8,10,39,25.6,29,17,1,16,8,30,8,0,Matches
1677,Lucas Mincarelli,fr FRA,"DF,MF",Montpellier,fr Ligue 1,20-064,2004,5.2,15,9,10,2,3,10,17,58.8,7,5,1,4,4,19,12,0,Matches
1678,Tyrone Mings,eng ENG,DF,Aston Villa,eng Premier League,30-362,1993,0.3,0,0,0,0,0,0,0,,0,0,0,0,1,1,1,0,Matches
1679,Óscar Mingueza,es ESP,"DF,MF",Celta Vigo,es La Liga,24-301,1999,23.0,42,26,29,7,6,27,61,44.3,34,28,4,24,13,55,34,1,Matches
1680,Ignasi Miquel,es ESP,DF,Granada,es La Liga,31-163,1992,24.2,32,20,28,4,0,17,29,58.6,12,18,8,10,33,65,96,3,Matches
1681,Rafa Mir,es ESP,"FW,MF",Sevilla,es La Liga,26-265,1997,4.3,2,2,1,1,0,1,2,50.0,1,2,0,2,1,3,1,0,Matches
1682,Ignacio Miramon,ar ARG,MF,Lille,fr Ligue 1,20-271,2003,0.4,1,0,0,1,0,0,1,0.0,1,1,0,1,0,1,0,0,Matches
1683,Aleksei Miranchuk,ru RUS,"MF,FW",Atalanta,it Serie A,28-144,1995,8.8,8,4,3,4,1,3,7,42.9,4,4,1,3,2,10,2,1,Matches
1684,Juan Miranda,es ESP,DF,Betis,es La Liga,24-050,2000,12.3,20,13,9,7,4,8,16,50.0,8,19,4,15,10,30,46,0,Matches
1685,Kevin Miranda,it ITA,DF,Sassuolo,it Serie A,20-365,2003,0.2,0,0,0,0,0,0,0,,0,0,0,0,0,0,1,0,Matches
1686,Antonio Mirante,it ITA,GK,Milan,it Serie A,40-245,1983,1.0,0,0,0,0,0,0,0,,0,0,0,0,0,0,0,0,Matches
1687,Fabio Miretti,it ITA,MF,Juventus,it Serie A,20-219,2003,8.9,10,7,3,6,1,6,19,31.6,13,8,1,7,5,15,4,0,Matches
1688,Filippo Missori,it ITA,DF,Sassuolo,it Serie A,19-351,2004,1.1,2,2,1,1,0,2,3,66.7,1,1,0,1,2,4,2,0,Matches
1689,Tyrick Mitchell,eng ENG,DF,Crystal Palace,eng Premier League,24-190,1999,25.1,72,36,57,9,6,27,38,71.1,11,37,8,29,21,93,84,0,Matches
1690,Kaoru Mitoma,jp JPN,FW,Brighton,eng Premier League,26-294,1997,16.5,13,6,3,7,3,5,19,26.3,14,15,1,14,5,18,12,0,Matches
1691,Aleksandar Mitrović,rs SRB,FW,Fulham,eng Premier League,29-175,1994,0.4,0,0,0,0,0,0,0,,0,0,0,0,0,0,0,0,Matches
1692,Stefan Mitrović,rs SRB,"MF,FW",Hellas Verona,it Serie A,21-207,2002,0.7,0,0,0,0,0,0,0,,0,0,0,0,0,0,0,0,Matches
1693,Stefan Mitrović,rs SRB,DF,Getafe,es La Liga,33-292,1990,7.8,9,3,7,2,0,4,8,50.0,4,3,2,1,6,15,26,0,Matches
1694,Maximilian Mittelstädt,de GER,DF,Stuttgart,de Bundesliga,26-357,1997,15.4,60,34,31,25,4,35,56,62.5,21,26,5,21,34,94,44,0,Matches
1695,Henrikh Mkhitaryan,am ARM,MF,Inter,it Serie A,35-048,1989,23.9,53,30,13,31,9,18,37,48.6,19,18,2,16,23,76,36,0,Matches
1696,Jakub Moder,pl POL,"MF,DF",Brighton,eng Premier League,24-337,1999,1.6,8,5,2,3,3,5,7,71.4,2,2,0,2,0,8,4,0,Matches
1697,Luka Modrić,hr CRO,MF,Real Madrid,es La Liga,38-182,1985,11.8,13,7,8,2,3,5,11,45.5,6,9,3,6,11,24,7,0,Matches
1698,Terem Moffi,ng NGA,FW,Nice,fr Ligue 1,24-289,1999,15.4,5,3,0,4,1,2,8,25.0,6,9,1,8,2,7,12,0,Matches
1699,Mostafa Mohamed,eg EGY,FW,Nantes,fr Ligue 1,26-102,1997,15.3,15,11,4,9,2,3,15,20.0,12,17,3,14,8,23,17,0,Matches
1700,Kudus Mohammed,gh GHA,"FW,MF",West Ham,eng Premier League,23-220,2000,16.7,44,33,16,20,8,17,26,65.4,9,20,0,20,5,49,6,1,Matches
1701,Dion Moise Sahi,ci CIV,"MF,FW",Strasbourg,fr Ligue 1,22-080,2001,5.5,4,4,1,2,1,0,2,0.0,2,10,1,9,1,5,6,0,Matches
1702,Johan Mojica,co COL,"DF,FW",Osasuna,es La Liga,31-201,1992,14.9,25,18,8,13,4,13,19,68.4,6,11,2,9,18,43,28,1,Matches
1703,Alberto Moleiro,es ESP,"FW,MF",Las Palmas,es La Liga,20-161,2003,10.8,7,5,4,3,0,4,19,21.1,15,7,0,7,6,13,8,0,Matches
1704,Nahuel Molina,ar ARG,DF,Atlético Madrid,es La Liga,25-338,1998,16.0,29,19,12,15,2,18,38,47.4,20,15,2,13,8,37,29,1,Matches
1705,Florent Mollet,fr FRA,"MF,FW",Nantes,fr Ligue 1,32-111,1991,16.4,13,8,5,4,4,7,23,30.4,16,10,0,10,8,21,11,0,Matches
1706,Jon Moncayola,es ESP,MF,Osasuna,es La Liga,25-301,1998,13.7,20,13,11,8,1,12,26,46.2,14,18,4,14,11,31,19,0,Matches
1707,Enzo Mongo,fr FRA,DF,Nantes,fr Ligue 1,18-336,2005,0.1,1,1,1,0,0,1,2,50.0,1,1,1,0,1,2,0,0,Matches
1708,Ilario Monterisi,it ITA,DF,Frosinone,it Serie A,22-081,2001,16.1,23,13,14,7,2,12,26,46.2,14,22,18,4,8,31,60,0,Matches
1709,César Montes,mx MEX,DF,Almería,es La Liga,27-014,1997,12.0,15,9,7,8,0,6,10,60.0,4,14,4,10,7,22,53,0,Matches
1710,Gonzalo Montiel,ar ARG,DF,Nott'ham Forest,eng Premier League,27-068,1997,5.5,14,11,8,5,1,10,18,55.6,8,5,2,3,6,20,28,1,Matches
1711,Lorenzo Montipò,it ITA,GK,Hellas Verona,it Serie A,28-018,1996,27.0,0,0,0,0,0,0,2,0.0,2,0,0,0,0,0,19,1,Matches
1712,Kieffer Moore,wls WAL,"FW,MF",Bournemouth,eng Premier League,31-214,1992,1.2,0,0,0,0,0,0,0,,0,0,0,0,0,0,0,0,Matches
1713,Álvaro Morata,es ESP,FW,Atlético Madrid,es La Liga,31-138,1992,17.5,11,6,2,5,4,2,2,100.0,0,16,3,13,0,11,23,0,Matches
1714,Diego Moreira,pt POR,"FW,MF",Lyon,fr Ligue 1,19-216,2004,3.0,0,0,0,0,0,0,3,0.0,3,3,0,3,2,2,5,0,Matches
1715,Alberto Moreno,es ESP,"DF,MF",Villarreal,es La Liga,31-248,1992,12.4,24,16,16,6,2,8,24,33.3,16,7,2,5,17,41,26,0,Matches
1716,Álex Moreno,es ESP,DF,Aston Villa,eng Premier League,30-275,1993,9.3,15,11,15,0,0,9,15,60.0,6,7,2,5,11,26,31,0,Matches
1717,Gerard Moreno,es ESP,FW,Villarreal,es La Liga,31-337,1992,20.5,22,10,9,6,7,9,21,42.9,12,19,7,12,6,28,22,0,Matches
1718,Mateu Morey,es ESP,DF,Dortmund,de Bundesliga,24-007,2000,0.0,0,0,0,0,0,0,0,,0,0,0,0,1,1,0,0,Matches
1719,Ilaix Moriba,gn GUI,MF,Getafe,es La Liga,21-050,2003,2.0,5,1,1,2,2,2,5,40.0,3,0,0,0,2,7,4,0,Matches
1720,Manu Morlanes,es ESP,MF,Mallorca,es La Liga,25-057,1999,12.7,32,20,17,14,1,15,36,41.7,21,9,1,8,10,42,18,0,Matches
1721,Nikola Moro,hr CRO,MF,Bologna,it Serie A,25-363,1998,7.7,18,14,8,10,0,6,13,46.2,7,13,1,12,6,24,9,0,Matches
1722,Carlton Morris,eng ENG,"FW,MF",Luton Town,eng Premier League,28-084,1995,19.8,9,6,3,3,3,4,9,44.4,5,14,1,13,1,10,27,0,Matches
1723,Cristhian Mosquera,co COL,DF,Valencia,es La Liga,19-256,2004,22.2,34,20,19,13,2,17,28,60.7,11,24,9,15,24,58,95,2,Matches
1724,Yerson Mosquera,co COL,DF,Villarreal,es La Liga,22-312,2001,4.1,6,2,4,1,1,3,3,100.0,0,2,0,2,2,8,26,0,Matches
1725,Dany Mota,pt POR,"FW,MF",Monza,it Serie A,25-312,1998,17.9,12,6,2,4,6,7,14,50.0,7,2,0,2,2,14,15,0,Matches
1726,Lebo Mothiba,za RSA,FW,Strasbourg,fr Ligue 1,28-041,1996,6.9,5,2,1,4,0,3,4,75.0,1,6,1,5,0,5,11,0,Matches
1727,Youssoufa Moukoko,de GER,FW,Dortmund,de Bundesliga,19-110,2004,3.8,4,1,2,2,0,3,5,60.0,2,4,1,3,1,5,1,0,Matches
1728,Steve Mounié,bj BEN,FW,Brest,fr Ligue 1,29-162,1994,12.3,6,5,0,2,4,2,8,25.0,6,12,3,9,1,7,14,0,Matches
1729,Mason Mount,eng ENG,MF,Manchester Utd,eng Premier League,25-059,1999,4.4,16,10,4,7,5,3,12,25.0,9,5,1,4,3,19,1,0,Matches
1730,Samuel Moutoussamy,cd COD,MF,Nantes,fr Ligue 1,27-210,1996,8.2,22,12,9,8,5,12,20,60.0,8,13,3,10,8,30,9,0,Matches
1731,Loris Mouyokolo,fr FRA,DF,Lorient,fr Ligue 1,22-292,2001,1.0,4,1,4,0,0,1,1,100.0,0,1,0,1,0,4,3,0,Matches
1732,Divin Mubama,eng ENG,FW,West Ham,eng Premier League,19-136,2004,0.9,0,0,0,0,0,0,0,,0,0,0,0,0,0,0,0,Matches
1733,Mykhailo Mudryk,ua UKR,"FW,MF",Chelsea,eng Premier League,23-064,2001,9.9,17,10,7,5,5,7,22,31.8,15,10,1,9,4,21,5,0,Matches
1734,François Mughe,cm CMR,"MF,DF",Marseille,fr Ligue 1,19-267,2004,2.0,0,0,0,0,0,0,3,0.0,3,2,0,2,1,1,1,0,Matches
1735,Joel Mugisha,no NOR,"DF,FW",Lorient,fr Ligue 1,21-118,2002,2.0,5,3,3,1,1,3,7,42.9,4,1,0,1,2,7,1,0,Matches
1736,Nordi Mukiele,fr FRA,DF,Paris S-G,fr Ligue 1,26-129,1997,6.2,10,7,5,4,1,7,13,53.8,6,13,4,9,10,20,24,0,Matches
1737,Samuele Mulattieri,it ITA,"FW,MF",Sassuolo,it Serie A,23-154,2000,3.0,1,1,0,0,1,1,1,100.0,0,7,2,5,0,1,1,0,Matches
1738,Andreas Müller,de GER,MF,Darmstadt 98,de Bundesliga,23-233,2000,2.7,13,9,7,5,1,4,7,57.1,3,3,1,2,4,17,4,0,Matches
1739,Jannik Müller,de GER,DF,Darmstadt 98,de Bundesliga,30-051,1994,7.4,12,5,9,3,0,7,11,63.6,4,12,8,4,9,21,26,1,Matches
1740,Kevin Müller,de GER,GK,Heidenheim,de Bundesliga,32-360,1991,24.0,1,0,1,0,0,1,2,50.0,1,0,0,0,0,1,6,1,Matches
1741,Marcus Müller,de GER,MF,Mainz 05,de Bundesliga,21-202,2002,0.2,0,0,0,0,0,0,0,,0,0,0,0,0,0,0,0,Matches
1742,Thomas Müller,de GER,"MF,FW",Bayern Munich,de Bundesliga,34-178,1989,10.4,19,11,1,8,10,11,22,50.0,11,17,0,17,1,20,3,0,Matches
1743,Abdul Mumin,gh GHA,DF,Rayo Vallecano,es La Liga,25-277,1998,9.8,10,5,7,2,1,4,6,66.7,2,17,12,5,9,19,53,1,Matches
1744,Marshall Munetsi,zw ZIM,"MF,FW",Reims,fr Ligue 1,27-261,1996,15.4,32,20,9,19,4,18,38,47.4,20,14,3,11,9,41,22,0,Matches
1745,Iker Muniain,es ESP,"MF,FW",Athletic Club,es La Liga,31-081,1992,4.4,4,0,1,3,0,1,1,100.0,0,3,0,3,0,4,0,0,Matches
1746,Rodrigo Muniz,br BRA,FW,Fulham,eng Premier League,22-310,2001,8.7,3,2,0,3,0,0,3,0.0,3,6,2,4,4,7,11,0,Matches
1747,Aihen Muñoz,es ESP,DF,Real Sociedad,es La Liga,26-206,1997,12.5,36,21,20,10,6,24,35,68.6,11,16,8,8,9,45,33,0,Matches
1748,Álvaro Muñoz,uy URU,FW,Real Madrid,es La Liga,19-239,2004,0.0,0,0,0,0,0,0,0,,0,0,0,0,0,0,1,0,Matches
1749,Daniel Muñoz,co COL,DF,Crystal Palace,eng Premier League,27-288,1996,5.0,12,11,9,2,1,6,13,46.2,7,9,5,4,6,18,17,0,Matches
1750,Iker Muñoz,es ESP,MF,Osasuna,es La Liga,21-125,2002,11.9,15,11,5,10,0,8,16,50.0,8,7,1,6,6,21,27,0,Matches
1751,Javier Muñoz,es ESP,MF,Las Palmas,es La Liga,29-010,1995,21.5,29,14,10,13,6,12,32,37.5,20,31,3,28,14,43,16,1,Matches
1752,Luis Muriel,co COL,"FW,MF",Atalanta,it Serie A,32-328,1991,4.5,3,2,0,2,1,1,1,100.0,0,4,0,4,1,4,0,0,Matches
1753,Murillo,br BRA,DF,Nott'ham Forest,eng Premier League,21-249,2002,20.2,32,20,23,8,1,13,24,54.2,11,32,18,14,23,55,126,0,Matches
1754,Vedat Muriqi,xk KVX,FW,Mallorca,es La Liga,29-320,1994,17.7,9,5,4,2,3,2,11,18.2,9,4,3,1,5,14,22,0,Matches
1755,Alex Murphy,ie IRL,"FW,DF",Newcastle Utd,eng Premier League,19-258,2004,0.0,0,0,0,0,0,0,1,0.0,1,0,0,0,1,1,0,0,Matches
1756,Jacob Murphy,eng ENG,FW,Newcastle Utd,eng Premier League,29-014,1995,4.7,7,5,4,1,2,4,7,57.1,3,9,0,9,0,7,7,0,Matches
1757,Yunus Musah,us USA,"MF,FW",Milan,it Serie A,21-101,2002,11.0,15,7,9,3,3,3,8,37.5,5,14,4,10,8,23,10,1,Matches
1758,Jamal Musiala,de GER,"MF,FW",Bayern Munich,de Bundesliga,21-012,2003,15.7,36,24,8,19,9,14,32,43.8,18,23,1,22,15,51,5,0,Matches
1759,Florent Muslija,xk KVX,MF,Freiburg,de Bundesliga,25-247,1998,0.3,0,0,0,0,0,0,1,0.0,1,1,0,1,0,0,0,0,Matches
1760,Juan Musso,ar ARG,GK,Atalanta,it Serie A,29-308,1994,10.0,1,0,1,0,0,1,1,100.0,0,0,0,0,0,1,6,0,Matches
1761,Kingstone Mutandwa,zm ZAM,FW,Cagliari,it Serie A,21-064,2003,0.0,0,0,0,0,0,0,0,,0,0,0,0,0,0,0,0,Matches
1762,Yvon Mvogo,ch SUI,GK,Lorient,fr Ligue 1,29-277,1994,24.0,0,0,0,0,0,0,0,,0,0,0,0,0,0,12,1,Matches
1763,Joel Mvuka,no NOR,MF,Lorient,fr Ligue 1,21-108,2002,0.2,,0,,,,,,,,,,,0,,,,Matches
1764,Junior Mwanga,fr FRA,MF,Strasbourg,fr Ligue 1,20-303,2003,15.0,35,18,20,10,5,11,23,47.8,12,17,5,12,16,51,17,0,Matches
1765,Phillipp Mwene,at AUT,"DF,MF",Mainz 05,de Bundesliga,30-040,1994,14.3,20,9,8,10,2,9,20,45.0,11,23,3,20,13,33,28,0,Matches
1766,Vitaliy Mykolenko,ua UKR,DF,Everton,eng Premier League,24-285,1999,22.0,60,34,40,19,1,35,55,63.6,20,28,10,18,32,92,73,0,Matches
1767,Joakim Mæhle,dk DEN,DF,Wolfsburg,de Bundesliga,26-294,1997,21.5,46,29,25,14,7,30,46,65.2,16,34,4,30,22,68,55,0,Matches
1768,Obite N'Dicka,ci CIV,DF,Roma,it Serie A,24-202,1999,16.8,25,13,7,17,1,10,15,66.7,5,17,6,11,9,34,46,0,Matches
1769,Kévin N'Doram,fr FRA,MF,Metz,fr Ligue 1,28-047,1996,11.8,16,12,10,5,1,10,24,41.7,14,8,3,5,16,32,29,0,Matches
1770,Nathan N'Goumou,fr FRA,"FW,MF",M'Gladbach,de Bundesliga,23-361,2000,11.2,23,16,11,11,1,11,26,42.3,15,17,0,17,4,27,17,1,Matches
1771,Stanley N'Soki,fr FRA,DF,Hoffenheim,de Bundesliga,24-335,1999,5.9,18,9,10,7,1,14,25,56.0,11,11,1,10,6,24,29,0,Matches
1772,Nacho,es ESP,DF,Real Madrid,es La Liga,34-051,1990,11.9,11,7,4,5,2,4,9,44.4,5,13,7,6,9,20,32,0,Matches
1773,Bilal Nadir,fr FRA,"MF,FW",Marseille,fr Ligue 1,20-102,2003,1.3,4,3,2,2,0,1,2,50.0,1,0,0,0,2,6,2,0,Matches
1774,Mahamadou Nagida,cm CMR,DF,Rennes,fr Ligue 1,18-255,2005,1.2,1,1,0,0,1,0,2,0.0,2,2,1,1,4,5,0,0,Matches
1775,Marvelous Nakamba,zw ZIM,MF,Luton Town,eng Premier League,30-050,1994,12.6,40,24,24,14,2,24,42,57.1,18,23,6,17,11,51,11,1,Matches
1776,Keito Nakamura,jp JPN,FW,Reims,fr Ligue 1,23-225,2000,9.3,21,10,8,7,6,12,25,48.0,13,13,2,11,5,26,4,0,Matches
1777,Nahitan Nández,uy URU,"MF,DF",Cagliari,it Serie A,28-072,1995,17.5,36,25,16,14,6,15,42,35.7,27,14,1,13,12,48,22,0,Matches
1778,Matija Nastasić,rs SRB,DF,Mallorca,es La Liga,30-347,1993,19.1,26,12,18,8,0,16,23,69.6,7,28,16,12,22,48,84,0,Matches
1779,Natan,br BRA,DF,Napoli,it Serie A,23-032,2001,10.1,14,10,10,3,1,5,10,50.0,5,11,9,2,7,21,31,0,Matches
1780,Roberto Navarro,es ESP,MF,Cádiz,es La Liga,21-332,2002,11.3,32,20,13,15,4,12,25,48.0,13,22,0,22,11,43,5,0,Matches
1781,Jesús Navas,es ESP,DF,Sevilla,es La Liga,38-109,1985,15.3,30,21,16,12,2,21,37,56.8,16,10,5,5,18,48,32,0,Matches
1782,Keylor Navas,cr CRC,GK,Paris S-G,fr Ligue 1,37-085,1986,1.0,0,0,0,0,0,0,0,,0,0,0,0,0,0,0,0,Matches
1783,Michel Ndary Adopo,fr FRA,"MF,DF",Atalanta,it Serie A,23-234,2000,1.0,3,2,0,2,1,1,1,100.0,0,0,0,0,0,3,2,1,Matches
1784,Youssouf Ndayishimiye,bi BDI,"MF,DF",Nice,fr Ligue 1,25-134,1998,18.0,29,19,16,11,2,11,21,52.4,10,18,11,7,12,41,45,1,Matches
1785,Bassirou Ndiaye,sn SEN,FW,Lorient,fr Ligue 1,22-023,2002,1.7,,2,,,,,,,,,,,1,,,,Matches
1786,Iliman Ndiaye,sn SEN,FW,Marseille,fr Ligue 1,24-003,2000,13.8,13,12,3,6,4,6,17,35.3,11,11,2,9,5,18,6,0,Matches
1787,Massamba Ndiaye,sn SEN,GK,Clermont Foot,fr Ligue 1,22-153,2001,2.0,0,0,0,0,0,0,0,,0,0,0,0,0,0,0,0,Matches
1788,Rassoul Ndiaye,fr FRA,"MF,FW",Le Havre,fr Ligue 1,22-089,2001,5.7,24,16,8,15,1,11,21,52.4,10,2,1,1,4,28,5,0,Matches
1789,Michael Ndiweni,eng ENG,FW,Newcastle Utd,eng Premier League,20-098,2003,0.0,0,0,0,0,0,0,0,,0,0,0,0,0,0,0,0,Matches
1790,Cher Ndour,it ITA,MF,Paris S-G,fr Ligue 1,19-226,2004,0.3,2,2,0,2,0,1,2,50.0,1,0,0,0,0,2,0,0,Matches
1791,Dan Ndoye,ch SUI,"FW,MF",Bologna,it Serie A,23-136,2000,13.9,24,11,15,9,0,13,30,43.3,17,16,1,15,6,30,11,0,Matches
1792,Joseph Nduquidi,fr FRA,"MF,DF",Metz,fr Ligue 1,19-130,2004,8.3,11,4,6,3,2,1,9,11.1,8,11,3,8,11,22,15,1,Matches
1793,Loïc Nego,hu HUN,"MF,DF",Le Havre,fr Ligue 1,33-054,1991,13.4,29,20,16,9,4,12,24,50.0,12,10,1,9,15,44,8,0,Matches
1794,Álvaro Negredo,es ESP,"FW,MF",Cádiz,es La Liga,38-202,1985,0.6,0,0,0,0,0,0,0,,0,1,0,1,1,1,0,0,Matches
1795,Reiss Nelson,eng ENG,"FW,MF",Arsenal,eng Premier League,24-090,1999,2.0,8,5,4,1,3,8,9,88.9,1,3,1,2,1,9,5,0,Matches
1796,Neto,br BRA,GK,Bournemouth,eng Premier League,34-234,1989,24.0,0,0,0,0,0,0,0,,0,1,0,1,1,1,10,1,Matches
1797,Pedro Neto,pt POR,"MF,FW",Wolves,eng Premier League,24-000,2000,16.2,7,3,3,2,2,5,14,35.7,9,5,1,4,4,11,2,0,Matches
1798,Luca Netz,de GER,DF,M'Gladbach,de Bundesliga,20-299,2003,18.4,34,20,16,15,3,20,36,55.6,16,27,8,19,18,52,67,1,Matches
1799,Manuel Neuer,de GER,GK,Bayern Munich,de Bundesliga,37-348,1986,16.0,0,0,0,0,0,0,0,,0,0,0,0,0,0,10,2,Matches
1800,Florian Neuhaus,de GER,MF,M'Gladbach,de Bundesliga,26-359,1997,10.9,15,12,7,8,0,8,23,34.8,15,6,5,1,12,27,8,0,Matches
1801,Carlos Neva,es ESP,DF,Granada,es La Liga,27-271,1996,24.0,24,16,17,6,1,13,31,41.9,18,28,10,18,14,38,77,1,Matches
1802,Jessic Ngankam,de GER,"FW,MF",Mainz 05,de Bundesliga,23-233,2000,1.8,1,1,0,1,0,0,0,,0,1,0,1,2,3,0,0,Matches
1803,Jessic Ngankam,de GER,FW,Eint Frankfurt,de Bundesliga,23-233,2000,3.1,3,2,1,1,1,0,0,,0,0,0,0,0,3,1,0,Matches
1804,Cyril Ngonge,be BEL,"FW,MF",Hellas Verona,it Serie A,23-288,2000,15.9,14,9,5,3,6,5,14,35.7,9,7,1,6,4,18,10,0,Matches
1805,Cyril Ngonge,be BEL,FW,Napoli,it Serie A,23-288,2000,0.8,2,1,1,1,0,1,1,100.0,0,1,0,1,0,2,2,0,Matches
1806,Steve Ngoura,fr FRA,"FW,MF",Le Havre,fr Ligue 1,19-016,2005,1.1,1,1,0,1,0,0,3,0.0,3,0,0,0,0,1,2,0,Matches
1807,Moussa Niakhate,sn SEN,DF,Nott'ham Forest,eng Premier League,28-001,1996,12.9,33,21,26,7,0,14,18,77.8,4,16,10,6,9,42,42,0,Matches
1808,M'Baye Niang,sn SEN,FW,Empoli,it Serie A,29-081,1994,1.5,1,0,0,0,1,0,0,,0,1,0,1,1,2,1,0,Matches
1809,Tanguy Nianzou,fr FRA,DF,Sevilla,es La Liga,21-276,2002,2.3,12,8,9,2,1,8,11,72.7,3,1,0,1,3,15,6,0,Matches
1810,Shamar Nicholson,jm JAM,FW,Clermont Foot,fr Ligue 1,26-359,1997,15.0,5,2,0,4,1,1,4,25.0,3,5,1,4,0,5,14,0,Matches
1811,Rasmus Nicolaisen,dk DEN,DF,Toulouse,fr Ligue 1,26-359,1997,24.0,34,22,29,5,0,17,28,60.7,11,36,26,10,29,63,119,0,Matches
1812,Moritz Nicolas,de GER,GK,M'Gladbach,de Bundesliga,26-140,1997,22.0,1,0,1,0,0,1,2,50.0,1,0,0,0,0,1,9,3,Matches
1813,Hans Nicolussi Caviglia,it ITA,MF,Juventus,it Serie A,23-265,2000,2.7,3,0,1,2,0,3,5,60.0,2,5,1,4,0,3,2,0,Matches
1814,Saúl Ñíguez,es ESP,MF,Atlético Madrid,es La Liga,29-109,1994,13.0,56,32,25,26,5,26,41,63.4,15,34,9,25,12,68,50,0,Matches
1815,Rasmus Nissen,dk DEN,DF,Roma,it Serie A,26-242,1997,16.5,30,14,20,7,3,22,39,56.4,17,25,6,19,5,35,38,0,Matches
1816,Justin Njinmah,de GER,FW,Werder Bremen,de Bundesliga,23-115,2000,9.5,5,1,2,2,1,3,9,33.3,6,8,1,7,2,7,6,0,Matches
1817,Eddie Nketiah,eng ENG,FW,Arsenal,eng Premier League,24-284,1999,11.7,12,7,2,6,4,2,7,28.6,5,11,0,11,4,16,3,0,Matches
1818,Niels Nkounkou,fr FRA,"DF,MF",Eint Frankfurt,de Bundesliga,23-129,2000,9.6,30,16,21,9,0,15,34,44.1,19,26,2,24,12,42,23,0,Matches
1819,Christopher Nkunku,fr FRA,"FW,MF",Chelsea,eng Premier League,26-116,1997,3.5,2,1,0,2,0,0,0,,0,3,0,3,2,4,3,0,Matches
1820,Felix Nmecha,de GER,MF,Dortmund,de Bundesliga,23-151,2000,6.7,13,9,3,6,4,8,13,61.5,5,9,0,9,8,21,11,0,Matches
1821,Lukas Nmecha,de GER,FW,Wolfsburg,de Bundesliga,25-086,1998,0.5,1,1,0,0,1,0,0,,0,1,0,1,0,1,0,0,Matches
1822,Peru Nolaskoain,es ESP,"DF,MF",Athletic Club,es La Liga,25-136,1998,0.1,1,1,1,0,0,1,1,100.0,0,0,0,0,0,1,1,0,Matches
1823,Joseph Nonge,be BEL,MF,Juventus,it Serie A,18-299,2005,0.3,0,0,0,0,0,0,0,,0,0,0,0,0,0,1,0,Matches
1824,Arnaud Nordin,fr FRA,"FW,MF",Montpellier,fr Ligue 1,25-266,1998,8.4,7,4,2,3,2,3,9,33.3,6,9,0,9,1,8,7,0,Matches
1825,Rhys Norrington-Davies,wls WAL,DF,Sheffield Utd,eng Premier League,24-322,1999,1.2,1,1,1,0,0,0,1,0.0,1,2,0,2,1,2,2,0,Matches
1826,Oliver Norwood,nir NIR,MF,Sheffield Utd,eng Premier League,32-332,1991,15.5,40,25,18,18,4,20,44,45.5,24,23,8,15,20,60,38,0,Matches
1827,Tijjani Noslin,nl NED,FW,Hellas Verona,it Serie A,24-246,1999,4.3,2,1,0,1,1,0,5,0.0,5,7,0,7,0,2,5,0,Matches
1828,Randy Ntekja,fr FRA,"FW,MF",Rayo Vallecano,es La Liga,26-094,1997,5.2,7,1,1,3,3,3,7,42.9,4,5,1,4,2,9,8,0,Matches
1829,Ernest Nuamah,gh GHA,"FW,MF",Lyon,fr Ligue 1,20-129,2003,15.1,20,10,11,5,4,8,27,29.6,19,10,1,9,6,26,7,0,Matches
1830,Alexander Nübel,de GER,GK,Stuttgart,de Bundesliga,27-161,1996,22.0,1,1,1,0,0,1,3,33.3,2,0,0,0,0,1,7,3,Matches
1831,Matheus Nunes,pt POR,MF,Wolves,eng Premier League,25-195,1998,2.0,3,1,3,0,0,2,6,33.3,4,0,0,0,6,9,1,0,Matches
1832,Matheus Nunes,pt POR,"MF,FW",Manchester City,eng Premier League,25-195,1998,5.6,8,3,1,5,2,4,10,40.0,6,4,1,3,0,8,7,0,Matches
1833,Darwin Núñez,uy URU,FW,Liverpool,eng Premier League,24-259,1999,16.6,19,12,2,9,8,10,21,47.6,11,17,6,11,2,21,4,0,Matches
1834,Unai Núñez,es ESP,DF,Celta Vigo,es La Liga,27-039,1997,26.5,39,22,19,18,2,15,34,44.1,19,34,22,12,46,85,136,1,Matches
1835,Fabian Nürnberger,de GER,"DF,MF",Darmstadt 98,de Bundesliga,24-225,1999,13.3,19,14,16,3,0,17,34,50.0,17,6,1,5,13,32,20,0,Matches
1836,Ethan Nwaneri,eng ENG,FW,Arsenal,eng Premier League,16-354,2007,0.2,0,0,0,0,0,0,0,,0,1,0,1,0,0,0,0,Matches
1837,Simeon Nwankwo,ng NGA,FW,Salernitana,it Serie A,31-307,1992,5.4,2,0,0,0,2,0,2,0.0,2,4,0,4,0,2,3,0,Matches
1838,Gerzino Nyamsi,fr FRA,DF,Strasbourg,fr Ligue 1,27-047,1997,12.1,18,14,13,5,0,12,18,66.7,6,19,11,8,10,28,43,0,Matches
1839,Ørjan Nyland,no NOR,GK,Sevilla,es La Liga,33-181,1990,13.0,0,0,0,0,0,0,0,,0,0,0,0,0,0,4,0,Matches
1840,Rabby Nzingoula,fr FRA,"FW,MF",Strasbourg,fr Ligue 1,18-105,2005,0.4,1,1,0,1,0,1,2,50.0,1,0,0,0,2,3,0,0,Matches
1841,M'Bala Nzola,ao ANG,FW,Fiorentina,it Serie A,27-204,1996,14.2,9,6,1,3,5,4,5,80.0,1,8,0,8,0,9,18,0,Matches
1842,Christian Nørgaard,dk DEN,MF,Brentford,eng Premier League,29-365,1994,23.8,73,46,39,27,7,29,78,37.2,49,40,2,38,45,118,50,0,Matches
1843,Jake O'Brien,ie IRL,DF,Lyon,fr Ligue 1,,,16.3,11,9,9,1,1,8,13,61.5,5,11,9,2,7,18,68,1,Matches
1844,Dara O'Shea,ie IRL,DF,Burnley,eng Premier League,25-005,1999,22.4,21,12,13,6,2,7,14,50.0,7,30,21,9,21,42,114,1,Matches
1845,Michael Obafemi,ie IRL,"FW,MF",Burnley,eng Premier League,23-247,2000,0.2,0,0,0,0,0,0,0,,0,1,0,1,0,0,0,0,Matches
1846,Adam Obert,sk SVK,DF,Cagliari,it Serie A,21-199,2002,6.4,10,5,4,5,1,5,10,50.0,5,10,5,5,13,23,23,0,Matches
1847,Pedro Obiang,gq EQG,MF,Sassuolo,it Serie A,31-348,1992,0.1,0,0,0,0,0,0,0,,0,0,0,0,0,0,0,0,Matches
1848,Jan Oblak,si SVN,GK,Atlético Madrid,es La Liga,31-062,1993,27.0,0,0,0,0,0,0,0,,0,0,0,0,0,0,6,0,Matches
1849,Brian Ocampo,uy URU,MF,Cádiz,es La Liga,24-258,1999,1.5,2,1,0,2,0,1,2,50.0,1,3,0,3,1,3,0,0,Matches
1850,Lucas Ocampos,ar ARG,"FW,MF",Sevilla,es La Liga,29-242,1994,22.0,38,25,12,14,12,13,26,50.0,13,25,1,24,12,50,15,0,Matches
1851,Guillermo Ochoa,mx MEX,GK,Salernitana,it Serie A,38-240,1985,19.0,0,0,0,0,0,0,0,,0,0,0,0,0,0,8,1,Matches
1852,Jens Odgaard,dk DEN,FW,Bologna,it Serie A,24-344,1999,0.5,0,0,0,0,0,0,0,,0,1,0,1,0,0,1,0,Matches
1853,Wilson Odobert,fr FRA,"MF,FW",Burnley,eng Premier League,19-102,2004,12.9,14,11,5,5,4,6,18,33.3,12,19,2,17,4,18,7,0,Matches
1854,Álvaro Odriozola,es ESP,DF,Real Sociedad,es La Liga,28-086,1995,1.2,1,0,0,1,0,0,0,,0,1,1,0,4,5,2,0,Matches
1855,Tim Oermann,de GER,DF,Bochum,de Bundesliga,20-155,2003,5.5,11,6,4,3,4,5,7,71.4,2,13,6,7,2,13,16,0,Matches
1856,Chiedozie Ogbene,ie IRL,"MF,DF",Luton Town,eng Premier League,26-313,1997,18.2,15,9,9,6,0,10,19,52.6,9,10,2,8,4,19,30,2,Matches
1857,Angelo Ogbonna,it ITA,DF,West Ham,eng Premier League,35-291,1988,3.6,3,1,3,0,0,2,2,100.0,0,10,8,2,2,5,18,0,Matches
1858,Florent Ogier,fr FRA,DF,Clermont Foot,fr Ligue 1,34-354,1989,10.0,17,9,12,5,0,10,17,58.8,7,23,17,6,8,25,32,3,Matches
1859,Noah Okafor,ch SUI,"FW,MF",Milan,it Serie A,23-290,2000,5.8,3,1,1,1,1,2,5,40.0,3,1,0,1,0,3,8,0,Matches
1860,David Okereke,ng NGA,"FW,MF",Torino,it Serie A,26-193,1997,0.3,0,0,0,0,0,0,1,0.0,1,0,0,0,0,0,0,0,Matches
1861,Caleb Okoli,it ITA,DF,Frosinone,it Serie A,22-240,2001,21.6,33,19,15,17,1,14,25,56.0,11,36,27,9,19,52,101,4,Matches
1862,Maduka Okoye,ng NGA,GK,Udinese,it Serie A,24-194,1999,10.0,0,0,0,0,0,0,0,,0,0,0,0,1,1,1,0,Matches
1863,Masaya Okugawa,jp JPN,"FW,DF",Augsburg,de Bundesliga,27-330,1996,0.4,0,0,0,0,0,0,0,,0,0,0,0,0,0,2,0,Matches
1864,Joseph Okumu,ke KEN,DF,Reims,fr Ligue 1,26-288,1997,17.1,40,26,26,12,2,21,35,60.0,14,19,14,5,32,72,103,2,Matches
1865,Michael Olakigbe,eng ENG,"DF,FW",Brentford,eng Premier League,19-319,2004,0.7,3,0,2,1,0,2,4,50.0,2,7,0,7,1,4,0,1,Matches
1866,Olasagasti,es ESP,MF,Real Sociedad,es La Liga,23-206,2000,3.5,14,12,3,7,4,4,7,57.1,3,2,0,2,3,17,5,1,Matches
1867,Finn Ole Becker,de GER,MF,Hoffenheim,de Bundesliga,23-275,2000,4.7,9,8,7,2,0,4,16,25.0,12,9,1,8,0,9,6,0,Matches
1868,Mathias Olesen,lu LUX,"MF,FW",Köln,de Bundesliga,22-354,2001,1.2,0,0,0,0,0,0,0,,0,0,0,0,2,2,2,0,Matches
1869,Michael Olise,fr FRA,"FW,MF",Crystal Palace,eng Premier League,22-088,2001,8.4,14,8,5,8,1,8,20,40.0,12,14,0,14,6,20,8,0,Matches
1870,Mathías Olivera,uy URU,DF,Napoli,it Serie A,26-130,1997,10.9,32,20,21,8,3,14,26,53.8,12,18,2,16,12,44,18,0,Matches
1871,Dani Olmo,es ESP,"MF,FW",RB Leipzig,de Bundesliga,25-307,1998,9.2,12,9,5,4,3,6,11,54.5,5,4,0,4,9,21,7,0,Matches
1872,Robin Olsen,se SWE,GK,Aston Villa,eng Premier League,34-061,1990,1.0,0,0,0,0,0,0,0,,0,0,0,0,0,0,0,0,Matches
1873,Warmed Omari,fr FRA,DF,Rennes,fr Ligue 1,23-321,2000,17.0,26,15,18,6,2,13,24,54.2,11,26,17,9,25,51,58,2,Matches
1874,Becir Omeragic,ch SUI,DF,Montpellier,fr Ligue 1,22-049,2002,16.7,35,20,21,10,4,17,27,63.0,10,32,18,14,17,52,46,0,Matches
1875,Jonas Omlin,ch SUI,GK,M'Gladbach,de Bundesliga,30-059,1994,2.0,0,0,0,0,0,0,0,,0,0,0,0,0,0,1,0,Matches
1876,Andrew Omobamidele,ie IRL,DF,Nott'ham Forest,eng Premier League,21-260,2002,4.5,8,3,7,1,0,4,7,57.1,3,6,5,1,8,16,29,1,Matches
1877,Samuel Omorodion,es ESP,FW,Alavés,es La Liga,19-309,2004,16.4,6,3,1,4,1,0,2,0.0,2,8,1,7,1,7,11,0,Matches
1878,Samuel Omorodion,es ESP,FW,Granada,es La Liga,19-309,2004,0.9,1,1,0,1,0,1,1,100.0,0,0,0,0,0,1,0,0,Matches
1879,Amadou Onana,be BEL,MF,Everton,eng Premier League,22-206,2001,17.5,52,31,25,20,7,14,30,46.7,16,16,2,14,11,63,22,0,Matches
1880,André Onana,cm CMR,GK,Manchester Utd,eng Premier League,27-342,1996,27.0,1,0,1,0,0,1,1,100.0,0,0,0,0,0,1,8,1,Matches
1881,Jean Onana,cm CMR,MF,Marseille,fr Ligue 1,24-061,2000,4.6,13,7,3,7,3,9,19,47.4,10,5,2,3,9,22,7,1,Matches
1882,Ryan One,sct SCO,FW,Sheffield Utd,eng Premier League,17-257,2006,0.1,0,0,0,0,0,0,0,,0,0,0,0,0,0,0,0,Matches
1883,Karim Onisiwo,at AUT,"FW,MF",Mainz 05,de Bundesliga,31-358,1992,14.8,15,6,3,6,6,5,9,55.6,4,15,3,12,1,16,7,0,Matches
1884,Tyler Onyango,eng ENG,MF,Everton,eng Premier League,21-005,2003,0.0,0,0,0,0,0,0,0,,0,0,0,0,0,0,0,0,Matches
1885,Frank Onyeka,ng NGA,MF,Brentford,eng Premier League,26-068,1998,11.2,34,21,8,21,5,14,24,58.3,10,14,6,8,20,54,14,0,Matches
1886,Loïs Openda,be BEL,FW,RB Leipzig,de Bundesliga,24-022,2000,20.9,2,2,0,0,2,0,3,0.0,3,12,1,11,5,7,8,0,Matches
1887,Royce Openda Owaga,ga GAB,FW,Lorient,fr Ligue 1,21-323,2002,0.2,,0,,,,,,,,,,,0,,,,Matches
1888,Christopher Operi,fr FRA,DF,Le Havre,fr Ligue 1,26-315,1997,19.2,35,24,20,12,3,17,39,43.6,22,25,3,22,25,60,44,1,Matches
1889,Leon Opitz,de GER,"FW,DF",Werder Bremen,de Bundesliga,18-333,2005,0.2,2,2,1,1,0,2,3,66.7,1,0,0,0,0,2,0,0,Matches
1890,Gift Orban,ng NGA,"FW,MF",Lyon,fr Ligue 1,21-236,2002,2.6,2,1,0,0,2,1,1,100.0,0,0,0,0,0,2,0,1,Matches
1891,Willi Orban,hu HUN,DF,RB Leipzig,de Bundesliga,31-127,1992,7.6,10,5,3,6,1,5,9,55.6,4,13,7,6,7,17,43,0,Matches
1892,Ivan Ordets,ua UKR,DF,Bochum,de Bundesliga,31-245,1992,14.7,10,7,4,5,1,4,10,40.0,6,26,17,9,22,32,89,0,Matches
1893,Divock Origi,be BEL,"FW,MF",Nott'ham Forest,eng Premier League,28-326,1995,3.8,4,2,3,0,1,0,0,,0,4,0,4,1,5,1,0,Matches
1894,Gaetano Oristanio,it ITA,"FW,MF",Cagliari,it Serie A,21-163,2002,9.6,14,8,4,9,1,3,11,27.3,8,7,0,7,7,21,7,0,Matches
1895,Aimar Oroz,es ESP,MF,Osasuna,es La Liga,22-103,2001,22.1,35,21,15,17,3,13,35,37.1,22,24,2,22,12,47,10,0,Matches
1896,Riccardo Orsolini,it ITA,"FW,MF",Bologna,it Serie A,27-045,1997,14.8,17,9,10,3,4,7,26,26.9,19,18,2,16,6,23,18,0,Matches
1897,Stefan Ortega,de GER,GK,Manchester City,eng Premier League,31-124,1992,1.9,0,0,0,0,0,0,0,,0,0,0,0,0,0,0,1,Matches
1898,Ben Osborn,eng ENG,"MF,DF",Sheffield Utd,eng Premier League,29-217,1994,6.8,9,3,3,4,2,4,7,57.1,3,9,0,9,2,11,14,0,Matches
1899,Gabriel Osho,eng ENG,DF,Luton Town,eng Premier League,25-208,1998,14.6,28,17,14,13,1,12,19,63.2,7,33,17,16,27,55,69,0,Matches
1900,Victor Osimhen,ng NGA,FW,Napoli,it Serie A,25-071,1998,14.8,6,3,0,2,4,2,4,50.0,2,4,1,3,1,7,13,0,Matches
1901,Milutin Osmajić,me MNE,MF,Cádiz,es La Liga,24-228,1999,0.1,0,0,0,0,0,0,0,,0,0,0,0,0,0,0,0,Matches
1902,Patrick Osterhage,de GER,MF,Bochum,de Bundesliga,24-037,2000,13.6,26,18,10,15,1,11,27,40.7,16,23,7,16,17,43,21,0,Matches
1903,William Osula,dk DEN,FW,Sheffield Utd,eng Premier League,20-218,2003,8.0,2,2,1,0,1,1,2,50.0,1,3,1,2,2,4,7,0,Matches
1904,Dango Ouattara,bf BFA,"FW,DF",Bournemouth,eng Premier League,22-027,2002,6.0,26,14,15,5,6,9,17,52.9,8,8,2,6,8,34,17,0,Matches
1905,Kassoum Ouattara,fr FRA,DF,Monaco,fr Ligue 1,19-147,2004,3.9,14,10,7,4,3,6,14,42.9,8,6,0,6,8,22,12,0,Matches
1906,Remi Oudin,fr FRA,"MF,FW",Lecce,it Serie A,27-112,1996,14.2,18,9,6,12,0,8,12,66.7,4,10,0,10,16,34,14,0,Matches
1907,Alexandre Oukidja,dz ALG,GK,Metz,fr Ligue 1,35-234,1988,23.2,1,1,1,0,0,1,2,50.0,1,0,0,0,2,3,19,0,Matches
1908,Azzedine Ounahi,ma MAR,MF,Marseille,fr Ligue 1,23-325,2000,11.4,22,10,8,13,1,9,29,31.0,20,5,0,5,9,31,8,0,Matches
1909,Adam Ounas,dz ALG,FW,Lille,fr Ligue 1,27-119,1996,4.4,4,3,2,2,0,2,7,28.6,5,2,0,2,6,10,1,0,Matches
1910,Mikel Oyarzabal,es ESP,"FW,MF",Real Sociedad,es La Liga,26-323,1997,15.4,18,14,6,8,4,6,18,33.3,12,17,3,14,4,22,10,0,Matches
1911,Anthony Oyono,ga GAB,DF,Frosinone,it Serie A,22-332,2001,13.3,37,26,21,14,2,23,34,67.6,11,17,3,14,9,46,32,0,Matches
1912,Salih Özcan,tr TUR,MF,Dortmund,de Bundesliga,26-058,1998,10.0,18,10,11,7,0,9,14,64.3,5,21,2,19,15,33,12,1,Matches
1913,Bertuğ Özgür Yıldırım,tr TUR,FW,Rennes,fr Ligue 1,21-241,2002,4.0,6,4,2,2,2,3,7,42.9,4,6,0,6,0,6,4,0,Matches
1914,Cenk Özkacar,tr TUR,DF,Valencia,es La Liga,23-155,2000,8.7,13,8,10,3,0,9,16,56.3,7,9,3,6,8,21,41,1,Matches
1915,David Ozoh,eng ENG,MF,Crystal Palace,eng Premier League,18-283,2005,1.5,9,5,3,5,1,5,6,83.3,1,2,0,2,0,9,2,0,Matches
1916,Jon Pacheco,es ESP,DF,Real Sociedad,es La Liga,23-061,2001,10.2,14,7,13,1,0,7,13,53.8,6,12,5,7,5,19,31,1,Matches
1917,Willian Pacho,ec ECU,DF,Eint Frankfurt,de Bundesliga,22-145,2001,23.0,49,30,31,17,1,24,35,68.6,11,39,15,24,32,81,119,0,Matches
1918,Gonçalo Paciência,pt POR,FW,Bochum,de Bundesliga,29-221,1994,6.4,8,4,2,2,4,3,6,50.0,3,3,0,3,0,8,6,0,Matches
1919,Simone Pafundi,it ITA,MF,Udinese,it Serie A,18-024,2006,0.1,0,0,0,0,0,0,0,,0,0,0,0,0,0,0,0,Matches
1920,Riccardo Pagano,it ITA,"MF,DF",Roma,it Serie A,19-102,2004,0.6,2,2,1,1,0,0,6,0.0,6,3,2,1,0,2,2,0,Matches
1921,Pablo Pagis,fr FRA,MF,Lorient,fr Ligue 1,21-071,2002,1.8,10,6,5,4,1,6,10,60.0,4,2,0,2,3,13,1,0,Matches
1922,Exequiel Palacios,ar ARG,MF,Leverkusen,de Bundesliga,25-156,1998,15.5,46,24,19,22,5,18,39,46.2,21,18,0,18,27,73,15,2,Matches
1923,Isaac Palazón Camacho,es ESP,"MF,FW",Rayo Vallecano,es La Liga,29-073,1994,22.2,33,16,13,15,5,14,39,35.9,25,23,1,22,15,48,30,0,Matches
1924,João Palhinha,pt POR,MF,Fulham,eng Premier League,28-244,1995,20.5,105,55,61,34,10,70,106,66.0,36,42,7,35,36,141,40,0,Matches
1925,Nicolas Pallois,fr FRA,DF,Nantes,fr Ligue 1,36-172,1987,12.4,22,11,14,6,2,13,23,56.5,10,25,18,7,16,38,79,0,Matches
1926,Cole Palmer,eng ENG,MF,Manchester City,eng Premier League,21-308,2002,0.1,0,0,0,0,0,0,0,,0,0,0,0,0,0,0,0,Matches
1927,Cole Palmer,eng ENG,"FW,MF",Chelsea,eng Premier League,21-308,2002,18.4,16,9,6,4,6,6,16,37.5,10,13,1,12,12,28,11,2,Matches
1928,Emerson Palmieri,it ITA,DF,West Ham,eng Premier League,29-219,1994,25.2,78,52,33,33,12,42,59,71.2,17,32,7,25,31,109,72,0,Matches
1929,Joaquín Panichelli,ar ARG,FW,Alavés,es La Liga,21-154,2002,0.0,0,0,0,0,0,0,0,,0,0,0,0,0,0,0,0,Matches
1930,Miloš Pantović,rs SRB,MF,Union Berlin,de Bundesliga,27-246,1996,0.2,0,0,0,0,0,0,0,,0,0,0,0,0,0,0,0,Matches
1931,Antonios Papadopoulos,de GER,DF,Dortmund,de Bundesliga,24-181,1999,0.3,3,1,3,0,0,3,3,100.0,0,1,0,1,0,3,4,0,Matches
1932,Sokratis Papastathopoulos,gr GRE,DF,Betis,es La Liga,35-274,1988,6.8,6,4,3,3,0,5,7,71.4,2,11,7,4,5,11,36,0,Matches
1933,Matondo-Merveille Papela,de GER,"MF,DF",Mainz 05,de Bundesliga,23-051,2001,2.9,5,4,2,3,0,0,4,0.0,4,1,0,1,4,9,2,0,Matches
1934,Leart Paqarada,xk KVX,DF,Köln,de Bundesliga,29-153,1994,9.8,17,9,8,8,1,8,19,42.1,11,15,5,10,9,26,22,1,Matches
1935,Lucas Paquetá,br BRA,"FW,MF",West Ham,eng Premier League,26-195,1997,18.5,47,34,25,18,4,18,37,48.6,19,22,0,22,14,61,19,1,Matches
1936,Victor Parada,es ESP,"FW,MF",Alavés,es La Liga,21-340,2002,0.0,1,1,0,1,0,1,1,100.0,0,0,0,0,0,1,0,0,Matches
1937,Aitor Paredes,es ESP,DF,Athletic Club,es La Liga,23-315,2000,22.7,11,8,6,5,0,5,11,45.5,6,19,9,10,21,32,76,0,Matches
1938,Kevin Paredes,us USA,"FW,MF",Wolfsburg,de Bundesliga,20-307,2003,9.9,28,14,14,11,3,11,22,50.0,11,20,2,18,17,45,15,0,Matches
1939,Leandro Paredes,ar ARG,MF,Roma,it Serie A,29-254,1994,21.4,41,27,22,16,3,23,56,41.1,33,17,4,13,21,62,31,0,Matches
1940,Daniel Parejo,es ESP,MF,Villarreal,es La Liga,34-328,1989,19.9,32,22,13,19,0,15,33,45.5,18,13,4,9,10,42,21,3,Matches
1941,Fabiano Parisi,it ITA,DF,Fiorentina,it Serie A,23-121,2000,11.1,22,10,8,8,6,12,18,66.7,6,19,4,15,12,34,20,0,Matches
1942,Ben Parkinson,eng ENG,FW,Newcastle Utd,eng Premier League,18-365,2005,0.3,0,0,0,0,0,0,0,,0,1,0,1,0,0,1,0,Matches
1943,Thomas Partey,gh GHA,"DF,MF",Arsenal,eng Premier League,30-270,1993,3.1,6,5,5,1,0,4,6,66.7,2,2,1,1,4,10,2,0,Matches
1944,Mario Pašalić,hr CRO,"MF,FW",Atalanta,it Serie A,29-029,1995,13.6,20,12,7,13,0,8,16,50.0,8,19,5,14,8,28,19,0,Matches
1945,Triantafyllos Pasaridīs,gr GRE,DF,Salernitana,it Serie A,27-234,1996,3.0,,2,,,,,,,,,,,1,,,,Matches
1946,Pascu,es ESP,FW,Villarreal,es La Liga,20-335,2003,0.2,0,0,0,0,0,0,0,,0,0,0,0,0,0,0,0,Matches
1947,Felix Passlack,de GER,DF,Bochum,de Bundesliga,25-285,1998,4.8,10,7,4,5,1,7,13,53.8,6,6,1,5,5,15,10,0,Matches
1948,Patric,es ESP,DF,Lazio,it Serie A,30-327,1993,11.4,9,5,7,2,0,5,11,45.5,6,8,5,3,5,14,28,0,Matches
1949,Rui Patrício,pt POR,GK,Roma,it Serie A,36-023,1988,23.0,0,0,0,0,0,0,1,0.0,1,1,0,1,0,0,3,1,Matches
1950,Nathan Patterson,sct SCO,DF,Everton,eng Premier League,22-145,2001,10.7,33,23,21,10,2,14,37,37.8,23,14,3,11,9,42,32,0,Matches
1951,Gabriel Paulista,br BRA,DF,Atlético Madrid,es La Liga,33-104,1990,3.0,3,2,2,1,0,1,2,50.0,1,2,1,1,3,6,18,0,Matches
1952,Gabriel Paulista,br BRA,DF,Valencia,es La Liga,33-104,1990,15.5,10,7,8,2,0,6,11,54.5,5,15,7,8,24,34,78,0,Matches
1953,Benjamin Pavard,fr FRA,DF,Inter,it Serie A,27-347,1996,12.1,24,15,12,10,2,15,18,83.3,3,17,11,6,20,44,27,1,Matches
1954,Jiří Pavlenka,cz CZE,GK,Werder Bremen,de Bundesliga,31-330,1992,7.0,0,0,0,0,0,0,0,,0,0,0,0,0,0,2,0,Matches
1955,Aleksandar Pavlovic,de GER,MF,Bayern Munich,de Bundesliga,19-311,2004,8.1,20,13,8,11,1,12,23,52.2,11,9,0,9,9,29,6,0,Matches
1956,Leonardo Pavoletti,it ITA,FW,Cagliari,it Serie A,35-104,1988,7.0,1,1,0,0,1,0,1,0.0,1,2,1,1,0,1,7,0,Matches
1957,Martín Payero,ar ARG,MF,Udinese,it Serie A,25-180,1998,12.6,27,18,9,12,6,11,28,39.3,17,12,1,11,13,40,12,0,Matches
1958,Nicolás Paz,ar ARG,"MF,FW",Real Madrid,es La Liga,19-183,2004,0.3,0,0,0,0,0,0,0,,0,2,0,2,1,1,0,0,Matches
1959,Myles Peart-Harris,eng ENG,"DF,MF",Brentford,eng Premier League,21-173,2002,0.1,0,0,0,0,0,0,0,,0,0,0,0,0,0,1,0,Matches
1960,Sydie Peck,eng ENG,MF,Sheffield Utd,eng Premier League,19-178,2004,0.1,0,0,0,0,0,0,0,,0,0,0,0,0,0,0,0,Matches
1961,Mads Pedersen,dk DEN,DF,Augsburg,de Bundesliga,27-190,1996,13.2,34,22,15,14,5,11,24,45.8,13,16,3,13,15,49,33,0,Matches
1962,Marcus Pedersen,no NOR,DF,Sassuolo,it Serie A,23-237,2000,15.6,30,18,20,5,5,16,19,84.2,3,17,4,13,9,39,44,0,Matches
1963,Alfonso Pedraza,es ESP,DF,Villarreal,es La Liga,27-335,1996,10.6,23,8,16,5,2,9,17,52.9,8,13,5,8,11,34,17,0,Matches
1964,Pedri,es ESP,"MF,FW",Barcelona,es La Liga,21-105,2002,12.1,22,18,12,8,2,6,20,30.0,14,24,2,22,10,32,6,0,Matches
1965,Pedro,es ESP,FW,Lazio,it Serie A,36-225,1987,6.8,14,11,4,7,3,3,10,30.0,7,12,0,12,2,16,1,0,Matches
1966,Adrià Pedrosa,es ESP,DF,Sevilla,es La Liga,25-301,1998,16.4,40,22,23,13,4,17,26,65.4,9,19,4,15,14,54,44,0,Matches
1967,Jordan Pefok,us USA,FW,M'Gladbach,de Bundesliga,27-318,1996,12.1,7,4,0,6,1,3,7,42.9,4,9,3,6,3,10,23,0,Matches
1968,Jordan Pefok,us USA,FW,Union Berlin,de Bundesliga,27-318,1996,0.3,0,0,0,0,0,0,0,,0,1,1,0,0,0,0,0,Matches
1969,Dženan Pejčinović,de GER,FW,Wolfsburg,de Bundesliga,19-023,2005,0.3,0,0,0,0,0,0,0,,0,1,0,1,0,0,0,0,Matches
1970,Pietro Pellegri,it ITA,"FW,MF",Torino,it Serie A,22-358,2001,6.4,4,1,1,3,0,1,5,20.0,4,2,1,1,0,4,3,0,Matches
1971,Lorenzo Pellegrini,it ITA,MF,Roma,it Serie A,27-264,1996,13.5,25,13,9,12,4,12,33,36.4,21,19,3,16,13,38,13,0,Matches
1972,Luca Pellegrini,it ITA,DF,Lazio,it Serie A,25-002,1999,6.6,16,11,6,9,1,9,16,56.3,7,7,3,4,6,22,16,0,Matches
1973,Marco Pellegrino,,DF,Salernitana,it Serie A,,,4.3,1,0,0,0,1,0,2,0.0,2,5,5,0,3,4,23,0,Matches
1974,Marco Pellegrino,,DF,Milan,it Serie A,,,0.8,1,1,0,0,1,0,2,0.0,2,1,1,0,1,2,2,0,Matches
1975,Facundo Pellistri,uy URU,"FW,MF",Manchester Utd,eng Premier League,22-080,2001,1.9,5,3,4,1,0,1,3,33.3,2,7,1,6,1,6,5,0,Matches
1976,Facundo Pellistri,uy URU,"MF,FW",Granada,es La Liga,22-080,2001,3.7,9,4,3,4,2,2,3,66.7,1,5,0,5,3,12,4,0,Matches
1977,Andy Pelmard,fr FRA,DF,Clermont Foot,fr Ligue 1,23-363,2000,23.2,39,27,31,7,1,24,28,85.7,4,24,12,12,23,62,48,1,Matches
1978,Aurélien Pelon,fr FRA,DF,Lorient,fr Ligue 1,19-308,2004,1.0,1,0,1,0,0,0,2,0.0,2,2,2,0,0,1,7,0,Matches
1979,Faris Pemi Moumbagna,cm CMR,FW,Marseille,fr Ligue 1,23-252,2000,2.5,0,0,0,0,0,0,1,0.0,1,2,0,2,0,0,1,0,Matches
1980,Iñaki Peña ,es ESP,GK,Barcelona,es La Liga,25-007,1999,10.0,0,0,0,0,0,0,1,0.0,1,0,0,0,0,0,5,1,Matches
1981,Rubén Peña,es ESP,"DF,FW",Osasuna,es La Liga,32-235,1991,16.6,36,22,17,14,5,17,42,40.5,25,25,4,21,21,57,32,3,Matches
1982,Pepín,gq EQG,"MF,FW",Monza,it Serie A,27-208,1996,2.6,6,1,1,4,1,2,4,50.0,2,5,2,3,0,6,5,0,Matches
1983,Alberto Perea,es ESP,"MF,FW",Granada,es La Liga,33-081,1990,0.0,0,0,0,0,0,0,2,0.0,2,0,0,0,0,0,0,0,Matches
1984,Andreas Pereira,br BRA,MF,Fulham,eng Premier League,28-068,1996,20.8,16,7,2,7,7,6,26,23.1,20,13,2,11,3,19,12,0,Matches
1985,Danilo Pereira,pt POR,DF,Paris S-G,fr Ligue 1,32-182,1991,14.4,15,9,10,3,2,5,11,45.5,6,20,19,1,14,29,68,0,Matches
1986,Mathias Pereira Lage,pt POR,FW,Brest,fr Ligue 1,27-100,1996,9.0,16,11,7,5,4,7,22,31.8,15,9,3,6,7,23,9,0,Matches
1987,Pedro Pereira,pt POR,DF,Monza,it Serie A,26-047,1998,7.4,12,7,9,3,0,5,13,38.5,8,14,2,12,4,16,14,0,Matches
1988,Roberto Pereyra,ar ARG,"FW,MF",Udinese,it Serie A,33-062,1991,13.8,12,5,8,4,0,7,16,43.8,9,12,2,10,3,15,6,0,Matches
1989,Ayoze Pérez,es ESP,FW,Betis,es La Liga,30-224,1993,16.4,37,22,10,23,4,12,28,42.9,16,29,2,27,17,54,12,0,Matches
1990,Carles Pérez,es ESP,"MF,FW",Celta Vigo,es La Liga,26-022,1998,4.9,6,3,2,3,1,4,9,44.4,5,8,0,8,4,10,3,0,Matches
1991,Francisco Perez,es ESP,"MF,FW",Valencia,es La Liga,21-182,2002,18.9,30,17,10,14,6,15,38,39.5,23,17,0,17,11,41,4,0,Matches
1992,Kike Pérez,es ESP,"MF,FW",Rayo Vallecano,es La Liga,27-024,1997,8.4,24,10,10,13,1,10,20,50.0,10,10,0,10,8,32,6,0,Matches
1993,Nehuén Pérez,ar ARG,DF,Udinese,it Serie A,23-259,2000,27.0,56,37,33,21,2,30,36,83.3,6,36,17,19,34,90,123,0,Matches
1994,Mattia Perin,it ITA,GK,Juventus,it Serie A,31-120,1992,2.0,0,0,0,0,0,0,0,,0,0,0,0,0,0,1,0,Matches
1995,Samuele Perisan,it ITA,GK,Empoli,it Serie A,26-201,1997,1.0,0,0,0,0,0,0,0,,0,0,0,0,0,0,0,0,Matches
1996,Ivan Perišić,hr CRO,FW,Tottenham,eng Premier League,35-036,1989,1.1,3,2,1,1,1,3,5,60.0,2,1,0,1,2,5,1,0,Matches
1997,Romain Perraud,fr FRA,"DF,FW",Nice,fr Ligue 1,26-169,1997,2.2,6,5,4,1,1,3,6,50.0,3,3,0,3,4,10,7,1,Matches
1998,Lucas Perrin,fr FRA,DF,Strasbourg,fr Ligue 1,25-111,1998,22.0,37,24,27,10,0,23,39,59.0,16,34,24,10,18,55,90,0,Matches
1999,Máximo Perrone,ar ARG,MF,Las Palmas,es La Liga,21-062,2003,14.2,37,19,16,19,2,17,32,53.1,15,18,3,15,24,61,19,0,Matches
2000,Pavao Pervan,at AUT,GK,Wolfsburg,de Bundesliga,36-117,1987,4.0,0,0,0,0,0,0,0,,0,0,0,0,0,0,1,0,Matches
2001,Matteo Pessina,it ITA,MF,Monza,it Serie A,26-323,1997,26.1,39,20,18,18,3,21,42,50.0,21,26,9,17,22,61,31,0,Matches
2002,Andrea Petagna,it ITA,FW,Cagliari,it Serie A,28-253,1995,11.1,4,2,1,0,3,1,2,50.0,1,6,3,3,1,5,4,0,Matches
2003,Denis Petrić,rs SRB,GK,Nantes,fr Ligue 1,35-290,1988,0.3,0,0,0,0,0,0,0,,0,0,0,0,0,0,0,0,Matches
2004,Njegoš Petrović,rs SRB,"MF,FW",Granada,es La Liga,24-235,1999,1.7,5,2,4,1,0,2,3,66.7,1,2,0,2,1,6,3,0,Matches
2005,Đorđe Petrović,rs SRB,GK,Chelsea,eng Premier League,24-153,1999,10.1,0,0,0,0,0,0,0,,0,0,0,0,0,0,5,0,Matches
2006,Jens Petter Hauge,no NOR,"MF,FW",Eint Frankfurt,de Bundesliga,24-149,1999,1.6,2,1,1,0,1,2,7,28.6,5,5,1,4,0,2,1,0,Matches
2007,Germán Pezzella,ar ARG,DF,Betis,es La Liga,32-256,1991,25.1,29,20,20,9,0,19,32,59.4,13,27,16,11,27,56,129,0,Matches
2008,Giuseppe Pezzella,it ITA,DF,Empoli,it Serie A,26-101,1997,4.0,12,8,7,4,1,10,14,71.4,4,12,4,8,0,12,11,0,Matches
2009,Luca Pfeiffer,de GER,"FW,MF",Darmstadt 98,de Bundesliga,27-202,1996,16.7,10,6,1,6,3,4,10,40.0,6,4,1,3,2,12,16,0,Matches
2010,Patric Pfeiffer,de GER,DF,Augsburg,de Bundesliga,24-202,1999,4.1,9,5,5,3,1,5,6,83.3,1,7,4,3,8,17,16,0,Matches
2011,Maximilian Philipp,de GER,"FW,MF",Freiburg,de Bundesliga,30-008,1994,3.0,8,5,4,4,0,1,6,16.7,5,6,0,6,1,9,1,0,Matches
2012,Kalvin Phillips,eng ENG,MF,West Ham,eng Premier League,28-098,1995,2.5,7,3,2,4,1,4,6,66.7,2,3,0,3,4,11,2,1,Matches
2013,Kalvin Phillips,eng ENG,MF,Manchester City,eng Premier League,28-098,1995,1.0,3,3,1,1,1,0,0,,0,0,0,0,2,5,2,0,Matches
2014,Jaden Philogene Bidace,eng ENG,FW,Aston Villa,eng Premier League,22-030,2002,0.0,0,0,0,0,0,0,0,,0,0,0,0,0,0,0,0,Matches
2015,Kamil Piątkowski,pl POL,DF,Granada,es La Liga,23-262,2000,2.9,13,7,11,1,1,7,9,77.8,2,3,3,0,3,16,12,0,Matches
2016,Roberto Piccoli,it ITA,FW,Empoli,it Serie A,23-042,2001,0.4,1,1,0,0,1,1,1,100.0,0,0,0,0,0,1,0,0,Matches
2017,Roberto Piccoli,it ITA,FW,Lecce,it Serie A,23-042,2001,8.5,8,4,2,4,2,1,3,33.3,2,10,1,9,1,9,8,0,Matches
2018,Florian Pick,de GER,"MF,FW",Heidenheim,de Bundesliga,28-183,1995,3.0,3,3,2,0,1,2,3,66.7,1,2,0,2,2,5,1,0,Matches
2019,Jordan Pickford,eng ENG,GK,Everton,eng Premier League,30-002,1994,27.0,0,0,0,0,0,0,0,,0,1,0,1,0,0,13,0,Matches
2020,Amos Pieper,de GER,DF,Werder Bremen,de Bundesliga,26-052,1998,6.0,13,10,8,5,0,7,12,58.3,5,12,7,5,8,21,34,1,Matches
2021,Marvin Pieringer,de GER,"MF,FW",Heidenheim,de Bundesliga,24-157,1999,11.2,14,10,4,8,2,7,16,43.8,9,23,4,19,10,24,15,0,Matches
2022,Santiago Pierotti,ar ARG,"MF,DF",Lecce,it Serie A,22-341,2001,0.3,2,2,1,0,1,1,2,50.0,1,0,0,0,0,2,0,0,Matches
2023,Niccolò Pierozzi,it ITA,DF,Salernitana,it Serie A,22-179,2001,3.6,4,4,4,0,0,3,5,60.0,2,8,1,7,7,11,13,0,Matches
2024,Ronaël Pierre-Gabriel,fr FRA,DF,Nantes,fr Ligue 1,25-270,1998,6.6,15,9,12,2,1,5,7,71.4,2,13,4,9,8,23,25,0,Matches
2025,Andrea Pinamonti,it ITA,FW,Sassuolo,it Serie A,24-295,1999,24.3,6,5,0,1,5,2,12,16.7,10,15,2,13,0,6,29,0,Matches
2026,Ethan Pinnock,jm JAM,DF,Brentford,eng Premier League,30-285,1993,23.0,32,21,21,11,0,8,17,47.1,9,34,21,13,36,68,144,2,Matches
2027,Yeremi Pino,es ESP,"MF,FW",Villarreal,es La Liga,21-141,2002,5.3,25,18,12,10,3,9,18,50.0,9,11,1,10,5,30,5,0,Matches
2028,Lorenzo Pirola,it ITA,DF,Salernitana,it Serie A,22-018,2002,13.4,23,12,14,9,0,8,17,47.1,9,24,17,7,11,34,58,0,Matches
2029,Niccolò Pisilli,it ITA,MF,Roma,it Serie A,19-168,2004,0.1,0,0,0,0,0,0,0,,0,0,0,0,0,0,0,0,Matches
2030,Alassane Pléa,fr FRA,"FW,MF",M'Gladbach,de Bundesliga,30-365,1993,15.2,11,6,4,5,2,4,12,33.3,8,7,0,7,1,12,3,0,Matches
2031,Tommaso Pobega,it ITA,MF,Milan,it Serie A,24-238,1999,3.3,14,8,11,3,0,5,10,50.0,5,8,2,6,6,20,7,0,Matches
2032,Paul Pogba,fr FRA,MF,Juventus,it Serie A,30-360,1993,0.6,1,1,0,1,0,1,1,100.0,0,0,0,0,1,2,1,0,Matches
2033,Ole Pohlmann,de GER,MF,Dortmund,de Bundesliga,22-339,2001,0.4,0,0,0,0,0,0,0,,0,0,0,0,0,0,0,0,Matches
2034,Matteo Politano,it ITA,FW,Napoli,it Serie A,30-219,1993,18.7,19,8,8,7,4,11,29,37.9,18,4,0,4,10,29,10,0,Matches
2035,Sebastian Polter,de GER,FW,Darmstadt 98,de Bundesliga,32-343,1991,3.8,0,0,0,0,0,0,0,,0,4,0,4,0,0,1,0,Matches
2036,Julien Ponceau,fr FRA,MF,Lorient,fr Ligue 1,23-102,2000,17.4,21,9,10,7,4,7,24,29.2,17,17,1,16,16,37,16,0,Matches
2037,Marin Pongračić,hr CRO,DF,Lecce,it Serie A,26-180,1997,24.8,32,21,15,16,1,16,22,72.7,6,24,18,6,35,67,88,0,Matches
2038,Nick Pope,eng ENG,GK,Newcastle Utd,eng Premier League,31-325,1992,13.9,0,0,0,0,0,0,1,0.0,1,0,0,0,0,0,7,2,Matches
2039,Pedro Porro,es ESP,DF,Tottenham,eng Premier League,24-178,1999,23.0,67,46,34,20,13,44,88,50.0,44,49,13,36,23,90,75,2,Matches
2040,Portu,es ESP,FW,Getafe,es La Liga,31-293,1992,1.1,5,3,4,0,1,5,6,83.3,1,0,0,0,0,5,0,0,Matches
2041,Portu,es ESP,"MF,FW",Girona,es La Liga,31-293,1992,8.0,13,9,1,9,3,2,12,16.7,10,6,1,5,1,14,3,0,Matches
2042,Stefan Posch,at AUT,DF,Bologna,it Serie A,26-300,1997,18.2,57,33,25,28,4,35,59,59.3,24,18,7,11,13,70,48,0,Matches
2043,Yussuf Poulsen,dk DEN,FW,RB Leipzig,de Bundesliga,29-268,1994,11.6,12,8,1,8,3,3,13,23.1,10,10,2,8,4,16,13,0,Matches
2044,José Pozo,es ESP,"MF,FW",Rayo Vallecano,es La Liga,27-360,1996,0.1,0,0,0,0,0,0,0,,0,0,0,0,0,0,0,0,Matches
2045,Alejandro Pozo Pozo,es ESP,"DF,MF",Almería,es La Liga,25-016,1999,9.4,17,10,9,6,2,10,18,55.6,8,13,4,9,5,22,19,0,Matches
2046,Beñat Prados,es ESP,"MF,DF",Athletic Club,es La Liga,23-030,2001,8.8,26,16,8,13,5,15,33,45.5,18,17,1,16,11,37,19,0,Matches
2047,Matteo Prati,it ITA,MF,Cagliari,it Serie A,20-072,2003,16.7,33,20,9,21,3,18,30,60.0,12,17,2,15,11,44,19,1,Matches
2048,Abdón Prats,es ESP,FW,Mallorca,es La Liga,31-093,1992,10.4,4,3,1,2,1,2,4,50.0,2,4,1,3,2,6,9,0,Matches
2049,Sanjin Prcić,ba BIH,MF,Strasbourg,fr Ligue 1,30-110,1993,1.0,0,0,0,0,0,0,1,0.0,1,2,1,1,3,3,1,0,Matches
2050,Grischa Prömel,de GER,MF,Hoffenheim,de Bundesliga,29-060,1995,17.7,28,17,10,12,6,12,29,41.4,17,20,5,15,15,43,27,0,Matches
2051,Ivan Provedel,it ITA,GK,Lazio,it Serie A,29-358,1994,27.0,1,0,1,0,0,1,3,33.3,2,0,0,0,0,1,11,1,Matches
2052,Pubill,es ESP,DF,Almería,es La Liga,20-263,2003,11.2,34,17,26,6,2,16,29,55.2,13,12,5,7,9,43,36,0,Matches
2053,Gustavo Puerta,co COL,"DF,MF",Leverkusen,de Bundesliga,20-230,2003,0.3,5,3,2,2,1,1,1,100.0,0,2,0,2,0,5,0,0,Matches
2054,Antonio Puertas,es ESP,"MF,FW",Granada,es La Liga,32-017,1992,7.0,10,7,4,5,1,5,13,38.5,8,4,0,4,5,15,4,0,Matches
2055,Arnau Puigmal,es ESP,"FW,DF",Almería,es La Liga,23-059,2001,2.8,2,1,1,1,0,1,3,33.3,2,3,0,3,3,5,2,0,Matches
2056,Christian Pulisic,us USA,FW,Milan,it Serie A,25-173,1998,20.4,25,19,11,6,8,12,19,63.2,7,15,1,14,9,34,7,1,Matches
2057,George Pușcaș,ro ROU,FW,Genoa,it Serie A,27-336,1996,2.1,0,0,0,0,0,0,3,0.0,3,1,0,1,0,0,1,0,Matches
2058,Jarell Quansah,eng ENG,DF,Liverpool,eng Premier League,21-040,2003,4.9,7,6,6,1,0,4,5,80.0,1,4,1,3,5,12,16,0,Matches
2059,Domingos Quina,pt POR,MF,Udinese,it Serie A,24-112,1999,0.1,1,1,1,0,0,0,0,,0,0,0,0,0,1,0,0,Matches
2060,Adrien Rabiot,fr FRA,MF,Juventus,it Serie A,28-341,1995,21.3,42,27,16,23,3,26,36,72.2,10,21,5,16,19,61,23,0,Matches
2061,Uroš Račić,rs SRB,MF,Sassuolo,it Serie A,25-358,1998,5.2,5,2,2,3,0,0,4,0.0,4,10,5,5,4,9,19,0,Matches
2062,Nemanja Radonjić,rs SRB,"MF,FW",Torino,it Serie A,28-023,1996,4.2,1,1,0,0,1,1,3,33.3,2,3,0,3,0,1,0,0,Matches
2063,Nemanja Radonjić,rs SRB,MF,Mallorca,es La Liga,28-023,1996,0.9,0,0,0,0,0,0,1,0.0,1,1,0,1,1,1,0,0,Matches
2064,Aleksandar Radovanović,rs SRB,DF,Almería,es La Liga,30-119,1993,3.8,5,4,5,0,0,4,4,100.0,0,6,6,0,6,11,35,0,Matches
2065,Ionuț Radu,ro ROU,GK,Bournemouth,eng Premier League,26-286,1997,2.0,0,0,0,0,0,0,0,,0,0,0,0,0,0,0,0,Matches
2066,Boris Radunović,rs SRB,GK,Cagliari,it Serie A,27-288,1996,7.0,0,0,0,0,0,0,0,,0,0,0,0,1,1,1,2,Matches
2067,Hamza Rafia,tn TUN,MF,Lecce,it Serie A,24-342,1999,11.0,29,22,9,18,2,7,21,33.3,14,19,1,18,8,37,8,0,Matches
2068,Antonio Raillo,es ESP,DF,Mallorca,es La Liga,32-153,1991,15.4,18,15,11,7,0,11,16,68.8,5,32,23,9,19,37,61,1,Matches
2069,Luca Raimund,de GER,"FW,MF",Stuttgart,de Bundesliga,18-335,2005,0.3,3,1,2,1,0,0,0,,0,2,0,2,0,3,0,0,Matches
2070,Predrag Rajković,rs SRB,GK,Mallorca,es La Liga,28-130,1995,28.0,1,1,1,0,0,1,1,100.0,0,0,0,0,0,1,11,0,Matches
2071,Jesuran Rak Sakyi,eng ENG,"MF,FW",Crystal Palace,eng Premier League,21-156,2002,1.5,4,1,3,1,0,2,3,66.7,1,2,0,2,3,7,1,0,Matches
2072,Ivan Rakitić,hr CRO,MF,Sevilla,es La Liga,35-365,1988,15.8,30,16,9,12,9,11,19,57.9,8,16,5,11,14,44,12,0,Matches
2073,Ylber Ramadani,al ALB,MF,Lecce,it Serie A,27-332,1996,24.4,54,32,26,23,5,30,69,43.5,39,42,10,32,38,92,37,0,Matches
2074,Largie Ramazani,be BEL,"FW,MF",Almería,es La Liga,23-011,2001,14.7,12,7,5,6,1,6,26,23.1,20,11,2,9,25,37,8,0,Matches
2075,Benito Ramírez,es ESP,"FW,MF",Las Palmas,es La Liga,28-242,1995,1.8,4,2,1,3,0,2,4,50.0,2,4,1,3,1,5,0,0,Matches
2076,Sandro Ramírez,es ESP,FW,Las Palmas,es La Liga,28-244,1995,12.3,8,7,2,5,1,3,8,37.5,5,11,1,10,1,9,9,1,Matches
2077,Chris Ramos,es ESP,"FW,MF",Cádiz,es La Liga,27-051,1997,21.7,20,10,8,10,2,5,22,22.7,17,16,4,12,8,28,38,0,Matches
2078,Gonçalo Ramos,pt POR,FW,Paris S-G,fr Ligue 1,22-263,2001,9.9,17,9,4,7,6,5,15,33.3,10,6,1,5,2,19,13,0,Matches
2079,Sergio Ramos,es ESP,DF,Sevilla,es La Liga,37-345,1986,17.0,29,18,21,7,1,16,25,64.0,9,20,17,3,28,57,88,0,Matches
2080,Aaron Ramsdale,eng ENG,GK,Arsenal,eng Premier League,25-300,1998,5.0,0,0,0,0,0,0,0,,0,0,0,0,0,0,3,1,Matches
2081,Aaron Ramsey,eng ENG,"MF,FW",Burnley,eng Premier League,21-048,2003,5.9,17,14,7,5,5,8,16,50.0,8,11,2,9,1,18,10,0,Matches
2082,Jacob Ramsey,eng ENG,"MF,FW",Aston Villa,eng Premier League,22-286,2001,9.5,16,8,7,6,3,5,15,33.3,10,15,2,13,3,19,8,0,Matches
2083,Luca Ranieri,it ITA,DF,Fiorentina,it Serie A,24-321,1999,14.9,5,4,5,0,0,5,10,50.0,5,18,9,9,21,26,40,0,Matches
2084,Filippo Ranocchia,it ITA,"MF,DF",Empoli,it Serie A,22-300,2001,5.3,16,11,7,9,0,7,16,43.8,9,9,1,8,3,19,14,0,Matches
2085,Grant Ranos,am ARM,"MF,FW",M'Gladbach,de Bundesliga,20-233,2003,0.5,1,0,0,0,1,0,0,,0,0,0,0,0,1,0,0,Matches
2086,Raphinha,br BRA,"FW,MF",Barcelona,es La Liga,27-086,1996,10.1,11,5,4,6,1,3,13,23.1,10,11,0,11,7,18,6,0,Matches
2087,Nicolai Rapp,de GER,DF,Werder Bremen,de Bundesliga,27-087,1996,0.8,3,2,2,1,0,2,2,100.0,0,2,0,2,2,5,8,0,Matches
2088,Elba Rashani,xk KVX,"MF,FW",Clermont Foot,fr Ligue 1,30-305,1993,7.4,16,12,1,10,5,6,13,46.2,7,13,1,12,3,19,5,0,Matches
2089,Marcus Rashford,eng ENG,FW,Manchester Utd,eng Premier League,26-130,1997,21.1,13,6,6,2,5,5,21,23.8,16,12,1,11,4,17,14,0,Matches
2090,Giacomo Raspadori,it ITA,"FW,MF",Napoli,it Serie A,24-020,2000,14.7,19,10,5,9,5,5,13,38.5,8,11,0,11,3,22,6,0,Matches
2091,Andrei Ratiu,ro ROU,DF,Rayo Vallecano,es La Liga,25-263,1998,3.6,9,2,4,4,1,7,12,58.3,5,2,0,2,0,9,5,0,Matches
2092,Raúl,es ESP,FW,Osasuna,es La Liga,23-127,2000,8.5,7,2,4,1,2,2,8,25.0,6,4,1,3,2,9,10,0,Matches
2093,David Raum,de GER,DF,RB Leipzig,de Bundesliga,25-322,1998,23.4,44,23,20,20,4,28,45,62.2,17,38,4,34,20,64,59,2,Matches
2094,Federico Ravaglia,it ITA,GK,Bologna,it Serie A,24-119,1999,3.0,0,0,0,0,0,0,0,,0,0,0,0,0,0,1,0,Matches
2095,David Raya,es ESP,GK,Arsenal,eng Premier League,28-176,1995,22.0,1,1,1,0,0,1,1,100.0,0,0,0,0,0,1,6,4,Matches
2096,Tim Ream,us USA,DF,Fulham,eng Premier League,36-156,1987,15.7,18,9,11,5,2,7,15,46.7,8,22,15,7,25,43,56,2,Matches
2097,Abderrahman Rebbach,dz ALG,"FW,MF",Alavés,es La Liga,25-211,1998,6.8,8,4,3,2,3,5,14,35.7,9,10,1,9,3,11,5,0,Matches
2098,Nathan Redmond,eng ENG,"FW,MF",Burnley,eng Premier League,30-003,1994,1.6,2,1,0,0,2,1,4,25.0,3,1,0,1,0,2,3,0,Matches
2099,Harrison Reed,eng ENG,MF,Fulham,eng Premier League,29-042,1995,12.0,21,12,6,12,3,10,25,40.0,15,18,9,9,9,30,20,0,Matches
2100,Sergio Reguilón,es ESP,DF,Manchester Utd,eng Premier League,27-084,1996,4.6,13,8,6,2,5,8,17,47.1,9,10,0,10,5,18,7,0,Matches
2101,Sergio Reguilón,es ESP,DF,Brentford,eng Premier League,27-084,1996,5.6,24,10,15,8,1,14,23,60.9,9,12,1,11,7,31,16,0,Matches
2102,Bobby Reid,jm JAM,FW,Fulham,eng Premier League,31-036,1993,12.9,16,11,3,11,2,3,10,30.0,7,17,2,15,3,19,12,0,Matches
2103,Tijjani Reijnders,nl NED,MF,Milan,it Serie A,25-224,1998,22.1,33,17,8,23,2,14,28,50.0,14,17,4,13,9,42,20,0,Matches
2104,Pepe Reina,es ESP,GK,Villarreal,es La Liga,41-191,1982,1.0,0,0,0,0,0,0,0,,0,0,0,0,0,0,0,0,Matches
2105,Reinier,br BRA,"MF,FW",Frosinone,it Serie A,22-050,2002,9.1,18,9,5,10,3,4,12,33.3,8,17,4,13,7,25,5,0,Matches
2106,Rocco Reitz,de GER,MF,M'Gladbach,de Bundesliga,21-285,2002,16.6,41,22,21,18,2,22,44,50.0,22,37,15,22,25,66,28,0,Matches
2107,Álex Remiro,es ESP,GK,Real Sociedad,es La Liga,28-351,1995,25.4,0,0,0,0,0,0,0,,0,0,0,0,0,0,16,2,Matches
2108,Guillaume Restes,fr FRA,GK,Toulouse,fr Ligue 1,18-364,2005,24.0,0,0,0,0,0,0,1,0.0,1,0,0,0,0,0,17,1,Matches
2109,Mateo Retegui,it ITA,FW,Genoa,it Serie A,24-315,1999,16.9,11,8,6,4,1,4,13,30.8,9,12,1,11,0,11,14,0,Matches
2110,Marco Reus,de GER,"MF,FW",Dortmund,de Bundesliga,34-283,1989,13.4,26,19,12,12,2,7,16,43.8,9,13,2,11,5,31,15,0,Matches
2111,Elvis Rexhbeçaj,de GER,MF,Augsburg,de Bundesliga,26-129,1997,21.1,29,19,13,13,3,18,35,51.4,17,30,6,24,19,48,19,0,Matches
2112,Gio Reyna,us USA,"MF,FW",Nott'ham Forest,eng Premier League,21-117,2002,0.5,1,1,1,0,0,0,0,,0,0,0,0,1,2,0,0,Matches
2113,Gio Reyna,us USA,"MF,FW",Dortmund,de Bundesliga,21-117,2002,3.1,9,6,3,4,2,2,5,40.0,3,5,1,4,2,11,5,0,Matches
2114,Chadi Riad,ma MAR,DF,Betis,es La Liga,20-266,2003,14.5,23,14,12,11,0,11,18,61.1,7,12,6,6,12,35,68,0,Matches
2115,Alexsandro Ribeiro,br BRA,DF,Lille,fr Ligue 1,24-213,1999,20.3,28,21,22,6,0,13,26,50.0,13,21,12,9,29,57,100,4,Matches
2116,Rodrigo Ribeiro,pt POR,FW,Nott'ham Forest,eng Premier League,18-316,2005,0.0,0,0,0,0,0,0,0,,0,0,0,0,1,1,0,0,Matches
2117,Samuele Ricci,it ITA,MF,Torino,it Serie A,22-201,2001,17.7,22,11,9,10,3,9,14,64.3,5,13,1,12,14,36,16,0,Matches
2118,Declan Rice,eng ENG,MF,Arsenal,eng Premier League,25-055,1999,25.6,54,34,27,21,6,24,41,58.5,17,30,9,21,35,89,42,0,Matches
2119,Chris Richards,us USA,"DF,MF",Crystal Palace,eng Premier League,23-347,2000,15.3,34,20,17,15,2,15,21,71.4,6,24,9,15,20,54,72,0,Matches
2120,Amir Richardson,ma MAR,MF,Reims,fr Ligue 1,22-045,2002,11.2,22,13,7,12,3,5,13,38.5,8,20,4,16,10,32,23,0,Matches
2121,Richarlison,br BRA,FW,Tottenham,eng Premier League,26-304,1997,15.0,16,11,4,8,4,2,9,22.2,7,31,6,25,8,24,21,0,Matches
2122,Marco Richter,de GER,"MF,FW",Mainz 05,de Bundesliga,26-106,1997,7.6,10,4,5,3,2,4,11,36.4,7,9,0,9,2,12,1,0,Matches
2123,Diego Rico,es ESP,DF,Getafe,es La Liga,31-015,1993,21.3,47,34,25,18,4,31,57,54.4,26,22,7,15,33,80,56,0,Matches
2124,Clemens Riedel,de GER,DF,Darmstadt 98,de Bundesliga,20-234,2003,6.2,19,11,13,5,1,12,20,60.0,8,8,2,6,11,30,24,0,Matches
2125,Fabian Rieder,ch SUI,MF,Rennes,fr Ligue 1,22-022,2002,2.8,6,4,1,3,2,3,6,50.0,3,1,1,0,2,8,1,0,Matches
2126,Jaïro Riedewald,nl NED,"MF,FW",Crystal Palace,eng Premier League,27-182,1996,2.0,4,1,0,2,2,1,2,50.0,1,0,0,0,2,6,0,0,Matches
2127,Manuel Riemann,de GER,GK,Bochum,de Bundesliga,35-182,1988,23.0,2,1,2,0,0,2,3,66.7,1,0,0,0,1,3,18,0,Matches
2128,Luis Rioja,es ESP,"FW,MF",Alavés,es La Liga,30-145,1993,23.6,25,18,9,12,4,13,31,41.9,18,24,0,24,14,39,24,0,Matches
2129,Rémy Riou,fr FRA,GK,Lyon,fr Ligue 1,36-216,1987,3.0,0,0,0,0,0,0,1,0.0,1,0,0,0,0,0,1,1,Matches
2130,Rodrigo Riquelme,es ESP,"DF,MF",Atlético Madrid,es La Liga,23-342,2000,11.2,17,10,11,2,4,11,33,33.3,22,14,0,14,6,23,13,0,Matches
2131,Mihailo Ristić,rs SRB,"DF,MF",Celta Vigo,es La Liga,28-130,1995,8.5,15,9,9,6,0,9,12,75.0,3,9,2,7,9,24,21,0,Matches
2132,Matt Ritchie,sct SCO,FW,Newcastle Utd,eng Premier League,34-181,1989,1.2,3,2,1,2,0,2,3,66.7,1,0,0,0,1,4,5,0,Matches
2133,Gorka Rivera Alonso,es ESP,DF,Getafe,es La Liga,19-221,2004,0.0,0,0,0,0,0,0,0,,0,0,0,0,0,0,0,0,Matches
2134,Sergi Roberto,es ESP,"MF,DF",Barcelona,es La Liga,32-031,1992,4.0,5,4,1,4,0,2,4,50.0,2,1,1,0,2,7,1,0,Matches
2135,Lucas Robertone,ar ARG,MF,Almería,es La Liga,26-357,1997,18.4,46,27,21,18,7,18,37,48.6,19,30,7,23,34,80,27,0,Matches
2136,Connor Roberts,wls WAL,DF,Burnley,eng Premier League,28-168,1995,9.1,12,5,6,4,2,8,17,47.1,9,8,6,2,4,16,25,2,Matches
2137,Andrew Robertson,sct SCO,DF,Liverpool,eng Premier League,29-364,1994,11.5,25,18,16,7,2,17,25,68.0,8,10,3,7,9,34,29,0,Matches
2138,Antonee Robinson,us USA,DF,Fulham,eng Premier League,26-214,1997,25.4,69,43,44,18,7,41,75,54.7,34,36,5,31,65,134,78,3,Matches
2139,Jack Robinson,eng ENG,DF,Sheffield Utd,eng Premier League,30-190,1993,24.8,33,22,24,9,0,21,31,67.7,10,39,26,13,26,59,111,2,Matches
2140,Marc Roca,es ESP,MF,Betis,es La Liga,27-104,1996,20.0,47,32,14,27,6,27,47,57.4,20,26,5,21,16,63,21,1,Matches
2141,Sebastian Rode,de GER,"MF,FW",Eint Frankfurt,de Bundesliga,33-150,1990,0.7,6,4,0,5,1,4,6,66.7,2,0,0,0,1,7,1,0,Matches
2142,Rodri,es ESP,MF,Manchester City,eng Premier League,27-261,1996,23.1,51,30,15,26,10,24,45,53.3,21,20,6,14,20,71,33,3,Matches
2143,Rodri,es ESP,"FW,MF",Betis,es La Liga,23-298,2000,9.6,14,8,5,7,2,8,19,42.1,11,9,0,9,7,21,2,0,Matches
2144,Óscar Rodríguez Arnaiz,es ESP,"MF,FW",Getafe,es La Liga,25-255,1998,4.0,9,5,1,6,2,2,5,40.0,3,3,0,3,4,13,3,0,Matches
2145,Dani Rodríguez,es ESP,MF,Mallorca,es La Liga,35-277,1988,22.1,40,21,18,16,6,20,41,48.8,21,28,5,23,12,52,16,0,Matches
2146,Guido Rodríguez,ar ARG,MF,Betis,es La Liga,29-332,1994,12.4,22,12,12,7,3,16,31,51.6,15,16,3,13,16,38,30,0,Matches
2147,Jay Rodriguez,eng ENG,FW,Burnley,eng Premier League,34-224,1989,8.1,12,8,5,4,3,6,10,60.0,4,10,1,9,1,13,8,0,Matches
2148,Kirian Rodríguez,es ESP,MF,Las Palmas,es La Liga,28-004,1996,24.7,36,24,17,14,5,17,51,33.3,34,27,3,24,17,53,18,1,Matches
2149,Miguel Rodríguez,es ESP,MF,Celta Vigo,es La Liga,20-315,2003,2.1,4,2,2,1,1,2,6,33.3,4,5,0,5,2,6,0,0,Matches
2150,Ricardo Rodríguez,ch SUI,DF,Torino,it Serie A,31-197,1992,22.9,35,21,14,20,1,22,36,61.1,14,14,6,8,20,55,53,1,Matches
2151,Rodrygo,br BRA,FW,Real Madrid,es La Liga,23-060,2001,20.7,10,9,2,6,2,2,14,14.3,12,10,0,10,7,17,3,0,Matches
2152,Mads Roerslev,dk DEN,DF,Brentford,eng Premier League,24-259,1999,14.7,30,20,23,6,1,19,40,47.5,21,10,2,8,14,44,52,0,Matches
2153,Rogério,br BRA,DF,Wolfsburg,de Bundesliga,26-056,1998,10.0,14,6,7,5,2,10,14,71.4,4,16,5,11,5,19,23,1,Matches
2154,Morgan Rogers,eng ENG,MF,Aston Villa,eng Premier League,21-227,2002,0.7,0,0,0,0,0,0,1,0.0,1,0,0,0,0,0,2,0,Matches
2155,Merlin Röhl,de GER,"MF,FW",Freiburg,de Bundesliga,21-248,2002,12.6,16,10,8,6,2,6,17,35.3,11,23,3,20,7,23,18,0,Matches
2156,Alessio Romagnoli,it ITA,DF,Lazio,it Serie A,29-057,1995,18.8,19,13,11,8,0,13,18,72.2,5,23,15,8,15,34,81,0,Matches
2157,Simone Romagnoli,it ITA,DF,Frosinone,it Serie A,34-029,1990,20.4,23,10,15,7,1,9,13,69.2,4,30,20,10,22,45,104,0,Matches
2158,Carlos Romero,es ESP,DF,Villarreal,es La Liga,22-132,2001,2.7,10,5,7,1,2,6,11,54.5,5,3,0,3,1,11,9,0,Matches
2159,Cristian Romero,ar ARG,DF,Tottenham,eng Premier League,25-317,1998,19.0,42,26,28,13,1,22,28,78.6,6,26,10,16,28,70,70,1,Matches
2160,Luka Romero,ar ARG,"FW,MF",Milan,it Serie A,19-112,2004,1.0,0,0,0,0,0,0,3,0.0,3,2,0,2,0,0,0,0,Matches
2161,Luka Romero,ar ARG,FW,Almería,es La Liga,19-112,2004,1.7,1,0,0,1,0,1,1,100.0,0,5,0,5,0,1,1,0,Matches
2162,Oriol Romeu,es ESP,MF,Barcelona,es La Liga,32-167,1991,8.4,26,17,14,11,1,11,18,61.1,7,9,2,7,9,35,15,0,Matches
2163,Valentin Rongier,fr FRA,MF,Marseille,fr Ligue 1,29-093,1994,9.5,23,12,9,12,2,14,26,53.8,12,16,4,12,15,38,18,0,Matches
2164,Frank Ronstadt,de GER,"DF,MF",Darmstadt 98,de Bundesliga,26-232,1997,0.8,1,0,0,1,0,0,1,0.0,1,1,0,1,1,2,3,0,Matches
2165,Marten de Roon,nl NED,"MF,DF",Atalanta,it Serie A,32-346,1991,24.0,69,37,33,27,9,31,74,41.9,43,26,7,19,31,100,43,0,Matches
2166,Unai Ropero,es ESP,MF,Alavés,es La Liga,22-110,2001,0.1,0,0,0,0,0,0,0,,0,0,0,0,0,0,0,0,Matches
2167,Vitor Roque,br BRA,FW,Barcelona,es La Liga,19-010,2005,2.2,2,1,1,0,1,0,1,0.0,1,3,0,3,0,2,4,0,Matches
2168,Pablo Rosario,nl NED,"DF,MF",Nice,fr Ligue 1,27-062,1997,14.6,25,16,11,11,3,15,24,62.5,9,20,10,10,14,39,26,0,Matches
2169,Valentin Rosier,fr FRA,"DF,MF",Nice,fr Ligue 1,27-203,1996,0.6,1,0,1,0,0,0,0,,0,1,0,1,2,3,5,0,Matches
2170,Joe Rothwell,eng ENG,MF,Bournemouth,eng Premier League,29-058,1995,4.3,7,2,4,2,1,2,8,25.0,6,4,2,2,3,10,2,0,Matches
2171,Anthony Rouault,fr FRA,DF,Stuttgart,de Bundesliga,22-285,2001,10.1,21,12,14,5,2,13,19,68.4,6,14,8,6,8,29,26,0,Matches
2172,Jérôme Roussillon,fr FRA,DF,Union Berlin,de Bundesliga,31-063,1993,7.6,15,8,6,6,3,7,11,63.6,4,12,4,8,5,20,24,0,Matches
2173,Nicolò Rovella,it ITA,MF,Lazio,it Serie A,22-096,2001,12.9,37,23,19,14,4,15,33,45.5,18,25,5,20,21,58,25,0,Matches
2174,Amir Rrahmani,xk KVX,DF,Napoli,it Serie A,30-014,1994,20.9,21,17,11,10,0,11,23,47.8,12,17,8,9,17,38,64,0,Matches
2175,Ruan,br BRA,DF,Sassuolo,it Serie A,24-276,1999,13.5,20,11,9,8,3,8,12,66.7,4,14,12,2,19,39,52,2,Matches
2176,Pelly Ruddock Mpanzu,cd COD,MF,Luton Town,eng Premier League,30-236,1993,9.2,8,1,2,6,0,4,8,50.0,4,10,4,6,6,14,14,1,Matches
2177,Antonio Rüdiger,de GER,DF,Real Madrid,es La Liga,31-006,1993,22.0,18,12,13,2,3,14,18,77.8,4,20,16,4,9,27,61,0,Matches
2178,Fabian Rüdlin,de GER,MF,Freiburg,de Bundesliga,27-056,1997,0.1,1,0,0,0,1,0,0,,0,0,0,0,0,1,0,0,Matches
2179,Daniele Rugani,it ITA,DF,Juventus,it Serie A,29-224,1994,10.3,8,6,4,3,1,2,3,66.7,1,9,3,6,7,15,32,0,Matches
2180,Matteo Ruggeri,it ITA,DF,Atalanta,it Serie A,21-242,2002,21.3,19,10,10,4,5,12,24,50.0,12,35,3,32,19,38,30,0,Matches
2181,Mário Rui,pt POR,DF,Napoli,it Serie A,32-287,1991,11.1,22,12,15,2,5,11,17,64.7,6,9,2,7,11,33,19,0,Matches
2182,Aitor Ruibal,es ESP,"DF,FW",Betis,es La Liga,27-353,1996,8.6,38,21,23,12,3,27,50,54.0,23,8,1,7,11,49,23,0,Matches
2183,Fabián Ruiz Peña,es ESP,MF,Paris S-G,fr Ligue 1,27-341,1996,10.7,30,19,16,11,3,20,35,57.1,15,7,2,5,9,39,18,1,Matches
2184,Sergio Ruiz,es ESP,MF,Granada,es La Liga,29-084,1994,18.4,54,31,27,23,4,23,52,44.2,29,14,5,9,18,72,31,1,Matches
2185,Julian Ryerson,no NOR,DF,Dortmund,de Bundesliga,26-113,1997,13.7,30,18,19,8,3,19,29,65.5,10,22,3,19,8,38,26,3,Matches
2186,Frederik Rønnow,dk DEN,GK,Union Berlin,de Bundesliga,31-218,1992,24.0,1,1,1,0,0,0,0,,0,0,0,0,1,2,16,1,Matches
2187,José Sá,pt POR,GK,Wolves,eng Premier League,31-052,1993,23.7,0,0,0,0,0,0,1,0.0,1,3,0,3,0,0,13,5,Matches
2188,Youssouf Sabaly,sn SEN,DF,Betis,es La Liga,31-004,1993,5.0,9,6,7,1,1,4,5,80.0,1,5,2,3,7,16,16,0,Matches
2189,Emmanuel Sabbi,us USA,"MF,FW",Le Havre,fr Ligue 1,26-076,1997,10.1,14,4,4,5,5,6,24,25.0,18,18,1,17,7,21,4,0,Matches
2190,Stefano Sabelli,it ITA,DF,Genoa,it Serie A,31-056,1993,21.7,37,17,19,15,3,11,35,31.4,24,24,4,20,19,56,27,0,Matches
2191,Marcel Sabitzer,at AUT,MF,Dortmund,de Bundesliga,29-358,1994,17.3,34,20,16,17,1,20,39,51.3,19,28,12,16,9,43,28,0,Matches
2192,Falaye Sacko,ml MLI,DF,Montpellier,fr Ligue 1,28-313,1995,15.1,28,16,13,10,5,21,32,65.6,11,19,7,12,23,51,37,0,Matches
2193,Umar Sadiq,ng NGA,FW,Real Sociedad,es La Liga,27-036,1997,11.0,13,9,2,7,4,3,7,42.9,4,8,0,8,0,13,10,0,Matches
2194,Alexis Saelemaekers,be BEL,"FW,MF",Bologna,it Serie A,24-256,1999,13.4,21,14,11,7,3,8,19,42.1,11,8,1,7,5,26,8,1,Matches
2195,Modibo Sagnan,fr FRA,DF,Montpellier,fr Ligue 1,24-330,1999,4.9,18,11,11,5,2,8,12,66.7,4,5,4,1,9,27,27,0,Matches
2196,Wesley Saïd,fr FRA,"FW,MF",Lens,fr Ligue 1,28-325,1995,7.9,5,1,1,2,2,2,7,28.6,5,3,0,3,4,9,1,0,Matches
2197,Théo Sainte-Luce,fr FRA,DF,Montpellier,fr Ligue 1,25-141,1998,3.8,17,7,10,6,1,11,19,57.9,8,9,4,5,3,20,15,0,Matches
2198,Bukayo Saka,eng ENG,FW,Arsenal,eng Premier League,22-186,2001,24.1,49,26,18,15,16,20,45,44.4,25,37,2,35,10,59,14,1,Matches
2199,Mamadou Sakho,fr FRA,DF,Montpellier,fr Ligue 1,34-025,1990,0.1,1,1,1,0,0,1,1,100.0,0,0,0,0,0,1,1,0,Matches
2200,Ibrahim Salah,ma MAR,"FW,MF",Rennes,fr Ligue 1,22-192,2001,5.0,15,7,5,6,4,11,18,61.1,7,4,0,4,8,23,5,0,Matches
2201,Mohamed Salah,eg EGY,FW,Liverpool,eng Premier League,31-268,1992,19.8,13,9,0,5,8,5,17,29.4,12,15,1,14,2,15,0,0,Matches
2202,Amine Salama,fr FRA,FW,Reims,fr Ligue 1,23-235,2000,3.5,0,0,0,0,0,0,0,,0,1,0,1,1,1,1,0,Matches
2203,Kike Salas,es ESP,DF,Sevilla,es La Liga,21-321,2002,9.1,24,15,13,8,3,14,23,60.9,9,11,4,7,15,39,53,0,Matches
2204,William Saliba,fr FRA,DF,Arsenal,eng Premier League,22-351,2001,27.0,26,16,15,10,1,13,15,86.7,2,20,10,10,21,47,55,2,Matches
2205,Mohammed Salisu,gh GHA,DF,Monaco,fr Ligue 1,24-327,1999,8.0,20,12,7,10,3,13,17,76.5,4,14,7,7,17,37,35,0,Matches
2206,Roland Sallai,hu HUN,"FW,MF",Freiburg,de Bundesliga,26-292,1997,14.4,12,5,5,4,3,5,15,33.3,10,18,1,17,4,16,20,0,Matches
2207,Yoann Salmier,gf GUF,DF,Le Havre,fr Ligue 1,31-109,1992,12.6,18,9,10,5,3,11,17,64.7,6,17,12,5,17,35,42,0,Matches
2208,Salvi,es ESP,MF,Rayo Vallecano,es La Liga,32-345,1991,0.3,0,0,0,0,0,0,4,0.0,4,0,0,0,1,1,0,0,Matches
2209,Lazar Samardzic,rs SRB,MF,Udinese,it Serie A,22-014,2002,17.5,23,11,12,8,3,8,22,36.4,14,15,5,10,8,31,18,0,Matches
2210,Diadie Samassékou,ml MLI,MF,Cádiz,es La Liga,28-058,1996,0.3,0,0,0,0,0,0,0,,0,0,0,0,2,2,1,0,Matches
2211,Diadie Samassékou,ml MLI,MF,Hoffenheim,de Bundesliga,28-058,1996,0.0,0,0,0,0,0,0,0,,0,0,0,0,1,1,0,0,Matches
2212,Mama Samba Baldé,gw GNB,"FW,MF",Lyon,fr Ligue 1,28-124,1995,4.6,5,3,0,1,4,2,6,33.3,4,0,0,0,1,6,1,1,Matches
2213,Brice Samba,fr FRA,GK,Lens,fr Ligue 1,29-319,1994,24.0,0,0,0,0,0,0,0,,0,0,0,0,0,0,6,2,Matches
2214,Albert Sambi Lokonga,be BEL,MF,Luton Town,eng Premier League,24-139,1999,9.7,19,12,10,7,2,13,18,72.2,5,19,11,8,6,25,11,0,Matches
2215,Junior Sambia,fr FRA,"DF,MF",Salernitana,it Serie A,27-184,1996,5.0,5,2,5,0,0,3,6,50.0,3,3,1,2,5,10,14,0,Matches
2216,Fede San Emeterio,es ESP,MF,Cádiz,es La Liga,26-359,1997,1.7,3,2,2,1,0,1,4,25.0,3,3,2,1,2,5,1,0,Matches
2217,Antonio Sanabria,py PAR,"FW,MF",Torino,it Serie A,28-005,1996,18.3,14,12,4,7,3,4,8,50.0,4,6,1,5,5,19,10,0,Matches
2218,Marciano Sanca,gw GNB,"FW,MF",Almería,es La Liga,20-006,2004,0.5,0,0,0,0,0,0,0,,0,0,0,0,0,0,0,0,Matches
2219,Oihan Sancet,es ESP,MF,Athletic Club,es La Liga,23-319,2000,18.2,17,11,3,8,6,6,16,37.5,10,5,1,4,7,24,4,0,Matches
2220,Renato Sanches,pt POR,MF,Roma,it Serie A,26-204,1997,1.4,2,1,1,1,0,2,3,66.7,1,1,0,1,0,2,1,0,Matches
2221,Ricard Sánchez ,es ESP,DF,Granada,es La Liga,24-016,2000,20.9,24,16,10,8,6,11,21,52.4,10,23,3,20,11,35,53,0,Matches
2222,Alexis Sánchez,cl CHI,FW,Inter,it Serie A,35-081,1988,4.3,3,3,0,2,1,0,0,,0,2,0,2,1,4,2,0,Matches
2223,Antonio Sánchez,es ESP,MF,Mallorca,es La Liga,27-068,1997,12.7,21,9,10,9,2,10,28,35.7,18,20,5,15,9,30,10,0,Matches
2224,Davinson Sánchez,co COL,DF,Tottenham,eng Premier League,27-271,1996,0.9,0,0,0,0,0,0,0,,0,3,2,1,1,1,2,0,Matches
2225,Juanlu Sánchez,es ESP,DF,Sevilla,es La Liga,20-207,2003,11.3,49,31,28,17,4,30,48,62.5,18,23,6,17,10,59,33,0,Matches
2226,Manu Sánchez,es ESP,DF,Celta Vigo,es La Liga,23-198,2000,17.0,46,23,19,22,5,26,46,56.5,20,20,2,18,15,61,57,0,Matches
2227,Robert Sánchez,es ESP,GK,Chelsea,eng Premier League,26-112,1997,15.9,0,0,0,0,0,0,0,,0,0,0,0,0,0,11,3,Matches
2228,Jadon Sancho,eng ENG,"FW,MF",Manchester Utd,eng Premier League,23-350,2000,0.9,1,0,1,0,0,1,3,33.3,2,1,0,1,1,2,0,0,Matches
2229,Jadon Sancho,eng ENG,"FW,MF",Dortmund,de Bundesliga,23-350,2000,4.7,2,1,0,1,1,0,0,,0,5,0,5,1,3,4,0,Matches
2230,Alex Sandro,br BRA,DF,Juventus,it Serie A,33-043,1991,7.0,11,6,5,6,0,4,5,80.0,1,12,6,6,9,20,19,0,Matches
2231,Ibou Sané,sn SEN,"MF,FW",Metz,fr Ligue 1,18-347,2005,1.2,5,3,2,1,2,2,2,100.0,0,3,0,3,1,6,2,0,Matches
2232,Leroy Sané,de GER,FW,Bayern Munich,de Bundesliga,28-058,1996,21.4,15,8,6,6,3,4,18,22.2,14,10,0,10,5,20,3,0,Matches
2233,Sadibou Sané,sn SEN,DF,Metz,fr Ligue 1,19-273,2004,3.7,10,5,9,0,1,3,3,100.0,0,3,3,0,3,13,17,0,Matches
2234,Arouna Sangante,sn SEN,DF,Le Havre,fr Ligue 1,21-332,2002,20.9,38,25,20,16,2,15,28,53.6,13,28,17,11,48,86,67,0,Matches
2235,Ibrahim Sangaré,ci CIV,MF,Nott'ham Forest,eng Premier League,26-098,1997,9.1,32,16,17,11,4,9,21,42.9,12,20,6,14,10,42,19,0,Matches
2236,Morgan Sanson,fr FRA,MF,Nice,fr Ligue 1,29-204,1994,18.1,22,15,9,7,6,11,28,39.3,17,28,5,23,19,41,11,0,Matches
2237,Nicola Sansone,it ITA,"FW,MF",Lecce,it Serie A,32-181,1991,6.4,10,6,6,2,2,4,13,30.8,9,6,1,5,3,13,3,2,Matches
2238,Baptiste Santamaria,fr FRA,MF,Rennes,fr Ligue 1,29-000,1995,15.1,39,27,16,17,6,22,33,66.7,11,7,2,5,22,61,23,0,Matches
2239,Jesús Santiago,es ESP,MF,Getafe,es La Liga,19-289,2004,1.8,3,1,0,1,2,1,3,33.3,2,0,0,0,0,3,0,0,Matches
2240,Andrey Santos,br BRA,MF,Nott'ham Forest,eng Premier League,19-311,2004,0.1,0,0,0,0,0,0,0,,0,1,0,1,0,0,0,0,Matches
2241,Andrey Santos,br BRA,MF,Strasbourg,fr Ligue 1,19-311,2004,0.4,1,1,1,0,0,0,0,,0,0,0,0,0,1,0,0,Matches
2242,Tiago santos,pt POR,DF,Lille,fr Ligue 1,21-230,2002,17.4,42,31,20,12,10,21,40,52.5,19,18,3,15,11,53,22,0,Matches
2243,Riccardo Saponara,it ITA,"FW,MF",Hellas Verona,it Serie A,32-079,1991,3.8,3,1,2,0,1,1,7,14.3,6,4,0,4,0,3,2,0,Matches
2244,Pablo Sarabia,es ESP,"MF,FW",Wolves,eng Premier League,31-303,1992,13.1,14,9,7,6,1,9,24,37.5,15,13,1,12,8,22,8,0,Matches
2245,Amin Sarr,se SWE,"FW,MF",Lyon,fr Ligue 1,22-364,2001,1.1,1,0,0,1,0,0,0,,0,1,0,1,0,1,1,0,Matches
2246,Amin Sarr,se SWE,"FW,MF",Wolfsburg,de Bundesliga,22-364,2001,1.5,0,0,0,0,0,0,0,,0,1,1,0,0,0,0,0,Matches
2247,Bouna Sarr,sn SEN,DF,Bayern Munich,de Bundesliga,32-038,1992,1.2,2,0,1,1,0,2,2,100.0,0,3,0,3,0,2,1,0,Matches
2248,Ismaila Sarr,sn SEN,"FW,MF",Marseille,fr Ligue 1,26-013,1998,12.1,13,8,2,9,2,5,14,35.7,9,16,4,12,10,23,8,0,Matches
2249,Mamadou Sarr,fr FRA,DF,Lyon,fr Ligue 1,18-193,2005,0.1,0,0,0,0,0,0,0,,0,0,0,0,0,0,0,0,Matches
2250,Martin Satriano,uy URU,FW,Brest,fr Ligue 1,23-018,2001,12.0,13,10,3,8,2,6,13,46.2,7,11,4,7,5,18,17,0,Matches
2251,Téji Savanier,fr FRA,MF,Montpellier,fr Ligue 1,32-078,1991,24.2,30,17,12,13,5,11,52,21.2,41,27,7,20,27,57,24,1,Matches
2252,Stefan Savić,me MNE,DF,Atlético Madrid,es La Liga,33-061,1991,13.1,18,13,9,6,3,8,20,40.0,12,26,14,12,23,41,45,1,Matches
2253,Sávio,br BRA,"MF,FW",Girona,es La Liga,19-334,2004,24.2,31,21,10,17,4,10,18,55.6,8,26,0,26,13,44,10,1,Matches
2254,Saba Sazonov,ge GEO,DF,Torino,it Serie A,22-037,2002,3.9,8,6,3,5,0,2,2,100.0,0,8,5,3,2,10,19,0,Matches
2255,Joe Scally,us USA,DF,M'Gladbach,de Bundesliga,21-069,2002,18.7,33,23,17,14,2,19,31,61.3,12,22,8,14,16,49,60,2,Matches
2256,Giorgio Scalvini,it ITA,DF,Atalanta,it Serie A,20-089,2003,22.2,47,30,26,16,5,18,32,56.3,14,41,15,26,46,93,57,0,Matches
2257,Gianluca Scamacca,it ITA,FW,Atalanta,it Serie A,25-068,1999,10.2,8,5,2,2,4,4,9,44.4,5,4,0,4,2,10,7,0,Matches
2258,Dane Scarlett,eng ENG,FW,Tottenham,eng Premier League,19-351,2004,0.0,0,0,0,0,0,0,0,,0,0,0,0,0,0,0,0,Matches
2259,Kevin Schade,de GER,"FW,MF",Brentford,eng Premier League,22-103,2001,2.9,2,1,1,1,0,0,3,0.0,3,0,0,0,1,3,3,0,Matches
2260,András Schäfer,hu HUN,MF,Union Berlin,de Bundesliga,24-331,1999,8.2,14,8,1,10,3,5,10,50.0,5,14,1,13,9,23,11,0,Matches
2261,Fabian Schär,ch SUI,DF,Newcastle Utd,eng Premier League,32-080,1991,26.1,29,20,21,7,1,13,29,44.8,16,40,31,9,25,54,101,0,Matches
2262,Patrik Schick,cz CZE,FW,Leverkusen,de Bundesliga,28-045,1996,6.2,3,2,0,0,3,0,1,0.0,1,1,0,1,1,4,5,0,Matches
2263,Stefan Schimmer,de GER,"MF,FW",Heidenheim,de Bundesliga,29-316,1994,1.4,1,1,0,1,0,0,3,0.0,3,1,0,1,1,2,5,0,Matches
2264,Xaver Schlager,at AUT,MF,RB Leipzig,de Bundesliga,26-163,1997,20.6,58,36,28,25,5,15,41,36.6,26,30,7,23,16,74,15,0,Matches
2265,Keven Schlotterbeck,de GER,DF,Bochum,de Bundesliga,26-316,1997,14.3,26,15,17,8,1,14,18,77.8,4,23,16,7,19,45,57,1,Matches
2266,Nico Schlotterbeck,de GER,DF,Dortmund,de Bundesliga,24-099,1999,22.5,43,31,21,19,3,20,36,55.6,16,34,17,17,27,70,80,3,Matches
2267,Jeffrey Schlupp,gh GHA,"FW,MF",Crystal Palace,eng Premier League,31-077,1992,13.6,35,21,14,15,6,9,17,52.9,8,12,2,10,7,42,23,0,Matches
2268,Romano Schmid,at AUT,MF,Werder Bremen,de Bundesliga,24-042,2000,20.0,22,13,5,13,4,11,30,36.7,19,26,2,24,9,31,11,2,Matches
2269,Kenneth Schmidt,de GER,DF,Freiburg,de Bundesliga,21-280,2002,0.8,2,2,2,0,0,2,4,50.0,2,1,0,1,1,3,2,0,Matches
2270,Niklas Schmidt,de GER,MF,Toulouse,fr Ligue 1,26-008,1998,11.9,31,20,11,17,3,13,27,48.1,14,13,7,6,4,35,12,0,Matches
2271,Benno Schmitz,de GER,DF,Köln,de Bundesliga,29-113,1994,9.7,19,10,15,4,0,12,28,42.9,16,15,4,11,6,25,22,0,Matches
2272,Fabian Schnellhardt,de GER,MF,Darmstadt 98,de Bundesliga,30-057,1994,2.4,4,1,2,1,1,1,3,33.3,2,1,0,1,4,8,5,0,Matches
2273,Jan Schöppner,de GER,MF,Heidenheim,de Bundesliga,24-271,1999,13.3,26,13,12,13,1,11,22,50.0,11,17,4,13,16,42,29,0,Matches
2274,Marcel Schuhen,de GER,GK,Darmstadt 98,de Bundesliga,31-056,1993,23.0,0,0,0,0,0,0,1,0.0,1,0,0,0,0,0,9,4,Matches
2275,Perr Schuurs,nl NED,DF,Torino,it Serie A,24-104,1999,8.6,20,12,11,8,1,3,9,33.3,6,10,2,8,9,29,23,0,Matches
2276,Marvin Schwäbe,de GER,GK,Köln,de Bundesliga,28-319,1995,24.0,1,0,1,0,0,1,1,100.0,0,0,0,0,0,1,10,1,Matches
2277,Alexander Schwolow,de GER,GK,Union Berlin,de Bundesliga,31-281,1992,1.0,0,0,0,0,0,0,0,,0,0,0,0,0,0,2,0,Matches
2278,Alex Scott,eng ENG,MF,Bournemouth,eng Premier League,20-201,2003,7.0,15,9,5,7,3,7,15,46.7,8,10,4,6,11,26,12,1,Matches
2279,Simone Scuffet,it ITA,GK,Cagliari,it Serie A,27-283,1996,20.0,1,0,1,0,0,1,1,100.0,0,1,0,1,1,2,7,0,Matches
2280,Jérémy Sebas,mq MTQ,FW,Strasbourg,fr Ligue 1,20-330,2003,0.7,2,0,1,1,0,1,2,50.0,1,0,0,0,0,2,0,0,Matches
2281,Manuel Sebastián,es ESP,MF,Sevilla,es La Liga,19-226,2004,0.2,1,0,1,0,0,1,1,100.0,0,2,0,2,0,1,0,0,Matches
2282,Demba Seck,sn SEN,MF,Torino,it Serie A,23-028,2001,4.7,5,3,1,4,0,3,4,75.0,1,1,0,1,1,6,0,0,Matches
2283,Demba Seck,sn SEN,FW,Frosinone,it Serie A,23-028,2001,2.2,5,3,1,2,2,3,3,100.0,0,3,0,3,0,5,1,0,Matches
2284,Aleksandar Sedlar,rs SRB,DF,Alavés,es La Liga,32-087,1991,10.5,14,10,10,4,0,10,16,62.5,6,8,4,4,13,27,43,0,Matches
2285,Alidu Seidu,gh GHA,DF,Rennes,fr Ligue 1,23-279,2000,3.0,8,4,7,1,0,6,8,75.0,2,5,3,2,6,14,6,0,Matches
2286,Alidu Seidu,gh GHA,DF,Clermont Foot,fr Ligue 1,23-279,2000,12.6,32,24,17,15,0,24,31,77.4,7,15,7,8,25,57,37,0,Matches
2287,Nicolas Seiwald,at AUT,MF,RB Leipzig,de Bundesliga,22-310,2001,4.8,18,11,11,6,1,6,12,50.0,6,9,1,8,4,22,7,0,Matches
2288,Davie Selke,de GER,FW,Köln,de Bundesliga,29-049,1995,12.0,4,2,1,3,0,0,2,0.0,2,4,2,2,0,4,16,0,Matches
2289,Matz Sels,be BEL,GK,Nott'ham Forest,eng Premier League,32-012,1992,5.0,0,0,0,0,0,0,0,,0,0,0,0,0,0,3,0,Matches
2290,Matz Sels,be BEL,GK,Strasbourg,fr Ligue 1,32-012,1992,19.0,0,0,0,0,0,0,0,,0,2,0,2,0,0,13,1,Matches
2291,Nélson Semedo,pt POR,"DF,MF",Wolves,eng Premier League,30-114,1993,25.1,61,40,38,15,8,29,49,59.2,20,31,8,23,27,88,64,0,Matches
2292,Vivaldo Semedo,pt POR,FW,Udinese,it Serie A,19-041,2005,0.1,0,0,0,0,0,0,0,,0,0,0,0,0,0,0,0,Matches
2293,Antoine Semenyo,gh GHA,FW,Bournemouth,eng Premier League,24-062,2000,13.8,15,11,6,4,5,7,19,36.8,12,24,1,23,5,20,10,0,Matches
2294,Marvin Senaya,tg TOG,DF,Strasbourg,fr Ligue 1,23-041,2001,16.8,56,39,31,21,4,33,51,64.7,18,30,10,20,34,90,47,0,Matches
2295,Marcos Senesi,ar ARG,DF,Bournemouth,eng Premier League,26-304,1997,18.4,39,19,21,16,2,15,40,37.5,25,36,17,19,23,62,84,1,Matches
2296,Stefano Sensi,it ITA,MF,Inter,it Serie A,28-217,1995,0.3,0,0,0,0,0,0,1,0.0,1,1,0,1,1,1,0,0,Matches
2297,Suat Serdar,de GER,MF,Hellas Verona,it Serie A,26-333,1997,9.3,29,23,13,13,3,12,23,52.2,11,12,3,9,14,43,15,1,Matches
2298,Benjamin Šeško,si SVN,FW,RB Leipzig,de Bundesliga,20-283,2003,10.2,10,4,2,7,1,1,6,16.7,5,18,1,17,3,13,15,0,Matches
2299,Kevin Sessa,de GER,"MF,FW",Heidenheim,de Bundesliga,23-247,2000,4.9,6,2,4,1,1,3,8,37.5,5,8,1,7,2,8,8,0,Matches
2300,Aaron Seydel,de GER,"FW,MF",Darmstadt 98,de Bundesliga,28-031,1996,3.1,2,1,0,2,0,0,0,,0,5,2,3,0,2,5,0,Matches
2301,Stephan El Shaarawy,it ITA,"FW,DF",Roma,it Serie A,31-134,1992,13.6,14,7,10,4,0,3,10,30.0,7,9,4,5,8,22,11,1,Matches
2302,Luke Shaw,eng ENG,DF,Manchester Utd,eng Premier League,28-241,1995,10.7,11,8,7,3,1,9,15,60.0,6,18,11,7,6,17,39,0,Matches
2303,Eldor Shomurodov,uz UZB,"FW,MF",Cagliari,it Serie A,28-254,1995,3.6,2,1,0,1,1,2,5,40.0,3,1,0,1,1,3,0,0,Matches
2304,Steven Shpendi,al ALB,"FW,MF",Empoli,it Serie A,20-295,2003,4.4,0,0,0,0,0,0,4,0.0,4,2,1,1,1,1,0,0,Matches
2305,Sofiane Sidi Ali,fr FRA,MF,Marseille,fr Ligue 1,28-239,1995,0.1,2,0,0,2,0,1,1,100.0,0,0,0,0,1,3,0,0,Matches
2306,Vincent Sierro,ch SUI,MF,Toulouse,fr Ligue 1,28-153,1995,17.4,28,13,11,13,4,19,54,35.2,35,25,9,16,23,51,27,0,Matches
2307,Tim Siersleben,de GER,DF,Heidenheim,de Bundesliga,24-000,2000,9.6,26,10,20,6,0,8,20,40.0,12,16,10,6,20,46,29,1,Matches
2308,Kiliann Sildillia,fr FRA,DF,Freiburg,de Bundesliga,21-298,2002,16.9,33,14,22,5,6,22,35,62.9,13,27,12,15,16,49,49,0,Matches
2309,André Silva,pt POR,FW,Real Sociedad,es La Liga,28-124,1995,5.5,2,2,0,0,2,0,3,0.0,3,3,0,3,1,3,2,0,Matches
2310,Bernardo Silva,pt POR,"MF,FW",Manchester City,eng Premier League,29-212,1994,20.1,36,18,10,20,6,18,39,46.2,21,18,3,15,10,46,10,1,Matches
2311,Caio Henrique Oliveira Silva,br BRA,DF,Monaco,fr Ligue 1,26-222,1997,5.9,12,6,3,6,3,6,9,66.7,3,7,1,6,3,15,8,0,Matches
2312,Fábio Silva,pt POR,FW,Wolves,eng Premier League,21-234,2002,2.9,7,4,3,4,0,2,3,66.7,1,1,0,1,2,9,0,0,Matches
2313,Rui Silva,pt POR,GK,Betis,es La Liga,30-031,1994,17.5,0,0,0,0,0,0,3,0.0,3,0,0,0,1,1,7,1,Matches
2314,Thiago Silva,br BRA,DF,Chelsea,eng Premier League,39-169,1984,22.0,25,11,21,3,1,17,29,58.6,12,26,20,6,21,46,108,3,Matches
2315,Marco Silvestri,it ITA,GK,Udinese,it Serie A,33-007,1991,17.0,0,0,0,0,0,0,3,0.0,3,1,0,1,0,0,5,3,Matches
2316,Mohamed Simakan,fr FRA,DF,RB Leipzig,de Bundesliga,23-311,2000,19.6,42,24,23,18,1,26,35,74.3,9,31,14,17,23,65,59,0,Matches
2317,Giovanni Simeone,ar ARG,FW,Napoli,it Serie A,28-248,1995,7.0,9,2,1,3,5,3,12,25.0,9,8,0,8,1,10,5,0,Matches
2318,Giuliano Simeone,ar ARG,FW,Alavés,es La Liga,21-082,2002,0.8,1,1,0,1,0,1,2,50.0,1,0,0,0,0,1,0,0,Matches
2319,Jan-Carlo Simic,rs SRB,DF,Milan,it Serie A,18-312,2005,1.6,1,1,1,0,0,0,0,,0,5,4,1,0,1,3,0,Matches
2320,Moses Simon,ng NGA,"FW,MF",Nantes,fr Ligue 1,28-241,1995,17.9,7,5,2,5,0,2,7,28.6,5,8,1,7,3,10,5,1,Matches
2321,Unai Simón,es ESP,GK,Athletic Club,es La Liga,26-272,1997,27.0,2,1,1,1,0,2,3,66.7,1,0,0,0,1,3,9,0,Matches
2322,Xavi Simons,nl NED,MF,RB Leipzig,de Bundesliga,20-323,2003,20.8,22,10,9,9,4,14,27,51.9,13,17,0,17,9,31,3,0,Matches
2323,Wilfried Singo,ci CIV,DF,Monaco,fr Ligue 1,23-075,2000,17.0,22,17,12,10,0,10,18,55.6,8,19,9,10,38,60,57,1,Matches
2324,Luis Sinisterra,co COL,"FW,MF",Bournemouth,eng Premier League,24-266,1999,6.5,21,10,9,8,4,8,14,57.1,6,17,0,17,8,29,3,0,Matches
2325,Daley Sinkgraven,nl NED,DF,Las Palmas,es La Liga,28-249,1995,2.9,7,4,3,4,0,1,6,16.7,5,2,1,1,3,10,7,0,Matches
2326,Jailson Siqueira,br BRA,"MF,DF",Celta Vigo,es La Liga,28-184,1995,3.4,11,5,9,2,0,6,8,75.0,2,5,1,4,8,19,16,0,Matches
2327,Ayanda Sishuba,be BEL,"MF,FW",Lens,fr Ligue 1,19-036,2005,0.5,2,0,0,1,1,1,2,50.0,1,1,0,1,0,2,0,0,Matches
2328,Ibrahima Sissoko,ml MLI,MF,Strasbourg,fr Ligue 1,26-134,1997,12.6,31,21,10,16,5,18,25,72.0,7,15,7,8,13,44,21,0,Matches
2329,Moussa Sissoko,fr FRA,MF,Nantes,fr Ligue 1,34-206,1989,10.3,15,8,7,6,2,9,14,64.3,5,0,0,0,7,22,23,0,Matches
2330,Antonio Sivera,es ESP,GK,Alavés,es La Liga,27-211,1996,27.0,0,0,0,0,0,0,1,0.0,1,0,0,0,0,0,14,0,Matches
2331,Tim Skarke,de GER,"FW,MF",Darmstadt 98,de Bundesliga,27-184,1996,18.7,20,13,10,7,3,9,23,39.1,14,17,1,16,5,25,15,0,Matches
2332,Ellyes Skhiri,tn TUN,MF,Eint Frankfurt,de Bundesliga,28-304,1995,16.7,30,16,11,16,3,13,26,50.0,13,22,2,20,27,57,36,1,Matches
2333,Oliver Skipp,eng ENG,"MF,FW",Tottenham,eng Premier League,23-175,2000,6.5,15,10,7,5,3,8,14,57.1,6,11,1,10,1,16,7,0,Matches
2334,Leo Skiri Østigård,no NOR,DF,Napoli,it Serie A,24-102,1999,13.0,19,10,11,7,1,4,8,50.0,4,13,8,5,13,32,44,0,Matches
2335,Łukasz Skorupski,pl POL,GK,Bologna,it Serie A,32-309,1991,24.0,2,2,2,0,0,2,3,66.7,1,0,0,0,0,2,8,3,Matches
2336,Robert Skov,dk DEN,"DF,FW",Hoffenheim,de Bundesliga,27-294,1996,12.2,20,12,13,6,1,14,31,45.2,17,15,3,12,8,28,18,1,Matches
2337,Milan Škriniar,sk SVK,DF,Paris S-G,fr Ligue 1,29-027,1995,13.4,20,15,14,6,0,13,19,68.4,6,16,9,7,11,31,33,0,Matches
2338,Naatan Skyttä,fi FIN,"MF,FW",Toulouse,fr Ligue 1,21-307,2002,1.1,4,4,2,1,1,1,1,100.0,0,0,0,0,0,4,0,0,Matches
2339,Chris Smalling,eng ENG,DF,Roma,it Serie A,34-108,1989,4.0,1,1,1,0,0,1,4,25.0,3,6,5,1,5,6,6,0,Matches
2340,Adam Smith,eng ENG,DF,Bournemouth,eng Premier League,32-315,1991,14.2,19,10,12,1,6,10,21,47.6,11,16,8,8,13,32,34,0,Matches
2341,Emile Smith Rowe,eng ENG,MF,Arsenal,eng Premier League,23-225,2000,2.6,3,0,2,1,0,2,4,50.0,2,3,1,2,1,4,0,0,Matches
2342,Hrvoje Smolčić,hr CRO,DF,Eint Frankfurt,de Bundesliga,23-205,2000,3.8,7,3,7,0,0,4,5,80.0,1,3,1,2,6,13,23,1,Matches
2343,Cédric Soares,pt POR,DF,Arsenal,eng Premier League,32-191,1991,0.7,0,0,0,0,0,0,0,,0,0,0,0,0,0,0,0,Matches
2344,Danilo Soares,br BRA,DF,Bochum,de Bundesliga,32-132,1991,3.9,10,6,5,3,2,5,8,62.5,3,6,0,6,7,17,11,0,Matches
2345,Eduard Sobol,ua UKR,DF,Strasbourg,fr Ligue 1,28-324,1995,0.3,0,0,0,0,0,0,0,,0,0,0,0,0,0,1,0,Matches
2346,Rubén Sobrino,es ESP,"MF,FW",Cádiz,es La Liga,31-282,1992,11.3,35,19,11,17,7,14,33,42.4,19,14,1,13,10,45,12,0,Matches
2347,Andrea Sodero,it ITA,MF,Empoli,it Serie A,19-215,2004,0.1,0,0,0,0,0,0,0,,0,0,0,0,0,0,0,0,Matches
2348,Emran Soglo,eng ENG,"MF,DF",Marseille,fr Ligue 1,18-242,2005,1.2,2,1,0,2,0,1,3,33.3,2,6,0,6,1,3,3,0,Matches
2349,Alex Sola,es ESP,"FW,MF",Alavés,es La Liga,24-274,1999,11.5,23,13,8,8,7,10,17,58.8,7,17,2,15,9,32,13,0,Matches
2350,Alex Sola,es ESP,"DF,MF",Real Sociedad,es La Liga,24-274,1999,0.3,0,0,0,0,0,0,0,,0,0,0,0,1,1,2,0,Matches
2351,Dominic Solanke,eng ENG,FW,Bournemouth,eng Premier League,26-177,1997,25.7,17,9,1,9,7,7,16,43.8,9,19,4,15,3,20,33,0,Matches
2352,Ola Solbakken,no NOR,FW,Roma,it Serie A,25-184,1998,0.3,0,0,0,0,0,0,0,,0,0,0,0,0,0,0,0,Matches
2353,Carlos Soler,es ESP,"DF,MF",Paris S-G,fr Ligue 1,27-067,1997,7.7,9,7,4,2,3,4,17,23.5,13,7,3,4,2,11,9,1,Matches
2354,Jhon Solis,co COL,MF,Girona,es La Liga,19-158,2004,2.7,6,4,2,3,1,2,7,28.6,5,7,3,4,3,9,5,0,Matches
2355,Manor Solomon,il ISR,FW,Tottenham,eng Premier League,24-229,1999,2.2,3,3,1,1,1,1,2,50.0,1,4,0,4,3,6,2,0,Matches
2356,Yann Sommer,ch SUI,GK,Inter,it Serie A,35-083,1988,26.0,2,1,2,0,0,2,2,100.0,0,1,0,1,0,2,5,1,Matches
2357,Brandon Soppy,fr FRA,DF,Torino,it Serie A,22-017,2002,2.0,2,2,1,1,0,2,6,33.3,4,2,0,2,0,2,3,1,Matches
2358,David Soria,es ESP,GK,Getafe,es La Liga,30-340,1993,27.0,0,0,0,0,0,0,2,0.0,2,0,0,0,0,0,14,6,Matches
2359,Alberto Soro,es ESP,MF,Granada,es La Liga,25-000,1999,0.1,0,0,0,0,0,0,0,,0,0,0,0,0,0,0,0,Matches
2360,Alessandro Sorrentino,it ITA,GK,Monza,it Serie A,21-341,2002,4.1,0,0,0,0,0,0,0,,0,0,0,0,0,0,0,0,Matches
2361,Borna Sosa,hr CRO,"FW,DF",Stuttgart,de Bundesliga,26-048,1998,0.5,0,0,0,0,0,0,1,0.0,1,0,0,0,0,0,0,0,Matches
2362,Hugo Sotelo,es ESP,MF,Celta Vigo,es La Liga,20-081,2003,3.6,8,7,1,5,2,2,7,28.6,5,5,1,4,1,9,2,0,Matches
2363,Florian Sotoca,fr FRA,"MF,FW",Lens,fr Ligue 1,33-136,1990,19.0,18,10,6,11,1,9,22,40.9,13,21,2,19,11,29,24,0,Matches
2364,Riccardo Sottil,it ITA,FW,Fiorentina,it Serie A,24-280,1999,8.4,8,5,4,1,3,2,7,28.6,5,9,0,9,2,10,1,0,Matches
2365,Tomáš Souček,cz CZE,MF,West Ham,eng Premier League,29-011,1995,22.8,34,24,13,19,2,14,33,42.4,19,38,21,17,29,63,70,0,Matches
2366,Matìas Soulé,ar ARG,"FW,MF",Frosinone,it Serie A,20-329,2003,24.2,29,18,9,12,8,11,27,40.7,16,27,2,25,14,43,7,0,Matches
2367,Boubakary Soumaré,fr FRA,MF,Sevilla,es La Liga,25-011,1999,15.4,24,19,13,11,0,7,13,53.8,6,13,3,10,15,39,14,1,Matches
2368,Issa Soumaré,sn SEN,"FW,MF",Le Havre,fr Ligue 1,23-151,2000,2.6,2,0,2,0,0,0,4,0.0,4,0,0,0,0,2,2,0,Matches
2369,Vinicius Souza,br BRA,MF,Sheffield Utd,eng Premier League,24-266,1999,23.6,102,61,50,39,13,32,57,56.1,25,41,12,29,28,130,58,1,Matches
2370,Djibril Sow,ch SUI,MF,Sevilla,es La Liga,27-032,1997,15.5,28,21,15,8,5,9,24,37.5,15,19,3,16,15,43,8,1,Matches
2371,Saidou Sow,gn GUI,DF,Strasbourg,fr Ligue 1,21-249,2002,2.5,10,5,7,3,0,5,6,83.3,1,2,1,1,5,15,14,1,Matches
2372,Çağlar Söyüncü,tr TUR,DF,Atlético Madrid,es La Liga,27-291,1996,1.3,1,1,1,0,0,0,0,,0,1,0,1,1,2,7,0,Matches
2373,Djed Spence,eng ENG,"DF,MF",Genoa,it Serie A,23-213,2000,3.0,4,3,4,0,0,1,1,100.0,0,7,1,6,3,7,5,0,Matches
2374,Stijn Spierings,nl NED,MF,Toulouse,fr Ligue 1,27-363,1996,12.0,40,31,21,14,5,25,40,62.5,15,15,3,12,23,63,23,0,Matches
2375,Stijn Spierings,nl NED,MF,Lens,fr Ligue 1,27-363,1996,1.3,1,0,0,1,0,1,1,100.0,0,2,1,1,2,3,1,0,Matches
2376,Leonardo Spinazzola,it ITA,DF,Roma,it Serie A,30-350,1993,12.2,11,4,7,4,0,6,14,42.9,8,6,2,4,3,14,12,0,Matches
2377,Marco Sportiello,it ITA,GK,Milan,it Serie A,31-304,1992,2.0,0,0,0,0,0,0,0,,0,0,0,0,0,0,1,0,Matches
2378,Anton Stach,de GER,MF,Hoffenheim,de Bundesliga,25-115,1998,18.4,59,34,35,18,6,27,50,54.0,23,25,6,19,55,114,46,0,Matches
2379,Anton Stach,de GER,MF,Mainz 05,de Bundesliga,25-115,1998,1.9,3,0,2,0,1,2,4,50.0,2,5,0,5,2,5,5,0,Matches
2380,Jens Stage,dk DEN,MF,Werder Bremen,de Bundesliga,27-122,1996,22.6,46,21,18,20,8,15,37,40.5,22,42,23,19,20,66,49,0,Matches
2381,Benjamin Stambouli,fr FRA,MF,Reims,fr Ligue 1,33-209,1990,1.7,5,4,1,3,1,3,6,50.0,3,3,1,2,2,7,3,0,Matches
2382,Josip Stanišić,hr CRO,DF,Leverkusen,de Bundesliga,23-342,2000,9.8,29,15,15,11,3,15,25,60.0,10,9,2,7,5,34,18,0,Matches
2383,Carl Starfelt,se SWE,DF,Celta Vigo,es La Liga,28-282,1995,18.9,25,22,20,4,1,12,20,60.0,8,26,22,4,22,47,128,2,Matches
2384,Niklas Stark,de GER,DF,Werder Bremen,de Bundesliga,28-330,1995,10.8,25,15,12,11,2,11,15,73.3,4,13,7,6,17,42,58,1,Matches
2385,Jason Steele,eng ENG,GK,Brighton,eng Premier League,33-204,1990,15.0,0,0,0,0,0,0,3,0.0,3,0,0,0,0,0,7,1,Matches
2386,Pascal Stenzel,de GER,DF,Stuttgart,de Bundesliga,27-355,1996,10.9,16,8,6,8,2,10,28,35.7,18,17,7,10,13,29,25,0,Matches
2387,Leonidas Stergiou,ch SUI,DF,Stuttgart,de Bundesliga,22-006,2002,1.6,5,3,2,3,0,3,3,100.0,0,1,0,1,2,7,2,0,Matches
2388,Raheem Sterling,eng ENG,"FW,MF",Chelsea,eng Premier League,29-092,1994,19.4,20,10,7,7,6,11,22,50.0,11,10,0,10,12,32,8,0,Matches
2389,Trivante Stewart,jm JAM,"FW,MF",Salernitana,it Serie A,23-353,2000,1.1,0,0,0,0,0,0,0,,0,1,0,1,0,0,0,0,Matches
2390,Angelo Stiller,de GER,MF,Hoffenheim,de Bundesliga,22-340,2001,0.9,0,0,0,0,0,0,1,0.0,1,2,0,2,0,0,3,0,Matches
2391,Angelo Stiller,de GER,MF,Stuttgart,de Bundesliga,22-340,2001,21.9,43,27,12,26,5,18,31,58.1,13,29,9,20,25,68,16,2,Matches
2392,Kevin Stöger,at AUT,MF,Bochum,de Bundesliga,30-195,1993,19.8,37,24,17,15,5,18,49,36.7,31,30,4,26,15,52,11,0,Matches
2393,Filip Stojilković,ch SUI,"FW,MF",Darmstadt 98,de Bundesliga,24-065,2000,1.7,1,1,0,0,1,0,0,,0,0,0,0,0,1,1,0,Matches
2394,John Stones,eng ENG,"DF,MF",Manchester City,eng Premier League,29-286,1994,9.6,2,1,1,0,1,0,3,0.0,3,9,5,4,8,10,17,0,Matches
2395,Thomas Strakosha,al ALB,GK,Brentford,eng Premier League,28-356,1995,1.5,0,0,0,0,0,0,0,,0,0,0,0,0,0,0,0,Matches
2396,Jørgen Strand Larsen,no NOR,FW,Celta Vigo,es La Liga,24-032,2000,23.8,13,8,1,9,3,5,27,18.5,22,11,1,10,3,16,13,0,Matches
2397,Gabriel Strefezza,br BRA,FW,Lecce,it Serie A,26-326,1997,12.4,24,17,8,7,9,14,20,70.0,6,17,0,17,7,31,11,0,Matches
2398,Kevin Strootman,nl NED,MF,Genoa,it Serie A,34-025,1990,10.1,30,15,13,14,3,12,26,46.2,14,15,4,11,3,33,18,0,Matches
2399,Cristhian Stuani,uy URU,FW,Girona,es La Liga,37-149,1986,7.9,12,10,3,6,3,4,7,57.1,3,9,2,7,5,17,12,0,Matches
2400,Álex Suárez,es ESP,DF,Las Palmas,es La Liga,30-357,1993,19.8,40,25,22,14,4,24,27,88.9,3,23,11,12,13,53,69,0,Matches
2401,Damián Suárez,uy URU,DF,Getafe,es La Liga,35-317,1988,14.4,36,21,16,16,4,26,45,57.8,19,13,3,10,10,46,31,0,Matches
2402,Denis Suárez,es ESP,"MF,FW",Villarreal,es La Liga,30-063,1994,1.5,0,0,0,0,0,0,2,0.0,2,2,2,0,0,0,4,0,Matches
2403,Gabriel Suazo,cl CHI,DF,Toulouse,fr Ligue 1,26-213,1997,17.9,46,20,29,14,3,24,56,42.9,32,28,3,25,17,63,26,0,Matches
2404,Isaac Success,ng NGA,FW,Udinese,it Serie A,28-062,1996,8.4,5,4,0,4,1,1,2,50.0,1,4,1,3,1,6,10,0,Matches
2405,Niklas Süle,de GER,DF,Dortmund,de Bundesliga,28-188,1995,12.4,13,8,9,3,1,7,10,70.0,3,17,9,8,17,30,43,2,Matches
2406,Ibrahim Sulemana,gh GHA,MF,Cagliari,it Serie A,20-292,2003,9.5,21,9,6,12,3,10,18,55.6,8,20,3,17,5,26,11,0,Matches
2407,Tomáš Suslov,sk SVK,"MF,FW",Hellas Verona,it Serie A,21-276,2002,16.8,26,17,8,12,6,9,29,31.0,20,11,0,11,5,31,5,0,Matches
2408,Suso,es ESP,"MF,FW",Sevilla,es La Liga,30-111,1993,13.2,19,13,12,7,0,5,14,35.7,9,8,0,8,3,22,3,0,Matches
2409,Mattias Svanberg,se SWE,MF,Wolfsburg,de Bundesliga,25-064,1999,16.5,34,16,8,16,10,12,35,34.3,23,25,5,20,19,53,24,0,Matches
2410,Mile Svilar,rs SRB,GK,Roma,it Serie A,24-195,1999,4.0,0,0,0,0,0,0,0,,0,0,0,0,0,0,1,1,Matches
2411,Williot Swedberg,se SWE,"MF,FW",Celta Vigo,es La Liga,20-037,2004,1.5,5,3,2,3,0,3,5,60.0,2,2,0,2,0,5,3,0,Matches
2412,Karol Świderski,pl POL,"FW,MF",Hellas Verona,it Serie A,27-046,1997,2.2,2,2,0,0,2,1,2,50.0,1,4,3,1,1,3,5,0,Matches
2413,Abakar Sylla,ci CIV,DF,Strasbourg,fr Ligue 1,21-075,2002,13.6,48,21,27,16,5,25,31,80.6,6,29,7,22,21,69,49,2,Matches
2414,Dembo Sylla,gn GUI,DF,Lorient,fr Ligue 1,21-120,2002,0.5,1,1,0,1,0,0,0,,0,0,0,0,1,2,2,0,Matches
2415,Issiaga Sylla,gn GUI,"DF,FW",Montpellier,fr Ligue 1,30-068,1994,13.0,23,14,16,5,2,12,28,42.9,16,15,4,11,17,40,35,0,Matches
2416,Mamadou Sylla,sn SEN,"FW,MF",Alavés,es La Liga,29-355,1994,0.2,0,0,0,0,0,0,0,,0,1,1,0,0,0,1,0,Matches
2417,Attila Szalai,hu HUN,DF,Hoffenheim,de Bundesliga,26-049,1998,3.2,3,1,3,0,0,1,4,25.0,3,6,2,4,1,4,7,0,Matches
2418,Attila Szalai,hu HUN,DF,Freiburg,de Bundesliga,26-049,1998,1.0,1,1,1,0,0,1,2,50.0,1,5,2,3,1,2,5,1,Matches
2419,Wojciech Szczęsny,pl POL,GK,Juventus,it Serie A,33-326,1990,25.0,0,0,0,0,0,0,0,,0,0,0,0,0,0,11,1,Matches
2420,Dominik Szoboszlai,hu HUN,MF,Liverpool,eng Premier League,23-136,2000,18.6,29,18,10,11,8,15,44,34.1,29,32,2,30,11,40,16,1,Matches
2421,Przemysław Szymiński,pl POL,MF,Frosinone,it Serie A,29-259,1994,0.1,0,0,0,0,0,0,0,,0,1,1,0,0,0,0,0,Matches
2422,Alexander Sørloth,no NOR,FW,Villarreal,es La Liga,28-095,1995,17.6,4,3,0,1,3,2,5,40.0,3,8,3,5,0,4,20,0,Matches
2423,Musa Al-Taamari,jo JOR,FW,Montpellier,fr Ligue 1,26-273,1997,17.6,17,14,9,3,5,8,19,42.1,11,16,1,15,4,21,5,0,Matches
2424,Nicolás Tagliafico,ar ARG,DF,Lyon,fr Ligue 1,31-191,1992,18.2,45,27,21,19,5,19,37,51.4,18,17,6,11,12,57,32,0,Matches
2425,Jonathan Tah,de GER,DF,Leverkusen,de Bundesliga,28-027,1996,20.5,17,8,9,6,2,4,15,26.7,11,22,17,5,11,28,75,1,Matches
2426,Montassar Talbi,tn TUN,DF,Lorient,fr Ligue 1,25-288,1998,20.5,33,20,20,11,2,16,25,64.0,9,34,21,13,28,61,97,0,Matches
2427,Adrien Tameze,cm CMR,"DF,MF",Torino,it Serie A,30-034,1994,16.6,22,15,5,15,2,8,22,36.4,14,16,7,9,39,61,21,1,Matches
2428,Renato Tapia,pe PER,"MF,DF",Celta Vigo,es La Liga,28-225,1995,13.6,36,25,17,16,3,11,22,50.0,11,30,7,23,17,53,45,0,Matches
2429,Edmond Tapsoba,bf BFA,DF,Leverkusen,de Bundesliga,25-036,1999,15.2,18,14,8,9,1,7,11,63.6,4,12,6,6,11,29,42,3,Matches
2430,Matt Targett,eng ENG,DF,Newcastle Utd,eng Premier League,28-173,1995,0.9,2,0,1,1,0,1,1,100.0,0,1,0,1,0,2,2,0,Matches
2431,Oussama Targhalline,ma MAR,MF,Le Havre,fr Ligue 1,21-294,2002,4.2,6,3,6,0,0,4,7,57.1,3,6,2,4,6,12,6,0,Matches
2432,James Tarkowski,eng ENG,DF,Everton,eng Premier League,31-111,1992,27.0,40,26,28,12,0,19,32,59.4,13,60,41,19,48,88,131,2,Matches
2433,César Tárrega,es ESP,DF,Valencia,es La Liga,22-012,2002,0.1,0,0,0,0,0,0,0,,0,0,0,0,0,0,2,0,Matches
2434,Nuno Tavares,pt POR,DF,Nott'ham Forest,eng Premier League,24-043,2000,5.1,10,7,8,1,1,7,8,87.5,1,6,0,6,1,11,19,0,Matches
2435,Marcus Tavernier,eng ENG,FW,Bournemouth,eng Premier League,24-353,1999,19.0,46,28,24,18,4,22,40,55.0,18,23,2,21,4,50,20,0,Matches
2436,Elayis Tavsan,nl NED,"MF,FW",Hellas Verona,it Serie A,22-314,2001,0.4,0,0,0,0,0,0,1,0.0,1,0,0,0,0,0,1,0,Matches
2437,Charlie Taylor,eng ENG,DF,Burnley,eng Premier League,30-173,1993,18.1,28,15,14,12,2,13,28,46.4,15,21,8,13,15,43,60,0,Matches
2438,Loum Tchaouna,fr FRA,"FW,MF",Salernitana,it Serie A,20-183,2003,12.8,11,3,2,8,1,6,13,46.2,7,15,1,14,2,13,12,1,Matches
2439,Jackson Tchatchoua,be BEL,DF,Hellas Verona,it Serie A,22-177,2001,14.4,29,21,21,7,1,18,36,50.0,18,15,6,9,13,42,42,1,Matches
2440,Enzo Tchato,cm CMR,"DF,MF",Montpellier,fr Ligue 1,21-107,2002,6.5,12,8,10,1,1,5,14,35.7,9,5,3,2,7,19,15,0,Matches
2441,Aurélien Tchouaméni,fr FRA,"MF,DF",Real Madrid,es La Liga,24-042,2000,17.0,28,17,17,10,1,6,12,50.0,6,16,9,7,22,50,37,1,Matches
2442,Mathys Tel,fr FRA,"FW,MF",Bayern Munich,de Bundesliga,18-317,2005,5.6,6,1,1,2,3,2,3,66.7,1,8,0,8,3,9,4,0,Matches
2443,Nathan Tella,ng NGA,"DF,MF",Leverkusen,de Bundesliga,24-248,1999,4.1,5,3,3,2,0,3,6,50.0,3,9,0,9,2,7,5,0,Matches
2444,Nahuel Tenaglia,ar ARG,DF,Alavés,es La Liga,28-017,1996,6.1,15,10,12,2,1,8,13,61.5,5,9,5,4,7,22,35,0,Matches
2445,Arnau Tenas,es ESP,GK,Paris S-G,fr Ligue 1,22-284,2001,2.9,0,0,0,0,0,0,0,,0,0,0,0,0,0,0,0,Matches
2446,Marc-André ter Stegen,de GER,GK,Barcelona,es La Liga,31-314,1992,18.0,0,0,0,0,0,0,0,,0,0,0,0,0,0,3,1,Matches
2447,Filippo Terracciano,it ITA,DF,Hellas Verona,it Serie A,21-030,2003,14.4,30,19,23,6,1,17,31,54.8,14,24,6,18,20,50,17,0,Matches
2448,Filippo Terracciano,it ITA,FW,Milan,it Serie A,21-030,2003,0.0,0,0,0,0,0,0,1,0.0,1,1,0,1,0,0,0,0,Matches
2449,Pietro Terracciano,it ITA,GK,Fiorentina,it Serie A,34-001,1990,25.0,1,1,1,0,0,1,2,50.0,1,1,0,1,0,1,5,0,Matches
2450,Ramón Terrats,es ESP,MF,Villarreal,es La Liga,23-143,2000,6.9,9,6,2,6,1,1,8,12.5,7,6,0,6,3,12,4,0,Matches
2451,Martin Terrier,fr FRA,"FW,MF",Rennes,fr Ligue 1,27-005,1997,11.0,7,4,2,3,2,2,9,22.2,7,13,2,11,6,13,10,0,Matches
2452,Kenny Tete,nl NED,DF,Fulham,eng Premier League,28-152,1995,7.5,21,14,14,5,2,9,17,52.9,8,7,3,4,16,37,31,0,Matches
2453,Benjamin Tetteh,gh GHA,"FW,MF",Metz,fr Ligue 1,26-243,1997,3.1,6,6,1,5,0,4,7,57.1,3,0,0,0,0,6,1,0,Matches
2454,Teddy Teuma,mt MLT,MF,Reims,fr Ligue 1,30-161,1993,19.0,44,32,15,19,10,20,48,41.7,28,28,4,24,17,61,5,0,Matches
2455,Florian Thauvin,fr FRA,FW,Udinese,it Serie A,31-043,1993,15.0,6,3,2,3,1,4,12,33.3,8,7,0,7,3,9,1,0,Matches
2456,Arthur Theate,be BEL,DF,Rennes,fr Ligue 1,23-289,2000,19.4,18,10,12,5,1,15,25,60.0,10,32,20,12,25,43,74,1,Matches
2457,Norman Theuerkauf,de GER,"MF,DF",Heidenheim,de Bundesliga,37-045,1987,9.3,16,8,9,5,2,9,15,60.0,6,11,4,7,11,27,13,0,Matches
2458,Malick Thiaw,de GER,DF,Milan,it Serie A,22-214,2001,12.4,18,14,7,9,2,7,14,50.0,7,18,8,10,9,27,36,0,Matches
2459,Jan Thielmann,de GER,"FW,MF",Köln,de Bundesliga,21-288,2002,11.9,20,13,8,8,4,7,16,43.8,9,27,3,24,4,24,15,0,Matches
2460,Denis Thomalla,de GER,"MF,FW",Heidenheim,de Bundesliga,31-206,1992,3.9,6,4,2,4,0,5,9,55.6,4,2,1,1,3,9,8,0,Matches
2461,Luke Thomas,eng ENG,DF,Sheffield Utd,eng Premier League,22-273,2001,10.2,20,9,13,6,1,8,14,57.1,6,23,5,18,10,30,27,0,Matches
2462,Adrien Thomasson,fr FRA,MF,Lens,fr Ligue 1,30-090,1993,11.9,21,11,4,13,4,8,29,27.6,21,11,0,11,8,29,9,0,Matches
2463,Morten Thorsby,no NOR,MF,Genoa,it Serie A,27-309,1996,7.6,11,7,5,5,1,5,9,55.6,4,13,2,11,4,15,9,0,Matches
2464,Kristian Thorstvedt,no NOR,MF,Sassuolo,it Serie A,24-362,1999,18.8,23,10,4,16,3,11,25,44.0,14,17,7,10,16,39,30,0,Matches
2465,Khéphren Thuram,fr FRA,MF,Nice,fr Ligue 1,22-349,2001,15.9,24,16,5,16,3,12,27,44.4,15,18,8,10,11,35,23,0,Matches
2466,Marcus Thuram,fr FRA,FW,Inter,it Serie A,26-216,1997,20.6,15,10,7,6,2,1,7,14.3,6,18,3,15,4,19,12,0,Matches
2467,Cheikh Tidiane Sabaly,sn SEN,"FW,MF",Metz,fr Ligue 1,25-005,1999,13.6,37,18,21,11,5,16,39,41.0,23,19,2,17,8,45,13,0,Matches
2468,Youri Tielemans,be BEL,"MF,FW",Aston Villa,eng Premier League,26-307,1997,11.1,23,11,8,13,2,9,24,37.5,15,15,1,14,9,32,4,0,Matches
2469,Kieran Tierney,sct SCO,DF,Real Sociedad,es La Liga,26-278,1997,9.7,30,19,14,15,1,16,23,69.6,7,17,6,11,10,40,28,0,Matches
2470,Phillip Tietz,de GER,FW,Augsburg,de Bundesliga,26-244,1997,18.0,15,9,7,7,1,4,9,44.4,5,15,3,12,5,20,30,0,Matches
2471,Steffen Tigges,de GER,FW,Köln,de Bundesliga,25-222,1998,4.7,3,2,2,0,1,0,0,,0,2,1,1,1,4,4,0,Matches
2472,Antonio Tikvić,hr CRO,DF,Udinese,it Serie A,19-323,2004,0.0,0,0,0,0,0,0,0,,0,0,0,0,0,0,0,0,Matches
2473,Jurriën Timber,nl NED,DF,Arsenal,eng Premier League,22-266,2001,0.5,1,1,0,1,0,0,0,,0,0,0,0,0,1,1,0,Matches
2474,Jean-Clair Todibo,fr FRA,DF,Nice,fr Ligue 1,24-070,1999,20.6,42,21,22,14,6,24,41,58.5,17,26,10,16,26,68,74,0,Matches
2475,Harry Toffolo,eng ENG,DF,Nott'ham Forest,eng Premier League,28-203,1995,12.7,20,9,16,4,0,11,18,61.1,7,28,11,17,11,31,37,0,Matches
2476,Umut Tohumcu,de GER,MF,Hoffenheim,de Bundesliga,19-211,2004,6.6,8,6,6,2,0,5,13,38.5,8,10,1,9,1,9,11,0,Matches
2477,Corentin Tolisso,fr FRA,MF,Lyon,fr Ligue 1,29-219,1994,12.5,25,16,8,9,8,11,25,44.0,14,18,5,13,8,33,12,0,Matches
2478,Jeremy Toljan,de GER,DF,Sassuolo,it Serie A,29-214,1994,17.9,10,7,6,3,1,7,13,53.8,6,16,4,12,10,20,41,1,Matches
2479,Rafael Tolói,it ITA,DF,Atalanta,it Serie A,33-151,1990,5.0,6,2,3,1,2,3,6,50.0,3,2,1,1,7,13,17,0,Matches
2480,Raúl de Tomás,es ESP,FW,Rayo Vallecano,es La Liga,29-144,1994,11.9,8,4,4,2,2,2,5,40.0,3,3,0,3,1,9,7,0,Matches
2481,Tiago Tomás,pt POR,"FW,MF",Wolfsburg,de Bundesliga,21-267,2002,7.9,4,1,3,0,1,1,6,16.7,5,11,0,11,2,6,6,0,Matches
2482,Takehiro Tomiyasu,jp JPN,DF,Arsenal,eng Premier League,25-125,1998,7.0,11,5,9,2,0,6,9,66.7,3,3,1,2,10,21,19,0,Matches
2483,James Tomkins,eng ENG,DF,Crystal Palace,eng Premier League,34-346,1989,0.1,0,0,0,0,0,0,0,,0,0,0,0,1,1,0,0,Matches
2484,Fikayo Tomori,eng ENG,DF,Milan,it Serie A,26-081,1997,15.5,30,19,22,6,2,15,24,62.5,9,23,16,7,19,49,50,1,Matches
2485,Sandro Tonali,it ITA,MF,Newcastle Utd,eng Premier League,23-306,2000,4.9,7,7,4,2,1,3,9,33.3,6,3,0,3,2,9,4,0,Matches
2486,Ivan Toney,eng ENG,FW,Brentford,eng Premier League,27-359,1996,8.0,9,2,0,4,5,3,9,33.3,6,3,0,3,7,16,7,0,Matches
2487,Pablo Torre,es ESP,"MF,FW",Girona,es La Liga,20-341,2003,5.6,4,1,0,4,0,3,9,33.3,6,8,2,6,4,8,5,1,Matches
2488,Raúl Torrente,es ESP,DF,Granada,es La Liga,22-180,2001,11.5,24,15,17,7,0,16,20,80.0,4,13,8,5,9,33,53,2,Matches
2489,Ferrán Torres,es ESP,FW,Barcelona,es La Liga,24-009,2000,10.4,7,5,1,4,2,5,14,35.7,9,5,0,5,3,10,4,0,Matches
2490,Óliver Torres,es ESP,MF,Sevilla,es La Liga,29-120,1994,13.6,28,15,15,9,4,18,49,36.7,31,30,3,27,4,32,4,0,Matches
2491,Pau Torres,es ESP,DF,Aston Villa,eng Premier League,27-053,1997,18.4,19,11,12,6,1,9,20,45.0,11,15,6,9,8,27,48,0,Matches
2492,Lucas Torró,es ESP,MF,Osasuna,es La Liga,29-234,1994,14.5,17,12,8,5,4,6,19,31.6,13,4,1,3,25,42,30,0,Matches
2493,Fabio Torsiello,it ITA,"DF,FW",Darmstadt 98,de Bundesliga,19-036,2005,1.0,1,0,1,0,0,1,6,16.7,5,1,0,1,0,1,1,0,Matches
2494,Ahmed Touba,dz ALG,DF,Lecce,it Serie A,25-363,1998,3.1,6,4,3,3,0,3,4,75.0,1,4,3,1,7,13,20,0,Matches
2495,Abdoulaye Touré,gn GUI,MF,Le Havre,fr Ligue 1,30-006,1994,17.9,32,22,15,15,2,20,42,47.6,22,23,5,18,20,52,19,0,Matches
2496,Souleymane Touré,fr FRA,DF,Lorient,fr Ligue 1,20-347,2003,17.0,23,11,15,8,0,7,11,63.6,4,29,18,11,31,54,84,1,Matches
2497,Lucas Tousart,fr FRA,MF,Union Berlin,de Bundesliga,26-315,1997,10.7,18,11,9,8,1,9,19,47.4,10,18,5,13,12,30,17,0,Matches
2498,Andros Townsend,eng ENG,"MF,FW",Luton Town,eng Premier League,32-237,1991,9.3,15,11,7,1,7,11,21,52.4,10,11,0,11,4,19,4,0,Matches
2499,James Trafford,eng ENG,GK,Burnley,eng Premier League,21-151,2002,27.0,2,1,2,0,0,2,2,100.0,0,0,0,0,1,3,17,1,Matches
2500,Adama Traoré,es ESP,"FW,MF",Fulham,eng Premier League,28-044,1996,1.0,1,0,0,1,0,1,2,50.0,1,0,0,0,0,1,1,0,Matches
2501,Bertrand Traoré,bf BFA,"DF,FW",Aston Villa,eng Premier League,28-185,1995,0.1,1,1,1,0,0,0,0,,0,0,0,0,0,1,1,0,Matches
2502,Bertrand Traoré,bf BFA,MF,Villarreal,es La Liga,28-185,1995,0.9,0,0,0,0,0,0,0,,0,0,0,0,0,0,1,0,Matches
2503,Boubacar Traoré,ml MLI,"MF,FW",Wolves,eng Premier League,22-202,2001,4.5,13,10,7,5,1,3,9,33.3,6,7,1,6,3,16,4,0,Matches
2504,Chaka Traorè,ci CIV,FW,Milan,it Serie A,19-077,2004,0.2,2,1,2,0,0,1,2,50.0,1,1,1,0,0,2,0,0,Matches
2505,Hamari Traoré,ml MLI,DF,Real Sociedad,es La Liga,32-042,1992,18.1,31,16,18,11,2,17,32,53.1,15,15,4,11,15,46,39,1,Matches
2506,Ismaël Traoré,ci CIV,DF,Metz,fr Ligue 1,37-204,1986,17.7,16,10,10,6,0,6,16,37.5,10,27,17,10,26,42,66,0,Matches
2507,Omar Traoré,de GER,DF,Heidenheim,de Bundesliga,26-034,1998,19.3,43,25,24,14,5,23,41,56.1,18,19,5,14,23,66,32,1,Matches
2508,Kevin Trapp,de GER,GK,Eint Frankfurt,de Bundesliga,33-245,1990,22.0,0,0,0,0,0,0,0,,0,0,0,0,1,1,9,1,Matches
2509,Óscar Trejo,ar ARG,"FW,MF",Rayo Vallecano,es La Liga,35-318,1988,11.2,21,12,8,7,6,11,17,64.7,6,12,1,11,4,25,8,0,Matches
2510,Mike Trésor,be BEL,"FW,MF",Burnley,eng Premier League,24-286,1999,4.5,10,6,9,1,0,8,17,47.1,9,5,0,5,1,11,1,0,Matches
2511,Manu Trigueros,es ESP,MF,Villarreal,es La Liga,32-144,1991,2.3,6,4,5,1,0,3,6,50.0,3,1,1,0,2,8,6,0,Matches
2512,Christopher Trimmel,at AUT,DF,Union Berlin,de Bundesliga,37-014,1987,12.5,17,12,7,9,1,9,24,37.5,15,10,2,8,10,27,35,0,Matches
2513,Kieran Trippier,eng ENG,DF,Newcastle Utd,eng Premier League,33-172,1990,24.0,57,27,30,16,11,37,76,48.7,39,38,8,30,23,80,55,3,Matches
2514,Leandro Trossard,be BEL,"FW,MF",Arsenal,eng Premier League,29-096,1994,10.5,16,11,6,6,4,5,12,41.7,7,18,0,18,6,22,4,0,Matches
2515,Adrien Truffert,fr FRA,DF,Rennes,fr Ligue 1,22-110,2001,17.6,31,17,19,6,6,21,33,63.6,12,19,4,15,10,41,34,0,Matches
2516,Auston Trusty,us USA,DF,Sheffield Utd,eng Premier League,25-210,1998,18.7,36,23,23,10,3,14,31,45.2,17,22,14,8,18,54,105,3,Matches
2517,Kostas Tsimikas,gr GRE,DF,Liverpool,eng Premier League,27-302,1996,7.5,19,13,9,6,4,9,15,60.0,6,9,1,8,6,25,10,0,Matches
2518,Viktor Tsyhankov,ua UKR,"MF,FW",Girona,es La Liga,26-115,1997,17.2,22,15,5,12,5,12,23,52.2,11,12,0,12,9,31,18,0,Matches
2519,Stefano Turati,it ITA,GK,Frosinone,it Serie A,22-186,2001,24.0,0,0,0,0,0,0,0,,0,0,0,0,0,0,6,3,Matches
2520,Matt Turner,us USA,GK,Nott'ham Forest,eng Premier League,29-259,1994,17.0,0,0,0,0,0,0,0,,0,0,0,0,0,0,8,4,Matches
2521,Beñat Turrientes,es ESP,MF,Real Sociedad,es La Liga,22-038,2002,10.9,22,12,4,14,4,9,21,42.9,12,9,3,6,3,25,11,0,Matches
2522,Tuta,br BRA,DF,Eint Frankfurt,de Bundesliga,24-249,1999,20.9,42,25,25,12,5,28,43,65.1,15,21,7,14,26,68,79,0,Matches
2523,Destiny Udogie,it ITA,DF,Tottenham,eng Premier League,21-102,2002,20.6,61,29,38,14,9,24,41,58.5,17,22,6,16,28,89,67,4,Matches
2524,Matthieu Udol,fr FRA,DF,Metz,fr Ligue 1,27-355,1996,22.0,40,26,26,9,5,26,38,68.4,12,47,12,35,34,74,81,0,Matches
2525,Manuel Ugarte Ribeiro,uy URU,MF,Paris S-G,fr Ligue 1,22-333,2001,15.8,67,42,22,33,12,32,67,47.8,35,19,4,15,31,98,17,1,Matches
2526,Lesley Ugochukwu,fr FRA,MF,Chelsea,eng Premier League,19-349,2004,3.0,12,9,3,8,1,3,8,37.5,5,5,2,3,1,13,3,0,Matches
2527,Lukas Ullrich,de GER,DF,M'Gladbach,de Bundesliga,19-359,2004,0.2,1,0,1,0,0,1,3,33.3,2,0,0,0,0,1,1,0,Matches
2528,Sven Ulreich,de GER,GK,Bayern Munich,de Bundesliga,35-219,1988,8.0,1,0,1,0,0,1,1,100.0,0,0,0,0,0,1,3,2,Matches
2529,Samuel Umtiti,fr FRA,DF,Lille,fr Ligue 1,30-116,1993,2.1,1,1,0,1,0,1,4,25.0,3,0,0,0,2,3,4,0,Matches
2530,Enes Ünal,tr TUR,"MF,FW",Bournemouth,eng Premier League,26-304,1997,0.3,0,0,0,0,0,0,1,0.0,1,0,0,0,0,0,0,0,Matches
2531,Enes Ünal,tr TUR,"FW,MF",Getafe,es La Liga,26-304,1997,1.6,0,0,0,0,0,0,0,,0,1,0,1,0,0,2,0,Matches
2532,Deniz Undav,de GER,"FW,MF",Stuttgart,de Bundesliga,27-234,1996,14.9,19,8,5,6,8,3,10,30.0,7,10,0,10,5,24,4,0,Matches
2533,Dayot Upamecano,fr FRA,DF,Bayern Munich,de Bundesliga,25-134,1998,15.4,28,17,16,10,2,14,26,53.8,12,12,4,8,15,43,40,2,Matches
2534,Kacper Urbanski,pl POL,"FW,MF",Bologna,it Serie A,19-184,2004,5.7,11,7,2,9,0,6,11,54.5,5,9,0,9,3,14,9,0,Matches
2535,Mark Uth,de GER,"MF,FW",Köln,de Bundesliga,32-198,1991,2.9,6,3,2,3,1,2,9,22.2,7,5,0,5,1,7,1,0,Matches
2536,Myrto Uzuni,al ALB,"FW,MF",Granada,es La Liga,28-283,1995,21.5,12,10,4,6,2,5,25,20.0,20,17,2,15,3,15,6,0,Matches
2537,Josha Vagnoman,de GER,DF,Stuttgart,de Bundesliga,23-089,2000,10.7,22,14,11,10,1,13,26,50.0,13,10,5,5,2,24,14,1,Matches
2538,Óscar Valentín,es ESP,MF,Rayo Vallecano,es La Liga,29-202,1994,23.0,75,45,29,42,4,34,71,47.9,37,44,8,36,25,100,42,1,Matches
2539,Emanuele Valeri,it ITA,DF,Frosinone,it Serie A,25-093,1998,4.2,8,7,5,2,1,6,7,85.7,1,3,2,1,4,12,12,0,Matches
2540,Martin Valjent,sk SVK,DF,Mallorca,es La Liga,28-089,1995,20.5,27,17,17,8,2,15,25,60.0,10,24,11,13,24,51,89,1,Matches
2541,Jesús Vallejo,es ESP,DF,Granada,es La Liga,27-064,1997,1.2,3,1,1,2,0,2,2,100.0,0,3,2,1,0,3,1,1,Matches
2542,Álvaro Vallés,es ESP,GK,Las Palmas,es La Liga,26-228,1997,27.0,2,1,2,0,0,2,7,28.6,5,0,0,0,0,2,35,1,Matches
2543,Federico Valverde,uy URU,MF,Real Madrid,es La Liga,25-231,1998,24.4,36,26,17,11,8,19,27,70.4,8,25,2,23,34,70,25,0,Matches
2544,Kévin Van Den Kerkhof,dz ALG,"FW,MF",Metz,fr Ligue 1,27-361,1996,13.9,22,16,8,9,5,9,22,40.9,13,11,2,9,8,30,23,1,Matches
2545,Siebe Van Der Heyden,be BEL,DF,Mallorca,es La Liga,25-284,1998,3.2,9,2,7,2,0,4,6,66.7,2,1,1,0,7,16,12,0,Matches
2546,Virgil van Dijk,nl NED,DF,Liverpool,eng Premier League,32-245,1991,24.3,27,13,17,7,3,8,9,88.9,1,35,26,9,30,57,110,0,Matches
2547,Vanderson,br BRA,DF,Monaco,fr Ligue 1,22-262,2001,13.0,42,28,15,18,9,21,48,43.8,27,20,1,19,25,67,23,1,Matches
2548,Raphaël Varane,fr FRA,DF,Manchester Utd,eng Premier League,30-319,1993,13.0,15,9,7,7,1,7,11,63.6,4,15,12,3,13,28,81,0,Matches
2549,Ruben Vargas,ch SUI,"MF,FW",Augsburg,de Bundesliga,25-217,1998,15.3,16,6,5,7,4,7,19,36.8,12,14,4,10,5,21,11,0,Matches
2550,Johan Vásquez,mx MEX,DF,Genoa,it Serie A,25-139,1998,21.9,42,27,30,10,2,30,41,73.2,11,38,18,20,31,73,74,0,Matches
2551,José Luis García Vayá,es ESP,MF,Valencia,es La Liga,25-211,1998,25.7,62,44,31,25,6,28,50,56.0,22,30,8,22,31,93,47,0,Matches
2552,Jesus Vazquez,es ESP,"DF,MF",Valencia,es La Liga,21-067,2003,3.3,9,3,6,2,1,5,7,71.4,2,7,1,6,0,9,4,0,Matches
2553,Kevin Vázquez,es ESP,DF,Celta Vigo,es La Liga,30-352,1993,7.0,15,13,7,7,1,12,18,66.7,6,11,3,8,4,19,25,0,Matches
2554,Lucas Vázquez,es ESP,DF,Real Madrid,es La Liga,32-252,1991,10.2,21,16,12,8,1,9,14,64.3,5,15,1,14,8,29,27,0,Matches
2555,Matías Vecino,uy URU,MF,Lazio,it Serie A,32-198,1991,6.4,13,8,4,9,0,6,13,46.2,7,11,3,8,6,19,7,0,Matches
2556,Gabriel Veiga,es ESP,FW,Celta Vigo,es La Liga,21-287,2002,0.2,0,0,0,0,0,0,0,,0,0,0,0,0,0,0,0,Matches
2557,Alejo Véliz,ar ARG,FW,Tottenham,eng Premier League,20-172,2003,0.6,1,0,1,0,0,0,0,,0,0,0,0,0,1,0,0,Matches
2558,Alejo Véliz,ar ARG,FW,Sevilla,es La Liga,20-172,2003,0.3,0,0,0,0,0,0,1,0.0,1,0,0,0,0,0,1,0,Matches
2559,Miloš Veljković,rs SRB,DF,Werder Bremen,de Bundesliga,28-165,1995,12.2,18,9,9,8,1,11,20,55.0,9,15,10,5,5,23,30,0,Matches
2560,Joël Veltman,nl NED,DF,Brighton,eng Premier League,32-054,1992,11.6,31,25,15,12,4,20,33,60.6,13,14,7,7,13,44,39,1,Matches
2561,Micky van de Ven,nl NED,DF,Tottenham,eng Premier League,22-325,2001,16.5,30,21,21,6,3,15,21,71.4,6,11,8,3,12,42,53,0,Matches
2562,Lorenzo Venuti,it ITA,DF,Lecce,it Serie A,28-332,1995,2.3,1,1,1,0,0,1,1,100.0,0,3,2,1,3,4,6,0,Matches
2563,Bart Verbruggen,nl NED,GK,Brighton,eng Premier League,21-204,2002,12.0,1,1,1,0,0,1,1,100.0,0,0,0,0,0,1,3,2,Matches
2564,Simone Verdi,it ITA,FW,Torino,it Serie A,31-241,1992,0.0,0,0,0,0,0,0,0,,0,0,0,0,0,0,0,0,Matches
2565,Jordan Veretout,fr FRA,MF,Marseille,fr Ligue 1,31-008,1993,15.5,27,17,16,8,3,13,26,50.0,13,18,4,14,8,35,19,0,Matches
2566,Arthur Vermeeren,be BEL,MF,Atlético Madrid,es La Liga,19-031,2005,0.7,1,0,0,1,0,0,0,,0,3,0,3,3,4,0,0,Matches
2567,Yorbe Vertessen,be BEL,FW,Union Berlin,de Bundesliga,23-061,2001,2.6,0,0,0,0,0,0,1,0.0,1,0,0,0,0,0,1,0,Matches
2568,Mikel Vesga,es ESP,MF,Athletic Club,es La Liga,30-293,1993,13.9,29,13,7,19,3,15,43,34.9,28,12,4,8,25,54,27,1,Matches
2569,Guglielmo Vicario,it ITA,GK,Tottenham,eng Premier League,27-154,1996,26.0,0,0,0,0,0,0,1,0.0,1,0,0,0,0,0,24,2,Matches
2570,Carlos Vicente,es ESP,"FW,MF",Alavés,es La Liga,24-321,1999,4.5,7,3,3,4,0,6,10,60.0,4,1,0,1,2,9,4,0,Matches
2571,Nacho Vidal,es ESP,"DF,FW",Osasuna,es La Liga,29-045,1995,1.1,5,4,2,2,1,2,5,40.0,3,2,0,2,0,5,6,0,Matches
2572,Nacho Vidal,es ESP,DF,Mallorca,es La Liga,29-045,1995,1.9,4,1,1,2,1,2,5,40.0,3,1,0,1,2,6,4,0,Matches
2573,Fabio Vieira,pt POR,"MF,FW",Arsenal,eng Premier League,23-284,2000,3.2,3,2,2,0,1,3,3,100.0,0,0,0,0,2,5,1,0,Matches
2574,Jonathan Viera,es ESP,"MF,FW",Las Palmas,es La Liga,34-140,1989,6.9,6,3,1,2,3,1,9,11.1,8,0,0,0,0,6,1,0,Matches
2575,Jonathan Viera,es ESP,MF,Almería,es La Liga,34-140,1989,2.3,3,0,1,2,0,3,5,60.0,2,0,0,0,0,3,0,0,Matches
2576,Emanuel Vignato,it ITA,MF,Salernitana,it Serie A,23-198,2000,0.0,0,0,0,0,0,0,0,,0,0,0,0,0,0,0,0,Matches
2577,Samuele Vignato,it ITA,"MF,FW",Monza,it Serie A,20-014,2004,3.8,6,4,2,3,1,2,3,66.7,1,2,0,2,1,7,1,0,Matches
2578,Oscar Vilhelmsson,se SWE,"FW,MF",Darmstadt 98,de Bundesliga,20-159,2003,7.0,8,4,0,5,3,4,5,80.0,1,9,3,6,2,10,5,0,Matches
2579,Asier Villalibre,es ESP,FW,Athletic Club,es La Liga,26-161,1997,3.8,2,1,0,0,2,2,2,100.0,0,1,0,1,0,2,4,0,Matches
2580,Gonzalo Villar,es ESP,MF,Granada,es La Liga,25-352,1998,15.5,41,26,20,17,4,19,33,57.6,14,27,10,17,6,47,23,1,Matches
2581,Iván Villar,es ESP,GK,Celta Vigo,es La Liga,26-244,1997,9.3,0,0,0,0,0,0,1,0.0,1,0,0,0,0,0,5,0,Matches
2582,Matías Viña,uy URU,DF,Sassuolo,it Serie A,26-121,1997,11.3,34,21,22,7,5,20,36,55.6,16,12,2,10,9,43,34,0,Matches
2583,Rúben Vinagre,pt POR,"FW,MF",Hellas Verona,it Serie A,24-335,1999,0.8,1,0,0,0,1,0,0,,0,1,1,0,0,1,2,0,Matches
2584,Carlos Vinícius,br BRA,FW,Fulham,eng Premier League,28-350,1995,3.5,3,2,0,1,2,0,4,0.0,4,4,0,4,0,3,1,0,Matches
2585,Nicolas Viola,it ITA,"MF,FW",Cagliari,it Serie A,34-149,1989,10.9,11,8,2,6,3,6,15,40.0,9,7,0,7,2,13,5,0,Matches
2586,Alan Virginius,fr FRA,FW,Lille,fr Ligue 1,21-066,2003,0.8,1,1,1,0,0,0,1,0.0,1,0,0,0,0,1,0,0,Matches
2587,Alan Virginius,fr FRA,"FW,MF",Clermont Foot,fr Ligue 1,21-066,2003,2.5,2,1,1,1,0,1,2,50.0,1,3,0,3,1,3,4,0,Matches
2588,Ricardo Visus,es ESP,DF,Betis,es La Liga,22-320,2001,0.8,,0,,,,,,,,,,,1,,,,Matches
2589,Mattia Viti,it ITA,DF,Sassuolo,it Serie A,22-045,2002,6.9,14,8,7,5,2,4,10,40.0,6,14,9,5,6,20,32,0,Matches
2590,Vitinha,pt POR,"FW,DF",Genoa,it Serie A,23-360,2000,0.6,2,2,1,0,1,1,1,100.0,0,0,0,0,0,2,2,0,Matches
2591,Vitinha,pt POR,FW,Marseille,fr Ligue 1,23-360,2000,10.3,14,8,3,5,6,3,12,25.0,9,11,2,9,5,19,8,0,Matches
2592,Vitinha,pt POR,MF,Paris S-G,fr Ligue 1,24-025,2000,18.6,30,17,10,11,9,14,39,35.9,25,22,6,16,20,50,17,2,Matches
2593,Vitinho,br BRA,DF,Burnley,eng Premier League,24-230,1999,16.8,44,21,27,13,4,30,60,50.0,30,24,1,23,10,54,30,3,Matches
2594,Daniel Vivian,es ESP,DF,Athletic Club,es La Liga,24-238,1999,23.7,30,21,24,6,0,19,31,61.3,12,40,18,22,19,49,77,0,Matches
2595,Odisseas Vlachodimos,gr GRE,GK,Nott'ham Forest,eng Premier League,29-318,1994,5.0,0,0,0,0,0,0,1,0.0,1,0,0,0,0,0,1,0,Matches
2596,Dušan Vlahović,rs SRB,FW,Juventus,it Serie A,24-041,2000,18.6,5,4,0,3,2,2,5,40.0,3,2,1,1,1,6,10,0,Matches
2597,Nikola Vlašić,hr CRO,"MF,FW",Torino,it Serie A,26-157,1997,22.7,23,14,3,13,7,4,25,16.0,21,17,4,13,7,30,13,0,Matches
2598,Alessandro Vogliacco,it ITA,DF,Genoa,it Serie A,25-177,1998,6.3,10,6,5,4,1,5,7,71.4,2,6,3,3,17,27,19,1,Matches
2599,Kevin Vogt,de GER,DF,Hoffenheim,de Bundesliga,32-168,1991,14.7,14,10,7,7,0,8,13,61.5,5,16,13,3,9,23,54,0,Matches
2600,Kevin Vogt,de GER,DF,Union Berlin,de Bundesliga,32-168,1991,8.7,6,5,4,2,0,5,7,71.4,2,12,9,3,4,10,41,2,Matches
2601,Mërgim Vojvoda,xk KVX,DF,Torino,it Serie A,29-037,1995,8.8,5,4,2,2,1,4,9,44.4,5,7,0,7,7,12,14,0,Matches
2602,Kevin Volland,de GER,"FW,MF",Union Berlin,de Bundesliga,31-223,1992,11.0,18,7,8,4,6,7,17,41.2,10,6,0,6,5,23,9,0,Matches
2603,Cristian Volpato,it ITA,"MF,FW",Sassuolo,it Serie A,20-115,2003,4.4,11,6,6,4,1,6,14,42.9,8,6,0,6,1,12,3,0,Matches
2604,Aster Vranckx,be BEL,MF,Wolfsburg,de Bundesliga,21-157,2002,9.6,26,12,10,7,9,13,24,54.2,11,14,5,9,10,36,23,0,Matches
2605,Stefan de Vrij,nl NED,DF,Inter,it Serie A,32-033,1992,14.6,16,12,11,4,1,6,11,54.5,5,17,7,10,20,36,40,0,Matches
2606,Elye Wahi,fr FRA,FW,Montpellier,fr Ligue 1,21-067,2003,0.2,0,0,0,0,0,0,0,,0,0,0,0,0,0,0,0,Matches
2607,Elye Wahi,fr FRA,FW,Lens,fr Ligue 1,21-067,2003,11.9,4,2,1,2,1,2,8,25.0,6,3,1,2,2,6,2,0,Matches
2608,Walace,br BRA,MF,Udinese,it Serie A,28-340,1995,26.0,46,32,25,21,0,26,55,47.3,29,31,4,27,34,80,47,1,Matches
2609,Luca Waldschmidt,de GER,"MF,FW",Köln,de Bundesliga,27-295,1996,9.4,16,9,2,11,3,5,14,35.7,9,14,3,11,5,21,8,0,Matches
2610,Kyle Walker,eng ENG,DF,Manchester City,eng Premier League,33-286,1990,24.1,25,15,13,10,2,13,27,48.1,14,13,4,9,19,44,33,1,Matches
2611,Sebastian Walukiewicz,pl POL,DF,Empoli,it Serie A,23-339,2000,15.7,28,20,26,2,0,20,26,76.9,6,28,16,12,12,40,90,0,Matches
2612,Aaron Wan-Bissaka,eng ENG,DF,Manchester Utd,eng Premier League,26-104,1997,9.8,25,19,12,11,2,16,22,72.7,6,14,8,6,20,45,38,1,Matches
2613,Joel Ward,eng ENG,DF,Crystal Palace,eng Premier League,34-132,1989,17.8,36,22,21,14,1,24,40,60.0,16,13,8,5,8,44,70,1,Matches
2614,James Ward-Prowse,eng ENG,MF,West Ham,eng Premier League,29-129,1994,25.4,34,23,12,17,5,12,29,41.4,17,23,7,16,29,63,41,0,Matches
2615,Deivid Washington,br BRA,DF,Chelsea,eng Premier League,18-278,2005,0.1,1,1,1,0,0,0,1,0.0,1,0,0,0,0,1,0,0,Matches
2616,Ollie Watkins,eng ENG,FW,Aston Villa,eng Premier League,28-070,1995,26.5,9,6,0,3,6,4,10,40.0,6,22,3,19,3,12,19,0,Matches
2617,Timothy Weah,us USA,"DF,FW",Juventus,it Serie A,24-016,2000,9.7,21,16,10,8,3,10,15,66.7,5,10,1,9,5,26,12,0,Matches
2618,Adam Webster,eng ENG,DF,Brighton,eng Premier League,29-065,1995,8.5,11,11,8,2,1,6,15,40.0,9,7,4,3,9,20,30,1,Matches
2619,Wout Weghorst,nl NED,FW,Hoffenheim,de Bundesliga,31-215,1992,16.9,12,6,4,6,2,9,12,75.0,3,17,4,13,4,16,16,0,Matches
2620,Julian Weigl,de GER,MF,M'Gladbach,de Bundesliga,28-183,1995,21.9,45,29,19,23,3,25,42,59.5,17,34,10,24,31,76,48,1,Matches
2621,Nelson Weiper,de GER,"FW,MF",Mainz 05,de Bundesliga,18-358,2005,1.2,1,0,1,0,0,1,2,50.0,1,1,0,1,1,2,0,0,Matches
2622,Mitchell Weiser,de GER,"DF,FW",Werder Bremen,de Bundesliga,29-323,1994,20.3,48,30,22,20,6,24,41,58.5,17,30,5,25,10,58,27,0,Matches
2623,Noah Weißhaupt,de GER,"DF,FW",Freiburg,de Bundesliga,22-171,2001,7.9,6,2,3,0,3,2,8,25.0,6,7,0,7,8,14,10,0,Matches
2624,Shon Weissman,il ISR,"FW,DF",Salernitana,it Serie A,28-024,1996,2.3,2,2,1,0,1,0,2,0.0,2,1,0,1,3,5,2,0,Matches
2625,Shon Weissman,il ISR,FW,Granada,es La Liga,28-024,1996,0.9,1,1,0,0,1,1,4,25.0,3,3,0,3,0,1,1,0,Matches
2626,Danny Welbeck,eng ENG,"FW,MF",Brighton,eng Premier League,33-104,1990,11.1,17,8,4,9,4,6,11,54.5,5,10,0,10,5,22,14,1,Matches
2627,Timo Werner,de GER,FW,Tottenham,eng Premier League,28-003,1996,4.6,3,1,2,1,0,2,8,25.0,6,1,0,1,3,6,0,0,Matches
2628,Timo Werner,de GER,"FW,MF",RB Leipzig,de Bundesliga,28-003,1996,2.3,2,1,0,1,1,0,0,,0,1,0,1,1,3,0,0,Matches
2629,Adam Wharton,eng ENG,MF,Crystal Palace,eng Premier League,19-281,2004,4.2,15,13,4,8,3,8,17,47.1,9,5,2,3,7,22,5,1,Matches
2630,Ben White,eng ENG,DF,Arsenal,eng Premier League,26-153,1997,22.7,30,19,12,15,3,15,31,48.4,16,30,16,14,24,54,47,1,Matches
2631,Joe White,eng ENG,MF,Newcastle Utd,eng Premier League,21-160,2002,0.0,0,0,0,0,0,0,0,,0,0,0,0,0,0,0,0,Matches
2632,Silvan Widmer,ch SUI,"DF,FW",Mainz 05,de Bundesliga,31-004,1993,8.9,14,8,8,4,2,10,20,50.0,10,10,3,7,8,22,21,0,Matches
2633,Mateusz Wieteska,pl POL,DF,Cagliari,it Serie A,27-027,1997,7.9,8,7,5,1,2,1,7,14.3,6,8,3,5,14,22,38,0,Matches
2634,Mateusz Wieteska,pl POL,DF,Clermont Foot,fr Ligue 1,27-027,1997,1.9,4,1,3,1,0,3,5,60.0,2,4,2,2,5,9,8,0,Matches
2635,Iñaki Williams,gh GHA,FW,Athletic Club,es La Liga,29-268,1994,22.6,20,14,5,7,8,11,26,42.3,15,32,5,27,11,31,23,0,Matches
2636,Neco Williams,wls WAL,"DF,FW",Nott'ham Forest,eng Premier League,22-331,2001,10.9,51,27,35,11,5,29,45,64.4,16,29,9,20,16,67,30,0,Matches
2637,Nico Williams,es ESP,FW,Athletic Club,es La Liga,21-241,2002,17.2,23,9,9,8,6,10,27,37.0,17,13,2,11,3,26,4,0,Matches
2638,Willian,br BRA,FW,Fulham,eng Premier League,35-213,1988,16.7,8,4,3,2,3,2,15,13.3,13,12,0,12,8,16,12,0,Matches
2639,Joe Willock,eng ENG,"MF,FW",Newcastle Utd,eng Premier League,24-202,1999,2.5,7,3,4,3,0,4,9,44.4,5,5,0,5,1,8,1,0,Matches
2640,Callum Wilson,eng ENG,FW,Newcastle Utd,eng Premier League,32-011,1992,9.6,4,3,0,2,2,0,4,0.0,4,5,0,5,1,5,2,0,Matches
2641,Harry Wilson,wls WAL,FW,Fulham,eng Premier League,26-353,1997,14.7,19,12,8,8,3,11,23,47.8,12,23,3,20,10,29,9,0,Matches
2642,Josh Wilson-Esbrand,eng ENG,"DF,MF",Reims,fr Ligue 1,21-074,2002,5.1,5,4,2,3,0,2,8,25.0,6,5,2,3,6,11,7,0,Matches
2643,Patrick Wimmer,at AUT,FW,Wolfsburg,de Bundesliga,22-284,2001,3.3,8,4,5,2,1,7,12,58.3,5,9,0,9,2,10,4,0,Matches
2644,Jonas Wind,dk DEN,FW,Wolfsburg,de Bundesliga,25-031,1999,22.7,10,8,3,4,3,5,13,38.5,8,11,3,8,3,13,17,0,Matches
2645,Florian Wirtz,de GER,MF,Leverkusen,de Bundesliga,20-311,2003,21.1,19,14,6,9,4,7,24,29.2,17,25,2,23,6,25,2,0,Matches
2646,Yoane Wissa,cd COD,FW,Brentford,eng Premier League,27-188,1996,19.4,20,12,8,7,5,1,14,7.1,13,15,3,12,7,27,9,0,Matches
2647,Axel Witsel,be BEL,DF,Atlético Madrid,es La Liga,35-057,1989,22.7,25,14,15,10,0,12,18,66.7,6,34,21,13,8,33,88,0,Matches
2648,Maximilian Wittek,de GER,"DF,FW",Bochum,de Bundesliga,28-201,1995,7.8,17,12,6,10,1,9,17,52.9,8,9,1,8,16,33,18,0,Matches
2649,Maximilian Wöber,at AUT,DF,M'Gladbach,de Bundesliga,26-034,1998,18.1,50,27,30,19,1,19,35,54.3,16,40,22,18,33,83,93,0,Matches
2650,Marius Wolf,de GER,DF,Dortmund,de Bundesliga,28-287,1995,7.5,12,7,4,7,1,6,13,46.2,7,7,0,7,5,17,12,0,Matches
2651,Nick Woltemade,de GER,"FW,MF",Werder Bremen,de Bundesliga,22-024,2002,6.3,18,13,3,11,4,10,14,71.4,4,4,0,4,1,19,12,0,Matches
2652,Jeong Woo-yeong,kr KOR,"MF,FW",Stuttgart,de Bundesliga,24-171,1999,5.4,11,7,4,6,1,5,7,71.4,2,4,0,4,5,16,2,0,Matches
2653,Chris Wood,nz NZL,FW,Nott'ham Forest,eng Premier League,32-093,1991,9.7,2,2,0,1,1,1,4,25.0,3,7,2,5,1,3,19,0,Matches
2654,Cauley Woodrow,eng ENG,"FW,MF",Luton Town,eng Premier League,29-098,1994,2.5,10,7,5,2,3,7,13,53.8,6,2,1,1,0,10,6,0,Matches
2655,Christopher Wooh,cm CMR,DF,Rennes,fr Ligue 1,22-173,2001,7.2,6,4,5,1,0,1,2,50.0,1,11,5,6,15,21,31,0,Matches
2656,Joe Worrall,eng ENG,DF,Nott'ham Forest,eng Premier League,27-059,1997,4.9,7,5,6,1,0,3,6,50.0,3,5,4,1,3,10,32,1,Matches
2657,Xeber,es ESP,"FW,MF",Alavés,es La Liga,26-257,1997,3.0,4,4,2,2,0,2,6,33.3,4,1,0,1,1,5,2,0,Matches
2658,Granit Xhaka,ch SUI,MF,Leverkusen,de Bundesliga,31-164,1992,23.6,25,17,9,13,3,8,26,30.8,18,23,5,18,14,39,30,0,Matches
2659,Abduqodir Xusanov,uz UZB,DF,Lens,fr Ligue 1,20-009,2004,5.6,11,7,8,3,0,7,15,46.7,8,9,5,4,4,15,18,2,Matches
2660,Antal Yaakobishvili,hu HUN,DF,Girona,es La Liga,19-241,2004,0.7,2,1,1,1,0,1,1,100.0,0,0,0,0,3,5,3,0,Matches
2661,Lamine Yamal,es ESP,FW,Barcelona,es La Liga,16-240,2007,16.4,46,30,24,12,10,14,34,41.2,20,23,0,23,14,60,11,0,Matches
2662,Roman Yaremchuk,ua UKR,FW,Valencia,es La Liga,28-103,1995,7.0,5,2,1,2,2,3,5,60.0,2,2,0,2,1,6,6,0,Matches
2663,Yehor Yarmoliuk,ua UKR,MF,Brentford,eng Premier League,20-008,2004,4.7,,8,,,,,,,,,,,3,,,,Matches
2664,Ryan Yates,eng ENG,MF,Nott'ham Forest,eng Premier League,26-109,1997,14.0,44,26,26,14,4,10,20,50.0,10,32,13,19,14,58,28,0,Matches
2665,Yusuf Yazıcı,tr TUR,"MF,FW",Lille,fr Ligue 1,27-040,1997,12.1,17,10,6,7,4,3,11,27.3,8,9,1,8,5,22,5,0,Matches
2666,Kelvin Yeboah,it ITA,FW,Montpellier,fr Ligue 1,23-308,2000,3.1,4,2,2,2,0,1,3,33.3,2,3,2,1,1,5,3,0,Matches
2667,Kenan Yıldız,tr TUR,"FW,DF",Juventus,it Serie A,18-310,2005,6.4,9,6,3,5,1,3,6,50.0,3,4,0,4,0,9,2,0,Matches
2668,Darlin Yongwa,cm CMR,DF,Lorient,fr Ligue 1,23-169,2000,8.5,20,16,10,8,2,9,15,60.0,6,9,2,7,11,31,27,0,Matches
2669,Leny Yoro,fr FRA,DF,Lille,fr Ligue 1,18-117,2005,21.6,27,20,19,6,2,12,19,63.2,7,11,6,5,31,58,69,1,Matches
2670,Ashley Young,eng ENG,"DF,MF",Everton,eng Premier League,38-244,1985,16.8,29,20,14,11,4,17,35,48.6,18,14,5,9,16,45,32,2,Matches
2671,Etienne Youte Kinkoue,fr FRA,DF,Le Havre,fr Ligue 1,22-055,2002,14.0,10,7,9,1,0,5,9,55.6,4,12,9,3,29,39,75,0,Matches
2672,Illia Zabarnyi,ua UKR,DF,Bournemouth,eng Premier League,21-190,2002,26.0,43,25,19,23,1,15,34,44.1,19,38,25,13,27,70,97,3,Matches
2673,Mattia Zaccagni,it ITA,FW,Lazio,it Serie A,28-267,1995,15.6,18,15,9,9,0,4,11,36.4,7,19,2,17,16,34,10,0,Matches
2674,Dan-Axel Zagadou,fr FRA,DF,Stuttgart,de Bundesliga,24-280,1999,16.1,21,14,16,5,0,4,8,50.0,4,23,18,5,20,41,78,1,Matches
2675,Warren Zaire-Emery,fr FRA,"MF,DF",Paris S-G,fr Ligue 1,18-001,2006,16.8,35,19,10,17,8,22,40,55.0,18,26,7,19,14,49,15,1,Matches
2676,Denis Zakaria,ch SUI,"MF,DF",Monaco,fr Ligue 1,27-110,1996,18.0,33,24,10,16,7,11,24,45.8,13,32,11,21,36,69,34,0,Matches
2677,Arsen Zakharyan,ru RUS,"MF,FW",Real Sociedad,es La Liga,20-288,2003,8.6,15,12,7,8,0,6,12,50.0,6,14,0,14,1,16,6,0,Matches
2678,Joseba Zaldúa,es ESP,"DF,MF",Cádiz,es La Liga,31-259,1992,3.6,12,7,10,1,1,6,9,66.7,3,4,3,1,1,13,10,0,Matches
2679,Nicola Zalewski,pl POL,"DF,FW",Roma,it Serie A,22-046,2002,7.7,17,12,8,8,1,6,17,35.3,11,9,3,6,7,24,15,0,Matches
2680,Andre-Frank Zambo Anguissa,cm CMR,MF,Napoli,it Serie A,28-114,1995,21.3,41,21,14,20,7,24,51,47.1,27,30,4,26,22,63,16,1,Matches
2681,Nicolò Zaniolo,it ITA,"FW,MF",Aston Villa,eng Premier League,24-251,1999,6.2,11,4,6,3,2,5,11,45.5,6,12,0,12,1,12,9,0,Matches
2682,Alessandro Zanoli,it ITA,DF,Salernitana,it Serie A,23-158,2000,4.7,10,8,6,4,0,6,8,75.0,2,5,1,4,1,11,7,0,Matches
2683,Alessandro Zanoli,it ITA,"DF,FW",Napoli,it Serie A,23-158,2000,0.6,1,1,1,0,0,0,0,,0,0,0,0,1,2,1,0,Matches
2684,Duván Zapata,co COL,FW,Torino,it Serie A,32-343,1991,22.8,11,4,8,1,2,0,5,0.0,5,13,3,10,4,15,11,0,Matches
2685,Duván Zapata,co COL,FW,Atalanta,it Serie A,32-343,1991,1.2,0,0,0,0,0,0,1,0.0,1,0,0,0,0,0,1,0,Matches
2686,Gabriele Zappa,it ITA,DF,Cagliari,it Serie A,24-078,1999,21.0,35,22,19,11,5,22,32,68.8,10,18,3,15,17,52,56,1,Matches
2687,Davide Zappacosta,it ITA,"DF,MF",Atalanta,it Serie A,31-272,1992,14.8,17,14,6,7,4,11,21,52.4,10,19,3,16,3,20,15,0,Matches
2688,Bryan Zaragoza,es ESP,"MF,FW",Granada,es La Liga,22-319,2001,18.2,18,9,8,6,4,8,23,34.8,15,9,0,9,3,21,3,0,Matches
2689,Bryan Zaragoza,es ESP,MF,Bayern Munich,de Bundesliga,22-319,2001,0.3,1,1,1,0,0,1,1,100.0,0,0,0,0,1,2,0,0,Matches
2690,Anass Zaroury,ma MAR,"FW,MF",Burnley,eng Premier League,23-123,2000,1.7,1,0,1,0,0,0,4,0.0,4,2,0,2,0,1,1,1,Matches
2691,Oier Zarraga,es ESP,"MF,DF",Udinese,it Serie A,25-065,1999,1.3,2,2,1,1,0,1,3,33.3,2,2,1,1,2,4,6,1,Matches
2692,Mehdi Zeffane,dz ALG,DF,Clermont Foot,fr Ligue 1,31-295,1992,8.9,16,12,10,3,3,7,19,36.8,12,4,1,3,10,26,20,0,Matches
2693,Jordan Zemura,zw ZIM,DF,Udinese,it Serie A,24-116,1999,10.4,23,16,13,7,3,10,17,58.8,7,5,1,4,13,36,16,0,Matches
2694,Robin Zentner,de GER,GK,Mainz 05,de Bundesliga,29-133,1994,20.0,2,2,2,0,0,2,5,40.0,3,0,0,0,0,2,10,1,Matches
2695,Alessio Zerbin,it ITA,"DF,MF",Monza,it Serie A,25-006,1999,1.3,3,1,3,0,0,0,1,0.0,1,4,1,3,2,5,3,0,Matches
2696,Alessio Zerbin,it ITA,"FW,DF",Napoli,it Serie A,25-006,1999,1.7,5,2,1,3,1,2,7,28.6,5,1,0,1,0,5,0,0,Matches
2697,Kevin Zeroli,it ITA,MF,Milan,it Serie A,19-058,2005,0.2,0,0,0,0,0,0,0,,0,0,0,0,0,0,0,0,Matches
2698,Cedric Zesiger,ch SUI,DF,Wolfsburg,de Bundesliga,25-259,1998,10.9,10,5,8,2,0,9,14,64.3,5,22,13,9,10,20,47,1,Matches
2699,Michael Zetterer,de GER,GK,Werder Bremen,de Bundesliga,28-241,1995,17.0,1,0,1,0,0,1,1,100.0,0,0,0,0,0,1,5,2,Matches
2700,Nathan Zeze,fr FRA,DF,Nantes,fr Ligue 1,18-265,2005,7.0,5,3,5,0,0,4,8,50.0,4,6,3,3,8,13,24,0,Matches
2701,Edon Zhegrova,xk KVX,FW,Lille,fr Ligue 1,24-344,1999,17.8,19,11,5,9,5,7,18,38.9,11,10,0,10,5,24,5,0,Matches
2702,Piotr Zieliński,pl POL,MF,Napoli,it Serie A,29-294,1994,18.3,19,13,5,10,4,10,21,47.6,11,12,1,11,8,27,14,0,Matches
2703,David Zima,cz CZE,DF,Torino,it Serie A,23-122,2000,1.0,1,1,1,0,0,0,0,,0,0,0,0,3,4,7,0,Matches
2704,Christoph Zimmermann,de GER,DF,Darmstadt 98,de Bundesliga,31-057,1993,10.3,24,16,19,5,0,15,27,55.6,12,17,12,5,15,39,50,1,Matches
2705,Oleksandr Zinchenko,ua UKR,DF,Arsenal,eng Premier League,27-085,1996,15.9,46,27,18,22,6,33,48,68.8,15,17,3,14,14,60,18,2,Matches
2706,Joshua Zirkzee,nl NED,FW,Bologna,it Serie A,22-292,2001,24.2,25,18,8,10,7,12,22,54.5,10,16,1,15,3,28,34,0,Matches
2707,Simon Zoller,de GER,"FW,MF",Bochum,de Bundesliga,32-257,1991,0.5,0,0,0,0,0,0,0,,0,1,0,1,0,0,0,0,Matches
2708,Nadir Zortea,it ITA,DF,Frosinone,it Serie A,24-264,1999,3.0,8,5,3,5,0,3,6,50.0,3,1,0,1,3,11,12,0,Matches
2709,Nadir Zortea,it ITA,DF,Atalanta,it Serie A,24-264,1999,1.7,5,4,3,1,1,1,4,25.0,3,2,0,2,1,6,3,0,Matches
2710,Kurt Zouma,fr FRA,DF,West Ham,eng Premier League,29-134,1994,22.2,13,9,8,5,0,4,7,57.1,3,29,20,9,20,33,115,0,Matches
2711,Igor Zubeldia,es ESP,DF,Real Sociedad,es La Liga,26-345,1997,23.0,28,21,20,7,1,17,23,73.9,6,24,16,8,28,56,87,2,Matches
2712,Martín Zubimendi,es ESP,MF,Real Sociedad,es La Liga,25-036,1999,24.7,42,23,14,26,2,19,34,55.9,15,26,5,21,33,75,48,0,Matches
2713,Szymon Żurkowski,pl POL,MF,Empoli,it Serie A,26-166,1997,5.0,12,4,4,7,1,4,7,57.1,3,2,0,2,4,16,6,0,Matches
2714,Lovro Zvonarek,hr CRO,MF,Bayern Munich,de Bundesliga,18-306,2005,0.0,0,0,0,0,0,0,0,,0,0,0,0,0,0,1,0,Matches
2715,Martin Ødegaard,no NOR,MF,Arsenal,eng Premier League,25-083,1998,23.5,33,12,8,19,6,10,37,27.0,27,18,1,17,7,40,5,0,Matches
2716,Milan Đurić,ba BIH,FW,Hellas Verona,it Serie A,33-292,1990,13.4,1,0,0,0,1,0,3,0.0,3,0,0,0,1,2,13,0,Matches
2717,Milan Đurić,ba BIH,FW,Monza,it Serie A,33-292,1990,4.3,3,3,0,3,0,1,2,50.0,1,3,1,2,0,3,5,0,Matches
2718,Mateusz Łęgowski,pl POL,MF,Salernitana,it Serie A,21-040,2003,10.3,16,9,6,9,1,10,25,40.0,15,10,2,8,4,20,15,0,Matches
